time,open,high,low,close,ParabolicSAR,WMA,MA,Smoothing Line,MA №1,MA №2,MA №3,MA №4,EMA,Smoothing Line,NV,OnBalanceVolume,Smoothing Line,OSC,PVT,ROC
2023-04-30T17:00:00-04:00,1.10246,1.10246,1.10165,1.10205,NaN,NaN,NaN,NaN,NaN,NaN,NaN,NaN,NaN,NaN,NaN,NaN,NaN,NaN,NaN,NaN
2023-04-30T17:15:00-04:00,1.10205,1.10221,1.10168,1.10168,1.10246,NaN,NaN,NaN,NaN,NaN,NaN,NaN,NaN,NaN,-73,-73,NaN,NaN,-0.0245088698334909,NaN
2023-04-30T17:30:00-04:00,1.10168,1.10196,1.10168,1.10168,1.10246,NaN,NaN,NaN,NaN,NaN,NaN,NaN,NaN,NaN,0,-73,NaN,NaN,-0.0245088698334909,NaN
2023-04-30T17:45:00-04:00,1.10168,1.10186,1.10168,1.10176,1.1024444,NaN,NaN,NaN,NaN,NaN,NaN,NaN,NaN,NaN,187,114,NaN,NaN,-0.010929609068100804,NaN
2023-04-30T18:00:00-04:00,1.10176,1.102,1.1013,1.10161,1.102429112,NaN,NaN,NaN,NaN,NaN,NaN,NaN,NaN,NaN,-1053,-939,NaN,NaN,-0.15429113971007322,NaN
2023-04-30T18:15:00-04:00,1.10161,1.10183,1.10133,1.10141,1.1023839475200001,NaN,NaN,NaN,NaN,NaN,NaN,NaN,NaN,NaN,-1155,-2094,-613,NaN,-0.3639842252847998,NaN
2023-04-30T18:30:00-04:00,1.10141,1.10148,1.10105,1.10116,1.1023405896192002,NaN,NaN,NaN,NaN,NaN,NaN,NaN,NaN,NaN,-858,-2952,-1188.8,NaN,-0.5587345907255272,NaN
2023-04-30T18:45:00-04:00,1.10116,1.10138,1.10106,1.10113,1.1022631542420482,NaN,NaN,NaN,NaN,NaN,NaN,NaN,NaN,NaN,-575,-3527,-1879.6,NaN,-0.574399889138097,NaN
2023-04-30T19:00:00-04:00,1.10113,1.10134,1.10105,1.10108,1.1021903649875253,1.101352888888889,1.1015066666666666,NaN,NaN,NaN,NaN,NaN,1.1015066666666666,NaN,-796,-4323,-2767,NaN,-0.6105445768678903,NaN
2023-04-30T19:15:00-04:00,1.10108,1.10127,1.10106,1.10124,1.1021219430882738,1.1012995555555554,1.1014166666666665,NaN,NaN,NaN,NaN,NaN,1.1014533333333334,NaN,591,-3732,-3325.6,NaN,-0.5246652583806203,-0.07349938750510207
2023-04-30T19:30:00-04:00,1.10124,1.10134,1.101,1.10108,1.1020576265029773,1.1012322222222222,1.10135,NaN,NaN,NaN,NaN,NaN,1.1013786666666667,NaN,-635,-4367,-3780.2,NaN,-0.6169248929743152,-0.054462275796958635
2023-04-30T19:45:00-04:00,1.10108,1.10115,1.10101,1.10106,1.1019730163827393,1.1011742222222223,1.1012811111111112,NaN,NaN,NaN,NaN,NaN,1.1013149333333334,NaN,-720,-5087,-4207.2,NaN,-0.6300029617795739,-0.056277684990202685
2023-04-30T20:00:00-04:00,1.10106,1.10143,1.1010199999999999,1.10108,1.1018951750721202,1.1011339999999998,1.1012055555555555,1.1013519999999999,NaN,NaN,NaN,NaN,1.1012679466666668,1.1013843093333333,1420,-3667,-4235.2,NaN,-0.6042096353485111,-0.06171943072901665
2023-04-30T20:15:00-04:00,1.10108,1.10112,1.10063,1.1007,1.1018235610663505,1.101032888888889,1.1011044444444444,1.1012715555555554,NaN,NaN,NaN,NaN,1.1011543573333336,1.1013138474666668,-1558,-5225,-4415.6,NaN,-1.1418999030857084,-0.08260636704459531
2023-04-30T20:30:00-04:00,1.1007,1.10098,1.10062,1.10089,1.1017042049597154,1.10099,1.1010466666666667,1.1011975555555555,NaN,NaN,NaN,NaN,1.1011014858666668,1.1012434779733336,911,-4314,-4532,NaN,-0.9846454286604152,-0.04721220980380385
2023-04-30T20:45:00-04:00,1.10089,1.10105,1.10044,1.10055,1.1015741003645496,1.1008906666666667,1.100978888888889,1.1011233333333332,NaN,NaN,NaN,NaN,1.1009911886933335,1.1011659823786668,-1372,-5686,-4795.8,NaN,-1.4083753199302147,-0.05539612771985901
2023-04-30T21:00:00-04:00,1.10055,1.10066,1.10028,1.10039,1.1014153263135127,1.1007728888888888,1.1008966666666666,1.1010464444444445,NaN,NaN,NaN,NaN,1.1008709509546668,1.1010771859029336,-1131,-6817,-5141.8,NaN,-1.5728021974005066,-0.0672036907540402
2023-04-30T21:15:00-04:00,1.10039,1.10061,1.10023,1.10059,1.1012336741033506,1.1007115555555556,1.1008422222222223,1.1009737777777777,NaN,NaN,NaN,NaN,1.1008147607637335,1.100986548722347,995,-5822,-5572.8,NaN,-1.3919572242546419,-0.04450176190650102
2023-04-30T21:30:00-04:00,1.10059,1.10084,1.10045,1.10054,1.1010530127647475,1.100651111111111,1.1007644444444447,1.1009057777777778,NaN,NaN,NaN,NaN,1.1007598086109869,1.1009076389778776,-869,-6691,-5866,NaN,-1.4314360492484168,-0.06356470887362636
2023-04-30T21:45:00-04:00,1.10054,1.10058,1.1002,1.10039,1.100904870467093,1.1005762222222222,1.100687777777778,1.1008340000000003,1.1011035,NaN,NaN,NaN,1.1006858468887895,1.1008245111823018,-1036,-7727,-6548.6,NaN,-1.572639458483972,-0.06266574635812833
2023-04-30T22:00:00-04:00,1.10039,1.10042,1.10009,1.1002399999999999,1.10084,1.1004866666666666,1.100596666666667,1.1007575555555555,1.101013,NaN,NaN,NaN,1.1005966775110316,1.1007456089458416,-1107,-8834,-7178.2,-0.03808875497300807,-1.723540502659314,-0.07447368899061295
2023-04-30T22:15:00-04:00,1.1002399999999999,1.10033,1.1000699999999999,1.1003,1.10069,1.1004273333333334,1.1005100000000003,1.1006802222222225,1.100944,NaN,NaN,NaN,1.1005373420088254,1.1006788871566733,864,-7970,-7408.8,-0.037425564086687915,-1.676423510003032,-0.07083953936135456
2023-04-30T22:30:00-04:00,1.1003,1.1006799999999999,1.10026,1.10058,1.1000699999999999,1.1004413333333334,1.100496666666667,1.1006111111111114,1.100889,NaN,NaN,NaN,1.1005458736070604,1.1006251097253388,1026,-6944,-7633.2,-0.03721107672927832,-1.4153310806657315,-0.010902153175263015
2023-04-30T22:45:00-04:00,1.10058,1.10082,1.10046,1.10081,1.1000699999999999,1.1005040000000001,1.100487777777778,1.100555777777778,1.1008415,NaN,NaN,NaN,1.1005986988856482,1.100592887780271,888,-6056,-7506.2,-0.03245007589128975,-1.229756201965269,-0.007266847732276428
2023-04-30T23:00:00-04:00,1.10081,1.10106,1.10055,1.10093,1.1000999999999999,1.1005924444444444,1.1005300000000002,1.1005242222222225,1.1008075,NaN,NaN,NaN,1.1006649591085185,1.100588710224217,1196,-4860,-6932.8,-0.028497570698877962,-1.0993794793701999,0.0345281904502337
2023-04-30T23:15:00-04:00,1.10093,1.1012,1.1008499999999999,1.10113,1.1001576,1.1007124444444443,1.1006122222222223,1.1005273333333334,1.1007935,NaN,NaN,NaN,1.1007579672868149,1.1006209681793737,831,-4029,-5971.8,-0.02115300762025376,-0.9484162028676232,0.067248884486406
2023-04-30T23:30:00-04:00,1.10113,1.10113,1.1008499999999999,1.10094,1.100240992,1.1007779999999998,1.1006511111111115,1.1005555555555557,1.1007825,NaN,NaN,NaN,1.1007943738294519,1.100672374543499,-981,-5010,-5379.8,-0.014123921077314498,-1.1176877693492504,0.03180112485122275
2023-04-30T23:45:00-04:00,1.10094,1.1014,1.10089,1.1014,1.1003177126400001,1.1009277777777777,1.1007466666666668,1.1006055555555556,1.100796,NaN,NaN,NaN,1.1009154990635615,1.1007462996347992,1214,-3796,-4750.2,-0.007803763888525427,-0.6104485010876879,0.07814345684844357
2023-05-01T00:00:00-04:00,1.1014,1.10143,1.10106,1.10117,1.100425941376,1.1010124444444445,1.1008333333333336,1.100674666666667,1.1008005,NaN,NaN,NaN,1.1009663992508492,1.1008198397078393,-1073,-4869,-4512.8,-0.0022537438751859293,-0.8345178673487638,0.07088395932351284
2023-05-01T00:15:00-04:00,1.10117,1.10136,1.10097,1.10134,1.10054642841088,1.1011137777777775,1.1009555555555557,1.1007597777777778,1.1008055,NaN,NaN,NaN,1.1010411194006793,1.1008950717662713,1039,-3830,-4306.8,0.005251466971816199,-0.6741157496012737,0.09997818657748318
2023-05-01T00:30:00-04:00,1.10134,1.10136,1.10083,1.10084,1.1006524570015743,1.1010906666666667,1.1010155555555559,1.1008404444444444,1.1007935,NaN,NaN,NaN,1.1010008955205435,1.100943657413017,-759,-4589,-4418.8,0.012432435939914365,-1.0186959882196462,0.049077524311550026
2023-05-01T00:45:00-04:00,1.10084,1.10088,1.10032,1.10061,1.10143,1.1010095555555557,1.1010188888888892,1.100914,1.1007710000000002,NaN,NaN,NaN,1.1009227164164348,1.1009693259304139,-914,-5503,-4517.4,0.01728204294083493,-1.2096592526358707,0.0027258354685889747
2023-05-01T01:00:00-04:00,1.10061,1.10061,1.10037,1.10044,1.1014077999999998,1.1008937777777779,1.100977777777778,1.1009602222222221,1.1007390000000001,NaN,NaN,NaN,1.100826173133148,1.1009514607443311,-1361,-6864,-5131,0.01869279360582066,-1.4198790398447865,-0.03361161326659291
2023-05-01T01:15:00-04:00,1.10044,1.1006,1.10026,1.10032,1.1013860439999998,1.1007622222222222,1.1009100000000003,1.1009755555555556,1.1007200000000001,NaN,NaN,NaN,1.1007249385065183,1.1009031685954649,-1111,-7975,-5752.2,0.01752966675468485,-1.5410305792291539,-0.055407700762082915
2023-05-01T01:30:00-04:00,1.10032,1.10078,1.10008,1.10072,1.1013410022399999,1.1007242222222222,1.1008644444444446,1.1009573333333333,1.1007115,NaN,NaN,NaN,1.1007239508052147,1.1008397348763719,1247,-6728,-6331.8,0.015535285994634716,-1.0877079094604092,-0.03723447730967474
2023-05-01T01:45:00-04:00,1.10072,1.10087,1.10043,1.1006,1.1012653421055998,1.1006713333333333,1.100826666666667,1.1009195555555558,1.1007140000000002,NaN,NaN,NaN,1.1006991606441718,1.1007793879010976,-1242,-7970,-7008,0.011974996138893827,-1.2231101916028917,-0.030882700237979087
2023-05-01T02:00:00-04:00,1.1006,1.10065,1.1001,1.10025,1.1011942215792638,1.1005559999999999,1.1006988888888891,1.1008555555555557,1.100707,NaN,NaN,NaN,1.1006093285153375,1.1007167103208781,-2154,-10124,-7932.2,0.007004252303682891,-1.9081001970546054,-0.10441256582531182
2023-05-01T02:15:00-04:00,1.10025,1.10025,1.09949,1.09967,1.101127368284508,1.1003502222222221,1.1005322222222227,1.1007664444444445,1.1006610000000001,NaN,NaN,NaN,1.10042146281227,1.1006357682567025,-1676,-11800,-8919.4,-0.005598384688592483,-2.7916084906242866,-0.136218749148638
2023-05-01T02:30:00-04:00,1.09967,1.10016,1.09947,1.10016,1.1009963788217474,1.1002757777777779,1.1004011111111116,1.1006646666666668,1.1006420000000001,NaN,NaN,NaN,1.100369170249816,1.100564614605362,1729,-10071,-9338.6,-0.012914597518780241,-2.0211864549225074,-0.10714220858226876
2023-05-01T02:45:00-04:00,1.10016,1.10056,1.09964,1.09978,1.1008437409395726,1.1001515555555557,1.1002833333333337,1.1005484444444447,1.1006114999999999,NaN,NaN,NaN,1.1002513361998527,1.1004700916842896,-1959,-12030,-10399,-0.02380084992521926,-2.6978334880814043,-0.0962901057374424
2023-05-01T03:00:00-04:00,1.09978,1.10045,1.09978,1.09987,1.1007063668456154,1.1000688888888888,1.1002011111111114,1.1004233333333335,1.100593,NaN,NaN,NaN,1.1001750689598822,1.1003652733474314,2310,-9720,-10749,-0.030365046880141102,-2.508795680520053,-0.06723544216390773
2023-05-01T03:15:00-04:00,1.09987,1.10057,1.09971,1.10021,1.1005827301610538,1.1000706666666666,1.100175555555556,1.100318666666667,1.1005885,NaN,NaN,NaN,1.1001820551679058,1.1002798186779452,2343,-7377,-10199.6,-0.033869748577185305,-1.7845100831312557,-0.020900730616860028
2023-05-01T03:30:00-04:00,1.10021,1.10046,1.09961,1.10002,1.10057,1.1000395555555555,1.1001422222222226,1.1002406666666669,1.1005604999999998,NaN,NaN,NaN,1.1001496441343246,1.1002254549423562,-2037,-9414,-9722.4,-0.03647489008849286,-2.136288380001691,-0.027264795695794583
2023-05-01T03:45:00-04:00,1.10002,1.10033,1.09973,1.10033,1.10057,1.100077111111111,1.1000988888888894,1.1001802222222226,1.1005365,NaN,NaN,NaN,1.1001857153074597,1.100188763953885,1914,-7500,-9208.2,-0.035302710247720574,-1.596898187096051,-0.03543135402281147
2023-05-01T04:00:00-04:00,1.10033,1.10033,1.09974,1.09992,1.10046,1.1000413333333334,1.1000233333333336,1.1001282222222226,1.100486,NaN,NaN,NaN,1.1001325722459678,1.1001650111631078,-2158,-9658,-8733.8,-0.038722407201790335,-2.401002410374564,-0.061784481192078314
2023-05-01T04:15:00-04:00,1.09992,1.09992,1.09918,1.09943,1.100361,1.0999226666666666,1.0999322222222228,1.1000744444444448,1.100401,NaN,NaN,NaN,1.0999920577967743,1.1001284089304866,-1793,-11451,-9080,-0.04286613743898167,-3.199760501872293,-0.07452851624631156
2023-05-01T04:30:00-04:00,1.09943,1.09966,1.09914,1.0996,1.10033,1.0998562222222221,1.0999244444444447,1.1000242222222227,1.100334,NaN,NaN,NaN,1.0999136462374195,1.1000747271443891,1811,-9640,-9532.6,-0.04215492551798362,-2.919733578830347,-0.006365546027445916
2023-05-01T04:45:00-04:00,1.0996,1.09973,1.09915,1.09922,1.1001634,1.0997153333333334,1.0998200000000002,1.0999597777777779,1.100225,NaN,NaN,NaN,1.0997749169899356,1.0999997817155114,-1271,-10911,-9832,-0.03880394185024723,-3.358966026993113,-0.08544211751017496
2023-05-01T05:00:00-04:00,1.09922,1.09954,1.09883,1.09945,1.100020124,1.0996413333333335,1.0997833333333338,1.0998966666666667,1.100139,NaN,NaN,NaN,1.0997099335919485,1.0999046253724092,1635,-9276,-10187.2,-0.036820543673201866,-3.0168598062184526,-0.030006001200234726
2023-05-01T05:15:00-04:00,1.09945,1.10008,1.09936,1.10004,1.09883,1.0996926666666664,1.0998022222222226,1.0998524444444446,1.100074,1.1006478,NaN,NaN,1.0997759468735588,1.0998333002979275,1335,-7941,-9843.8,-0.029567818993442952,-2.300456149844971,0.01545637211670502
2023-05-01T05:30:00-04:00,1.10004,1.10023,1.09987,1.10023,1.09883,1.099778222222222,1.0998044444444448,1.0998268888888891,1.1000435000000002,1.1006114,NaN,NaN,1.099866757498847,1.099808240238342,1149,-6792,-8912,-0.021491915533455745,-2.1019997300782767,0.0018178347770090278
2023-05-01T05:45:00-04:00,1.10023,1.10045,1.10017,1.10033,1.098886,1.0998833333333333,1.0998388888888893,1.099809777777778,1.1000295,1.1005844,NaN,NaN,1.0999594059990776,1.0998173921906735,1337,-5455,-8075,-0.018193860059168496,-1.9804796842696863,0.028181305794443053
2023-05-01T06:00:00-04:00,1.10033,1.10067,1.10018,1.10021,1.09897984,1.0999575555555554,1.099825555555556,1.0998108888888891,1.100018,1.100555,NaN,NaN,1.100009524799262,1.0998643137525388,-1829,-7284,-7349.6,-0.014735420418295151,-2.1799471167674094,-0.010905819163352813
2023-05-01T06:15:00-04:00,1.10021,1.10032,1.09997,1.10022,1.0991150528,1.1000364444444446,1.0998588888888894,1.0998260000000004,1.1000130000000001,1.1005242,NaN,NaN,1.1000516198394097,1.099932651002031,2215,-5069,-6508.2,-0.014783178604123358,-2.1598145966120343,0.027274710888061583
2023-05-01T06:30:00-04:00,1.10022,1.10063,1.10006,1.10063,1.099239448576,1.1001906666666668,1.0999922222222227,1.0998640000000006,1.1000085,1.1005046,NaN,NaN,1.1001672958715278,1.1000109208016249,1086,-3983,-5716.6,-0.009670623079846079,-1.7551137186057963,0.10914746732398516
2023-05-01T06:45:00-04:00,1.10063,1.10095,1.10046,1.10088,1.09935389268992,1.1003682222222222,1.1001344444444452,1.0999300000000005,1.1000225000000001,1.1004939999999999,NaN,NaN,1.1003098366972224,1.1000995366413,960,-3023,-4962.8,0.0028180537248814466,-1.5370567875753136,0.116405965805763
2023-05-01T07:00:00-04:00,1.10088,1.10101,1.10066,1.1007,1.099513503420928,1.1004813333333332,1.1002988888888894,1.1000220000000005,1.1000450000000002,1.1004848,NaN,NaN,1.100387869357778,1.1001852293130399,-1262,-4285,-4728.8,0.012384664832744472,-1.7434008032719264,0.13464092720291895
2023-05-01T07:15:00-04:00,1.1007,1.10118,1.10062,1.10109,1.0996930830104166,1.1006395555555557,1.1004811111111117,1.1001531111111116,1.1001160000000003,1.100484,NaN,NaN,1.1005282954862223,1.100288983450432,1535,-2750,-3822,0.025746699743214287,-1.1995196367416894,0.1491654918368151
2023-05-01T07:30:00-04:00,1.10109,1.10139,1.10087,1.10105,1.0999012513889583,1.1007533333333335,1.1005933333333338,1.1003000000000007,1.1001605,1.1004834,NaN,NaN,1.1006326363889778,1.1004051867603457,-1827,-4577,-3723.6,0.0343153401430601,-1.2658902331504003,0.09181484309663081
2023-05-01T07:45:00-04:00,1.10105,1.1014,1.10083,1.10134,1.100139451166725,1.1009026666666668,1.1007166666666672,1.1004448888888896,1.1002385000000001,1.1004854,NaN,NaN,1.1007741091111822,1.1005265494082768,1725,-2852,-3497.4,0.04102222289551279,-0.8115511931432888,0.10088799614625527
2023-05-01T08:00:00-04:00,1.10134,1.10134,1.10075,1.10116,1.1003663499567145,1.1009913333333332,1.1008088888888894,1.1005797777777784,1.1003030000000003,1.100487,NaN,NaN,1.1008512872889458,1.1006348395266214,-2759,-5611,-4015,0.043499655716115686,-1.26247461370387,0.07543191587977119
2023-05-01T08:15:00-04:00,1.10116,1.10199,1.10116,1.10165,1.1005524069645058,1.1011595555555556,1.1009688888888896,1.1007137777777785,1.100375,1.1004988,NaN,NaN,1.1010110298311566,1.1007594716212972,3311,-2300,-3618,0.047789244369096415,0.21087167566401122,0.13088410394380237
2023-05-01T08:30:00-04:00,1.10165,1.10302,1.10131,1.10298,1.10075,1.1015617777777778,1.101275555555556,1.100872666666667,1.1005230000000001,1.1005368,NaN,NaN,1.1014048238649252,1.1009347772970377,4206,1906,-2686.8,0.060968011049542775,5.288691309849301,0.2508589191252746
2023-05-01T08:45:00-04:00,1.10298,1.10337,1.1025099999999999,1.10328,1.10116,1.1019626666666666,1.1015700000000006,1.1010680000000004,1.1006705,1.1005884000000001,NaN,NaN,1.10177985909194,1.1011642218376303,3753,5659,-639.6,0.07465689239389757,6.309471378390776,0.24077119467941463
2023-05-01T09:00:00-04:00,1.10328,1.10356,1.10261,1.10266,1.10131,1.1021806666666667,1.1017677777777783,1.1012782222222228,1.1008075000000002,1.1006238000000002,NaN,NaN,1.101955887273552,1.1014005774701041,-3613,2046,340,0.0830115153657362,4.279107372879723,0.1616888307535692
2023-05-01T09:15:00-04:00,1.10266,1.10288,1.1020699999999999,1.10248,1.10176,1.1023231111111111,1.101965555555556,1.101509555555556,1.1009600000000002,1.1006624,NaN,NaN,1.1020607098188415,1.1016424619760834,-2515,-469,1368.4,0.08646273589744538,3.868554709320536,0.16171527209956327
2023-05-01T09:30:00-04:00,1.10248,1.10265,1.10219,1.10231,1.1020699999999999,1.1023919999999998,1.1021011111111116,1.1017360000000005,1.1010955000000002,1.1007008,NaN,NaN,1.102110567855073,1.1018623695808667,-3617,-4086,1011.2,0.08861877965586876,3.3108212356974205,0.11079929887656767
2023-05-01T09:45:00-04:00,1.10231,1.10275,1.10171,1.10174,1.10356,1.1023197777777776,1.1021777777777784,1.101916444444445,1.1012215000000003,1.1007238,NaN,NaN,1.1020364542840584,1.1019886956646934,-3184,-7270,-824,0.0852590313380972,1.66438783674443,0.06266745379409266
2023-05-01T10:00:00-04:00,1.10174,1.10175,1.0995,1.09961,1.103523,1.1018062222222222,1.1019855555555562,1.101999555555556,1.1012295,1.1007052,NaN,NaN,1.1015511634272468,1.101942956531755,-10831,-18101,-5576,0.07049373725356381,-19.27524401832085,-0.15708137359943428
2023-05-01T10:15:00-04:00,1.09961,1.09978,1.09833,1.09852,1.1033620800000001,1.101113111111111,1.101692222222223,1.101984444444445,1.1011535000000001,1.1006677999999999,NaN,NaN,1.1009449307417973,1.1017407652254039,-5715,-23816,-10748.4,0.04890778100353573,-24.940297992002613,-0.23974717570561735
2023-05-01T10:30:00-04:00,1.09852,1.0992,1.09784,1.09804,1.1030601552000001,1.1003826666666665,1.1012911111111119,1.1018495555555563,1.1010440000000004,1.1006238,NaN,NaN,1.100363944593438,1.1014014121803233,-5516,-29332,-16521,0.02922437547336853,-27.350522657916933,-0.3276902827576919
2023-05-01T10:45:00-04:00,1.09804,1.09861,1.09778,1.09814,1.102642542784,1.0997524444444444,1.100753333333334,1.1015800000000007,1.1009345000000004,1.1005806,NaN,NaN,1.0999191556747503,1.1009631297442586,4923,-24409,-20585.6,0.0063843536620776815,-26.902178335305784,-0.4388112205117207
2023-05-01T11:00:00-04:00,1.09814,1.0982,1.09696,1.09712,1.1021562885056,1.0990257777777777,1.1000688888888894,1.101158222222223,1.1007800000000003,1.1005113999999998,NaN,NaN,1.0993593245398003,1.100427703795407,-5050,-29459,-25023.4,-0.03296445160258121,-31.59283708555528,-0.5583351461097766
2023-05-01T11:15:00-04:00,1.09712,1.0976,1.0968,1.09688,1.101532733884928,1.0983880000000001,1.0994266666666672,1.100646444444445,1.1006130000000005,1.1004327999999999,NaN,NaN,1.0988634596318403,1.0998901630363256,-3886,-33345,-28072.2,-0.07671180245472974,-32.44291729555972,-0.5241869660638725
2023-05-01T11:30:00-04:00,1.09688,1.09711,1.09662,1.09684,1.100870151141038,1.0978706666666667,1.0988000000000007,1.1000680000000007,1.1004235000000002,1.100351,NaN,NaN,1.0984587677054722,1.0993929304290606,-2869,-36214,-30551.8,-0.11498500590669401,-32.54754132006569,-0.511573906102593
2023-05-01T11:45:00-04:00,1.09684,1.09718,1.09669,1.09693,1.1001901269584717,1.0974966666666666,1.098202222222223,1.0994502222222227,1.1002260000000006,1.1002669999999999,NaN,NaN,1.0981530141643778,1.0989507443432487,2631,-33583,-31402,-0.14943260017133933,-32.331657508388695,-0.488065970552743
2023-05-01T12:00:00-04:00,1.09693,1.09707,1.09643,1.09649,1.0996189066451163,1.0971542222222221,1.0976188888888896,1.098823333333334,1.1000155000000005,1.1001779999999999,NaN,NaN,1.0978204113315022,1.098530995474599,-2240,-35823,-33684.8,-0.18336427714625286,-33.23016516156619,-0.4765189609163666
2023-05-01T12:15:00-04:00,1.09649,1.09672,1.09643,1.09662,1.0990449034489953,1.0969544444444443,1.0972866666666674,1.0982668888888896,1.0997920000000005,1.1000824,NaN,NaN,1.0975803290652018,1.0981751963796793,1996,-33827,-34558.4,-0.21228362384086366,-32.99351913652271,-0.2719145878993505
2023-05-01T12:30:00-04:00,1.09662,1.09715,1.09647,1.0968,1.0985742208281761,1.0968571111111112,1.0970955555555562,1.0978006666666675,1.0995795000000004,1.099995,NaN,NaN,1.0974242632521614,1.0978873571037435,2166,-31661,-34221.6,-0.2192993092170851,-32.63799032982563,-0.15657429996722352
2023-05-01T12:45:00-04:00,1.0968,1.09706,1.09664,1.09675,1.0981882610791045,1.096788,1.096952222222223,1.097431111111112,1.0993500000000005,1.0999032,NaN,NaN,1.097289410601729,1.097653485682995,-1971,-33632,-33705.2,-0.21681506769210235,-32.727842627418816,-0.11748205894138769
2023-05-01T13:00:00-04:00,1.09675,1.09697,1.09662,1.09693,1.0978717740848656,1.0967835555555556,1.0968177777777786,1.097154222222223,1.0991385000000002,1.0998249999999998,NaN,NaN,1.0972175284813832,1.0974663885463958,1738,-31894,-33367.4,-0.20785022307720524,-32.44259986471071,-0.1101863150417919
2023-05-01T13:15:00-04:00,1.09693,1.09716,1.09692,1.0971,1.0976122547495897,1.09684,1.096815555555556,1.0969935555555563,1.0989110000000004,1.0997548,NaN,NaN,1.0971940227851065,1.0973411108371167,1809,-30085,-32219.8,-0.19975849084065378,-32.16224469163676,-0.0018229546449003776
2023-05-01T13:30:00-04:00,1.0971,1.09714,1.09652,1.09675,1.0973994488946635,1.0968268888888888,1.0968011111111116,1.0968964444444453,1.0985995000000004,1.0996809999999997,NaN,NaN,1.0971052182280852,1.0972460886696935,-2059,-32144,-31883.2,-0.18193306426830183,-32.81911279846398,-0.011851797826579526
2023-05-01T13:45:00-04:00,1.09675,1.09721,1.09671,1.0971899999999999,1.097224948093624,1.0969046666666666,1.0968400000000007,1.096845333333334,1.0982950000000002,1.0996183999999998,NaN,NaN,1.0971221745824682,1.097185670935755,1349,-30795,-31710,-0.15405835838114607,-32.27791380142729,0.031909850114861825
2023-05-01T14:00:00-04:00,1.0971899999999999,1.09753,1.09686,1.09726,1.09643,1.0969886666666666,1.0968766666666674,1.096830222222223,1.0980250000000003,1.0995491999999998,NaN,NaN,1.0971497396659746,1.097157736748604,2090,-28705,-30724.6,-0.12417205621425179,-32.144573176740565,0.030083961601920037
2023-05-01T14:15:00-04:00,1.09726,1.09756,1.09726,1.0974,1.096452,1.0970933333333333,1.0969777777777783,1.096862222222223,1.0977710000000003,1.0994852,NaN,NaN,1.0971997917327796,1.0971541893988834,1821,-26884,-29722.6,-0.0971077157936684,-31.91223079663006,0.08299209295114104
2023-05-01T14:30:00-04:00,1.0974,1.09747,1.0969,1.09695,1.09649632,1.0970877777777777,1.0970144444444452,1.0969020000000007,1.0975030000000003,1.0994191999999998,NaN,NaN,1.0971498333862237,1.097145351519107,-1655,-28539,-29413.4,-0.06895169563903793,-32.59088033189499,0.030092465940814824
2023-05-01T14:45:00-04:00,1.09695,1.09736,1.09689,1.09694,1.0965388672,1.0970728888888888,1.0970300000000006,1.0969477777777787,1.0972630000000003,1.0993646,NaN,NaN,1.097107866708979,1.0971458812152854,-1988,-30527,-29090,-0.04275176812593834,-32.60900330924138,0.012764405543401622
2023-05-01T15:00:00-04:00,1.09694,1.097,1.09671,1.09684,1.096579712512,1.097034888888889,1.0970400000000007,1.0969877777777786,1.0971245000000003,1.0992981999999998,NaN,NaN,1.0970542933671832,1.0971323049722286,-2194,-32721,-29475.2,-0.021130886507666986,-32.80901424876403,0.008206063369058174
2023-05-01T15:15:00-04:00,1.09684,1.09706,1.09666,1.09673,1.09661892401152,1.096972888888889,1.0970177777777783,1.0970160000000007,1.0970350000000004,1.0992371999999997,NaN,NaN,1.0969894346937465,1.097100243977783,-1847,-34568,-30647.8,-0.008815402604689444,-32.99424637013096,-0.018232704001164887
2023-05-01T15:30:00-04:00,1.09673,1.09697,1.09657,1.09657,1.09756,1.0968833333333332,1.0969588888888895,1.097012222222223,1.0969615000000004,1.0991711999999998,NaN,NaN,1.0969055477549972,1.0970413951822267,-2115,-36683,-32607.6,-0.003633243001358686,-33.30279997949686,-0.04830917874395401
2023-05-01T15:45:00-04:00,1.09657,1.09735,1.09657,1.09727,1.0975402,1.0969455555555556,1.0970166666666674,1.0970126666666673,1.0969180000000003,1.0991123999999999,NaN,NaN,1.0969784382039978,1.0970071161457813,1910,-34773,-33854.4,0.0012588717905058727,-32.08354357087739,0.04741281057671083
2023-05-01T16:00:00-04:00,1.09727,1.09742,1.09715,1.09734,1.097520796,1.0970102222222222,1.0970333333333337,1.097013333333334,1.0969290000000005,1.0990588,NaN,NaN,1.0970507505631981,1.0969956929166254,2173,-32600,-34269,0.010110393866973686,-31.94491770850985,0.013671287561871191
2023-05-01T16:15:00-04:00,1.09734,1.0975,1.09725,1.0974599999999999,1.09750178008,1.0970955555555555,1.097055555555556,1.0970164444444452,1.0969580000000003,1.0990014,NaN,NaN,1.0971326004505584,1.0970113543333002,1734,-30866,-33898,0.011095657066128603,-31.755295531244986,0.0182272205311392
2023-05-01T16:30:00-04:00,1.0974599999999999,1.0976,1.09738,1.09758,1.09657,1.0972004444444445,1.097075555555556,1.0970280000000008,1.0969950000000004,1.0989546,NaN,NaN,1.0972220803604467,1.0970578834666402,631,-30235,-33031.4,0.010973774935222159,-31.686299850308938,0.016402405686173592
2023-05-01T16:45:00-04:00,1.09758,1.09768,1.09731,1.09731,1.0965906,1.0972473333333335,1.097115555555556,1.097059333333334,1.0970140000000004,1.0989122,NaN,NaN,1.0972396642883573,1.0971247067733123,-1417,-31652,-32025.2,0.008112961595671127,-32.03487580832566,0.03281826883631122
2023-05-01T17:00:00-04:00,1.09731,1.09759,1.09692,1.09743,1.096634176,1.0973102222222222,1.0971700000000004,1.0970900000000008,1.0970610000000005,1.0988688,NaN,NaN,1.0972777314306859,1.0971845654186498,113,-31539,-31378.4,0.010317865794875042,-32.02251831591241,0.04466971757797869
2023-05-01T17:15:00-04:00,1.09743,1.09743,1.09714,1.09741,1.09667600896,1.0973582222222222,1.097233333333334,1.0971300000000006,1.0971005000000003,1.0988326,NaN,NaN,1.0973041851445486,1.09723525233492,-120,-31659,-31190.2,0.01060826967582076,-32.02470524355243,0.051967470187079194
2023-05-01T17:30:00-04:00,1.09741,1.09758,1.09732,1.09736,1.0967161686016,1.0973835555555556,1.0973033333333337,1.0971795555555564,1.0971285000000004,1.0987908,NaN,NaN,1.0973153481156388,1.0972718018679362,-106,-31765,-31370,0.012135748503588086,-32.029534796773206,0.05744349110536854
2023-05-01T17:45:00-04:00,1.09736,1.0976,1.09733,1.09756,1.096754721857536,1.0974348888888887,1.0974133333333338,1.097247111111112,1.0971690000000005,1.0987411999999999,1.0996945,NaN,1.097364278492511,1.0973002414943491,294,-31471,-31617.2,0.016401817177316116,-31.9759516517706,0.09028151417602583
2023-05-01T18:00:00-04:00,1.09756,1.09765,1.09732,1.0975,1.0967917329832346,1.0974522222222223,1.097438888888889,1.0973117777777786,1.0971975000000005,1.0986866,1.099649,NaN,1.097391422794009,1.0973305931954793,-369,-31840,-31654.8,0.021622438031933904,-31.99612366970134,0.020961112579397274
2023-05-01T18:15:00-04:00,1.0975,1.09751,1.09737,1.09745,1.0968272636639051,1.0974544444444445,1.0974511111111116,1.0973680000000008,1.0972150000000005,1.098629,1.0996066999999998,NaN,1.0974031382352072,1.0973556745563835,-361,-32201,-31787.2,0.021005668058418272,-32.01257013894959,0.010024240435968296
2023-05-01T18:30:00-04:00,1.09745,1.09757,1.09745,1.09749,1.0968613731173489,1.0974622222222223,1.0974544444444447,1.097412222222223,1.0972520000000006,1.0985746,1.0995648,NaN,1.0974205105881658,1.097378939645107,226,-31975,-31850.4,0.02067981697608806,-32.004332861624874,0.0027335848231549707
2023-05-01T18:45:00-04:00,1.09749,1.09752,1.09733,1.0974,1.096894118192655,1.0974513333333331,1.0974344444444446,1.097438444444445,1.0972625000000007,1.0985182,1.0995211999999999,NaN,1.0974164084705327,1.0973991517160857,-266,-32241,-31945.6,0.01731153471599655,-32.02614627222546,-0.01639971573826682
2023-05-01T19:00:00-04:00,1.0974,1.09744,1.09712,1.09715,1.096925553464949,1.0973944444444446,1.097416666666667,1.0974391111111115,1.0972570000000006,1.0984486,1.0994766,NaN,1.0973631267764261,1.0973989213728685,-450,-32691,-32189.6,0.01356629517762886,-32.12866130776395,-0.014581111992047641
2023-05-01T19:15:00-04:00,1.09715,1.09722,1.09692,1.09721,1.09768,1.0973531111111112,1.0973922222222228,1.0974297777777784,1.0972475000000006,1.0983752,1.0994346,NaN,1.0973325014211408,1.097387137098295,778,-31913,-32204.2,0.012871950994626138,-32.08611470976007,-0.02004683670028038
2023-05-01T19:30:00-04:00,1.09721,1.09723,1.09694,1.097,1.0976648,1.0972746666666666,1.0973466666666671,1.0974088888888893,1.0972500000000005,1.0983012,1.099393,NaN,1.0972660011369126,1.097359709678636,-1012,-32925,-32349,0.010689199481854645,-32.279805981257816,-0.03736069472667658
2023-05-01T19:45:00-04:00,1.097,1.09701,1.09672,1.09689,1.097649904,1.0971833333333334,1.097294444444445,1.0973768888888895,1.0972475000000006,1.0982172000000001,1.0993506,NaN,1.0971908009095301,1.097313767742909,-768,-33693,-32692.6,0.006210428050873889,-32.356816008605165,-0.04283006488298922
2023-05-01T20:00:00-04:00,1.09689,1.09785,1.0968499999999999,1.09778,1.09672,1.0972804444444444,1.0973188888888896,1.0973537777777786,1.0972945000000007,1.0981518000000001,1.0993176,NaN,1.097308640727624,1.0972922141943273,1536,-32157,-32675.8,0.006392471725410632,-31.110528778344985,0.020044462261733932
2023-05-01T20:15:00-04:00,1.09778,1.09778,1.09741,1.09766,1.09672,1.0973486666666667,1.0973366666666673,1.0973377777777784,1.0973410000000006,1.0980782,1.0992818,NaN,1.0973789125820992,1.097295371355462,-1260,-33417,-32821,0.0037450826804754952,-31.248261293056377,0.01457858769933121
2023-05-01T20:30:00-04:00,1.09766,1.09782,1.09753,1.09761,1.0967426,1.0974033333333333,1.097354444444445,1.0973302222222228,1.0973930000000005,1.0980072,1.0992471000000001,NaN,1.0974251300656794,1.0973138970843697,-1079,-34496,-33337.6,0.000928640890699384,-31.297411303077798,0.01457925190213112
2023-05-01T20:45:00-04:00,1.09761,1.09792,1.09747,1.0979,1.096764748,1.0975124444444444,1.0974000000000004,1.0973408888888896,1.0974245000000005,1.0979322,1.0992155,NaN,1.0975201040525435,1.0973647176674959,1367,-33129,-33378.4,-0.0007420019994535349,-30.93623565781202,0.0373579713710395
2023-05-01T21:00:00-04:00,1.0979,1.09872,1.09784,1.09869,1.09681095808,1.0977704444444445,1.0975433333333338,1.0973906666666673,1.0974920000000004,1.0978464,1.0991916000000002,NaN,1.0977540832420347,1.097477374133997,1763,-31366,-32913,0.004030861910263855,-29.667659284736395,0.11755057408420024
2023-05-01T21:15:00-04:00,1.09869,1.09941,1.09857,1.09925,1.0969255005952,1.098111777777778,1.0977766666666673,1.097482222222223,1.0975815000000007,1.0977658000000001,1.0991771,NaN,1.0980532665936278,1.0976262993071975,2066,-29300,-32341.6,0.012599195890207509,-28.614623396542054,0.19140500387367185
2023-05-01T21:30:00-04:00,1.09925,1.09945,1.09905,1.09907,1.0971242605475842,1.0983704444444444,1.097983333333334,1.0976115555555563,1.0976560000000006,1.097694,1.0991589,NaN,1.0982566132749023,1.0978018394457583,-2661,-31961,-32050.4,0.02310558898435927,-29.050356851170378,0.16952087567557467
2023-05-01T21:45:00-04:00,1.09907,1.09913,1.09864,1.09879,1.0973568344928257,1.0985317777777779,1.0981822222222228,1.0977771111111116,1.0977300000000005,1.0976202000000002,1.0991413,NaN,1.0983632906199219,1.0979894715566065,-1593,-33554,-31862,0.03224895464199391,-29.456190874481077,0.16317228805833714
2023-05-01T22:00:00-04:00,1.09879,1.0990199999999999,1.09875,1.09899,1.097566151043543,1.0986933333333333,1.0984155555555561,1.097980222222223,1.0978080000000006,1.0975538000000002,1.0991273,NaN,1.0984886324959375,1.0981831772452852,1092,-32462,-31728.6,0.04308656482577119,-29.25742677943109,0.19145037332822717
2023-05-01T22:15:00-04:00,1.09899,1.09914,1.09866,1.09886,1.0977545359391887,1.0987822222222223,1.0985355555555563,1.0981786666666675,1.0978805000000005,1.0974962000000001,1.09911,NaN,1.09856290599675,1.0983449417962283,-1102,-33564,-32168.2,0.054825369919520854,-29.387782833626268,0.09838036765107488
2023-05-01T22:30:00-04:00,1.09886,1.09891,1.09859,1.09867,1.0979240823452698,1.0988091111111111,1.0986477777777786,1.0983528888888896,1.0979460000000008,1.0974774000000003,1.0990913,NaN,1.0985843247974,1.0984511534369827,-943,-34507,-33209.6,0.05746373656121474,-29.550833631726043,0.0920139205218333
2023-05-01T22:45:00-04:00,1.09867,1.09893,1.09866,1.09884,1.0980766741107428,1.0988475555555555,1.098784444444445,1.098513111111112,1.0980100000000006,1.0974838,1.0990758,NaN,1.09863545983792,1.0985269227495862,874,-33633,-33544,0.061788309011859735,-29.41559739154473,0.11206166124580355
2023-05-01T23:00:00-04:00,1.09884,1.09886,1.09869,1.09876,1.0982140066996686,1.0988426666666666,1.0988800000000007,1.0986526666666674,1.0980730000000007,1.0974982000000002,1.0990609999999998,NaN,1.098660367870336,1.098586338199669,-635,-34268,-33686.8,0.06705419498542992,-29.46182796196449,0.07833135986882783
2023-05-01T23:15:00-04:00,1.09876,1.0988,1.09854,1.09864,1.0983376060297019,1.0987946666666666,1.0988744444444452,1.0987444444444452,1.0981325000000006,1.0975082000000003,1.0990444,NaN,1.0986562942962688,1.0986198705597352,-952,-35220,-34238.4,0.06884618887174615,-29.5657997119371,-0.004550874222927621
2023-05-01T23:30:00-04:00,1.09864,1.09871,1.09848,1.0986,1.0984488454267316,1.0987397777777776,1.098802222222223,1.0987977777777787,1.0981880000000006,1.0975378000000002,1.0990246,NaN,1.098645035437015,1.098636296447788,-1161,-36381,-34801.8,0.06303647894200974,-29.608070155394508,-0.059131225835800716
2023-05-01T23:45:00-04:00,1.0986,1.09861,1.09834,1.09839,1.09945,1.0986573333333332,1.0987266666666673,1.0988135555555563,1.0982375000000006,1.0975680000000003,1.0990004,NaN,1.098594028349612,1.0986382371582306,-1043,-37424,-35385.2,0.051300507541648756,-29.807442083302796,-0.061870490505610554
2023-05-02T00:00:00-04:00,1.09839,1.09856,1.09833,1.09842,1.0994278,1.098596,1.0986855555555564,1.0987937777777783,1.0983010000000006,1.0975996000000003,1.0989753,NaN,1.0985592226796896,1.0986229897265845,1033,-36391,-35936.8,0.040957075718634425,-29.779228060961028,-0.03367340438118125
2023-05-02T00:15:00-04:00,1.09842,1.09857,1.09814,1.0982,1.099383888,1.0984988888888887,1.0985977777777787,1.0987373333333341,1.098350500000001,1.0976250000000003,1.098946,NaN,1.0984873781437516,1.0985883917812675,-985,-37376,-36558.4,0.031030748059198067,-29.9765114316206,-0.07188418456945436
2023-05-02T00:30:00-04:00,1.0982,1.09891,1.0979,1.09826,1.09930925472,1.0984313333333333,1.0985311111111118,1.0986686666666672,1.0984135000000008,1.0976604,1.0989192,NaN,1.0984419025150014,1.0985455134250142,5418,-31958,-35906,0.019830680499370583,-29.680499776184686,-0.05460204211636914
2023-05-02T00:45:00-04:00,1.09826,1.09874,1.09821,1.09845,1.0991965143424,1.0984151111111111,1.0985066666666674,1.0986095555555564,1.0984915000000008,1.0976970000000004,1.0988897,NaN,1.098443522012001,1.0985052107400113,1673,-30285,-34686.8,0.009810670958078214,-29.39106922239974,-0.020024211091602483
2023-05-02T01:00:00-04:00,1.09845,1.09881,1.09835,1.09873,1.099092793195008,1.0984597777777778,1.0984944444444453,1.0985631111111118,1.098539000000001,1.0977356000000003,1.0988653,NaN,1.0985008176096007,1.0984865685920089,2481,-27804,-32762.8,0.0023798624622377133,-28.758650814643225,-0.010010556586951193
2023-05-02T01:15:00-04:00,1.09873,1.09915,1.09864,1.09908,1.0979,1.0985768888888887,1.098530000000001,1.098532000000001,1.098610000000001,1.0977822000000004,1.0988427,NaN,1.0986166540876805,1.0984980548736072,2029,-25775,-30639.6,-0.0010706610269065372,-28.11231367995122,0.029123739488159196
2023-05-02T01:30:00-04:00,1.09908,1.09927,1.09869,1.09877,1.097925,1.098624888888889,1.0985444444444452,1.0985213333333341,1.0986680000000009,1.0978190000000003,1.098822,NaN,1.0986473232701444,1.0985300438988856,-1837,-27612,-28686.8,-0.0057908271736395985,-28.630447027842237,0.011832811476003374
2023-05-02T01:45:00-04:00,1.09877,1.09887,1.0983,1.09834,1.0979788000000001,1.098584,1.0985155555555564,1.098518222222223,1.0986900000000008,1.0978438000000004,1.0987992999999998,NaN,1.0985858586161155,1.0985588351191085,-1676,-29288,-28152.8,-0.011685311442068962,-29.28634407636002,-0.02366648461677835
2023-05-02T02:00:00-04:00,1.09834,1.09919,1.09829,1.09871,1.098030448,1.098622888888889,1.098551111111112,1.0985271111111117,1.098691000000001,1.0978830000000002,1.098782,NaN,1.0986106868928924,1.0985922680952869,2595,-26693,-27434.4,-0.014194381105385394,-28.41216121859289,0.029133550014120484
2023-05-02T02:15:00-04:00,1.09871,1.09921,1.09865,1.09896,1.09808003008,1.0987046666666664,1.0986111111111119,1.0985504444444452,1.098676500000001,1.0979184000000002,1.0987684,NaN,1.098680549514314,1.0986282144762296,2256,-24437,-26761,-0.010176493686418117,-27.898831950633475,0.0491615229147307
2023-05-02T02:30:00-04:00,1.09896,1.09907,1.09855,1.09876,1.0981276288768,1.0987344444444447,1.098673333333334,1.0985791111111118,1.098661000000001,1.0979484000000002,1.0987487999999999,NaN,1.0986964396114511,1.0986441715809836,-1972,-26409,-26887.8,-0.00495832880041547,-28.257716714410098,0.050992533236195035
2023-05-02T02:45:00-04:00,1.09876,1.09947,1.09847,1.09914,1.098173323721728,1.098827777777778,1.0987711111111118,1.0986244444444453,1.098678500000001,1.0979832000000003,1.0987342,NaN,1.098785151689161,1.098671737264787,2743,-23666,-26098.6,0.00329398466396576,-27.309065507595026,0.08012674594358275
2023-05-02T03:00:00-04:00,1.09914,1.10017,1.09899,1.0999,1.0982511242984243,1.0990535555555558,1.098932222222223,1.0987077777777785,1.098724000000001,1.0980422000000003,1.0987307,NaN,1.0990081213513287,1.0987561898118297,4248,-19418,-24124.6,0.01340933981764396,-24.371787271883107,0.13200418771907446
2023-05-02T03:15:00-04:00,1.0999,1.10067,1.09966,1.09967,1.0984046343545504,1.099201111111111,1.0990366666666675,1.0988048888888895,1.098764500000001,1.0980968000000002,1.0987307,NaN,1.099140497081063,1.098862151849464,-3787,-23205,-23427,0.021565258091954576,-25.163686535453124,0.08555332065202013
2023-05-02T03:30:00-04:00,1.09967,1.10046,1.09941,1.10015,1.0986311709190955,1.0994237777777778,1.0991555555555566,1.0989137777777784,1.098838500000001,1.0981630000000002,1.0987306,NaN,1.0993423976648504,1.098994521479571,3894,-19311,-22401.8,0.028896523750013434,-23.463976622479105,0.09735415074425013
2023-05-02T03:45:00-04:00,1.10015,1.10029,1.09822,1.09857,1.10067,1.0993066666666667,1.0991333333333344,1.0990057777777786,1.098825000000001,1.0981998000000002,1.0987184999999997,NaN,1.0991879181318804,1.099092817183657,-4054,-23365,-21793,0.02468869364446317,-29.286200864627588,-0.018202171519060218
2023-05-02T04:00:00-04:00,1.09857,1.09867,1.0959699999999999,1.09647,1.100621,1.098774,1.0989255555555566,1.0990366666666675,1.0987105000000013,1.0981978000000003,1.0986845,NaN,1.0986443345055044,1.0990646537469257,-8041,-31406,-23341,0.014029403236867518,-44.657183141587566,-0.17025693319009033
2023-05-02T04:15:00-04:00,1.09647,1.09765,1.09636,1.09705,1.10043496,1.0983988888888887,1.0987411111111123,1.0989984444444452,1.0986310000000012,1.0981934000000002,1.0986528999999998,NaN,1.0983254676044034,1.0989281229975407,4093,-27313,-24920,0.009700380473456541,-42.49210794573168,-0.15108627390303125
2023-05-02T04:30:00-04:00,1.09705,1.0974599999999999,1.09666,1.09744,1.1002563616,1.0981386666666668,1.0985722222222234,1.0989055555555567,1.0985730000000014,1.0981954000000003,1.0986270999999999,NaN,1.0981483740835227,1.0987296983980328,3517,-23796,-25038.2,0.0033419939090889644,-41.24181853321665,-0.13831258644536343
2023-05-02T04:45:00-04:00,1.09744,1.09848,1.09716,1.09717,1.1000849071360002,1.0978582222222222,1.0983955555555567,1.0987535555555565,1.0985120000000013,1.0981896000000002,1.0985955,NaN,1.0979526992668183,1.0984517587184262,-4064,-27860,-26748,-0.006753760409600827,-42.24167273936912,-0.1447085805817449
2023-05-02T05:00:00-04:00,1.09717,1.09817,1.09693,1.09695,1.0999203108505602,1.097569111111111,1.0981522222222233,1.0985573333333343,1.0984385000000012,1.098177,1.0985658,NaN,1.0977521594134547,1.098164606974741,-3583,-31443,-28363.6,-0.016989498937559855,-42.960121111088725,-0.1992466837709404
2023-05-02T05:15:00-04:00,1.09695,1.09717,1.09534,1.09552,1.0997622984165378,1.0970426666666668,1.0976655555555568,1.0983053333333346,1.0983045000000013,1.0981412,1.0985266999999999,NaN,1.0973057275307638,1.097896885579793,-4388,-35831,-29248.6,-0.03737812870013056,-48.680381834002425,-0.39821801981998817
2023-05-02T05:30:00-04:00,1.09552,1.09609,1.09517,1.0957999999999999,1.0994969605115457,1.0966695555555555,1.0972355555555566,1.0980042222222233,1.0981815000000013,1.0981086,1.0984886999999999,NaN,1.097004582024611,1.0976327084638344,3672,-32159,-30217.8,-0.06430956005765666,-47.74186861653547,-0.35192375894586925
2023-05-02T05:45:00-04:00,1.0957999999999999,1.09602,1.09491,1.09528,1.099150803670622,1.0962784444444444,1.0966944444444455,1.0976286666666677,1.098023000000001,1.098066,1.0984493,NaN,1.0966596656196888,1.0973349667710677,-3047,-35206,-32499.8,-0.09137465734492577,-49.18778940500011,-0.4426669090578494
2023-05-02T06:00:00-04:00,1.09528,1.09598,1.0948,1.09587,1.0987267233035598,1.0961135555555555,1.0963944444444453,1.0972284444444456,1.097880000000001,1.0980362000000001,1.0984135,NaN,1.096501732495751,1.097044773416854,2905,-32301,-33388,-0.119177683525406,-47.62293840799513,-0.24577405172179712
2023-05-02T06:15:00-04:00,1.09587,1.09601,1.09498,1.09547,1.0982555165071326,1.0959286666666666,1.0962833333333344,1.0968546666666676,1.0976995000000012,1.0979944000000001,1.0983678,NaN,1.0962953859966007,1.0967534187334833,-2226,-34527,-34004.8,-0.13329244217789013,-48.43544354090314,-0.0912017656661935
2023-05-02T06:30:00-04:00,1.09547,1.09554,1.09491,1.09553,1.0978408545262768,1.095778,1.0961144444444453,1.0965444444444454,1.097537500000001,1.097955,1.0983208,NaN,1.0961423087972806,1.0965207349867867,2306,-32221,-33282.8,-0.12647551879597813,-48.309141588316685,-0.13855339319084706
2023-05-02T06:45:00-04:00,1.09553,1.09598,1.09547,1.09569,1.0974759519831236,1.0956931111111112,1.095920000000001,1.0962813333333343,1.097405000000001,1.0979198000000001,1.0982744,NaN,1.0960518470378244,1.0963301879894294,2322,-29899,-32830.8,-0.12552047084052637,-47.970018059065666,-0.1594620207027189
2023-05-02T07:00:00-04:00,1.09569,1.0974,1.09568,1.09731,1.0948,1.0959711111111112,1.0959355555555566,1.0961295555555566,1.0973350000000013,1.0979162,1.0982454,NaN,1.0963034776302596,1.0962589503915434,2948,-26951,-31179.8,-0.12224126192583039,-43.611339965809485,0.012760100987087597
2023-05-02T07:15:00-04:00,1.09731,1.0976299999999999,1.09699,1.09713,1.094852,1.0962100000000001,1.0959555555555562,1.0960417777777787,1.0972435000000014,1.0979108000000002,1.0982145,NaN,1.0964687821042076,1.0962523603132346,-3185,-30136,-30746.8,-0.11575766701969925,-44.133799434874945,0.01640913441814549
2023-05-02T07:30:00-04:00,1.09713,1.09714,1.09659,1.0968,1.0949631199999998,1.0963788888888888,1.0960977777777785,1.0960046666666676,1.0971455000000012,1.0979038,1.0981762000000002,NaN,1.0965350256833661,1.096300288250588,-2361,-32497,-30340.8,-0.10776128639971613,-44.84395228822857,0.11683949174820613
2023-05-02T07:45:00-04:00,1.0968,1.09696,1.0965,1.09676,1.0950697952,1.0965113333333334,1.096204444444445,1.0960226666666677,1.0970265000000015,1.0978948,1.098135,NaN,1.096580020546693,1.0963878306004702,-2290,-34787,-30854,-0.08778771570936604,-44.92746797021261,0.08760722759628327
2023-05-02T08:00:00-04:00,1.09676,1.09682,1.09613,1.09614,1.095172203392,1.0964984444444446,1.0963000000000007,1.0960986666666677,1.0968385000000014,1.0978776,1.0980894,NaN,1.0964920164373544,1.0964758644803763,-3293,-38080,-32490.2,-0.07167702623676603,-46.789005590111415,0.0785187349353463
2023-05-02T08:15:00-04:00,1.09614,1.09682,1.09609,1.09651,1.09527051525632,1.0965404444444444,1.0963711111111119,1.0961857777777786,1.0966805000000015,1.09787,1.0980436,NaN,1.0964956131498835,1.0965142915843011,2784,-35296,-34159.2,-0.04575553286363753,-45.849271614523836,0.058401087720276676
2023-05-02T08:30:00-04:00,1.09651,1.09695,1.09601,1.0969,1.0953648946460672,1.0966462222222222,1.0965300000000007,1.0963006666666675,1.0965180000000014,1.0978524,1.0980021,NaN,1.096576490519907,1.0965358332674409,3268,-32028,-34537.6,-0.024341623350840138,-44.68692927382504,0.13053757747816394
2023-05-02T08:45:00-04:00,1.0969,1.09707,1.09541,1.09551,1.0976299999999999,1.0964422222222223,1.0965277777777787,1.0963866666666675,1.0963650000000014,1.0978094,1.0979438000000001,NaN,1.0963631924159256,1.0965014666139528,-3561,-35589,-35156,-0.003830474157887337,-49.19945548405387,-0.001825600394321377
2023-05-02T09:00:00-04:00,1.09551,1.09579,1.09486,1.09489,1.0975856,1.0961146666666666,1.0964388888888896,1.0964335555555564,1.0962860000000014,1.097755,1.0978811,NaN,1.0960685539327404,1.0963991732911622,-4055,-39644,-36127.4,0.0063156459051812676,-51.49436835568468,-0.07301335231681716
2023-05-02T09:15:00-04:00,1.09489,1.09551,1.09486,1.09547,1.097476576,1.095920888888889,1.0962344444444456,1.0964204444444454,1.0962070000000015,1.0977064,1.0978193000000003,NaN,1.0959488431461923,1.0962905386329298,3625,-36019,-35715.2,0.008652897613129358,-49.57408412621862,-0.1676827879086187
2023-05-02T09:30:00-04:00,1.09547,1.09575,1.0951,1.0957,1.0973719129600001,1.095814,1.0960755555555566,1.0963613333333342,1.0961200000000013,1.0976466,1.0977465000000002,NaN,1.095899074516954,1.096171230906344,5024,-30995,-34855,-0.0001694190749145484,-48.51926747217993,-0.13034006908935516
2023-05-02T09:45:00-04:00,1.0957,1.09592,1.09418,1.09433,1.0972714364416,1.095464888888889,1.0958011111111121,1.0962155555555566,1.0959780000000015,1.0975482,1.097657,NaN,1.0955852596135631,1.0959729847250752,-5424,-36419,-35733.2,-0.012204166273733507,-55.301123819719685,-0.22520058351567945
2023-05-02T10:00:00-04:00,1.09433,1.09714,1.0943,1.09613,1.09418,1.0955306666666667,1.0957311111111119,1.0960562222222232,1.0959370000000015,1.0974894,1.0975917,NaN,1.0956942076908505,1.0958391877800602,12818,-23601,-33335.6,-0.01379928214176638,-34.21753842957201,-0.0574419198366013
2023-05-02T10:15:00-04:00,1.09613,1.09627,1.09518,1.09586,1.09418,1.0955564444444443,1.0957000000000008,1.0959084444444456,1.0959540000000014,1.0974308000000002,1.0975255,NaN,1.0957273661526803,1.0957709502240482,-7394,-30995,-31605.8,-0.01727599002364679,-36.0388369981724,-0.02554418231246337
2023-05-02T10:30:00-04:00,1.09586,1.09933,1.09586,1.09918,1.0942391999999999,1.0962524444444446,1.0959966666666676,1.09586088888889,1.0961230000000015,1.0974346,1.0974942,NaN,1.0964178929221442,1.0958647601792386,9831,-21164,-28634.8,-0.005439160040679986,-6.254995996584697,0.24349983128288388
2023-05-02T10:45:00-04:00,1.09918,1.09922,1.09739,1.09789,1.094442832,1.0966311111111111,1.0961066666666677,1.095867111111112,1.0962535000000015,1.0974152000000001,1.0974556999999998,NaN,1.0967123143377153,1.096027408143391,-7610,-28774,-28190.6,-0.0019287282772885422,-15.186108280287185,0.0902543531771398
2023-05-02T11:00:00-04:00,1.09789,1.09888,1.09775,1.0987,1.09463831872,1.097149777777778,1.096461111111112,1.0959991111111123,1.0963950000000016,1.0974158,1.0974466,NaN,1.0971098514701723,1.096332326514713,7046,-21728,-25252.4,-0.0003648403366568585,-9.987718641981125,0.29118857883543064
2023-05-02T11:15:00-04:00,1.0987,1.09912,1.09803,1.09823,1.0948259859712,1.0975035555555557,1.096832222222223,1.0962193333333343,1.0965330000000013,1.0974036000000003,1.0974437000000001,NaN,1.0973338811761377,1.0966602612117702,-5461,-27189,-25970,0.014192571656718448,-12.323815847769637,0.30505347569163305
2023-05-02T11:30:00-04:00,1.09823,1.09895,1.09801,1.09882,1.095006146532352,1.0979011111111112,1.0972044444444455,1.0965202222222235,1.0966975000000017,1.0974048000000003,1.0974515,NaN,1.0976311049409102,1.0970410089694163,4568,-22621,-24295.2,0.035480610070317206,-9.869757954614835,0.30580481437191015
2023-05-02T11:45:00-04:00,1.09882,1.09975,1.09845,1.09966,1.0951791006710578,1.0983922222222222,1.0976444444444455,1.096849777777779,1.0968960000000014,1.0974252000000002,1.0974667,NaN,1.0980368839527281,1.0973648071755329,4511,-18110,-23684.4,0.05574462709067966,-6.421295058052355,0.36141279547323046
2023-05-02T12:00:00-04:00,1.09966,1.1002399999999999,1.09956,1.09969,1.0954533546307943,1.0988013333333333,1.0982400000000012,1.0972764444444458,1.0970150000000016,1.0974470000000003,1.0974924,NaN,1.0983675071621826,1.0976958457404262,3656,-14454,-20820.4,0.07474299634389191,-6.321555138440923,0.48979741028757606
2023-05-02T12:15:00-04:00,1.09969,1.10013,1.09953,1.09974,1.0958362862603308,1.0991013333333335,1.0986411111111123,1.0977124444444457,1.0971455000000017,1.097474,1.0975209999999997,NaN,1.0986420057297461,1.0980022765923412,2774,-11680,-18810.8,0.11349806684371828,-6.195428684622414,0.3293404979336293
2023-05-02T12:30:00-04:00,1.09974,1.09998,1.09939,1.09988,1.0961885833595044,1.099349111111111,1.099087777777779,1.0981635555555571,1.0972995000000016,1.0975032000000002,1.0975513999999997,NaN,1.0988896045837968,1.098313421273873,2477,-9203,-15213.6,0.13572575195981781,-5.880099606840327,0.36683517967622803
2023-05-02T12:45:00-04:00,1.09988,1.10031,1.09987,1.09997,1.0965126966907441,1.0995255555555556,1.099175555555557,1.098557777777779,1.0974600000000017,1.0975386000000003,1.0975817999999997,NaN,1.0991056836670374,1.0986083370190982,2293,-6910,-12071.4,0.15940320993362672,-5.692470047252168,0.07187175894756513
2023-05-02T13:00:00-04:00,1.09997,1.10011,1.0996,1.0996299999999999,1.0968924270216698,1.0996164444444443,1.0993688888888902,1.0989026666666681,1.0976345000000018,1.0975660000000003,1.0976131999999998,NaN,1.09921054693363,1.0988430696152787,-2296,-9206,-10290.6,0.1510315274138269,-6.402162129763523,0.15848582280555
2023-05-02T13:15:00-04:00,1.0996299999999999,1.09988,1.0994599999999999,1.09987,1.0972341843195028,1.0997166666666667,1.0994988888888901,1.0991544444444459,1.0978025000000018,1.0975944000000004,1.0976457,NaN,1.0993424375469039,1.099038055692223,1595,-7611,-8922,0.1528637166545475,-6.054045035831902,0.10648948757621673
2023-05-02T13:30:00-04:00,1.09987,1.1002399999999999,1.09981,1.10022,1.0975417658875526,1.099860888888889,1.0997200000000011,1.0993702222222237,1.0979685000000017,1.0976242000000003,1.0976799,NaN,1.0995179500375232,1.0992132445537783,1808,-5803,-7746.6,0.1505924418824775,-5.478704313746446,0.18120065924259365
2023-05-02T13:45:00-04:00,1.10022,1.10036,1.09971,1.09971,1.0978185892987973,1.0998588888888887,1.09981888888889,1.099516444444446,1.0981785000000017,1.0976368000000003,1.0977095,NaN,1.0995563600300184,1.0993465956430228,-1832,-7635,-7433,0.1518664231183961,-6.327916289533125,0.08099597750314497
2023-05-02T14:00:00-04:00,1.09971,1.10009,1.0997,1.09996,1.0981235585829416,1.099887111111111,1.0998522222222233,1.0996517777777792,1.0984320000000016,1.0976606000000004,1.0977398,NaN,1.0996370880240147,1.0994528765144183,2593,-5042,-7059.4,0.14292261418791702,-5.738442701041416,0.027281159631155714
2023-05-02T14:15:00-04:00,1.09996,1.10017,1.0997999999999999,1.10004,1.0983919315529886,1.0999246666666667,1.0998911111111123,1.0997562222222235,1.0986605000000016,1.0976946000000003,1.0977692000000001,NaN,1.0997176704192118,1.0995543012115345,1669,-3373,-5892.8,0.12402530183788453,-5.617056468815005,0.03182715128807668
2023-05-02T14:30:00-04:00,1.10004,1.10009,1.09983,1.09997,1.09862809976663,1.0999404444444443,1.0999166666666678,1.099839777777779,1.0988740000000017,1.0977198000000004,1.0978014000000003,NaN,1.0997681363353693,1.0996394409692276,-1534,-4907,-5352,0.10704636292014562,-5.714671101010218,0.020914034226267343
2023-05-02T14:45:00-04:00,1.09997,1.10013,1.09992,1.1001,1.0988359277946345,1.099977111111111,1.0999411111111121,1.0998840000000012,1.0991625000000016,1.0977426000000003,1.0978305000000002,NaN,1.0998345090682955,1.099702752775382,1914,-2993,-4790,0.09123573615609046,-5.488464931750734,0.020002182056234226
2023-05-02T15:00:00-04:00,1.1001,1.10047,1.10005,1.10022,1.0990188164592782,1.1000328888888888,1.0999688888888899,1.0999140000000012,1.0993670000000015,1.0977718000000005,1.0978601000000001,NaN,1.0999116072546364,1.0997738022203056,1808,-1185,-3500,0.06878948442334115,-5.291246497063146,0.022727892578896108
2023-05-02T15:15:00-04:00,1.10022,1.1005,1.10002,1.10036,1.0992219821549793,1.100111111111111,1.100050000000001,1.0999535555555569,1.0995920000000017,1.0977962000000003,1.0978897,NaN,1.1000012858037092,1.0998466417762447,1332,147,-2462.2,0.0540027807014852,-5.121753123010649,0.06638596618863796
2023-05-02T15:30:00-04:00,1.10036,1.10058,1.10029,1.10044,1.0994264650101826,1.100189111111111,1.1001133333333344,1.0999980000000014,1.0996550000000016,1.0978070000000004,1.0979246000000003,NaN,1.1000890286429674,1.0999209134209957,1249,1396,-1508.4,0.041524700029692704,-5.03094647791259,0.05182430650896756
2023-05-02T15:45:00-04:00,1.10044,1.10079,1.10044,1.10056,1.0996341013083497,1.1002784444444444,1.1001511111111122,1.10004488888889,1.0997885000000018,1.0978248000000006,1.0979608,NaN,1.100183222914374,1.1000039307367966,1203,2599,-7.2,0.041821001954705506,-4.899762587832369,0.030902910327026138
2023-05-02T16:00:00-04:00,1.10056,1.10069,1.10028,1.1003,1.0998652810466798,1.1003082222222222,1.1002166666666675,1.1001000000000012,1.0998685000000017,1.0978278000000004,1.0979954,NaN,1.1002065783314992,1.1000783445894373,-742,1857,962.8,0.032109358865028005,-5.0750551661560825,0.05365050786117163
2023-05-02T16:15:00-04:00,1.1003,1.10053,1.10015,1.10018,1.1000502248373438,1.1003008888888888,1.1002411111111121,1.1001544444444458,1.0999660000000016,1.0978600000000005,1.0980299,NaN,1.1002012626651994,1.10013627567155,-587,1270,1453.8,0.029972875911152663,-5.139074070091437,0.020000727299164238
2023-05-02T16:30:00-04:00,1.10018,1.10023,1.09986,1.09992,1.10079,1.1002366666666665,1.1002277777777787,1.1001900000000013,1.1000210000000017,1.0979290000000006,1.0980634,NaN,1.1001450101321595,1.1001650205372402,-569,701,1564.6,0.022290776666321534,-5.273542975179657,-0.010908694229291478
2023-05-02T16:45:00-04:00,1.09992,1.09998,1.09977,1.09987,1.1007714,1.100165111111111,1.1002166666666675,1.1002106666666678,1.1000315000000016,1.0979854000000007,1.0980894,NaN,1.1000900081057277,1.1001652164297924,-367,334,1352.2,0.016198930836026085,-5.290226006672892,-0.009091157031554406
2023-05-02T17:00:00-04:00,1.09987,1.09999,1.09969,1.09988,1.100731344,1.1000977777777778,1.1001922222222231,1.10021888888889,1.1000410000000014,1.0980342000000005,1.0981148,NaN,1.1000480064845821,1.1001381731438338,172,506,933.6,0.014428252882824814,-5.288662185494015,-0.019998181983465955
2023-05-02T17:15:00-04:00,1.09988,1.10023,1.09986,1.10014,1.10066886336,1.1000873333333332,1.1001833333333342,1.1002122222222235,1.1000610000000015,1.0980936000000006,1.0981416000000002,NaN,1.1000664051876656,1.1001101385150671,193,699,702,0.012843622083360881,-5.2430390266039675,-0.00727127301813092
2023-05-02T17:30:00-04:00,1.10014,1.10019,1.10009,1.10014,1.1006101315583998,1.1000786666666666,1.1001588888888896,1.1001957777777789,1.1000740000000016,1.0981574000000005,1.0981672,NaN,1.1000811241501325,1.1000861108120537,0,699,587.8,0.010384669993539685,-5.2430390266039675,-0.019993456686912374
2023-05-02T17:45:00-04:00,1.10014,1.10018,1.10003,1.10013,1.100554923664896,1.1000728888888889,1.1001244444444453,1.1001751111111122,1.1000820000000016,1.0982496000000004,1.0981954,NaN,1.100090899320106,1.100075288649643,-710,-11,445.4,0.00721161858425901,-5.249492750675349,-0.0281705499618364
2023-05-02T18:00:00-04:00,1.10013,1.10031,1.10005,1.10023,1.1005030282450021,1.100094,1.1000877777777787,1.1001493333333345,1.1001120000000015,1.0983382000000006,1.0982234000000002,NaN,1.1001187194560849,1.1000810309197147,606,595,497.6,0.0041771510272702655,-5.194408351558887,-0.029984735043972293
2023-05-02T18:15:00-04:00,1.10023,1.1005,1.1002,1.10039,1.09969,1.1001544444444444,1.1000977777777787,1.1001304444444455,1.1001380000000016,1.0984404000000005,1.0982532,NaN,1.100172975564868,1.1001060247357717,482,1077,611.8,-0.0006579337502755583,-5.124313916758918,0.00817958738525161
2023-05-02T18:30:00-04:00,1.10039,1.10054,1.10039,1.10053,1.0997062,1.1002408888888888,1.1001366666666674,1.1001211111111122,1.1001535000000016,1.0985336000000006,1.0982849000000001,NaN,1.1002443804518944,1.1001416197886176,308,1385,749,-0.0014240396063765935,-5.085127810014937,0.03181297605846975
2023-05-02T18:45:00-04:00,1.10053,1.10065,1.10045,1.10064,1.099739552,1.1003415555555556,1.1002166666666673,1.1001326666666678,1.1002000000000016,1.0986370000000005,1.0983157,1.0990051,1.1003235043615156,1.100190095830894,491,1876,984.4,0.0009392430913923862,-5.036051455894625,0.0654593061313599
2023-05-02T19:00:00-04:00,1.10064,1.10108,1.10049,1.10094,1.0997941788799999,1.1004862222222223,1.1003355555555563,1.10017488888889,1.1002490000000018,1.0987452000000006,1.0983501000000002,1.09899955,1.1004468034892125,1.1002612766647155,722,2598,1506.2,0.004886400916972364,-4.839256863657402,0.0972842244992705
2023-05-02T19:15:00-04:00,1.10094,1.10136,1.10087,1.10109,1.0998970445696,1.100637111111111,1.100470000000001,1.1002513333333344,1.1003015000000018,1.0988532000000006,1.0983865000000002,1.0989966,1.10057544279137,1.1003526213317727,690,3288,2044.8,0.011083667625120017,-4.745246290874224,0.11001200130922768
2023-05-02T19:30:00-04:00,1.10109,1.10137,1.101,1.10119,1.10004334011264,1.1007811111111112,1.1005866666666675,1.100349111111112,1.1003625000000017,1.0989308000000007,1.0984235,1.09899415,1.1006983542330961,1.1004576970654183,703,3991,2627.6,0.01801168639076532,-4.681400465374045,0.09544239824022356
2023-05-02T19:45:00-04:00,1.10119,1.10121,1.10097,1.10106,1.100202539299123,1.1008757777777778,1.1006888888888897,1.1004595555555565,1.1004105000000017,1.0990094000000008,1.0984601,1.09899065,1.100770683386477,1.1005629576523348,-1038,2953,2941.2,0.0216545476498454,-4.803940626472459,0.08362572036286582
2023-05-02T20:00:00-04:00,1.10106,1.10132,1.10047,1.1007,1.1003426345832283,1.100878,1.1007522222222232,1.1005666666666676,1.1004345000000018,1.0990874000000006,1.0984956000000001,1.0989861,1.1007565467091815,1.1006495661218678,-1505,1448,2855.6,0.024146530494185567,-5.296011903242002,0.051812058574892
2023-05-02T20:15:00-04:00,1.1007,1.10122,1.10064,1.10121,1.100465918433241,1.1009695555555556,1.100861111111112,1.1006717777777788,1.1004770000000017,1.0991764000000008,1.0985356,1.0989851,1.1008472373673452,1.1007296528974944,1019,2467,2829.4,0.029675593576876918,-4.8238669046047615,0.08907228488588576
2023-05-02T20:30:00-04:00,1.10121,1.10206,1.1012,1.10177,1.10047,1.1011513333333334,1.1010144444444454,1.1007806666666675,1.1005435000000017,1.0992890000000006,1.0985833,1.09898815,1.1010317898938762,1.1008209223179957,1457,3924,2956.6,0.03756602286942268,-4.082936473533626,0.12541008188005498
2023-05-02T20:45:00-04:00,1.10177,1.10184,1.10162,1.10173,1.10064,1.1012944444444446,1.1011477777777785,1.1008928888888896,1.1006020000000016,1.0993934000000007,1.0986316999999999,1.09899115,1.101171431915101,1.1009155378543967,-712,3212,2800.8,0.044157732146201764,-4.108785788726334,0.10903837242056917
2023-05-02T21:00:00-04:00,1.10173,1.10174,1.10128,1.10147,1.1008388,1.1013588888888888,1.1012400000000007,1.1010031111111118,1.1006605000000016,1.0994848000000008,1.0986685999999999,1.0989931,1.1012311455320807,1.1010076302835172,-1054,2158,2641.8,0.04875936194903847,-4.357521867439047,0.07541067015553554
2023-05-02T21:15:00-04:00,1.10147,1.10192,1.10141,1.10189,1.101009768,1.101488888888889,1.1013455555555565,1.1011217777777784,1.1007460000000016,1.0996124000000007,1.0987108999999997,1.09899635,1.1013629164256646,1.101128904226814,1087,3245,3001.2,0.05323360054694978,-3.943039403095856,0.08628989772376391
2023-05-02T21:30:00-04:00,1.10189,1.10206,1.10155,1.1018999999999999,1.1011568004799999,1.1015997777777777,1.1014355555555564,1.1012366666666673,1.1008450000000016,1.0997526000000009,1.0987538,1.0990004500000001,1.1014703331405318,1.1012535233814513,1383,4628,3433.4,0.054510092651284765,-3.9304882410018327,0.07356346892624377
2023-05-02T21:45:00-04:00,1.1018999999999999,1.1024,1.10189,1.10227,1.1012832484128,1.1017666666666668,1.1015555555555563,1.1013448888888895,1.1009650000000017,1.0998886000000008,1.0987974999999999,1.0990065,1.1016302665124253,1.101373218705161,1370,5998,3848.2,0.05505820494431232,-3.4704646453939927,0.09807571808681445
2023-05-02T22:00:00-04:00,1.10227,1.10245,1.10206,1.10218,1.101461928666752,1.1018915555555557,1.1016800000000007,1.1014513333333338,1.1010800000000016,1.1000182000000007,1.0988323999999998,1.099012,1.1017402132099403,1.101486974964129,-1292,4706,4147,0.054053633245056056,-3.575956040424419,0.10172016057254009
2023-05-02T22:15:00-04:00,1.10218,1.10223,1.10196,1.102,1.1016397815067367,1.1019555555555556,1.1018244444444452,1.1015682222222227,1.1011730000000015,1.1001716000000008,1.0988599,1.0990185,1.1017921705679523,1.1015991799713032,-1012,3694,4454.2,0.053417287965656576,-3.7412285004580297,0.11810665939857172
2023-05-02T22:30:00-04:00,1.102,1.10245,1.102,1.10244,1.1017856208355241,1.1020786666666667,1.1019611111111118,1.101691333333334,1.1012880000000016,1.1002978000000008,1.0988936,1.09902625,1.1019217364543619,1.1017109439770425,866,4560,4717.2,0.05926688258628915,-3.395457175594149,0.11169531696952119
2023-05-02T22:45:00-04:00,1.10244,1.10258,1.10239,1.10253,1.1019052090851298,1.1021924444444444,1.1020455555555566,1.1018133333333342,1.1014080000000015,1.1004312000000007,1.098931,1.09903615,1.1020433891634895,1.1018255551816343,977,5537,4899,0.06091241505546415,-3.315697732903458,0.06897991413816804
2023-05-02T23:00:00-04:00,1.10253,1.10293,1.1025,1.10287,1.102,1.1023573333333334,1.1021722222222232,1.1019366666666675,1.1015400000000013,1.1005050000000007,1.0989697999999999,1.09904855,1.1022087113307917,1.1019412441453074,920,6457,4990.8,0.05904622491963937,-3.031986632071729,0.1034736278398445
2023-05-02T23:15:00-04:00,1.10287,1.10292,1.10261,1.10275,1.102186,1.102472888888889,1.1023144444444453,1.1020635555555562,1.1016580000000014,1.1006022000000006,1.0990087000000002,1.09905935,1.1023169690646333,1.102056595316246,-900,5557,5161,0.05740580239534233,-3.129912951583646,0.11620833976412866
2023-05-02T23:30:00-04:00,1.10275,1.10279,1.10253,1.10274,1.1023348000000002,1.102558,1.1024088888888897,1.1021804444444452,1.1017685000000015,1.1006830000000007,1.0990494,1.0990703499999999,1.1024015752517067,1.102178476252997,-653,4904,5403,0.058770136454725015,-3.1358345113205743,0.0771401864069932
2023-05-02T23:45:00-04:00,1.10274,1.10299,1.10265,1.10295,1.1024538400000001,1.102666222222222,1.1025255555555562,1.1022933333333342,1.1018840000000014,1.1007774000000008,1.0990905,1.09908315,1.1025112602013654,1.1022963810023976,598,5502,5591.4,0.05792555380007242,-3.0219545396137115,0.09528995371632794
2023-05-03T00:00:00-04:00,1.10295,1.10296,1.1026799999999999,1.1026799999999999,1.10253,1.102697111111111,1.1025711111111118,1.1023984444444452,1.1019710000000011,1.1008546000000008,1.0991297,1.0990953499999998,1.1025450081610924,1.102396704801918,-918,4584,5400.8,0.056183222733051756,-3.246679141817072,0.03719596831990342
2023-05-03T00:15:00-04:00,1.1026799999999999,1.1027,1.10234,1.10235,1.10299,1.1026528888888891,1.1025900000000008,1.1024820000000006,1.1020340000000013,1.1009084000000007,1.0991667999999999,1.0991056000000001,1.1025060065288739,1.1024561638415344,-1266,3318,4773,0.050812880778071876,-3.6255560598712,0.015423977934638943
2023-05-03T00:30:00-04:00,1.10235,1.1025,1.1022,1.10248,1.1029769999999999,1.102630888888889,1.102643333333334,1.1025477777777786,1.1020985000000012,1.1009642000000006,1.0992056000000001,1.0991151,1.1025008052230991,1.1024929310732277,794,4112,4484,0.047525921265851145,-3.5319197374690856,0.04355716878401215
2023-05-03T00:45:00-04:00,1.10248,1.10256,1.10211,1.10216,1.1029459199999998,1.1025342222222223,1.102612222222223,1.1025884444444451,1.1021535000000013,1.1010126000000007,1.0992433,1.09912185,1.1024326441784793,1.1024991448585824,-776,3336,4170.4,0.04478457388559404,-3.7571573835033933,-0.02539820761221091
2023-05-03T01:00:00-04:00,1.10216,1.10259,1.10216,1.10258,1.1028957647999997,1.1025277777777778,1.1026177777777786,1.1026068888888898,1.1022475000000014,1.1010666000000007,1.0992849,1.0991301,1.1024621153427834,1.1024893158868658,1087,4423,3954.6,0.03948474119339816,-3.3429344031739916,0.004535023990266339
2023-05-03T01:15:00-04:00,1.10258,1.10264,1.1021,1.10225,1.1028486189119997,1.1024542222222222,1.1025488888888895,1.1026024444444453,1.1022995000000013,1.1011122000000007,1.0993254000000001,1.0991357,1.1024196922742266,1.1024642527094928,-1209,3214,3680.6,0.030245558858185938,-3.70478569741108,-0.056216961201235406
2023-05-03T01:30:00-04:00,1.10225,1.10233,1.10209,1.10222,1.1027887293990397,1.1023884444444443,1.1024900000000006,1.1025824444444454,1.1023220000000014,1.1011640000000005,1.0993650000000001,1.0991421,1.1023797538193814,1.1024390021675943,-1143,2071,3431.2,0.019984266602156745,-3.735894792443941,-0.04806166402175647
2023-05-03T01:45:00-04:00,1.10222,1.10229,1.10182,1.102,1.1027188564591357,1.1022904444444444,1.1024077777777785,1.1025353333333343,1.1023355000000012,1.1012066000000005,1.0994005000000002,1.0991450999999999,1.102303803055505,1.1023996017340756,-1267,804,2769.6,0.012186566351903644,-3.9887844152051475,-0.06710557338991628
2023-05-03T02:00:00-04:00,1.102,1.10237,1.1016299999999999,1.10168,1.1026109936840394,1.102144888888889,1.1022666666666672,1.1024662222222232,1.1023460000000012,1.1012358000000007,1.09943,1.09914765,1.102179042444404,1.1023488813872604,-1914,-1110,1880.4,0.0027863708881015457,-4.544573888889528,-0.11514574550071212
2023-05-03T02:15:00-04:00,1.10168,1.10205,1.10142,1.10192,1.1024736545682738,1.1020755555555555,1.1021822222222228,1.102379111111112,1.1023475000000011,1.1012800000000005,1.0994584,1.09915055,1.1021272339555233,1.1022819051098085,1662,552,1106.2,-0.00850150590690787,-4.18250867939128,-0.06892298763012587
2023-05-03T02:30:00-04:00,1.10192,1.10297,1.10176,1.10276,1.10142,1.102191111111111,1.1022277777777783,1.1023148888888898,1.1023905000000012,1.1013360000000005,1.0994983,1.0991601500000001,1.1022537871644187,1.1022487240878467,2522,3074,1078.2,-0.011533621803361073,-2.259973468123784,0.03719326892547934
2023-05-03T02:45:00-04:00,1.10276,1.1032,1.1025099999999999,1.10307,1.10142,1.1023595555555556,1.1022933333333338,1.1022755555555566,1.102430500000001,1.1013966000000006,1.0995456000000001,1.09917245,1.102417029731535,1.1022561792702776,2192,5266,1717.2,-0.010055773257786931,-1.6437741137764457,0.05351571003556441
2023-05-03T03:00:00-04:00,1.10307,1.10347,1.10259,1.10327,1.1014912000000001,1.102554888888889,1.102416666666667,1.1022773333333344,1.102485000000001,1.1014626000000007,1.0995912,1.0991866,1.102587623785228,1.1023129434162222,3996,9262,3408.8,-0.007208917807018229,-0.9192507381068037,0.1007113304783284
2023-05-03T03:15:00-04:00,1.10327,1.10412,1.10319,1.10386,1.101609928,1.1028435555555556,1.102558888888889,1.1023357777777787,1.1025780000000012,1.1015378000000007,1.0996402000000003,1.0992043,1.1028420990281824,1.102445554732978,3301,12563,6143.4,0.0009544968463146684,0.8460379038396814,0.11609134938055923
2023-05-03T03:30:00-04:00,1.10386,1.10413,1.10326,1.10333,1.10181073376,1.1029977777777777,1.1026788888888892,1.1024351111111121,1.1026225000000012,1.1016000000000006,1.0996859,1.09921735,1.1029396792225459,1.1026080437863823,-3467,9096,7852.2,0.0020125338535885054,-0.8185844214556374,0.09798140167838239
2023-05-03T03:45:00-04:00,1.10333,1.10354,1.10295,1.10344,1.1020426603840001,1.1031499999999999,1.1028144444444448,1.1025524444444454,1.102668000000001,1.1016616000000006,1.0997289000000001,1.0992315499999998,1.1030397433780368,1.102765235029106,2604,11700,9577.4,0.008485961887103169,-0.5589703440715892,0.11068570702763504
2023-05-03T04:00:00-04:00,1.10344,1.10444,1.10342,1.10365,1.1022513943456,1.103317111111111,1.1029977777777782,1.1026933333333342,1.102707000000001,1.1017258000000005,1.0997664000000003,1.09924855,1.1031617947024295,1.102914188023285,4000,15700,11664.2,0.016616998481310614,0.20228536534638908,0.14972776769509338
2023-05-03T04:15:00-04:00,1.10365,1.10406,1.10355,1.10376,1.102514027024128,1.1034695555555556,1.1032288888888893,1.1028557777777788,1.102757500000001,1.1017898000000006,1.0998073000000002,1.0992689999999998,1.1032814357619436,1.103052950418628,2633,18333,13478.4,0.028733175288013186,0.4647145775061712,0.18880255609615149
2023-05-03T04:30:00-04:00,1.10376,1.10465,1.10342,1.10456,1.1027451437812328,1.1037357777777776,1.1035222222222225,1.1030484444444455,1.102848500000001,1.1018750000000006,1.0998514000000001,1.099291,1.1035371486095549,1.1031919603349025,2413,20746,15115,0.04702994985697573,2.2136455045190973,0.23958182082183604
2023-05-03T04:45:00-04:00,1.10456,1.10467,1.10396,1.10397,1.1030118236518602,1.1038253333333332,1.103656666666667,1.103244000000001,1.102899500000001,1.1019508000000007,1.0999054000000001,1.09931195,1.1036237188876439,1.103328768267922,-2189,18557,17007.2,0.060304115463430334,1.0443925893309698,0.10972469077586541
2023-05-03T05:00:00-04:00,1.10397,1.10469,1.1038999999999999,1.1043,1.1032771318675627,1.103954,1.1037933333333336,1.1034397777777787,1.102980500000001,1.1020384000000008,1.0999837000000001,1.0993340999999999,1.1037589751101151,1.1034726146143377,2494,21051,18877.4,0.06843451144088963,1.7899019781734273,0.11150697598521077
2023-05-03T05:15:00-04:00,1.1043,1.10458,1.10389,1.10441,1.1035314481314014,1.1040773333333331,1.1039200000000005,1.1036242222222232,1.103083500000001,1.1021292000000007,1.1000573000000002,1.0993551,1.1038891800880921,1.1036180916914702,2283,23334,20404.2,0.0731090717415213,2.0173130077845998,0.10332919412291813
2023-05-03T05:30:00-04:00,1.10441,1.10444,1.10365,1.10398,1.10469,1.1040893333333333,1.1039333333333337,1.1037651111111122,1.103158500000001,1.1022112000000006,1.1001227000000002,1.0993749,1.1039073440704736,1.1037432733531762,-2099,21235,20984.6,0.0725039012504041,1.200071222578151,0.010870943779093178
2023-05-03T05:45:00-04:00,1.10398,1.10436,1.10376,1.10404,1.1046692,1.1041106666666667,1.1040122222222226,1.1038631111111121,1.1032525000000009,1.1022892000000006,1.1001914000000002,1.09939345,1.103933875256379,1.1038226186825408,2152,23387,21512.8,0.06739698047374523,1.317029863133134,0.06435064758503697
2023-05-03T06:00:00-04:00,1.10404,1.10405,1.10335,1.10392,1.104648816,1.104092222222222,1.1040655555555559,1.10394488888889,1.103319500000001,1.1023648000000006,1.1002611000000002,1.09941345,1.103931100205103,1.1038840949460327,-2157,21230,22047.4,0.06514316346395777,1.0825818358879438,0.04350032625245015
2023-05-03T06:15:00-04:00,1.10392,1.10398,1.10325,1.10362,1.10459686336,1.104003111111111,1.1040622222222227,1.103998666666668,1.103388000000001,1.1024346000000005,1.1003421000000002,1.0994344,1.1038688801640826,1.1039060759568262,-2144,19086,21654.4,0.06228309784939265,0.4999309191549114,-0.002718253069358446
2023-05-03T06:30:00-04:00,1.10362,1.10383,1.10324,1.10359,1.1045160515584,1.1039086666666666,1.1040433333333337,1.1040233333333345,1.103456500000001,1.1025018000000006,1.1004200000000002,1.0994543499999998,1.103813104131266,1.103890860765461,-1926,17160,20419.6,0.05595271747227352,0.4475759418982915,-0.015401898963543114
2023-05-03T06:45:00-04:00,1.10359,1.10359,1.10295,1.10328,1.104413967433728,1.1037560000000002,1.1039011111111114,1.1040168888888897,1.103520500000001,1.1025596000000006,1.1005,1.0994746499999999,1.1037064833050128,1.103850688612369,-2088,15072,19187,0.047025751745325715,-0.13894622666074558,-0.11588324762801006
2023-05-03T07:00:00-04:00,1.10328,1.10394,1.10318,1.1038,1.1042675706903553,1.1037357777777776,1.1038822222222224,1.1039908888888896,1.103626500000001,1.1026250000000006,1.1005793000000001,1.0994964,1.10372518664401,1.1038089508898952,1931,17003,17910.2,0.03236787791258459,0.7711763170269113,-0.015398969174887315
2023-05-03T07:15:00-04:00,1.1038,1.10395,1.10339,1.10384,1.1041358136213197,1.1037273333333333,1.1038311111111114,1.1039440000000007,1.103722500000001,1.1026890000000007,1.1006630000000002,1.0995154,1.1037481493152081,1.103772360711916,1636,18639,17392,0.02186709998161468,0.8304624195817812,-0.041655347278830655
2023-05-03T07:30:00-04:00,1.10384,1.10436,1.10325,1.10405,1.10295,1.103771111111111,1.1037911111111116,1.1038897777777783,1.103787000000001,1.1027512000000006,1.1007482000000002,1.0995345,1.1038085194521665,1.1037602885695328,2382,21021,17779,0.010410509739682073,1.2836259215386805,-0.03259659003449045
2023-05-03T07:45:00-04:00,1.10405,1.10427,1.1034,1.10395,1.1029782000000001,1.103802888888889,1.103787777777778,1.1038386666666673,1.103831000000001,1.1028084000000005,1.1008308000000002,1.0995526,1.1038368155617333,1.1037650308556262,-2833,18188,17984.6,0.0011087292366921838,1.0270252241065272,-0.0027174405333406848
2023-05-03T08:00:00-04:00,1.10395,1.10435,1.10379,1.10411,1.1030058360000001,1.1038673333333333,1.1037955555555559,1.103817555555556,1.103873000000001,1.1028668000000006,1.1008988000000002,1.0995721,1.1038914524493866,1.103802024684501,2860,21048,19179.8,-0.002200103275404539,1.441536750896529,0.006340349987320614
2023-05-03T08:15:00-04:00,1.10411,1.10422,1.10215,1.10375,1.10436,1.1038582222222222,1.103776666666667,1.1037964444444452,1.1038675000000011,1.1029206000000005,1.1009650000000002,1.09958975,1.1038631619595092,1.1038296197476007,-7781,13267,18432.6,-0.006897828025340444,-1.0954930740297426,-0.015399666642510641
2023-05-03T08:30:00-04:00,1.10375,1.1042,1.1033,1.10335,1.10435,1.103772888888889,1.1037466666666669,1.103779555555556,1.103868500000001,1.1029736000000006,1.1010305000000002,1.09960335,1.1037605295676074,1.1038320957980807,-5135,8132,16331.2,-0.009861652150259153,-2.9564217263511683,-0.024464942643300455
2023-05-03T08:45:00-04:00,1.10335,1.10401,1.10317,1.10384,1.104306,1.1037915555555553,1.1037744444444448,1.1037762222222227,1.103888500000001,1.1030262000000006,1.1011013,1.09961815,1.103776423654086,1.1038256766384644,3537,11669,14460.8,-0.010068499444132439,-1.3856327654597254,0.02265334046157191
2023-05-03T09:00:00-04:00,1.10384,1.10434,1.10336,1.10409,1.10215,1.1038546666666667,1.1038644444444448,1.1037915555555562,1.103910500000001,1.1030726000000006,1.1011808,1.0996351,1.1038391389232687,1.1038261413107715,3826,15495,13922.2,-0.00834273004840227,-0.5191122552405636,0.07341744616053743
2023-05-03T09:15:00-04:00,1.10409,1.10419,1.10359,1.10381,1.1021938,1.1038437777777779,1.1038655555555559,1.1038055555555562,1.1039130000000008,1.1031142000000005,1.1012538,1.0996487000000001,1.103833311138615,1.1038145130486172,-3387,12108,12134.2,-0.004231727864922489,-1.3780639711334675,0.0009059612248655112
2023-05-03T09:30:00-04:00,1.10381,1.10406,1.10311,1.10364,1.102236724,1.1037986666666666,1.1038433333333337,1.1038188888888896,1.1038670000000008,1.1031576000000005,1.1013212000000001,1.09966165,1.1037946489108919,1.1038008104388939,-5002,7106,10902,-0.005163511187585076,-2.148432059844403,-0.018118567908390525
2023-05-03T09:45:00-04:00,1.10364,1.10386,1.1029,1.10313,1.10227878952,1.103656,1.1037411111111115,1.1038177777777787,1.103825000000001,1.1031824000000006,1.1013974000000002,1.0996706,1.1036617191287135,1.103781048351115,-4649,2457,9767,-0.005426982282910215,-4.296768473892506,-0.08332955934967003
2023-05-03T10:00:00-04:00,1.10313,1.10538,1.10313,1.1048499999999999,1.1023200137295999,1.1038777777777777,1.1038411111111115,1.1038311111111119,1.1038525000000008,1.1032414000000008,1.1014970000000002,1.09968905,1.1038993753029707,1.1038056386808919,7768,10225,9478.2,-0.0019757261763964375,7.815095041739889,0.08152543140539888
2023-05-03T10:15:00-04:00,1.1048499999999999,1.10521,1.10393,1.10453,1.1024424131804158,1.1040155555555555,1.103887777777778,1.1038357777777787,1.1038585000000007,1.1032866000000008,1.1015876000000002,1.09970345,1.1040255002423764,1.1038429109447134,-4539,5686,7516.4,0.0022862980004187384,6.5004550453608,0.03803968807456567
2023-05-03T10:30:00-04:00,1.10453,1.10547,1.10437,1.10547,1.1025599166531992,1.104332,1.1040788888888893,1.1038784444444452,1.103933000000001,1.1033524000000008,1.1016853000000002,1.0997159,1.1043144001939011,1.1039391287557705,4119,9805,7055.8,0.010033369797408952,10.005891746944059,0.15583238958096887
2023-05-03T10:45:00-04:00,1.10547,1.10594,1.10461,1.10527,1.1027345216540072,1.104570222222222,1.1042922222222225,1.103968222222223,1.103994500000001,1.1034178000000008,1.1017947000000001,1.09972585,1.1045055201551208,1.1040813030046164,-5900,3905,6415.6,0.01823677003857175,8.938472459220403,0.17401549825530627
2023-05-03T11:00:00-04:00,1.10527,1.10582,1.105,1.1057,1.1029909599216867,1.1048517777777778,1.1044988888888891,1.1041197777777785,1.104083500000001,1.1034830000000009,1.1018904000000003,1.09974105,1.1047444161240967,1.104297842403693,5080,8985,7721.2,0.032360617090185125,10.914822129436411,0.16850268154804798
2023-05-03T11:15:00-04:00,1.1057,1.10586,1.10543,1.10548,1.1032268831279517,1.105048,1.104653333333334,1.104282222222223,1.104176500000001,1.1035420000000007,1.1019866000000003,1.09975605,1.1048915328992774,1.1044962739229545,-3149,5836,6843.4,0.04048362994157168,10.288268814794424,0.12589553387857896
2023-05-03T11:30:00-04:00,1.10548,1.10567,1.10481,1.1054,1.1034439324777157,1.1051973333333334,1.1048300000000006,1.1044706666666675,1.1042670000000012,1.1035926000000007,1.1020488000000002,1.0997715,1.104993226319422,1.1046898191383636,-3481,2355,6177.2,0.04466786522708738,10.036360141638621,0.14404652974696555
2023-05-03T11:45:00-04:00,1.1054,1.10547,1.10477,1.10478,1.1036436178794984,1.1051873333333333,1.1049566666666673,1.104646222222223,1.1043420000000013,1.1036332000000006,1.1021177000000002,1.0997867,1.1049505810555376,1.1048170553106909,-2816,-461,4124,0.04831799059256896,8.45691378737812,0.10329455257150348
2023-05-03T12:00:00-04:00,1.10478,1.10518,1.10461,1.1051,1.1038273284491384,1.105216,1.105175555555556,1.1048228888888898,1.1044070000000012,1.103680400000001,1.1021817,1.09981415,1.1049804648444301,1.1049120442485527,1881,1420,3627,0.05368675496748908,9.001746242708382,0.17858275996482983
2023-05-03T12:15:00-04:00,1.1051,1.10525,1.10445,1.10511,1.1039963421732073,1.105202888888889,1.105204444444445,1.1049640000000012,1.104470500000001,1.1037236000000008,1.1022505000000002,1.0998471,1.105006371875544,1.1049644353988421,1748,3168,2463.6,0.06596315738415341,9.017563815778797,0.023532606236154142
2023-05-03T12:30:00-04:00,1.10511,1.10528,1.10442,1.10522,1.1041518347993506,1.105206,1.1052811111111118,1.1050895555555567,1.1045290000000012,1.1037744000000007,1.1023145000000003,1.099883,1.1050490975004352,1.1049959483190737,2305,5473,2391,0.06335949312405705,9.246997989752542,0.06247000986845803
2023-05-03T12:45:00-04:00,1.10522,1.10524,1.1045099999999999,1.1046799999999999,1.1042948880154027,1.1050857777777776,1.105193333333334,1.1051622222222233,1.104565500000001,1.1038210000000006,1.1023647000000003,1.0999157,1.1049752780003481,1.1049923586552588,-1716,3757,2671.4,0.06199973615298302,8.408576679967743,-0.07146281672049612
2023-05-03T13:00:00-04:00,1.1046799999999999,1.10476,1.10416,1.1046799999999999,1.10594,1.104983111111111,1.1051277777777786,1.1051964444444455,1.104594000000001,1.1038650000000008,1.1024146000000001,1.0999535,1.1049162224002784,1.1049854869242068,0,3757,3515,0.051698591006489526,8.408576679967743,-0.05338062192949148
2023-05-03T13:15:00-04:00,1.1046799999999999,1.10494,1.10463,1.10494,1.1059044,1.1049455555555556,1.105043333333334,1.1051700000000013,1.104653500000001,1.1039206000000008,1.1024666000000003,1.0999937999999998,1.1049209779202227,1.1049735895393655,1823,5580,4347,0.04513118608497414,8.837642110680955,-0.06873473817490024
2023-05-03T13:30:00-04:00,1.10494,1.10516,1.10465,1.10507,1.105869512,1.1049508888888888,1.1049977777777786,1.105128666666668,1.104739500000001,1.1039704000000008,1.1025185000000002,1.10003495,1.1049507823361782,1.1049624716314923,1973,7553,5224,0.03373546327422271,9.069772362097256,-0.03708796179035545
2023-05-03T13:45:00-04:00,1.10507,1.10532,1.10466,1.1049,1.1058353217599999,1.1049313333333333,1.1049422222222232,1.1050608888888902,1.104792500000001,1.1040234000000007,1.1025678,1.1000747999999998,1.1049406258689425,1.1049407773051938,-1779,5774,5284.2,0.021802015457966138,8.796097391280922,-0.04523249502442057
2023-05-03T14:00:00-04:00,1.1049,1.1092,1.1046799999999999,1.10691,1.10416,1.1053248888888887,1.1051788888888898,1.1050580000000014,1.104933500000001,1.1041172000000008,1.1026406000000002,1.1001269,1.105334500695154,1.105012621844155,18613,24387,9410.2,0.022234423835798062,42.65629288408684,0.19279856623037755
2023-05-03T14:15:00-04:00,1.10691,1.10704,1.1058999999999999,1.10628,1.1042608,1.1055451111111112,1.105310000000001,1.1050944444444457,1.105057000000001,1.1042028000000008,1.1027047,1.1001751999999998,1.1055236005561233,1.1051340974753239,-9145,15242,11707.2,0.026369373775859517,37.451398177199025,0.10677766717943706
2023-05-03T14:30:00-04:00,1.10628,1.10641,1.10373,1.10536,1.1092,1.105555111111111,1.1053377777777786,1.105153333333335,1.105143000000001,1.1042764000000007,1.1027561000000001,1.100218,1.1054908804448986,1.1052480779802591,-21724,-6482,9294.8,0.02204123844611725,19.385375108897424,0.022622182407168647
2023-05-03T14:45:00-04:00,1.10536,1.10626,1.10444,1.10598,1.1090906,1.1056835555555555,1.1054222222222232,1.105238222222224,1.105285500000001,1.1043576000000008,1.1028188,1.10026415,1.105588704355919,1.1053756623842073,13056,6574,9099,0.019828651496575315,26.70852774695276,0.0687645898554018
2023-05-03T15:00:00-04:00,1.10598,1.10602,1.10401,1.10443,1.108983388,1.105485111111111,1.1053944444444452,1.1053286666666682,1.105264500000001,1.1043910000000008,1.1028635000000002,1.10030165,1.1053569634847351,1.1054589299073658,-12053,-5479,6848.4,0.007078802626753549,9.816585758852359,-0.022630988159454454
2023-05-03T15:15:00-04:00,1.10443,1.10637,1.10431,1.1054599999999999,1.1088783202399999,1.1054982222222223,1.105481111111112,1.1053891111111125,1.105311000000001,1.1044388000000007,1.1029177000000001,1.10034345,1.105377570787788,1.1054675439258925,11422,5943,3159.6,0.011507598849680894,20.46883171377793,0.0706086830575373
2023-05-03T15:30:00-04:00,1.1054599999999999,1.1054599999999999,1.10404,1.10449,1.1087753538351999,1.1053,1.105431111111112,1.105413333333335,1.105262000000001,1.1044632000000008,1.1029629,1.1003821500000002,1.1052000566302305,1.1054028351407141,-5425,518,214.8,0.009960918903385935,15.708596155730113,-0.04072619327746859
2023-05-03T15:45:00-04:00,1.10449,1.10582,1.10446,1.10543,1.108674446758496,1.1052997777777778,1.105471111111112,1.1054400000000015,1.105270000000001,1.1044946000000009,1.1030162000000001,1.10042335,1.1052460453041844,1.1053538681125712,4699,5217,2554.6,0.014566576492608646,19.707781300004594,0.03257712181128036
2023-05-03T16:00:00-04:00,1.10543,1.10558,1.10515,1.10525,1.108575557823326,1.1052555555555554,1.1055100000000009,1.105457555555557,1.105247500000001,1.1045330000000009,1.1030665000000002,1.1004633000000001,1.1052468362433474,1.105285494490057,-1833,3384,1916.6,0.01628131913581614,19.409309212220005,0.03167707484840913
2023-05-03T16:15:00-04:00,1.10525,1.10585,1.10519,1.10576,1.1084786466668595,1.1053055555555555,1.105382222222223,1.1054551111111128,1.105261500000001,1.1045794000000009,1.1031205000000002,1.1005051000000001,1.105349468994678,1.1052839955920457,857,4241,3860.6,0.023803666497067742,19.804758205660413,-0.10389281874768358
2023-05-03T16:30:00-04:00,1.10576,1.10576,1.1055,1.1057,1.1083836737335222,1.105369111111111,1.1053177777777785,1.105422444444446,1.1052765000000009,1.1046204000000008,1.1031731000000002,1.10054885,1.1054195751957423,1.1052923964736365,-693,3548,3381.6,0.011908182912082038,19.7671551091475,-0.05242795675597724
2023-05-03T16:45:00-04:00,1.1057,1.10627,1.10569,1.10594,1.1082906002588517,1.1054935555555556,1.105382222222223,1.1054126666666684,1.105334500000001,1.104664000000001,1.1032269000000001,1.10059385,1.1055236601565939,1.1053571171789094,1904,5452,4368.4,0.006505404440103266,20.180431766468683,0.05247159296519007
2023-05-03T17:00:00-04:00,1.10594,1.10594,1.10549,1.10592,1.1081993882536747,1.105601111111111,1.1053755555555564,1.1053935555555572,1.105375500000001,1.1046912000000009,1.1032831,1.10063925,1.105602928125275,1.1054284937431276,-271,5181,4361.2,0.006660173069713418,20.175530958106588,-0.005425052894261107
2023-05-03T17:15:00-04:00,1.10592,1.10635,1.1057,1.10632,1.1081100004886013,1.1057899999999998,1.1055855555555563,1.1054086666666683,1.105436000000001,1.1047382000000008,1.1033445000000002,1.1006872,1.10574634250022,1.1055283949945018,417,5598,4804,0.004480087947584762,20.32635561088435,0.1711289986689919
2023-05-03T17:30:00-04:00,1.10632,1.10663,1.10613,1.10655,1.1080224004788293,1.105982888888889,1.1057066666666673,1.1054735555555573,1.105502500000001,1.1047832000000009,1.1034108000000002,1.1007371000000001,1.105907074000176,1.1056399159956016,329,5927,5141.2,0.017454029179944187,20.394753542766612,0.09860148716371786
2023-05-03T17:45:00-04:00,1.10655,1.10658,1.10601,1.1061,1.1079365524692526,1.1060615555555555,1.1058855555555562,1.1055871111111126,1.105573500000001,1.1048170000000008,1.1034731000000002,1.10078125,1.1059456592001409,1.1057451327964811,-138,5789,5589.4,0.01945197631821414,20.338633168630803,0.1457686352977493
2023-05-03T18:00:00-04:00,1.1061,1.10781,1.10608,1.1072899999999999,1.1078524214198675,1.1063424444444445,1.106092222222223,1.1057291111111127,1.1057040000000011,1.1048832000000008,1.1035472000000002,1.1008310000000001,1.1062145273601127,1.105883306237185,1833,7622,6023.4,0.0335332291646748,22.31067005498795,0.16826031499054422
2023-05-03T18:15:00-04:00,1.1072899999999999,1.1076,1.10699,1.10748,1.10781,1.10662,1.1063400000000005,1.1059220000000014,1.1058310000000011,1.1049520000000008,1.1036206000000002,1.1008811,1.1064676218880902,1.1060562449897477,2145,9767,6940.6,0.040010231870711434,22.67873081594514,0.20176430671793297
2023-05-03T18:30:00-04:00,1.10748,1.10782,1.10707,1.10758,1.10373,1.106868,1.106542222222223,1.1061133333333348,1.1059565000000011,1.105025200000001,1.103695,1.1009311000000002,1.106690097510472,1.1062449959917982,2411,12178,8256.6,0.04970677138503893,22.896432264278268,0.16459267833887395
2023-05-03T18:45:00-04:00,1.10758,1.10762,1.10672,1.10676,1.1038118000000001,1.1069115555555555,1.1066600000000006,1.1063040000000015,1.1060495000000012,1.1050880000000007,1.1037613000000002,1.10097835,1.1067040780083777,1.1064043967934385,-1295,10883,9247.8,0.051468425967737874,21.937675334756197,0.0958668716650141
2023-05-03T19:00:00-04:00,1.10676,1.10698,1.10642,1.10697,1.1038919640000002,1.1069735555555555,1.1067744444444452,1.1064817777777793,1.1060525000000012,1.1051556000000007,1.1038287000000002,1.10102605,1.1067572624067021,1.1065667174347507,1341,12224,10534.8,0.05403401762357269,22.192120742974833,0.09313344304393426
2023-05-03T19:15:00-04:00,1.10697,1.1071,1.10672,1.10687,1.1039705247200002,1.1069926666666667,1.1068800000000008,1.1066393333333349,1.1060820000000011,1.1052274000000009,1.1038935000000003,1.10107335,1.1067798099253616,1.1066797739478005,-986,11238,11258,0.06261430209849418,22.10304877173804,0.0859013310185191
2023-05-03T19:30:00-04:00,1.10687,1.10727,1.1068,1.10718,1.1040475142256003,1.1070526666666667,1.1069755555555565,1.106766444444446,1.1061730000000012,1.1052950000000008,1.10396,1.10112245,1.1068598479402894,1.1067582191582404,846,12084,11721.4,0.07012840083997433,22.339987165587388,0.07773519415721337
2023-05-03T19:45:00-04:00,1.10718,1.10718,1.10682,1.10687,1.1041229639410883,1.1070315555555557,1.107011111111112,1.1068602222222237,1.1062175000000012,1.1053556000000007,1.1040223000000002,1.101169,1.1068618783522315,1.1067925753265924,-1077,11007,11487.2,0.06859566781873726,22.038437282099576,0.028918711309936108
2023-05-03T20:00:00-04:00,1.10687,1.1084,1.10686,1.10798,1.1041969046622666,1.1072253333333335,1.1072200000000008,1.106972222222224,1.1063950000000011,1.1054342000000006,1.1040927000000003,1.1012214,1.1070855026817852,1.1068688602612737,2389,13396,11989.8,0.07290702224010868,24.434192881221303,0.1699665491365954
2023-05-03T20:15:00-04:00,1.10798,1.10873,1.1077299999999999,1.10778,1.104365028475776,1.1073373333333334,1.1072744444444451,1.1070722222222238,1.1065110000000011,1.105510800000001,1.1041596000000002,1.1012730499999999,1.107224402145428,1.106962288209019,-2233,11163,11777.6,0.07366257411014013,24.0311170134259,0.044252183258234205
2023-05-03T20:30:00-04:00,1.10778,1.1081,1.1076,1.10768,1.1046269267672295,1.1074184444444446,1.1072966666666675,1.1071555555555572,1.1066705000000012,1.1055822000000008,1.1042245000000002,1.101324,1.1073155217163424,1.1070694305672153,-1591,9572,11444.4,0.06762659276440795,23.887496438943618,0.018059016867119766
2023-05-03T20:45:00-04:00,1.10768,1.10804,1.10742,1.10758,1.1048731111611958,1.1074751111111112,1.1072966666666675,1.1072197777777795,1.1067780000000011,1.1056588000000007,1.1042897000000003,1.1013749,1.107368417373074,1.1071711444537722,-1578,7994,10626.4,0.05522570251956053,23.74503652272234,0
2023-05-03T21:00:00-04:00,1.10758,1.10762,1.1071199999999999,1.10743,1.105104524491524,1.1075017777777778,1.1073711111111117,1.1072917777777793,1.106887000000001,1.1057404000000006,1.1043570000000003,1.1014263,1.1073807338984591,1.1072749155630177,-2101,5893,9603.6,0.04526095825017767,23.46049725693549,0.060537063139248656
2023-05-03T21:15:00-04:00,1.10743,1.10782,1.10731,1.10779,1.1053220530220327,1.1075855555555554,1.1074622222222228,1.107340222222224,1.1069885000000013,1.1058194000000008,1.1044228000000003,1.1014792,1.1074625871187673,1.1073503324504141,1883,7776,8479.6,0.04363419547758312,24.072617210341356,0.07407608155596293
2023-05-03T21:30:00-04:00,1.10779,1.10841,1.10779,1.10831,1.1055265298407106,1.107755111111111,1.107622222222223,1.1074097777777794,1.1071190000000013,1.1059038000000008,1.1044882000000003,1.10153575,1.107632069695014,1.1074318659603315,2692,10468,8340.6,0.04476498704409636,25.336250209375113,0.13009657864066113
2023-05-03T21:45:00-04:00,1.10831,1.1083399999999999,1.10796,1.10815,1.105718738050268,1.1078606666666666,1.1077300000000008,1.1074964444444462,1.1072295000000012,1.1059906000000006,1.1045524000000002,1.10159205,1.1077356557560112,1.1075158927682653,-1893,8575,8141.2,0.04578390256048838,25.06296926812232,0.08760996405281123
2023-05-03T22:00:00-04:00,1.10815,1.10846,1.1080699999999999,1.1083399999999999,1.105899413767252,1.1079826666666668,1.107893333333334,1.1076157777777795,1.1073505000000012,1.1060846000000006,1.1046211000000001,1.10164485,1.1078565246048089,1.1076135142146122,1679,10254,8593.2,0.04593399627488444,25.35084545816866,0.13280692402900615
2023-05-03T22:15:00-04:00,1.1083399999999999,1.10857,1.10823,1.10842,1.106069248941217,1.108088,1.1079422222222228,1.1077300000000017,1.107455500000001,1.1061904000000007,1.1046864000000003,1.1016986500000001,1.107969219683847,1.1077312113716897,1143,11397,9694,0.04917561188935417,25.433347217556655,0.03971190815718659
2023-05-03T22:30:00-04:00,1.10842,1.10855,1.10804,1.1082,1.106228894004744,1.1081395555555555,1.1079888888888894,1.107835333333335,1.1075380000000012,1.1062574000000007,1.1047494000000002,1.1017516,1.1080153757470776,1.1078417690973519,-1425,9972,10133.2,0.04307462900909897,25.150512191122775,0.03791366516818204
2023-05-03T22:45:00-04:00,1.1082,1.10876,1.10815,1.1084,1.1063789603644594,1.1082217777777776,1.1080688888888894,1.1079246666666684,1.107653000000001,1.1063348000000004,1.1048107000000003,1.1018040999999998,1.1080923005976622,1.1079338152778813,2257,12229,10485.4,0.04071514190536295,25.557839388379545,0.06500072223025187
2023-05-03T23:00:00-04:00,1.1084,1.10859,1.10826,1.10841,1.1065694435353026,1.10829,1.1081611111111114,1.1080108888888904,1.1077090000000012,1.1063936000000005,1.1048730000000004,1.1018527,1.1081558404781298,1.1080178522223052,1274,13503,11471,0.03737081104504023,25.569333433850314,0.07493815345165915
2023-05-03T23:15:00-04:00,1.10841,1.10853,1.10814,1.10848,1.1067446880524785,1.1083537777777779,1.1082777777777784,1.1080877777777793,1.107759000000001,1.1064578000000005,1.1049378000000003,1.10189885,1.1082206723825039,1.1080906817778442,1142,14645,12349.2,0.040378013520394086,25.641454760796133,0.09481411917683244
2023-05-03T23:30:00-04:00,1.10848,1.10849,1.10803,1.10804,1.1069059130082801,1.1083062222222222,1.1083055555555559,1.108160444444446,1.1077820000000012,1.1065046000000005,1.1049938000000004,1.1019436999999999,1.1081845379060031,1.1081337454222753,-1081,13564,12782.6,0.04347635452012592,25.212362670726854,0.022567454120353266
2023-05-03T23:45:00-04:00,1.10804,1.10824,1.10801,1.10812,1.1070542399676178,1.108269111111111,1.1082844444444448,1.108219555555557,1.1078500000000013,1.1065574000000005,1.1050497000000004,1.10199035,1.1081716303248026,1.1081649963378204,691,14255,13639.2,0.04413302062951233,25.26225256639854,-0.017143218052702986
2023-05-04T00:00:00-04:00,1.10812,1.10833,1.10808,1.10812,1.1071907007702084,1.1082362222222224,1.1082811111111117,1.1082620000000014,1.1079075000000014,1.1066118000000005,1.1051022000000004,1.102036,1.1081613042598422,1.1081787970702563,0,14255,14044.4,0.03656976624235267,25.26225256639854,-0.0027072147272458142
2023-05-04T00:15:00-04:00,1.10812,1.10837,1.10793,1.10818,1.1073162447085918,1.108216,1.108263333333334,1.1082824444444461,1.1079730000000014,1.1066798000000007,1.1051565000000003,1.1020826,1.1081650434078738,1.1081806376562053,946,15201,14384,0.031637993615668596,25.313474455724563,-0.014436003392455201
2023-05-04T00:30:00-04:00,1.10818,1.10874,1.10813,1.10862,1.1074317451319045,1.1082873333333332,1.108285555555556,1.1082840000000016,1.1080450000000013,1.1067502000000007,1.1052153000000002,1.1021323499999998,1.108256034726299,1.1081877101249642,1364,16565,14768,0.026641648129115812,25.85504712442459,0.01804370184586871
2023-05-04T00:45:00-04:00,1.10862,1.10862,1.10811,1.10814,1.1075380055213522,1.1082582222222221,1.1082788888888893,1.1082786666666682,1.1081085000000013,1.1068108000000008,1.1052672000000003,1.1021788499999998,1.1082328277810392,1.1081973680999715,-1053,15512,15157.6,0.019987932463029386,25.399128955890703,-0.00541418516514808
2023-05-04T01:00:00-04:00,1.10814,1.1085099999999999,1.10798,1.10847,1.107635765079644,1.1082964444444443,1.1082866666666673,1.1082791111111128,1.1081330000000014,1.1068758000000007,1.1053251000000004,1.1022273999999999,1.1082802622248313,1.1082190944799772,1524,17036,15713.8,0.015547488165336748,25.85297052825543,0.006315409599423899
2023-05-04T01:15:00-04:00,1.10847,1.10856,1.1083,1.10835,1.1077257038732724,1.108309111111111,1.1082800000000006,1.1082788888888904,1.1081615000000014,1.1069492000000007,1.1053851000000003,1.10227595,1.1082942097798651,1.1082456755839818,-948,16088,16080.4,0.013506074725616407,25.75034258162619,-0.005413159390473651
2023-05-04T01:30:00-04:00,1.10835,1.10876,1.1083,1.10845,1.1078084475634107,1.108343111111111,1.1082766666666672,1.1082815555555572,1.1082000000000014,1.1070246000000006,1.1054448000000003,1.1023252,1.108325367823892,1.1082777404671855,1466,17554,16551,0.010987603817179054,25.88261126931508,-0.002706408775979223
2023-05-04T01:45:00-04:00,1.10845,1.10864,1.10819,1.10841,1.1078845717583379,1.1083697777777777,1.1083177777777784,1.1082880000000017,1.1082415000000014,1.1070940000000007,1.1055073000000004,1.1023752999999998,1.1083422942591137,1.1082949923737484,-1737,15817,16401.4,0.0072188484132341335,25.81992914562879,0.03339229630699086
2023-05-04T02:00:00-04:00,1.10841,1.10909,1.10804,1.10906,1.1079546060176708,1.108518222222222,1.1084222222222226,1.1083166666666684,1.1083230000000013,1.1071738000000007,1.1055721000000005,1.1024284999999998,1.1084858354072908,1.1083455938989988,2959,18776,17054.2,0.010062778504164758,27.555162497908288,0.084828357939568
2023-05-04T02:15:00-04:00,1.10906,1.10916,1.10822,1.10885,1.10804,1.1086037777777777,1.1085033333333338,1.1083600000000016,1.1083760000000014,1.1072528000000006,1.1056381000000004,1.10248175,1.1085586683258326,1.1084012751191987,-3481,15295,16706,0.01054765758225671,26.8960367517808,0.06587734180412748
2023-05-04T02:30:00-04:00,1.10885,1.10885,1.1072899999999999,1.10745,1.10916,1.1083931111111112,1.1084222222222229,1.108388444444446,1.1083330000000013,1.1072636000000005,1.1056904000000005,1.1025277,1.1083369346606662,1.1084098200953592,-3698,11597,15807.8,0.005963487815478006,22.227055374678912,-0.06587377501848954
2023-05-04T02:45:00-04:00,1.10745,1.10801,1.10727,1.10753,1.10916,1.1082146666666666,1.1083011111111116,1.108393333333335,1.1083020000000015,1.1072886000000006,1.1057457000000006,1.1025730999999999,1.1081755477285329,1.1083798560762874,3452,15049,15306.8,0.0034501737761944147,22.47642103452767,-0.09832043441395928
2023-05-04T03:00:00-04:00,1.10753,1.10767,1.10657,1.10691,1.1090844,1.1079364444444444,1.1081644444444452,1.1083626666666682,1.1082305000000017,1.1073196000000005,1.1057980000000005,1.102614,1.1079224381828263,1.10829588486103,-5399,9650,14073.4,-0.006651498843042625,19.454037893665436,-0.11099680545777993
2023-05-04T03:15:00-04:00,1.10691,1.10726,1.10653,1.10678,1.1089335359999999,1.1076595555555555,1.1079766666666673,1.108273555555557,1.1081485000000015,1.1073356000000005,1.1058466000000005,1.1026525,1.107693950546261,1.108137507888824,-4759,4891,11296.4,-0.012221014730922904,18.895121631277505,-0.15246240313224257
2023-05-04T03:30:00-04:00,1.10678,1.10688,1.10604,1.10616,1.1087412531199998,1.107296222222222,1.107733333333334,1.108119555555557,1.1080465000000017,1.1073702000000007,1.1058806000000003,1.10268945,1.107387160437009,1.1079032063110592,-4122,769,8391.2,-0.023357125943225938,16.586044849983782,-0.19759101366895965
2023-05-04T03:45:00-04:00,1.10616,1.10631,1.1052,1.10578,1.108471127808,1.1069055555555554,1.1074366666666673,1.1079224444444458,1.1079155000000016,1.1073766000000007,1.1059077000000004,1.10272665,1.107065728349607,1.1076489650488475,-4471,-3702,5331.4,-0.03615466045690497,15.050118763341516,-0.24087690017591684
2023-05-04T04:00:00-04:00,1.10578,1.10579,1.1051,1.10555,1.10807859247104,1.1065282222222224,1.1071188888888894,1.1076860000000013,1.1077725000000016,1.1073978000000007,1.1059305000000004,1.10276085,1.1067625826796856,1.107366372039078,-3448,-7150,891.6,-0.050086271151901084,14.332941748022161,-0.258027264279451
2023-05-04T04:15:00-04:00,1.10555,1.1056,1.10414,1.10423,1.1076615895250943,1.1059504444444443,1.1065822222222228,1.107369555555557,1.1075600000000017,1.1073738000000006,1.1059342000000005,1.1027871999999999,1.1062560661437486,1.1070330976312626,-3302,-10452,-3128.8,-0.06986338591071989,10.390433494211877,-0.43550394027373546
2023-05-04T04:30:00-04:00,1.10423,1.10473,1.10405,1.10465,1.1070981352010791,1.1055639999999998,1.1061155555555562,1.1069973333333345,1.1073905000000017,1.1073618000000005,1.1059474000000007,1.1028166499999998,1.1059348529149988,1.10668127810501,3590,-6862,-5479.4,-0.09322815549635154,11.755909889527631,-0.3787707985750987
2023-05-04T04:45:00-04:00,1.10465,1.10477,1.10366,1.10405,1.1065494708648849,1.1051508888888888,1.1057377777777786,1.1065982222222235,1.107187000000002,1.1073276000000005,1.1059535000000005,1.1028411999999996,1.1055578823319991,1.106315422484008,-3406,-10268,-7686.8,-0.11943560644181091,9.905912152688112,-0.30701160323265786
2023-05-04T05:00:00-04:00,1.10405,1.10452,1.1036299999999999,1.10437,1.1059715766919078,1.1048773333333333,1.1053866666666672,1.1061882222222235,1.106999500000002,1.1073010000000005,1.1059607000000005,1.1028635499999997,1.1053203058655994,1.1059663379872067,3649,-6619,-8270.2,-0.13114614478336983,10.963545412051689,-0.28531958502251226
2023-05-04T05:15:00-04:00,1.10437,1.10478,1.1041,1.1047,1.1055032613535263,1.10474,1.105141111111112,1.1057926666666682,1.1068255000000018,1.1072762000000005,1.1059701000000006,1.1028886999999996,1.1051962446924795,1.1056530703897653,2608,-4011,-7642.4,-0.14201953220281,11.742849449647645,-0.19965489515859872
2023-05-04T05:30:00-04:00,1.1047,1.10561,1.10466,1.1052,1.1036299999999999,1.1047517777777778,1.1049655555555562,1.1054693333333347,1.1066545000000017,1.1072618000000005,1.1059765000000006,1.1029139499999996,1.1051969957539836,1.1054412563118121,2898,-1113,-5774.6,-0.14466663597469162,13.05451777588992,-0.1427564646994106
2023-05-04T05:45:00-04:00,1.1052,1.10559,1.10481,1.1055,1.1036696,1.1048586666666667,1.104892222222223,1.1052246666666679,1.1065225000000019,1.1072454000000005,1.1059918000000009,1.1029485999999995,1.1052575966031868,1.10530580504945,3266,2153,-3971.6,-0.14282708202172506,13.94105414939688,-0.059665871121727866
2023-05-04T06:00:00-04:00,1.1055,1.10553,1.1049,1.10538,1.103708408,1.104956222222222,1.1048477777777785,1.1050466666666678,1.1063680000000018,1.1072220000000006,1.1060026000000007,1.1029931499999996,1.1052820772825493,1.1052506440395597,-2830,-677,-2053.4,-0.1380152979256208,13.633862833250602,-0.0361735607444479
2023-05-04T06:15:00-04:00,1.10538,1.10592,1.10511,1.10531,1.1037464398399999,1.1050486666666666,1.104821111111112,1.1049335555555568,1.1062160000000016,1.1072062000000007,1.1060116000000006,1.1030344499999998,1.1052876618260394,1.1052441152316477,-2443,-3120,-1353.6,-0.12868086190692732,13.479155854654973,-0.021708651802271987
2023-05-04T06:30:00-04:00,1.10531,1.10592,1.10491,1.10591,1.1038333822464,1.1052664444444444,1.1050077777777785,1.10490688888889,1.1060890000000017,1.1071786000000006,1.1060309000000006,1.1030767999999995,1.1054121294608314,1.105287292185318,2474,-646,-680.6,-0.11493644272999323,14.822127509665636,0.15214221674831363
2023-05-04T06:45:00-04:00,1.10591,1.10633,1.10559,1.10604,1.103916846956544,1.105472888888889,1.1051622222222228,1.1049462222222233,1.1059705000000015,1.1071498000000006,1.1060509000000005,1.1031211499999998,1.105537703568665,1.1053554337482545,3082,2436,29.2,-0.08820888055784626,15.184417388588773,0.1258317114018017
2023-05-04T07:00:00-04:00,1.10604,1.10719,1.106,1.10682,1.1040616361391513,1.1058044444444444,1.1054700000000006,1.1050617777777787,1.1058585000000014,1.1071346000000006,1.1060799000000008,1.1031704999999996,1.1057941628549321,1.1054627469986034,3687,6123,823.2,-0.06174915171334721,17.784558432312338,0.25089443412888357
2023-05-04T07:15:00-04:00,1.10682,1.10692,1.10623,1.10667,1.1043119052480193,1.1060444444444446,1.105725555555556,1.1052373333333345,1.1057495000000015,1.107132800000001,1.1061104000000006,1.1032262499999996,1.1059693302839457,1.1056001975988827,-2541,3582,1675,-0.027773184796270958,17.440193494924436,0.20826353486602936
2023-05-04T07:30:00-04:00,1.10667,1.10717,1.10643,1.10679,1.1045421528281778,1.1062573333333332,1.1059577777777783,1.1054646666666677,1.1057165000000015,1.1071292000000008,1.1061424000000006,1.1032811999999996,1.1061334642271565,1.1057693580791061,2683,6265,3552,0.002979961053861759,17.731120329481918,0.1891916357382027
2023-05-04T07:45:00-04:00,1.10679,1.10766,1.10669,1.10745,1.1047539806019235,1.106555777777778,1.1062077777777783,1.1057046666666674,1.1057125000000014,1.1071408000000007,1.1061841000000008,1.1033420499999997,1.1063967713817253,1.1059662864632849,3036,9301,5541.4,0.02784885568640296,19.541545071303148,0.20358306188925854
2023-05-04T08:00:00-04:00,1.10745,1.1083,1.10701,1.10763,1.1050445825417312,1.1068402222222222,1.106444444444445,1.1059611111111118,1.1057485000000014,1.1071498000000008,1.1062224000000007,1.1034008499999997,1.1066434171053803,1.106187429170628,4657,13958,7845.8,0.04939307239558203,20.29847314931957,0.19267299864314477
2023-05-04T08:15:00-04:00,1.10763,1.10829,1.10334,1.10356,1.1083,1.1062633333333334,1.1062422222222226,1.1061155555555562,1.1055875000000013,1.1070836000000006,1.1062196000000006,1.1034412999999996,1.1060267336843042,1.1062339433365023,-12106,1852,6991.6,0.04628199976490288,-24.18517211127967,-0.16464926088765247
2023-05-04T08:30:00-04:00,1.10356,1.1036,1.10122,1.1029,1.1083,1.105594888888889,1.1059744444444448,1.106165333333334,1.1054245000000014,1.1069820000000008,1.1062081000000008,1.1034781499999997,1.1054013869474433,1.1061203546692018,-12192,-10340,4207.2,0.04056920952938539,-31.47677383660614,-0.21803837837349008
2023-05-04T08:45:00-04:00,1.1029,1.10296,1.10012,1.10092,1.10829,1.104584,1.1054200000000005,1.1060577777777785,1.1051815000000014,1.1068448000000006,1.1061778000000007,1.1035042999999998,1.1045051095579546,1.1057946837353616,-10014,-20354,-1116.6,0.02343446041934793,-49.454577807955246,-0.4512121239522249
2023-05-04T09:00:00-04:00,1.10092,1.10555,1.10025,1.10427,1.1077998,1.104354,1.105223333333334,1.1058608888888897,1.1051175000000013,1.1067766000000008,1.1061794000000007,1.1035390999999997,1.1044580876463637,1.1054069469882892,15724,-4630,-3902.8,0.015102615919626377,-1.6078677836093007,-0.16003037864813455
2023-05-04T09:15:00-04:00,1.10427,1.10464,1.10265,1.10316,1.107339012,1.1039413333333332,1.104816666666667,1.1055353333333342,1.1050640000000012,1.1066882000000007,1.1061735000000006,1.1035692499999996,1.1041984701170908,1.1049179575906312,-6896,-11526,-8999.6,-0.0006593261685899107,-8.53965077146657,-0.3306770748631211
2023-05-04T09:30:00-04:00,1.10316,1.1044,1.10139,1.10141,1.10690587128,1.10326,1.1042322222222227,1.1051333333333342,1.1049020000000012,1.1065678000000008,1.1061541000000006,1.1035922999999996,1.1036407760936726,1.1044407660725049,-9320,-20846,-13539.2,-0.03746979337302791,-23.32445080047346,-0.47529977319345806
2023-05-04T09:45:00-04:00,1.10141,1.10302,1.10116,1.10239,1.1064987190031998,1.1028915555555556,1.1037433333333337,1.104687111111112,1.1048190000000013,1.1064598000000005,1.1061396000000006,1.1036204499999998,1.103390620874938,1.104038612858004,8393,-12453,-13961.8,-0.06647290589004909,-15.85662319767356,-0.39754605661416886
2023-05-04T10:00:00-04:00,1.10239,1.10242,1.1003,1.10055,1.1061159958630078,1.102252888888889,1.102976666666667,1.1041984444444453,1.104628000000001,1.1063046000000007,1.1061042000000005,1.1036424999999996,1.1028224966999505,1.103702090286403,-7671,-20124,-13915.8,-0.10788496581222694,-28.660295219372316,-0.6230529595015691
2023-05-04T10:15:00-04:00,1.10055,1.10303,1.10025,1.10262,1.1057562361112274,1.1021815555555556,1.1024200000000004,1.1036377777777786,1.104524000000001,1.1061940000000006,1.1060923000000007,1.1036730499999996,1.1027819973599604,1.1033668722291223,9945,-10179,-15025.6,-0.1440773471039628,-9.954966065767152,-0.4523171095040726
2023-05-04T10:30:00-04:00,1.10262,1.10382,1.10213,1.10287,1.1054180619445537,1.1022715555555556,1.1023433333333337,1.1031431111111119,1.104407500000001,1.1060846000000006,1.1060846000000006,1.1037028999999996,1.1027995978879683,1.1030870977832978,8882,-1297,-12979.8,-0.1792970830000408,-7.941126302294023,-0.06252491935192281
2023-05-04T10:45:00-04:00,1.10287,1.10287,1.0986,1.1000699999999999,1.1051001782278804,1.1018168888888888,1.1020288888888894,1.102702444444445,1.104136000000001,1.1059176000000006,1.1060540000000005,1.1037256999999996,1.1022536783103747,1.1028096782266381,-14529,-15826,-11975.8,-0.18882001292028566,-44.827794721964494,-0.2565962462598704
2023-05-04T11:00:00-04:00,1.1000699999999999,1.10087,1.09952,1.09958,1.10458016396965,1.1013271111111111,1.1018800000000004,1.1023297777777785,1.1038460000000012,1.1057452000000005,1.1060013000000006,1.1037491499999996,1.1017189426482998,1.1024753425813105,-8699,-24525,-14390.2,-0.19340617626372458,-48.70255723707621,-0.12171638266176443
2023-05-04T11:15:00-04:00,1.09958,1.10064,1.09954,1.10017,1.104101750852078,1.100985111111111,1.1014244444444448,1.1020193333333341,1.103589000000001,1.1055806000000006,1.1059577000000007,1.1037726499999996,1.10140915411864,1.1021926740650483,6049,-18476,-14060.6,-0.17776606122680447,-45.456854332330266,-0.37128600795095335
2023-05-04T11:30:00-04:00,1.10017,1.10131,1.09966,1.10108,1.103661610783912,1.1009162222222222,1.1011933333333337,1.1017740000000007,1.1033475000000013,1.1054340000000007,1.1059138000000006,1.1037995499999997,1.101343323294912,1.1019049392520386,5570,-12906,-14606,-0.18845321639188387,-40.849657262786636,-0.1885492584937688
2023-05-04T11:45:00-04:00,1.10108,1.10137,1.1004099999999999,1.10081,1.1032566819211989,1.1008395555555555,1.1011266666666673,1.1015306666666673,1.1030860000000011,1.1052806000000006,1.1058692000000006,1.1038319499999998,1.1012366586359295,1.1015923514016308,-4816,-17722,-17891,-0.18778250465293966,-42.03060687589373,-0.05447562669668279
2023-05-04T12:00:00-04:00,1.10081,1.10241,1.10078,1.10222,1.1028841473675028,1.101058222222222,1.1011077777777782,1.1013464444444452,1.1028560000000012,1.1051642000000006,1.1058344000000009,1.1038623999999997,1.1014333269087435,1.1014282811213045,4383,-13339,-17393.6,-0.1639790122059671,-36.416531785733206,-0.015421039740926849
2023-05-04T12:15:00-04:00,1.10222,1.10253,1.10172,1.10243,1.1025414155781026,1.101322666666667,1.101316666666667,1.1012337777777783,1.102644000000001,1.1050504000000005,1.1058039000000008,1.1038952499999997,1.101632661526995,1.1014110248970435,4429,-8910,-14270.6,-0.14469193054263876,-35.5726984312303,0.17082367906956558
2023-05-04T12:30:00-04:00,1.10243,1.10304,1.10197,1.10296,1.0986,1.1016513333333333,1.101354444444445,1.1012197777777786,1.1024525000000012,1.1049472000000007,1.1057795000000008,1.1039141499999998,1.101898129221596,1.1015088199176346,3647,-5263,-11628,-0.10683697935373279,-33.81938076026733,0.030835646006784477
2023-05-04T12:45:00-04:00,1.10296,1.10303,1.10235,1.10248,1.0986888000000001,1.1018764444444444,1.1013111111111114,1.101243333333334,1.102204000000001,1.1048332000000007,1.1057565000000007,1.1039370999999998,1.1020145033772768,1.1016430559341077,-2563,-7826,-10612,-0.08951028290564353,-34.934779324131924,-0.035362282045944896
2023-05-04T13:00:00-04:00,1.10248,1.10275,1.10204,1.10254,1.098775824,1.1021222222222222,1.101585555555556,1.1013351111111116,1.1019495000000012,1.1047116000000008,1.1057309000000008,1.1039563,1.1021196027018214,1.101819644747286,3247,-4579,-7983.4,-0.0713106276423096,-34.75806863550215,0.22453116619853233
2023-05-04T13:15:00-04:00,1.10254,1.10286,1.10249,1.10271,1.09886110752,1.1023471111111112,1.1019333333333339,1.101500222222223,1.101907000000001,1.1046030000000007,1.1057069000000006,1.1039786999999996,1.1022376821614572,1.1019805157978289,2908,-1671,-5649.8,-0.026108712842988577,-34.30968581038922,0.2846541406718999
2023-05-04T13:30:00-04:00,1.10271,1.10315,1.1026,1.10284,1.0989446853696,1.1025284444444445,1.1022300000000005,1.1016828888888894,1.101904000000001,1.1044904000000006,1.1056831000000007,1.1039987999999996,1.1023581457291658,1.102125612638263,2312,641,-3739.6,0.006585719360279944,-34.03712094746069,0.24268976612704854
2023-05-04T13:45:00-04:00,1.10284,1.10293,1.10204,1.10216,1.0991128979548161,1.1025144444444444,1.1023500000000004,1.1018820000000005,1.1019660000000013,1.1043666000000008,1.1056579000000006,1.1040112999999996,1.1023185165833327,1.1022096901106104,-2398,-1757,-3038.4,0.027843272152806662,-35.51570351610169,0.09808551603879553
2023-05-04T14:00:00-04:00,1.10216,1.10226,1.10117,1.10133,1.0992743820366235,1.1023104444444445,1.1024077777777783,1.102101333333334,1.1018190000000012,1.1042242000000007,1.1056244000000006,1.1040194999999997,1.1021208132666662,1.1022309520884883,-2874,-4631,-2399.4,0.028339739808573728,-37.68001722735986,0.04723794296925481
2023-05-04T14:15:00-04:00,1.10133,1.10165,1.10128,1.10128,1.0994294067551587,1.1020848888888888,1.1023033333333339,1.1022448888888896,1.1017250000000014,1.1040816000000007,1.1055878000000006,1.1040271999999995,1.101952650613333,1.1021975616707906,-2343,-6974,-2878.4,0.04553182992581383,-37.78638861468222,-0.08528243000489384
2023-05-04T14:30:00-04:00,1.10128,1.10179,1.10111,1.10165,1.0995782304849524,1.1019542222222223,1.102216666666667,1.1023015555555564,1.1017370000000013,1.1039334000000007,1.1055536000000006,1.1040360499999997,1.1018921204906664,1.1021284493366326,2526,-4448,-3433.8,0.04688766281343918,-36.93772160901612,-0.07075279156046216
2023-05-04T14:45:00-04:00,1.10165,1.10173,1.10142,1.10158,1.0997211012655543,1.101826888888889,1.1020633333333338,1.1022682222222229,1.1016965000000014,1.1037880000000009,1.1055204000000005,1.1040440999999996,1.1018296963925331,1.1020227594693062,-1870,-6318,-4825.6,0.03843740058924681,-37.05654337636513,-0.12511786465510416
2023-05-04T15:00:00-04:00,1.10158,1.10201,1.10152,1.10154,1.0998582572149322,1.1017222222222223,1.1019588888888892,1.1021900000000007,1.1017460000000012,1.103669800000001,1.1054667000000007,1.1040536499999998,1.1017717571140264,1.1019134075754449,-2219,-8537,-6181.6,0.029223525608158288,-37.13711855020642,-0.08526231768376215
2023-05-04T15:15:00-04:00,1.10154,1.10162,1.10135,1.1015,1.099989926926335,1.1016304444444445,1.1018433333333337,1.1020771111111118,1.1016900000000014,1.1035492000000007,1.1054189000000005,1.1040617999999998,1.1017174056912211,1.1018327260603558,-2017,-10554,-7366.2,0.016221178557510884,-37.21036146467169,-0.09432764344152156
2023-05-04T15:30:00-04:00,1.1015,1.10177,1.10149,1.10171,1.1001163298492815,1.1016037777777778,1.1017322222222226,1.1019628888888895,1.1016320000000013,1.1034452000000008,1.1053824000000005,1.1040692499999998,1.1017159245529768,1.1017853808482845,1921,-8633,-7698,0.012621290820955037,-36.84412451505745,-0.09068567438402769
2023-05-04T15:45:00-04:00,1.10171,1.10176,1.10138,1.10145,1.1002376766553104,1.1015473333333332,1.101577777777778,1.101835111111112,1.1017010000000014,1.103338600000001,1.1053371000000005,1.1040779499999998,1.1016627396423815,1.1017395046786276,-2118,-10751,-8958.6,0.007322527058609015,-37.34396567107841,-0.12603822857350136
2023-05-04T16:00:00-04:00,1.10145,1.10155,1.10133,1.10144,1.100354169589098,1.1015197777777779,1.1014977777777781,1.101722000000001,1.1017940000000013,1.103244200000001,1.1053072000000004,1.1040853499999996,1.1016181917139052,1.1016972037429018,-1030,-11781,-10051.2,-0.011307317857476325,-37.35331698071577,-0.06532626841838335
2023-05-04T16:15:00-04:00,1.10144,1.10144,1.10123,1.10127,1.100466002805534,1.1014742222222222,1.1014911111111116,1.1016284444444453,1.1018490000000012,1.1031540000000009,1.1052653000000003,1.1040914999999998,1.1015485533711242,1.1016525629943215,-555,-12336,-10811,-0.02668868032573514,-37.43897757048916,-0.005447958377593363
2023-05-04T16:30:00-04:00,1.10127,1.10141,1.10127,1.1014,1.1005733626933125,1.1014559999999998,1.1015044444444448,1.1015606666666675,1.1018650000000014,1.1030710000000008,1.1052344000000003,1.1040986499999996,1.1015188426968994,1.101612850395457,806,-11530,-11006.2,-0.03136779670825988,-37.343832873911595,0.01089641144848703
2023-05-04T16:45:00-04:00,1.1014,1.10152,1.10096,1.10096,1.10067642818558,1.101347111111111,1.1014277777777783,1.1014997777777786,1.1018725000000014,1.1030056000000008,1.1051897000000004,1.1041029499999997,1.1014070741575195,1.1015510803163655,-1127,-12657,-11811,-0.03375361846562022,-37.79405985775034,-0.0626333227431652
2023-05-04T17:00:00-04:00,1.10096,1.10121,1.10087,1.10098,1.100775371058157,1.1012575555555555,1.1013611111111115,1.1014564444444455,1.1018105000000014,1.1029322000000008,1.1051470000000003,1.1041067499999997,1.1013216593260156,1.1014828642530925,61,-12596,-12180,-0.04056887178595589,-37.79295173393112,-0.05446721981153742
2023-05-04T17:15:00-04:00,1.10098,1.1014,1.10067,1.1013,1.10315,1.1012453333333332,1.1013344444444446,1.101423777777779,1.1017540000000015,1.102877200000001,1.1051024000000005,1.1041114499999998,1.1013173274608123,1.1014226914024738,104,-12492,-12322.2,-0.03913558546269688,-37.76272411853394,-0.02178767906748897
2023-05-04T17:30:00-04:00,1.1013,1.10145,1.1012899999999999,1.10131,1.1031004,1.1012404444444444,1.1013133333333336,1.1013882222222233,1.1016715000000015,1.102816000000001,1.1050585000000004,1.1041157999999998,1.1013158619686498,1.1013761531219792,181,-12311,-12317.2,-0.036384241448146976,-37.76108060632109,-0.017249205628680205
2023-05-04T17:45:00-04:00,1.10131,1.10141,1.1012899999999999,1.1014,1.103051792,1.1012577777777777,1.1012788888888891,1.101343111111112,1.1016175000000015,1.102750000000001,1.1050131000000005,1.10412,1.1013326895749198,1.1013389224975831,88,-12223,-12455.8,-0.030551337528681853,-37.75388917066719,-0.02813807626326642
2023-05-04T18:00:00-04:00,1.1014,1.1014,1.10095,1.10108,1.1030041561600001,1.1012179999999998,1.101237777777778,1.101305111111112,1.1015445000000015,1.1026676000000009,1.1049647000000005,1.1041238999999998,1.1012821516599358,1.1013139379980665,-477,-12700,-12464.4,-0.03022033481411953,-37.892476423254756,-0.0335920831631015
2023-05-04T18:15:00-04:00,1.10108,1.1016,1.10099,1.10152,1.1029574730368001,1.1012744444444444,1.101246666666667,1.1012822222222232,1.1014850000000016,1.1025880000000008,1.1049167000000004,1.1041306,1.1013297213279487,1.101315550398453,599,-12101,-12365.4,-0.025176797402383592,-37.653111436151185,0.007263219058694074
2023-05-04T18:30:00-04:00,1.10152,1.10189,1.10144,1.10185,1.1029117235760642,1.101395111111111,1.1013111111111114,1.1012775555555567,1.1014355000000013,1.1025174000000009,1.1048697000000005,1.10414025,1.101433777062359,1.1013388403187625,466,-11635,-12194,-0.01773767862501782,-37.513504347764254,0.052666466897311734
2023-05-04T18:45:00-04:00,1.10185,1.10214,1.10183,1.10214,1.1028668891045428,1.101560888888889,1.1013933333333334,1.1012935555555567,1.1014345000000014,1.102454000000001,1.1048301000000003,1.1041515999999998,1.1015750216498872,1.1013906722550098,555,-11080,-11947.8,-0.006813411526126964,-37.36743183335672,0.06718721627019819
2023-05-04T19:00:00-04:00,1.10214,1.10217,1.10191,1.10201,1.102822951322452,1.101684222222222,1.1015100000000002,1.101339777777779,1.1014685000000015,1.102376000000001,1.1047773000000003,1.10416225,1.1016620173199096,1.1014565378040078,-715,-11795,-11862.2,-0.0006268725113563208,-37.45176776164167,0.09537131230925697
2023-05-04T19:15:00-04:00,1.10201,1.10232,1.10198,1.10231,1.1027798922960028,1.1018442222222222,1.1016577777777778,1.101423777777779,1.1015200000000014,1.1023014000000009,1.1047256000000005,1.1041731,1.1017916138559276,1.101558430243206,698,-11097,-11541.6,0.007392459172934546,-37.261751337108336,0.12080146778323232
2023-05-04T19:30:00-04:00,1.10231,1.10238,1.1022399999999999,1.10228,1.1027376944500829,1.1019686666666666,1.1017666666666668,1.1015277777777788,1.1015515000000016,1.1022106000000007,1.1046726000000004,1.1041838,1.101889291084742,1.1016703441945648,-458,-11555,-11432.4,0.014870736983424334,-37.27421607025962,0.08898574412058304
2023-05-04T19:45:00-04:00,1.10228,1.10244,1.10222,1.10229,1.1026963405610812,1.1020733333333332,1.1018755555555557,1.1016406666666676,1.1015870000000016,1.1021230000000009,1.1046279000000006,1.1041946,1.1019694328677936,1.1017774753556515,622,-10933,-11292,0.021090790254123377,-37.26857322089282,0.08898493612152626
2023-05-04T20:00:00-04:00,1.10229,1.10232,1.1018999999999999,1.10199,1.1026558137498597,1.1020962222222221,1.1019411111111113,1.1017502222222233,1.1016095000000015,1.1020270000000008,1.1045781000000006,1.1042034,1.1019735462942348,1.1018571802845212,-836,-11769,-11429.8,0.02549091737484722,-37.49609955243894,0.05356818594516892
2023-05-04T20:15:00-04:00,1.10199,1.10226,1.10195,1.1022399999999999,1.1026160974748624,1.102156,1.10207,1.101862222222223,1.1016465000000015,1.1019228000000008,1.1045318000000006,1.10421265,1.1020268370353878,1.1019301442276166,670,-11099,-11290.6,0.030089351672010458,-37.344101802913165,0.10535110981943435
2023-05-04T20:30:00-04:00,1.1022399999999999,1.1028,1.10202,1.10279,1.10067,1.1022999999999998,1.102211111111111,1.1019728888888898,1.1017005000000013,1.1018260000000009,1.1044879000000005,1.10422395,1.1021794696283103,1.102007715382093,1002,-10097,-11090.6,0.040033333736840565,-36.84411994778175,0.11529522841163867
2023-05-04T20:45:00-04:00,1.10279,1.10296,1.10247,1.10249,1.1007126,1.1023557777777777,1.1022822222222222,1.1020760000000007,1.1017525000000015,1.1018046000000008,1.1044441000000005,1.1042332,1.1022415757026482,1.1020781723056745,-1142,-11239,-11027.4,0.04546495796694174,-37.15478652981456,0.05808413123383164
2023-05-04T21:00:00-04:00,1.10249,1.1031,1.10249,1.10309,1.100802496,1.1025173333333333,1.1023877777777777,1.1021784444444451,1.1018350000000015,1.1018084000000008,1.1043952000000006,1.1042439499999999,1.1024112605621186,1.1021665378445396,1232,-10007,-10842.2,0.04962801677238388,-36.48430425786659,0.08619594606855813
2023-05-04T21:15:00-04:00,1.10309,1.10372,1.10304,1.10324,1.10094034624,1.1026877777777777,1.1025244444444444,1.1022951111111117,1.1019335000000012,1.1018548000000008,1.1043498000000005,1.1042546999999998,1.1025770084496949,1.1022872302756315,1631,-8376,-10163.6,0.05182813784313906,-36.26251818420066,0.11161423217575743
2023-05-04T21:30:00-04:00,1.10324,1.10369,1.10323,1.10365,1.1011627185408,1.1029128888888888,1.1026733333333334,1.1024157777777783,1.1020460000000012,1.101842400000001,1.1043095000000005,1.1042669999999999,1.1027916067597558,1.102440184220505,1552,-6824,-9308.6,0.056420445314122276,-35.68574431813341,0.12156289972876223
2023-05-04T21:45:00-04:00,1.10365,1.10366,1.1032899999999999,1.10354,1.101367301057536,1.1030862222222222,1.1028133333333334,1.102536222222223,1.1021750000000012,1.101850000000001,1.1042691000000004,1.1042794,1.1029412854078047,1.1025925473764038,-1385,-8209,-8931,0.05832929348975588,-35.82378626983918,0.11430852414994729
2023-05-04T22:00:00-04:00,1.10354,1.10372,1.10311,1.10331,1.1015555169729332,1.1031855555555554,1.1029266666666666,1.1026651111111119,1.102291500000001,1.101888000000001,1.1042279000000006,1.10429245,1.1030150283262437,1.102747237901123,-1622,-9831,-8649.4,0.0575154848552133,-36.161843793807435,0.0925346324469986
2023-05-04T22:15:00-04:00,1.10331,1.10339,1.10297,1.10302,1.1017286756150986,1.1032042222222223,1.1030411111111111,1.1027957777777786,1.1023775000000013,1.1019006000000011,1.1041802000000005,1.1043015,1.1030160226609949,1.1028681903208981,-1406,-11237,-8895.4,0.055320242690311064,-36.531404479381,0.09346727284275395
2023-05-04T22:30:00-04:00,1.10302,1.10308,1.10274,1.10299,1.1018879815658906,1.103194,1.1031244444444444,1.1029157777777785,1.102461500000001,1.101949400000001,1.1041270000000005,1.1043076,1.1030108181287959,1.1029549522567184,-1125,-12362,-9692.6,0.057087221291662146,-36.562002292657255,0.06804325736681925
2023-05-04T22:45:00-04:00,1.10299,1.10342,1.10298,1.1031,1.1020345430406193,1.1031891111111112,1.103158888888889,1.1030128888888897,1.1025465000000012,1.101959000000001,1.1040765000000006,1.10431445,1.1030286545030368,1.1030023618053746,1161,-11201,-10568,0.05715191516368187,-36.44621701808535,0.02811051968190068
2023-05-04T23:00:00-04:00,1.1031,1.1036,1.10309,1.10353,1.1021693795973697,1.1032633333333333,1.1032744444444444,1.1031051111111119,1.1026690000000012,1.101972200000001,1.1040284000000005,1.10432475,1.1031289236024293,1.1030398894442994,1171,-10030,-10932.2,0.05465901601685273,-35.989748882830234,0.09433192137796532
2023-05-04T23:15:00-04:00,1.10353,1.10395,1.10352,1.10393,1.10229342922958,1.1033944444444443,1.1033677777777777,1.1031933333333341,1.1027895000000014,1.1020494000000012,1.1039835000000005,1.10433495,1.1032891388819435,1.1030947115554395,1174,-8856,-10737.2,0.055403671670037534,-35.564205399644266,0.07614972486380749
2023-05-04T23:30:00-04:00,1.10393,1.10423,1.10386,1.10409,1.1024590863066221,1.1035388888888888,1.1034622222222223,1.1032775555555563,1.1029015000000013,1.102139600000001,1.1039424000000004,1.1043459,1.1034493111055548,1.1031813692443513,1202,-7654,-10020.6,0.0533681521666679,-35.389991454919574,0.07704579239331581
2023-05-04T23:45:00-04:00,1.10409,1.10446,1.10409,1.10441,1.1026715959498274,1.1037284444444444,1.103546666666667,1.103362000000001,1.1030150000000014,1.102224400000001,1.1039025000000007,1.1043566,1.1036414488844437,1.103307495395481,1224,-6430,-8834.2,0.05291756827009852,-35.03523776636171,0.06886241109046091
2023-05-05T00:00:00-04:00,1.10441,1.10448,1.1042,1.10421,1.1029219725168515,1.1038611111111112,1.1036211111111112,1.1034544444444454,1.1031250000000012,1.1022870000000011,1.1038605000000006,1.10436675,1.103755159107555,1.1034527963163847,-996,-7426,-8079.2,0.049053487425423134,-35.21560556455258,0.06071370317341904
2023-05-05T00:15:00-04:00,1.10421,1.10442,1.10411,1.10441,1.1031712569141552,1.1040188888888889,1.1037433333333333,1.103548222222223,1.1032300000000013,1.102359000000001,1.1038198000000006,1.1043788,1.1038861272860439,1.1036042370531074,546,-6880,-7449.2,0.046575050362841056,-35.11671133247717,0.09969999365544396
2023-05-05T00:30:00-04:00,1.10441,1.10447,1.1042,1.10423,1.1033806558078902,1.104116222222222,1.103877777777778,1.103650222222223,1.1033275000000011,1.1023992000000011,1.1037817000000008,1.1043877500000001,1.103954901828835,1.1037373896424856,-677,-7557,-7189.4,0.04662298441493047,-35.227050789743856,0.10969882685718804
2023-05-05T00:45:00-04:00,1.10423,1.10433,1.10404,1.10417,1.1035565508786278,1.1041746666666667,1.104008888888889,1.1037595555555564,1.1034215000000012,1.102434000000001,1.1037422000000006,1.10439595,1.103997921463068,1.1038471117139883,-686,-8243,-7307.2,0.04888497206826481,-35.26432563284716,0.1069819309332071
2023-05-05T01:00:00-04:00,1.10417,1.10463,1.10415,1.10441,1.1037043027380473,1.1042548888888888,1.1041544444444444,1.103881111111112,1.1035425000000012,1.102463000000001,1.1037051000000007,1.10440365,1.1040803371704544,1.1039348893711904,1750,-6493,-7319.8,0.052600371814652123,-34.88394942266246,0.11875623243585554
2023-05-05T01:15:00-04:00,1.10441,1.10448,1.1042399999999999,1.10436,1.1038709282451988,1.104296,1.1042466666666668,1.104006222222223,1.1036485000000014,1.1025006000000013,1.1036669000000006,1.1044117,1.1041362697363635,1.1040111114969522,-1800,-8293,-7493.2,0.05378592038654109,-34.965440897748515,0.07521317952390134
2023-05-05T01:30:00-04:00,1.10436,1.1045099999999999,1.10412,1.10426,1.1040075611610631,1.1042986666666665,1.1042833333333335,1.104114222222223,1.1037220000000014,1.1025350000000012,1.1036233000000006,1.1044193,1.1041610157890909,1.1040660891975616,-1688,-9981,-8113.4,0.05168003251472925,-35.11828960650289,0.02989319974997884
2023-05-05T01:45:00-04:00,1.10426,1.10443,1.1038,1.10398,1.10463,1.1042379999999998,1.1042711111111112,1.1041928888888897,1.1037965000000012,1.102560400000001,1.1035817000000008,1.10442445,1.1041248126312726,1.104100071358049,-2642,-12623,-9126.6,0.04699630086958387,-35.78820430050625,-0.009962955918453613
2023-05-05T02:00:00-04:00,1.10398,1.10398,1.1032899999999999,1.10354,1.1046134,1.1040917777777777,1.1041744444444446,1.1042260000000008,1.1038190000000012,1.102574400000001,1.1035324000000006,1.1044287499999998,1.1040078501050181,1.104102057086439,-2834,-15457,-10569.4,0.037481443708658344,-36.91771751632537,-0.07877509258336365
2023-05-05T02:15:00-04:00,1.10354,1.10375,1.10299,1.10316,1.104560464,1.103888888888889,1.104057777777778,1.1042066666666674,1.1038150000000013,1.1025944000000012,1.1034805000000005,1.1044328,1.1038382800840145,1.104053645669151,-2292,-17749,-12820.6,0.025854697720540103,-37.70695941059301,-0.09509060776482693
2023-05-05T02:30:00-04:00,1.10316,1.10401,1.1031,1.10364,1.10446623616,1.1038053333333333,1.1039722222222224,1.1041517777777785,1.1038145000000013,1.102640600000001,1.1034324000000006,1.1044386,1.1037986240672115,1.1039861165353206,2665,-15084,-14178.8,0.018964673765389142,-36.547381470856166,-0.06972048424044852
2023-05-05T02:45:00-04:00,1.10364,1.1046799999999999,1.10349,1.10453,1.10299,1.1039168888888888,1.1040055555555557,1.104096222222223,1.103864000000001,1.102705600000001,1.1033936000000006,1.1044504499999999,1.1039448992537693,1.1039428932282562,3037,-12047,-14592,0.016254817560433264,-34.09827669031163,0.027168252990768856
2023-05-05T03:00:00-04:00,1.10453,1.10478,1.1032,1.10342,1.1030237999999999,1.103799777777778,1.1039222222222225,1.1040264444444452,1.1038695000000012,1.102741000000001,1.1033372000000008,1.1044546499999999,1.1038399194030155,1.1038859145826048,-4505,-16552,-15377.8,0.009434572726491994,-38.62558694897346,-0.06792432324732861
2023-05-05T03:15:00-04:00,1.10342,1.10386,1.10309,1.10369,1.10478,1.1037533333333334,1.1038422222222222,1.1039600000000007,1.1039030000000012,1.102783200000001,1.1032856000000006,1.1044618499999999,1.1038099355224125,1.1038463316660836,3942,-12610,-14808.4,0.0034467764228576425,-37.661004106538144,-0.0651931800689809
2023-05-05T03:30:00-04:00,1.10369,1.10418,1.10317,1.10332,1.10478,1.1036488888888891,1.1037266666666667,1.1038937777777786,1.1039195000000013,1.1028188000000012,1.1032443000000005,1.10446735,1.10371194841793,1.1038210653328668,-3533,-16143,-14487.2,-0.007721714582975958,-38.84540371149962,-0.0941721902278179
2023-05-05T03:45:00-04:00,1.10332,1.10388,1.10254,1.10269,1.1047462000000001,1.1034415555555557,1.1035522222222225,1.1038097777777787,1.1038990000000013,1.1028426000000011,1.1031959000000007,1.1044708,1.1035075587343441,1.1037628522662932,-3082,-19225,-15315.4,-0.021556372697002762,-40.605237667197336,-0.1421766612935424
2023-05-05T04:00:00-04:00,1.10269,1.10307,1.10242,1.1028,1.1046579520000002,1.103291111111111,1.1034211111111112,1.1036928888888897,1.1038625000000013,1.1028644000000012,1.1031548000000007,1.1044764,1.1033660469874753,1.1036470818130346,3052,-16173,-16140.6,-0.033488950760063405,-40.30078219920527,-0.10688599431148743
2023-05-05T04:15:00-04:00,1.1028,1.10294,1.10244,1.1026799999999999,1.1045236748800003,1.1031428888888888,1.1033255555555557,1.1035735555555564,1.1038000000000014,1.1028890000000013,1.1031138000000005,1.1044801999999998,1.1032288375899801,1.1035248654504275,-2241,-18414,-16513,-0.041600643315113366,-40.54463421226319,-0.07793102198380511
2023-05-05T04:30:00-04:00,1.1026799999999999,1.10298,1.10255,1.10297,1.1043974543872002,1.1030717777777779,1.1033044444444444,1.1034660000000007,1.1037440000000014,1.1029196000000012,1.1030819000000007,1.1044812499999999,1.103177070071984,1.1033982923603418,2702,-15712,-17133.4,-0.042624844848559315,-39.834020072167846,-0.01722324957394326
2023-05-05T04:45:00-04:00,1.10297,1.10316,1.10241,1.1028,1.1042788071239682,1.102970888888889,1.1032111111111111,1.1033628888888898,1.1036635000000015,1.102950200000001,1.1030521000000006,1.1044798999999998,1.1031016560575873,1.1032762338882733,-3446,-19158,-17736.4,-0.04032327653151974,-40.365149658647994,-0.0761117755789888
2023-05-05T05:00:00-04:00,1.1028,1.10282,1.10219,1.10279,1.1041293025540508,1.1028866666666668,1.1030177777777779,1.1032560000000007,1.1035925000000013,1.1029780000000011,1.1030245000000007,1.1044774999999998,1.1030393248460697,1.1031825871106185,-2703,-21861,-18263.6,-0.04103803666366282,-40.38965999597133,-0.15753306836392628
2023-05-05T05:15:00-04:00,1.10279,1.10319,1.10266,1.10274,1.1039353722986458,1.102831111111111,1.1029422222222223,1.1031602222222232,1.1035090000000014,1.1030136000000013,1.1030096000000007,1.1044718999999998,1.1029794598768559,1.1031052696884944,-1902,-23763,-19781.6,-0.05091783716557963,-40.47589581602753,-0.061626579181092773
2023-05-05T05:30:00-04:00,1.10274,1.10314,1.10244,1.10283,1.1037608350687813,1.1028086666666668,1.1028466666666668,1.103064444444445,1.1034390000000016,1.1030506000000013,1.1029914000000007,1.1044694,1.1029495679014847,1.1030494157507955,2055,-21708,-20440.4,-0.04944976936525869,-40.308177224156516,-0.07792043055568891
2023-05-05T05:45:00-04:00,1.10283,1.10304,1.10247,1.10273,1.1036037515619033,1.1027853333333335,1.102781111111111,1.1029597777777786,1.1033670000000015,1.1030792000000011,1.1029782000000008,1.1044658499999997,1.1029056543211877,1.1029951326006362,-1922,-23630,-22024,-0.05167984304860514,-40.482456124803015,-0.05347496646485973
2023-05-05T06:00:00-04:00,1.10273,1.10298,1.10246,1.10293,1.103462376405713,1.102815111111111,1.1028077777777776,1.1028791111111118,1.1032930000000014,1.1031116000000012,1.1029638000000006,1.10446225,1.10291052345695,1.1029569060805087,1843,-21787,-22549.8,-0.049865625217117814,-40.148194791566446,0.021764956606119396
2023-05-05T06:15:00-04:00,1.10293,1.10311,1.10241,1.10307,1.1033351387651418,1.1028675555555554,1.1028377777777776,1.1028431111111119,1.1032285000000015,1.1031450000000012,1.1029475000000006,1.1044588,1.10294241876556,1.1029375248644067,1969,-19818,-22141.2,-0.04064063381431885,-39.89826052556583,0.02448313384113098
2023-05-05T06:30:00-04:00,1.10307,1.10307,1.10242,1.10258,1.1032206248886276,1.102816,1.1028266666666664,1.1028200000000006,1.1031445000000013,1.1031750000000011,1.1029213000000007,1.1044489,1.102869935012448,1.1029156198915253,-1695,-21513,-21691.2,-0.034954666413432325,-40.65120458170023,-0.009068814161859198
2023-05-05T06:45:00-04:00,1.10258,1.10259,1.10211,1.10248,1.1031175623997649,1.1027466666666665,1.102772222222222,1.1028051111111117,1.1030695000000015,1.1031942000000012,1.1028911000000006,1.1044414499999997,1.1027919480099584,1.10288409591322,-1621,-23134,-21976.4,-0.029086520094422152,-40.798223392126665,-0.044425505680127424
2023-05-05T07:00:00-04:00,1.10248,1.10258,1.10206,1.10237,1.10307,1.102666222222222,1.1027244444444444,1.1027937777777783,1.1030110000000015,1.1032046000000013,1.1028610000000005,1.1044317999999997,1.1027075584079666,1.1028444767305756,-2202,-25336,-22317.6,-0.02757756081050577,-41.01792805797061,-0.03899165759883301
2023-05-05T07:15:00-04:00,1.10237,1.10257,1.1018999999999999,1.10213,1.1029286,1.1025473333333333,1.102651111111111,1.102762444444445,1.1029595000000012,1.1032044000000012,1.1028292000000006,1.1044204,1.1025920467263732,1.1027807813844603,-1752,-27088,-23377.8,-0.027566287531258817,-41.39936078926775,-0.059848203193707136
2023-05-05T07:30:00-04:00,1.10213,1.10226,1.10131,1.10142,1.102764024,1.1023011111111112,1.1025044444444445,1.1026957777777784,1.1028485000000015,1.1031926000000012,1.1027843000000006,1.1044075999999998,1.1023576373810986,1.1026638251075682,-2564,-29652,-25344.6,-0.032477555642982804,-43.0511078608473,-0.11970183361445016
2023-05-05T07:45:00-04:00,1.10142,1.10148,1.10082,1.10093,1.10257,1.101986222222222,1.1022933333333331,1.102589111111112,1.1026685000000014,1.1031650000000013,1.1027332000000007,1.1043920499999997,1.102072109904879,1.1025042600860544,-2563,-32215,-27485,-0.037192491547156106,-44.191335930067275,-0.17228403289718386
2023-05-05T08:00:00-04:00,1.10093,1.10149,1.10072,1.1012899999999999,1.10226,1.1017855555555554,1.1021333333333332,1.102461333333334,1.1025620000000012,1.103145200000001,1.1026779000000007,1.1043788999999997,1.1019156879239032,1.1023290080688435,2799,-29416,-28741.4,-0.037171783131312225,-43.276073379314944,-0.13058500267518866
2023-05-05T08:15:00-04:00,1.1012899999999999,1.10185,1.10095,1.10112,1.101952,1.1015828888888888,1.1019322222222219,1.1023028888888895,1.1024335000000014,1.1031218000000012,1.1026224000000004,1.1043663999999997,1.1017565503391225,1.1021388064550748,-3627,-33043,-30282.8,-0.04184454630111967,-43.835953156666235,-0.16410832963106156
2023-05-05T08:30:00-04:00,1.10112,1.10113,1.0969,1.09723,1.10185,1.1006424444444445,1.1012833333333332,1.1020293333333337,1.102129000000001,1.103026600000001,1.1025268000000006,1.1043345999999996,1.100851240271298,1.1017906451640596,-19220,-52263,-35317.8,-0.06566173706791281,-111.73572793144399,-0.5294314957346377
2023-05-05T08:45:00-04:00,1.09723,1.09872,1.09667,1.09759,1.10185,1.0999037777777778,1.1007288888888889,1.1016742222222227,1.1018740000000011,1.102933600000001,1.1024282000000007,1.1043061499999998,1.1001989922170383,1.1013589161312474,8732,-43531,-38093.6,-0.09064756222619072,-108.87076798685516,-0.4525748698506982
2023-05-05T09:00:00-04:00,1.09759,1.09896,1.09759,1.09892,1.10113,1.099542,1.1003333333333334,1.1012822222222227,1.1016800000000013,1.1028562000000008,1.1023411000000005,1.1042817499999997,1.0999431937736306,1.1009331329049978,7044,-36487,-38948,-0.10758804308360903,-100.33523103772222,-0.32290835207895
2023-05-05T09:15:00-04:00,1.09892,1.0996,1.09821,1.09859,1.100238,1.0991933333333332,1.0999133333333333,1.1008382222222226,1.1014755000000012,1.102778200000001,1.1022914000000006,1.1042554999999998,1.0996725550189044,1.100484506323998,-6522,-43009,-41666.6,-0.12472230255759012,-102.29375395112777,-0.34289757522430003
2023-05-05T09:30:00-04:00,1.09859,1.09935,1.09784,1.09831,1.0996,1.0988726666666666,1.099488888888889,1.100349555555556,1.1012425000000012,1.1026826000000012,1.1022455000000004,1.1042267999999997,1.0994000440151235,1.1000132050591982,-6725,-49734,-45004.8,-0.14271556938784544,-104.00776918884192,-0.3466015805758083
2023-05-05T09:45:00-04:00,1.09831,1.09945,1.09806,1.09912,1.09667,1.0987988888888889,1.0992333333333333,1.099939555555556,1.101058500000001,1.102600200000001,1.1022275000000006,1.1042026499999997,1.099344035212099,1.0997117640473584,6910,-42824,-43117,-0.1534252120202384,-98.91166699547085,-0.20882133972507932
2023-05-05T10:00:00-04:00,1.09912,1.09936,1.0985,1.09922,1.0967256,1.0987962222222223,1.0990433333333334,1.099602444444445,1.1008800000000012,1.102511600000001,1.1021770000000004,1.1041781999999998,1.099319228169679,1.0995358112378866,5994,-36830,-41776.8,-0.15794716265596936,-98.36632162826805,-0.15532322672648383
2023-05-05T10:15:00-04:00,1.09922,1.10079,1.09917,1.10056,1.096780088,1.0990995555555556,1.0989622222222222,1.0993282222222227,1.1007710000000013,1.1024520000000009,1.1021510000000003,1.10416225,1.0995673825357433,1.099460648990309,5577,-31253,-40730,-0.15167729611696845,-91.56770078803642,-0.06628590107963366
2023-05-05T10:30:00-04:00,1.10056,1.10064,1.09979,1.10009,1.0969404844800001,1.099325111111111,1.0988477777777776,1.0991151111111115,1.1006340000000012,1.102387600000001,1.1021378000000004,1.1041459499999997,1.0996719060285947,1.099460519192247,-4348,-35601,-39248.4,-0.15113229169504672,-93.42453730762632,-0.09354112176693606
2023-05-05T10:45:00-04:00,1.10009,1.10077,1.09991,1.10067,1.0970944651008,1.0996895555555555,1.0992299999999997,1.0990633333333337,1.1005310000000013,1.1023406000000011,1.1021206000000003,1.1041300999999997,1.0998715248228756,1.0995548153537975,4552,-31049,-35511.4,-0.14588971308788382,-91.02458821255217,0.313516764944461
2023-05-05T11:00:00-04:00,1.10067,1.1021,1.10048,1.10198,1.0972422864967681,1.1002395555555557,1.0997177777777773,1.0991602222222225,1.100483500000001,1.102320400000001,1.1021349000000003,1.1041195499999998,1.1002932198583004,1.099744652283038,4630,-26419,-32230.4,-0.09949118662548312,-85.51403554917474,0.39996720086734516
2023-05-05T11:15:00-04:00,1.10198,1.10227,1.10155,1.10191,1.0975337493069621,1.100678,1.1000499999999998,1.0993615555555558,1.1004255000000012,1.1022966000000012,1.1021278000000003,1.1041100499999998,1.1006165758866404,1.1000041218264303,-3860,-30279,-30920.2,-0.055829155773848685,-85.75923056178844,0.27208532013249814
2023-05-05T11:30:00-04:00,1.10191,1.10219,1.1014,1.10202,1.0979126493624052,1.101072,1.100431111111111,1.0996553333333334,1.100397500000001,1.102266400000001,1.1021193000000005,1.1041019499999998,1.1008972607093124,1.100270097461144,2951,-27328,-30135.2,-0.023119331317779237,-85.46464207452527,0.3122183890259373
2023-05-05T11:45:00-04:00,1.10202,1.1026799999999999,1.10192,1.10246,1.0982612374134129,1.1014777777777778,1.100892222222222,1.1000642222222223,1.100396500000001,1.102237000000001,1.1021432000000002,1.1040985999999997,1.10120980856745,1.100577677968915,3366,-23962,-27807.4,0.012565765817226541,-84.12071002247541,0.37785324726171104
2023-05-05T12:00:00-04:00,1.10246,1.10282,1.10226,1.10227,1.0987031136720715,1.1017533333333334,1.101242222222222,1.100466666666667,1.100391500000001,1.102200600000001,1.1021701000000004,1.1040856999999997,1.10142184685396,1.1008877423751318,-2375,-26337,-26865,0.04945868058261545,-84.53002192494787,0.28659291069218884
2023-05-05T12:15:00-04:00,1.10227,1.1025099999999999,1.10212,1.1022,1.0991971400314229,1.101944888888889,1.101573333333333,1.100837777777778,1.1003950000000011,1.102156400000001,1.1021904000000005,1.10407405,1.1015774774831681,1.1011445939001052,-2354,-28691,-27319.4,0.07818250344115599,-84.67951342884442,0.27110132639507856
2023-05-05T12:30:00-04:00,1.1022,1.1027,1.10219,1.10267,1.0996318832276522,1.1021642222222223,1.1018077777777775,1.1011893333333334,1.1004575000000012,1.102125600000001,1.1022063000000004,1.10406005,1.1017959819865346,1.1013804751200842,2407,-26284,-26520.4,0.10719337515259382,-83.65312075963745,0.19172057861452863
2023-05-05T12:45:00-04:00,1.10267,1.10366,1.10262,1.10322,1.1000144572403339,1.1024466666666668,1.1021555555555553,1.1015342222222224,1.1005720000000012,1.1021018000000011,1.1022304000000005,1.1040497999999999,1.1020807855892276,1.1016171800960675,2484,-23800,-25814.8,0.12356586537858771,-82.4141281326501,0.2845221754583786
2023-05-05T13:00:00-04:00,1.10322,1.10345,1.10296,1.10323,1.100524833226687,1.1026615555555557,1.1024399999999996,1.1018437777777779,1.1006690000000012,1.1020818000000012,1.1022405000000004,1.1040374499999999,1.1023106284713822,1.1018373440768536,2153,-21647,-25351.8,0.14213051711316857,-82.3946125328607,0.2325856069484855
2023-05-05T13:15:00-04:00,1.10323,1.10345,1.10206,1.10208,1.1009637565749508,1.1025895555555556,1.1024511111111108,1.1020855555555555,1.100717000000001,1.1020400000000012,1.1022370000000004,1.10402045,1.1022645027771056,1.102005875261483,-2798,-24445,-24973.4,0.15151764230520243,-85.31123010127342,0.00907457485616699
2023-05-05T13:30:00-04:00,1.10208,1.10221,1.10125,1.10151,1.10366,1.1024013333333331,1.1024066666666663,1.1022522222222222,1.1009310000000012,1.1019820000000013,1.1022225000000005,1.104001,1.1021136022216844,1.1021131002091862,-2442,-26887,-24612.6,0.14555813435371912,-86.57424186085521,-0.03630060531258959
2023-05-05T13:45:00-04:00,1.10151,1.10155,1.10096,1.10116,1.1036118000000001,1.102152,1.1023111111111108,1.102352888888889,1.101109500000001,1.1019180000000013,1.1022093000000004,1.1039828999999999,1.1019228817773474,1.1021384801673486,-1652,-28539,-25063.6,0.12172261154738823,-87.0991576582607,-0.07803851109780974
2023-05-05T14:00:00-04:00,1.10116,1.10181,1.10111,1.10159,1.1035057280000002,1.1020077777777777,1.1022144444444442,1.1023646666666664,1.101243000000001,1.1018646000000014,1.1021998000000004,1.10396535,1.101856305421878,1.1020935841338786,1945,-26594,-25622.4,0.10049827493605377,-86.3396404218915,-0.0789144277343329
2023-05-05T14:15:00-04:00,1.10159,1.10194,1.10107,1.10188,1.1034038988800001,1.1019408888888889,1.1021711111111108,1.1023108888888888,1.101407500000001,1.1018226000000013,1.1021915000000004,1.1039491999999997,1.1018610443375023,1.102003667307103,1630,-24964,-26285.8,0.0824197444170965,-85.91053340385409,-0.03538153084091125
2023-05-05T14:30:00-04:00,1.10188,1.10249,1.10162,1.10245,1.1033061429248001,1.1019966666666667,1.1021988888888885,1.1022604444444444,1.101614500000001,1.1018008000000012,1.1021876000000004,1.1039353499999998,1.1019788354700017,1.101946533845682,2265,-22699,-25936.6,0.06735233846076913,-84.73885409213239,0.02268190890944125
2023-05-05T14:45:00-04:00,1.10245,1.10269,1.10213,1.10264,1.103212297207808,1.102084888888889,1.1021955555555552,1.102218222222222,1.1017905000000012,1.1017904000000014,1.1021924000000005,1.1039251499999998,1.1021110683760014,1.1019460270765455,2256,-20443,-24647.8,0.05261740580154858,-84.35004734352673,-0.002720668921796593
2023-05-05T15:00:00-04:00,1.10264,1.10265,1.10211,1.10263,1.1031222053194958,1.1021717777777778,1.1021299999999996,1.1021819999999998,1.101961000000001,1.1017702000000014,1.1022054000000006,1.1039148999999997,1.102214854700801,1.1020044216612361,-1888,-22331,-23406.2,0.037076829725784334,-84.36716988578904,-0.05347981363645424
2023-05-05T15:15:00-04:00,1.10263,1.10264,1.10215,1.10226,1.103035717106716,1.1021977777777778,1.1020222222222218,1.1021435555555554,1.102046000000001,1.1017248000000015,1.1022152000000005,1.1039014999999999,1.1022238837606408,1.1020779373289886,-1253,-23584,-22804.2,0.015223745413045414,-84.78762824444061,-0.0879236423955037
2023-05-05T15:30:00-04:00,1.10226,1.1025099999999999,1.10206,1.10228,1.1029526884224474,1.1022493333333332,1.1020444444444442,1.102118222222222,1.102155500000001,1.1017020000000015,1.1022215000000004,1.1038875499999998,1.1022351070085126,1.102152749863191,1430,-22154,-22242.2,-0.0008296173389686747,-84.76168155309749,0.018147502903598466
2023-05-05T15:45:00-04:00,1.10228,1.10236,1.10165,1.10181,1.1028729808855495,1.1022024444444447,1.1020777777777773,1.102094,1.102212500000001,1.1016644000000015,1.1022238000000004,1.1038720999999998,1.10215008560681,1.1021869998905525,-1500,-23654,-22433.2,-0.010710773681617646,-85.40126496203166,0.02723534057793093
2023-05-05T16:00:00-04:00,1.10181,1.10197,1.10165,1.10193,1.1027964616501276,1.1021728888888886,1.102163333333333,1.1020875555555556,1.102210000000001,1.1016366000000015,1.1022277000000005,1.1038471999999997,1.102106068485448,1.1021859999124417,1357,-22297,-22804,-0.012343289475834305,-85.2534717853495,0.06992625958082017
2023-05-05T16:15:00-04:00,1.10193,1.10198,1.10169,1.10171,1.1027230031841224,1.1020822222222224,1.1021766666666661,1.1020968888888887,1.1022000000000012,1.1016170000000016,1.1022298000000006,1.1038243499999998,1.1020268547883585,1.1021483999299533,-698,-22995,-22936.8,-0.0061868381929982025,-85.39282727980022,0.010893345073929316
2023-05-05T16:30:00-04:00,1.10171,1.1018999999999999,1.1017,1.10177,1.1026524830567574,1.102000888888889,1.102164444444444,1.1021253333333334,1.1021875000000012,1.1015964000000016,1.1022304000000005,1.1038063999999996,1.1019754838306868,1.1020987199439625,365,-22630,-22746,-0.003948885692717039,-85.37294909044006,-0.009982938250994165
2023-05-05T16:45:00-04:00,1.10177,1.10191,1.10169,1.10176,1.102584783734487,1.10192,1.1020877777777773,1.102134,1.1021525000000012,1.1015780000000013,1.1022335000000005,1.1037852999999995,1.1019323870645494,1.1020381759551698,-1150,-23780,-23071.2,-0.0039143661124716655,-85.38338684060554,-0.06258787246585854
2023-05-07T17:00:00-04:00,1.1024,1.1024,1.10175,1.10201,1.1025197923851076,1.1019044444444444,1.1020177777777773,1.102122,1.1021395000000012,1.1015588000000014,1.1022392000000005,1.1037731999999998,1.1019479096516396,1.1019977407641357,356,-23424,-23025.2,-0.005962395431234066,-85.30260699744555,-0.05713560182835108
2023-05-07T17:15:00-04:00,1.10201,1.10205,1.10198,1.10204,1.1024574006897032,1.1019088888888888,1.1019522222222218,1.1020797777777775,1.1021315000000012,1.1015436000000016,1.1022469000000006,1.1037560999999996,1.1019663277213116,1.1019697926113086,112,-23312,-23228.2,-0.010412692596986612,-85.29955802329832,-0.053508429845015144
2023-05-07T17:30:00-04:00,1.10204,1.1021,1.10192,1.10208,1.1024,1.1019344444444443,1.1019322222222216,1.1020308888888886,1.1021020000000012,1.1015294000000013,1.1022537000000006,1.1037440499999998,1.1019890621770494,1.1019622340890467,813,-22499,-23129,-0.014884610781432382,-85.27004911255095,-0.016330085460786837
2023-05-07T17:45:00-04:00,1.10208,1.10222,1.10197,1.10203,1.1023424,1.1019539999999999,1.1019044444444441,1.1019788888888888,1.1020425000000011,1.1015152000000015,1.1022644000000006,1.1037270499999996,1.1019972497416395,1.1019665872712372,-115,-22614,-23125.8,-0.014206662873015105,-85.27526651963572,-0.022680262728150876
2023-05-07T18:00:00-04:00,1.10203,1.10226,1.10193,1.10204,1.102287104,1.101981111111111,1.1019299999999994,1.101947333333333,1.1019830000000013,1.1014994000000013,1.1022750000000006,1.1037109999999997,1.1020057997933115,1.1019812698169897,571,-22043,-22778.4,-0.011286403729162868,-85.27008517248554,0.02087474246920544
2023-05-07T18:15:00-04:00,1.10204,1.10204,1.10174,1.10177,1.10226,1.101949111111111,1.1019122222222217,1.101926222222222,1.1019675000000013,1.1014802000000012,1.1022797000000006,1.1036910499999997,1.1019586398346493,1.1019834158535917,-558,-22601,-22613.8,-0.005341070106700012,-85.40679527375228,-0.01451997858304611
2023-05-07T18:30:00-04:00,1.10177,1.10178,1.10142,1.1015,1.10226,1.1018666666666665,1.1018888888888885,1.1019135555555555,1.1019670000000013,1.1014516000000014,1.1022816000000006,1.1036700499999994,1.1018669118677193,1.101963532682873,-648,-23249,-22601.2,-0.006737004042634938,-85.56559429714191,-0.019061277468666298
2023-05-07T18:45:00-04:00,1.1015,1.10172,1.10148,1.1016299999999999,1.102208,1.101814888888889,1.1018733333333328,1.1019017777777775,1.1019905000000012,1.1014228000000013,1.1022839000000004,1.1036484999999996,1.1018195294941755,1.1019296261462983,455,-22794,-22660.2,-0.007981515035876675,-85.51189479646104,-0.012706826288610962
2023-05-07T19:00:00-04:00,1.1016299999999999,1.10184,1.10143,1.10182,1.1021580800000002,1.101804222222222,1.1018799999999995,1.1018968888888885,1.1020020000000013,1.1014076000000015,1.1022913000000003,1.1036279999999996,1.1018196235953404,1.1018941009170384,888,-21906,-22518.6,-0.010379562718785788,-85.35873992595087,0.005445832123143786
2023-05-07T19:15:00-04:00,1.10182,1.10206,1.10162,1.10206,1.1021101568000002,1.1018402222222223,1.1018855555555551,1.1018879999999995,1.1020110000000014,1.1013992000000012,1.1022967000000006,1.1036066999999996,1.1018676988762723,1.1018664807336307,445,-21461,-22402.2,-0.009687971273132654,-85.26180939283293,0.004537163909592972
2023-05-07T19:30:00-04:00,1.10206,1.10219,1.10188,1.10204,1.10096,1.1018711111111112,1.1018855555555551,1.1018826666666663,1.1019905000000012,1.1013926000000014,1.1022986000000006,1.1035841499999994,1.1019021591010179,1.1018551845869045,-606,-22067,-22295.4,-0.010107050910325386,-85.27280697917132,0
2023-05-07T19:45:00-04:00,1.10204,1.1021,1.10179,1.10182,1.1009845999999999,1.1018579999999998,1.101856666666666,1.101876222222222,1.1019495000000012,1.1013864000000013,1.1022954000000005,1.1035627499999996,1.1018857272808142,1.1018589476695235,-723,-22790,-22203.6,-0.009381361641335115,-85.4171393083063,-0.023591753774673978
2023-05-07T20:00:00-04:00,1.10182,1.10216,1.10167,1.1020699999999999,1.101008708,1.1019006666666666,1.1018611111111105,1.1018737777777774,1.1019215000000013,1.1013994000000014,1.1022960000000006,1.1035366499999995,1.1019225818246514,1.1018795581356187,1740,-21050,-21854.8,-0.0070091862688870105,-85.02233797959585,0.0036296652541054197
2023-05-07T20:15:00-04:00,1.1020699999999999,1.1025,1.10199,1.10232,1.1010323338399999,1.1019924444444444,1.1018922222222218,1.1018762222222218,1.1019245000000013,1.1014272000000012,1.1022961000000004,1.1035108499999995,1.1020020654597211,1.1019160465084947,1439,-19611,-21395.8,-0.0030379309226955934,-84.69590680916191,0.025407426227728395
2023-05-07T20:30:00-04:00,1.10232,1.10253,1.10215,1.10216,1.1010910404863998,1.102046,1.1019355555555552,1.1018862222222219,1.1019185000000014,1.1014446000000013,1.1022949000000006,1.1034837499999994,1.102033652367777,1.1019492372067958,-1273,-20884,-21280.4,-0.0015168113255120469,-84.88068074050663,0.03539758751827628
2023-05-07T20:45:00-04:00,1.10216,1.1025,1.10195,1.10242,1.1011773780572158,1.102142888888889,1.1020377777777774,1.1019166666666664,1.1019490000000012,1.1014706000000012,1.1022962000000005,1.1034620499999996,1.1021109218942216,1.1019909897654365,1353,-19531,-20773.2,0.003776880564585717,-84.56150748072594,0.08352246935996659
2023-05-07T21:00:00-04:00,1.10242,1.10248,1.10185,1.10195,1.101258535373783,1.1021253333333332,1.102073333333333,1.1019599999999996,1.101950000000001,1.1015650000000015,1.1022958000000005,1.1034369499999996,1.1020787375153773,1.1020295918123493,-1488,-21019,-20419,0.007255542452299319,-85.19589364933677,0.029047865435772265
2023-05-07T21:15:00-04:00,1.10195,1.10229,1.10188,1.1022399999999999,1.101334823251356,1.1021586666666665,1.1021199999999998,1.1020117777777776,1.1019765000000012,1.1016580000000014,1.1022958000000005,1.1034137999999993,1.1021109900123018,1.102067273449879,1288,-19731,-20155.2,0.011451417469455829,-84.85693090148081,0.03811874897894982
2023-05-07T21:30:00-04:00,1.1022399999999999,1.10297,1.10223,1.10284,1.1014065338562746,1.1023026666666664,1.1022066666666666,1.1020746666666663,1.1020300000000012,1.1017364000000012,1.1022963000000003,1.1033920999999993,1.1022567920098414,1.1021182187599032,1909,-17822,-19797.4,0.015823789871165322,-83.81777427497451,0.07077654574161142
2023-05-07T21:45:00-04:00,1.10284,1.10321,1.10279,1.10313,1.1015316111477726,1.1024873333333334,1.1023277777777776,1.102153111111111,1.1020985000000012,1.1018272000000011,1.1023027000000005,1.1033733999999995,1.102431433607873,1.1021977750079226,1366,-16456,-18911.8,0.019655431514310866,-83.45857439103861,0.09890748067221113
2023-05-07T22:00:00-04:00,1.10313,1.1032,1.10281,1.10294,1.1016994500329953,1.1026097777777777,1.102452222222222,1.102236,1.102145000000001,1.1019198000000012,1.1023012000000003,1.1033481999999994,1.1025331468862984,1.102282220006338,-1159,-17615,-18528.6,0.022722058543373048,-83.6581972822662,0.1016499972772331
2023-05-07T22:15:00-04:00,1.10294,1.10327,1.10282,1.10325,1.1018505050296958,1.1027693333333333,1.102583333333333,1.102338,1.102205500000001,1.1020024000000013,1.1023013000000004,1.1033255499999997,1.1026765175090387,1.1024017760050704,929,-16686,-17662,0.03033765874673022,-83.39708607041422,0.10707123866906648
2023-05-07T22:30:00-04:00,1.10325,1.10361,1.10321,1.1036,1.1020208444261324,1.1029726666666666,1.1027255555555553,1.102459111111111,1.102281500000001,1.1020900000000011,1.1023008000000005,1.1033051499999995,1.102861214007231,1.1025518208040563,1684,-15002,-16716.2,0.037476709359210325,-82.86284632421005,0.1161187314028547
2023-05-07T22:45:00-04:00,1.1036,1.1037,1.10315,1.10319,1.102243326206474,1.1030655555555557,1.1028399999999996,1.1025857777777777,1.102339500000001,1.1021426000000012,1.1022973000000005,1.1032831999999995,1.1029269712057848,1.102685856643245,-1705,-16707,-16493.2,0.040572262430691924,-83.49627329050222,0.09345285620961243
2023-05-07T23:00:00-04:00,1.10319,1.10357,1.1031199999999999,1.10355,1.102476394013438,1.1032075555555556,1.1029655555555553,1.1027133333333332,1.102415000000001,1.1022118000000014,1.1022997000000005,1.1032637999999995,1.1030515769646279,1.1028098853145958,975,-15732,-16348.4,0.04661270633610077,-83.17810506925281,0.10250176883584074
2023-05-07T23:15:00-04:00,1.10355,1.10384,1.10355,1.10371,1.102672170971288,1.1033564444444444,1.1031611111111106,1.102855111111111,1.1025120000000008,1.1022726000000014,1.1023066000000004,1.1032433999999995,1.1031832615717023,1.1029399082516764,709,-15023,-15830,0.05109707537275403,-83.07530954571517,0.159716865556512
2023-05-07T23:30:00-04:00,1.10371,1.10393,1.1036299999999999,1.10389,1.102882380196456,1.1035022222222222,1.103344444444444,1.1030073333333332,1.1026315000000009,1.1023108000000013,1.1023156000000005,1.1032212999999995,1.1033246092573619,1.103069526601341,835,-14188,-15330.4,0.059531496108922666,-82.93913247021521,0.1496951662070104
2023-05-07T23:45:00-04:00,1.10389,1.10399,1.10375,1.10391,1.1030919041571647,1.1036153333333334,1.103463333333333,1.1031548888888887,1.1027455000000008,1.1023508000000013,1.1023237000000004,1.1032000999999996,1.1034416874058894,1.1031856212810727,1205,-12983,-14926.6,0.06426262299985382,-82.91730058479195,0.09702223350621163
2023-05-08T00:00:00-04:00,1.10391,1.10399,1.10385,1.10395,1.1032715233257318,1.1037126666666668,1.1035544444444438,1.1032977777777777,1.1028520000000008,1.1023894000000014,1.1023279000000006,1.1031781499999995,1.1035433499247116,1.1033088970248581,1072,-11911,-13967.4,0.06430368334194583,-82.878456838472,0.0743339406960234
2023-05-08T00:15:00-04:00,1.10395,1.10417,1.10394,1.10405,1.1034152186605855,1.1038117777777778,1.1036777777777773,1.1034402222222222,1.102951500000001,1.1024212000000013,1.1023291000000004,1.1031562999999995,1.1036446799397692,1.1034275176198864,1961,-9950,-12811,0.06301085138915109,-82.70082198182091,0.10064010734944279
2023-05-08T00:30:00-04:00,1.10405,1.10427,1.10402,1.10422,1.1035661749284684,1.103920222222222,1.103785555555555,1.1035651111111109,1.103060500000001,1.1024602000000014,1.1023304000000005,1.1031363999999995,1.1037597439518154,1.1035428140959092,1191,-8759,-11558.2,0.0652844484258674,-82.51743354832604,0.08792204849308093
2023-05-08T00:45:00-04:00,1.10422,1.10443,1.10418,1.10435,1.1037069399427748,1.104033111111111,1.1038688888888883,1.10367,1.1031870000000008,1.1025032000000015,1.1023298000000004,1.1031161499999995,1.1038777951614522,1.103653451276727,1089,-7670,-10254.6,0.06527793845693663,-82.38922540139883,0.06795940558173509
2023-05-08T01:00:00-04:00,1.10435,1.10444,1.1040699999999999,1.10414,1.1038515519542198,1.1040873333333334,1.103974444444444,1.103772222222222,1.1032905000000008,1.1025326000000013,1.1023291000000004,1.1030947999999996,1.1039302361291619,1.1037511610213815,-1359,-9029,-9463.8,0.060152245263719234,-82.64764890843922,0.08611390603613217
2023-05-08T01:15:00-04:00,1.10414,1.10423,1.10408,1.10418,1.103969241563376,1.1041284444444444,1.1040444444444437,1.103870222222222,1.103383500000001,1.1025518000000014,1.1023268000000004,1.1030732999999995,1.1039801889033294,1.103838528817105,834,-8195,-8720.6,0.060012973678460035,-82.61743534856454,0.057088487155082086
2023-05-08T01:30:00-04:00,1.10418,1.10428,1.10385,1.10393,1.10444,1.1041055555555557,1.1040688888888883,1.103948444444444,1.103472000000001,1.1025658000000014,1.1023238000000004,1.1030527499999996,1.1039701511226636,1.1039036230536838,-1493,-9688,-8668.2,0.05650451414662877,-82.9554690024976,0.01993277219560473
2023-05-08T01:45:00-04:00,1.10393,1.10412,1.10365,1.10389,1.1044282,1.1040697777777777,1.1040688888888883,1.1040051111111109,1.103545500000001,1.1026020000000014,1.1023210000000003,1.1030315999999996,1.103954120898131,1.103942498442947,-1406,-11094,-9135.2,0.050666002684976376,-83.00641426170792,0
2023-05-08T02:00:00-04:00,1.10389,1.10462,1.10372,1.10461,1.10365,1.1041779999999999,1.104146666666666,1.1040606666666661,1.1036785000000011,1.1026640000000014,1.1023230000000004,1.1030140499999994,1.1040852967185049,1.1039839987543576,1907,-9187,-9438.6,0.04773571423638503,-81.76259467823483,0.06341096647372929
2023-05-08T02:15:00-04:00,1.10461,1.10466,1.10421,1.10428,1.10365,1.1042046666666665,1.1041833333333326,1.1041024444444438,1.103780500000001,1.1027264000000014,1.1023222000000004,1.1029945499999996,1.104124237374804,1.104022799003486,-1498,-10685,-9769.8,0.04103055287698246,-82.21011914388356,0.029892658181977578
2023-05-08T02:30:00-04:00,1.10428,1.10471,1.10425,1.10437,1.1036904,1.104242,1.1042188888888882,1.1041373333333329,1.103857000000001,1.1027820000000013,1.1023233000000003,1.1029732999999995,1.1041733898998431,1.1040614392027888,1268,-9417,-10014.2,0.035642826266466844,-82.10677578893718,0.028984194556414836
2023-05-08T02:45:00-04:00,1.10437,1.10505,1.10426,1.10482,1.103751576,1.1043622222222222,1.1042855555555549,1.1041806666666663,1.103941500000001,1.1028408000000014,1.1023317000000004,1.1029566999999996,1.1043027119198745,1.104127951362231,1772,-7645,-9605.6,0.034073909194895446,-81.38473516849321,0.054336998061974416
2023-05-08T03:00:00-04:00,1.10482,1.10502,1.10456,1.10477,1.1038554499200002,1.104459111111111,1.1043322222222214,1.1042333333333327,1.104033000000001,1.1028872000000014,1.1023440000000004,1.1029381999999996,1.1043961695358997,1.1042163610897848,-2515,-10160,-9418.8,0.031979502751947365,-81.4985546141945,0.03803142119799764
2023-05-08T03:15:00-04:00,1.10477,1.10494,1.10437,1.10444,1.1039510139264002,1.1044806666666667,1.1043655555555547,1.1042771111111107,1.104092500000001,1.1029232000000015,1.1023568000000004,1.1029186499999997,1.1044049356287198,1.1042802888718277,-2415,-12575,-10096.4,0.026322940164179028,-82.21992648345223,0.027170467513194796
2023-05-08T03:30:00-04:00,1.10444,1.1046799999999999,1.10383,1.10427,1.10505,1.1044615555555557,1.1043755555555548,1.104315555555555,1.1041260000000013,1.1029560000000016,1.1023631000000003,1.1028977499999997,1.1043779485029759,1.1043310310974621,-2592,-15167,-10992.8,0.02310002708517816,-82.61889790788453,0.008150844970941833
2023-05-08T03:45:00-04:00,1.10427,1.10498,1.10422,1.10493,1.1050256,1.1045724444444445,1.1044866666666657,1.1043691111111105,1.104213000000001,1.1030094000000015,1.1023671000000004,1.1028803499999997,1.1044883588023806,1.1043940248779696,2665,-12502,-11609.8,0.024155308151623034,-81.02608093377522,0.09058545378782076
2023-05-08T04:00:00-04:00,1.10493,1.10534,1.10429,1.10454,1.10383,1.104583111111111,1.1045588888888878,1.1044237777777772,1.1042625000000013,1.1030546000000014,1.1023783000000003,1.1028577499999996,1.1044986870419045,1.1044332199023756,-2928,-15430,-13166.8,0.023856344442155397,-82.05955816762685,0.05888267852775543
2023-05-08T04:15:00-04:00,1.10454,1.10524,1.10435,1.10498,1.1038602000000002,1.1046673333333334,1.104599999999999,1.1044773333333326,1.104326000000001,1.1031180000000014,1.1023912000000005,1.1028383999999996,1.1045949496335237,1.1044729759219005,2284,-13146,-13764,0.027559019466398972,-81.14971334534789,0.033495985008281784
2023-05-08T04:30:00-04:00,1.10498,1.10524,1.10478,1.10502,1.1038897960000003,1.1047513333333334,1.1046822222222215,1.1045406666666662,1.1043825000000012,1.1031798000000015,1.1024082000000004,1.1028262499999997,1.1046799597068189,1.1045279807375201,2403,-10743,-13397.6,0.025621411945933228,-81.06272534556548,0.06701198971275066
2023-05-08T04:45:00-04:00,1.10502,1.10536,1.10358,1.1036,1.10536,1.1045348888888888,1.1045966666666658,1.1045848888888883,1.1043670000000012,1.1032176000000016,1.1024173000000004,1.1028065999999996,1.104463967765455,1.104545184590016,-3431,-14174,-13199,0.02071470921146276,-85.47171341817948,-0.06972300949864262
2023-05-08T05:00:00-04:00,1.1036,1.10368,1.10273,1.1028,1.10536,1.1041755555555555,1.1043722222222214,1.1045619999999994,1.104309500000001,1.1032382000000016,1.1024173000000004,1.1027860499999995,1.104131174212364,1.1044737476720128,-3177,-17351,-14168.8,0.01128496852542828,-87.77472175453298,-0.1828352129758613
2023-05-08T05:15:00-04:00,1.1028,1.10301,1.10226,1.10295,1.10536,1.1038911111111112,1.104169999999999,1.1044842222222218,1.104254500000001,1.1032620000000015,1.1024200000000004,1.1027668999999998,1.1038949393698914,1.1043529981376101,2696,-14655,-14013.8,-0.0013368326725155366,-87.40801881655669,-0.16474017216252548
2023-05-08T05:30:00-04:00,1.10295,1.10328,1.10291,1.10326,1.1051739999999999,1.1037091111111113,1.104038888888888,1.1043719999999995,1.104206500000001,1.1032870000000015,1.1024229000000003,1.1027523999999997,1.1037679514959131,1.104187598510088,2466,-12189,-13822.4,-0.011604965424432718,-86.71491396139595,-0.10684147622326073
2023-05-08T05:45:00-04:00,1.10326,1.10392,1.1032,1.1036,1.10499916,1.1036213333333333,1.1039644444444434,1.104228444444444,1.1041690000000008,1.1033182000000012,1.1024309000000003,1.1027414999999996,1.1037343611967305,1.1039984788080706,1667,-10522,-13778.2,-0.01653891950611729,-86.20118193086823,-0.06067356715297621
2023-05-08T06:00:00-04:00,1.1036,1.10441,1.10353,1.10437,1.1048348104,1.1037024444444443,1.1039022222222212,1.104089555555555,1.104180500000001,1.1033640000000013,1.1024467000000004,1.1027355999999997,1.1038614889573843,1.1038779830464562,1666,-8856,-12714.6,-0.015719507067280068,-85.03878613528988,-0.050681943652529475
2023-05-08T06:15:00-04:00,1.10437,1.10449,1.10396,1.1043,1.1046803217760002,1.103782,1.1038755555555546,1.1039902222222218,1.1041865000000008,1.1034094000000014,1.1024623000000005,1.1027359499999998,1.1039491911659074,1.103841586437165,-1670,-10526,-11349.6,-0.022114972845745994,-85.14463834061964,-0.021728502362976257
2023-05-08T06:30:00-04:00,1.1043,1.10484,1.10414,1.10461,1.10226,1.103928888888889,1.1038344444444435,1.1039231111111105,1.104220500000001,1.1034608000000015,1.1024801000000004,1.1027357499999997,1.104081352932726,1.1038788691497319,1979,-8547,-10128,-0.023335003713036866,-84.5890918405743,-0.03348476895509253
2023-05-08T06:45:00-04:00,1.10461,1.10501,1.10456,1.10478,1.1023116,1.104118,1.1038077777777768,1.1038768888888884,1.104265000000001,1.1035210000000015,1.1025006000000004,1.1027393999999997,1.1042210823461809,1.1039694953197854,1961,-6586,-9007.4,-0.028810838153443916,-84.28729301564965,-0.021719063908327084
2023-05-08T07:00:00-04:00,1.10478,1.10514,1.10478,1.10504,1.102419536,1.1043644444444445,1.1039677777777768,1.103877555555555,1.104286500000001,1.1035918000000013,1.1025217000000003,1.1027427499999995,1.1043848658769446,1.1040995962558284,1972,-4614,-7825.8,-0.03358726090259534,-83.82320061716321,0.13048205871693622
2023-05-08T07:15:00-04:00,1.10504,1.10509,1.1045,1.10458,1.10258276384,1.1044868888888888,1.1041655555555545,1.1039302222222216,1.104301500000001,1.1036508000000014,1.1025368000000002,1.1027421499999996,1.1044238927015557,1.1042120770046626,-2159,-6773,-7409.2,-0.024583543730107568,-84.72193731447759,0.1614073268044879
2023-05-08T07:30:00-04:00,1.10458,1.10501,1.10432,1.10437,1.1027361980096,1.1045277777777778,1.1043233333333324,1.1040197777777774,1.104301500000001,1.1037018000000014,1.1025547000000002,1.1027379999999998,1.1044131141612445,1.10430486160373,-2557,-9330,-7170,-0.01075445011729946,-85.20806778940882,0.12874563670157094
2023-05-08T07:45:00-04:00,1.10437,1.10442,1.103,1.1035,1.102880426129024,1.1043631111111112,1.104349999999999,1.1041228888888885,1.104235500000001,1.1037306000000013,1.1025649000000002,1.102728,1.1042304913289955,1.1043346892829837,-2838,-12168,-7894.2,-0.0020224644483765363,-87.44378589113235,0.021753711727065063
2023-05-08T08:00:00-04:00,1.1035,1.10388,1.10318,1.1035,1.103,1.104193111111111,1.1043388888888879,1.1042291111111104,1.1041720000000008,1.1037598000000015,1.1025762000000003,1.1027186,1.1040843930631965,1.104307351426387,0,-12168,-9010.6,0.005843486840963054,-87.44378589113235,-0.009061254077563337
2023-05-08T08:15:00-04:00,1.1035,1.10391,1.10319,1.10386,1.103,1.1040973333333335,1.1042822222222213,1.1042919999999996,1.104143000000001,1.1038006000000014,1.1025935000000002,1.1027113499999999,1.1040395144505573,1.1042382811411096,3000,-9168,-9921.4,0.012123015616321111,-86.46508176788775,-0.046180175122468956
2023-05-08T08:30:00-04:00,1.10386,1.10395,1.10336,1.10378,1.1031284,1.103996888888889,1.1042244444444433,1.1043037777777773,1.1041185000000007,1.1038348000000016,1.1026171000000002,1.1027007,1.103987611560446,1.1041510249128876,-3174,-12342,-11035.2,0.009626233037646816,-86.69511093825379,-0.047088653445628535
2023-05-08T08:45:00-04:00,1.10378,1.10411,1.10356,1.10369,1.10319,1.10389,1.1041222222222211,1.1042635555555549,1.1040565000000009,1.1038622000000016,1.1026447000000001,1.10268895,1.1039280892483567,1.10405401993031,-2608,-14950,-12159.2,0.006603105486682509,-86.90776201002515,-0.08328731407465366
2023-05-08T09:00:00-04:00,1.10369,1.10422,1.10334,1.10416,1.1033069999999998,1.1038975555555555,1.104053333333332,1.1042042222222217,1.104037500000001,1.1039022000000014,1.1026734000000002,1.10267565,1.1039744713986854,1.104002815944248,3381,-11569,-12039.4,0.005848535860491784,-85.46798272417504,-0.05611977045204157
2023-05-08T09:15:00-04:00,1.10416,1.10422,1.10358,1.10376,1.10334,1.103838888888889,1.10391111111111,1.104118666666666,1.1039765000000006,1.1039290000000015,1.1026998000000001,1.1026610999999997,1.1039315771189484,1.1039722527553983,-2444,-14013,-12408.4,-0.000025879347878570044,-86.35336165476471,-0.1158329110258405
2023-05-08T09:30:00-04:00,1.10376,1.10442,1.10375,1.1038999999999999,1.10334,1.1038366666666668,1.1038355555555546,1.1040293333333326,1.1039205000000007,1.1039680000000014,1.1027665000000002,1.1026466499999998,1.1039252616951587,1.1039494022043188,4224,-9789,-12532.6,-0.0056937217659135154,-85.81759300940776,-0.06156186061670626
2023-05-08T09:45:00-04:00,1.1038999999999999,1.10437,1.10343,1.10434,1.10514,1.1039375555555555,1.103832222222221,1.103950888888888,1.1039575000000008,1.1040100000000015,1.102834,1.1026310999999998,1.104008209356127,1.103953521763455,4941,-4848,-11033.8,-0.004934703605028325,-83.8481754897039,-0.002716480889554632
2023-05-08T10:00:00-04:00,1.10434,1.1044,1.10305,1.1032,1.1051058,1.103811111111111,1.1037988888888877,1.1038862222222214,1.1039775000000007,1.1040172000000015,1.1028768,1.1026089499999998,1.1038465674849016,1.103937217410764,-4617,-9465,-9936.8,-0.013807918524235525,-88.61426202102636,-0.027186225645669866
2023-05-08T10:15:00-04:00,1.1032,1.10326,1.10245,1.10257,1.105023568,1.1035653333333333,1.1036955555555543,1.103814666666666,1.1039585000000007,1.1040060000000014,1.1029166000000001,1.1026039999999997,1.1035912539879214,1.1038605739286111,-3764,-13229,-10268.8,-0.021240507770627314,-90.76375440681285,-0.08427729950157457
2023-05-08T10:30:00-04:00,1.10257,1.10273,1.10213,1.10222,1.10486915392,1.1032702222222222,1.103513333333332,1.1037351111111104,1.1039065000000008,1.1039916000000014,1.1029557000000003,1.1026005999999997,1.103317003190337,1.103737659142889,-3419,-16648,-10795.8,-0.029687607171080127,-91.84908232250096,-0.1485695649810742
2023-05-08T10:45:00-04:00,1.10222,1.1023,1.10127,1.10158,1.1046500216064,1.1028835555555554,1.1032688888888875,1.1036217777777768,1.1038055000000009,1.1039582000000014,1.1029803000000002,1.1026038999999996,1.1029696025522695,1.103546527314311,-4611,-21259,-13089.8,-0.0430980370332365,-94.52644255911423,-0.19931508090380146
2023-05-08T11:00:00-04:00,1.10158,1.10177,1.10114,1.10137,1.1043120194457599,1.1025037777777777,1.1030111111111098,1.1034575555555546,1.1036555000000008,1.1039136000000014,1.1030018000000004,1.1025893999999998,1.1026496820418157,1.1032748218514488,-3384,-24643,-17048.8,-0.0553166263113973,-95.17155231056229,-0.21020395219673094
2023-05-08T11:15:00-04:00,1.10137,1.10192,1.10116,1.10171,1.1039313771122687,1.1022435555555556,1.1027388888888876,1.1032455555555547,1.103526000000001,1.1038840000000014,1.1030133000000002,1.1025821499999997,1.1024617456334525,1.102997857481159,2825,-21818,-19519.4,-0.0617868876651199,-94.29945664788761,-0.2218881321547659
2023-05-08T11:30:00-04:00,1.10171,1.1023,1.10161,1.1020699999999999,1.1035964118587964,1.1021097777777777,1.10255111111111,1.1030166666666659,1.103399000000001,1.1038544000000015,1.1030331000000002,1.1025854499999996,1.102383396506762,1.1027562859849271,2679,-19139,-20701.4,-0.07110987593531734,-93.4240538649413,-0.15311299557876634
2023-05-08T11:45:00-04:00,1.1020699999999999,1.10234,1.10189,1.10197,1.103301642435741,1.1019935555555556,1.1023366666666654,1.1027813333333325,1.103258500000001,1.1038196000000013,1.1030461,1.1025833499999997,1.1023007172054096,1.1025530287879417,-1720,-20859,-21543.6,-0.07594750959753314,-93.5801238060521,-0.17483467705407985
2023-05-08T12:00:00-04:00,1.10197,1.10243,1.10189,1.10242,1.103042245343452,1.1020102222222221,1.1021233333333322,1.1025522222222215,1.1031275000000007,1.1037902000000015,1.1030505000000002,1.1025926999999995,1.1023245737643277,1.1024240230303533,1991,-18868,-21065.4,-0.07918389439730643,-92.76707989378578,-0.1738594997917438
2023-05-08T12:15:00-04:00,1.10242,1.10286,1.1024,1.10267,1.10114,1.1021195555555556,1.1020644444444434,1.1023628888888881,1.103032000000001,1.1037654000000012,1.1030581000000002,1.1025929499999996,1.1023936590114622,1.1023728184242827,1620,-17248,-19586.4,-0.08410021575449737,-92.39970629751564,-0.04804205946337196
2023-05-08T12:30:00-04:00,1.10267,1.10291,1.1025099999999999,1.10266,1.1011744,1.1022386666666668,1.102074444444443,1.1022299999999992,1.102946500000001,1.1037396000000013,1.1030645000000003,1.1025918999999997,1.1024469272091697,1.1023698547394263,-1283,-18531,-18929,-0.08071388791751619,-92.4113416916046,0.008162747036462399
2023-05-08T12:45:00-04:00,1.10266,1.10276,1.10244,1.1027,1.1012438240000002,1.102363777777778,1.1021277777777767,1.1021453333333326,1.102906500000001,1.1037126000000013,1.1030669000000002,1.1026050499999998,1.1024975417673357,1.102392683791541,1774,-16757,-18452.6,-0.07233083336533264,-92.34698821909261,0.04354847489612201
2023-05-08T13:00:00-04:00,1.1027,1.10291,1.1025099999999999,1.10271,1.1013104710400001,1.1024802222222223,1.1022533333333322,1.1021286666666659,1.102867000000001,1.1036824000000012,1.1030713000000003,1.1026206999999997,1.1025400334138686,1.1024405470332328,1627,-15130,-17306.8,-0.06447952664929725,-92.3322335260663,0.10257993064508028
2023-05-08T13:15:00-04:00,1.10271,1.10277,1.1023,1.10236,1.1013744521984001,1.1025015555555553,1.102363333333332,1.102176666666666,1.1027920000000009,1.1036426000000013,1.1030729000000004,1.1026316499999997,1.1025040267310948,1.1024764376265863,-1430,-16560,-16845.2,-0.052487726524951345,-92.7861153263584,0.08988804852139122
2023-05-08T13:30:00-04:00,1.10236,1.10237,1.10178,1.10179,1.1014358741104642,1.102386888888889,1.102372222222221,1.1022382222222213,1.102692500000001,1.1035956000000013,1.1030641000000003,1.1026351999999995,1.102361221384876,1.102469950101269,-1553,-18113,-17018.2,-0.03974499981217795,-93.58912886095683,0.007261439035688159
2023-05-08T13:45:00-04:00,1.10179,1.1018,1.10132,1.10155,1.10291,1.1022224444444444,1.102314444444443,1.1022862222222216,1.1025855000000009,1.1035430000000013,1.1030474000000003,1.1026388999999996,1.1021989771079008,1.1024203600810152,-1485,-19598,-17231.6,-0.03156930996657045,-93.91260248115671,-0.04718393568465288
2023-05-08T14:00:00-04:00,1.10155,1.10155,1.10049,1.10077,1.1028782000000001,1.1019135555555557,1.10218111111111,1.1022968888888882,1.102416000000001,1.1034798000000015,1.1030228000000002,1.1026316499999997,1.1019131816863206,1.1023034880648122,-3859,-23457,-18571.6,-0.030752645073017407,-96.64513391413752,-0.10889588645787707
2023-05-08T14:15:00-04:00,1.10077,1.10114,1.10065,1.10111,1.1027826720000002,1.1016993333333334,1.1020355555555543,1.1022533333333326,1.1022835000000009,1.1034242000000014,1.1030131,1.1026250499999997,1.1017525453490564,1.1021459904518498,2195,-21262,-19798,-0.02538291439572661,-95.96715395465459,-0.1188294842256057
2023-05-08T14:30:00-04:00,1.10111,1.10111,1.10063,1.1008,1.1026909651200003,1.101452222222222,1.1018277777777765,1.1021462222222216,1.1021285000000012,1.1033480000000013,1.1030060000000002,1.1026142499999996,1.101562036279245,1.10195759236148,-1602,-22864,-21058.8,-0.027295738831898834,-96.41817156415777,-0.1695883627921353
2023-05-08T14:45:00-04:00,1.1008,1.1008499999999999,1.10053,1.10057,1.1026029265152002,1.1012006666666667,1.101595555555554,1.101990888888888,1.1019400000000013,1.1032738000000013,1.1030001,1.1026046999999997,1.1013636290233961,1.101758073889184,-1652,-24516,-22339.4,-0.03196627596775643,-96.76333871532049,-0.18954165381894014
2023-05-08T15:00:00-04:00,1.10057,1.10078,1.10051,1.10072,1.1025184094545921,1.1010255555555555,1.1013755555555542,1.1018031111111104,1.1018160000000012,1.1032008000000013,1.1029914,1.1025955999999997,1.101234903218717,1.101565259111347,1469,-23047,-23029.2,-0.03393328815810817,-96.56312428098208,-0.17955926362565455
2023-05-08T15:15:00-04:00,1.10072,1.10074,1.10023,1.10034,1.1024372730764085,1.1008184444444444,1.101112222222221,1.1015893333333324,1.1017045000000012,1.1031112000000014,1.102976,1.1025837499999998,1.1010559225749736,1.1013938072890777,-1669,-24716,-23281,-0.04299669874562829,-97.13931077709346,-0.21492504829012007
2023-05-08T15:30:00-04:00,1.10034,1.10046,1.10013,1.10036,1.102304836691824,1.1006679999999998,1.1008899999999988,1.1013602222222214,1.101611500000001,1.1030230000000014,1.1029551,1.1025713499999996,1.100916738059979,1.1012266458312623,1517,-23199,-23668.4,-0.05477977648053939,-97.11173748156675,-0.18142893428644016
2023-05-08T15:45:00-04:00,1.10036,1.10049,1.10001,1.10017,1.1021308497564781,1.100524,1.1007099999999985,1.1011366666666658,1.1015410000000014,1.1029376000000013,1.1029304,1.1025613999999997,1.100767390447983,1.10106771666501,-1699,-24898,-24075.2,-0.0658038076464528,-97.40510510670748,-0.14703346372720344
2023-05-08T16:00:00-04:00,1.10017,1.1003,1.10001,1.10026,1.1019187647808304,1.1004340000000001,1.1005666666666651,1.100930888888888,1.1014855000000012,1.1028574000000015,1.1029067000000001,1.1025560499999996,1.1006659123583864,1.100928173332008,1259,-23639,-23899.8,-0.07399135708323831,-97.30211193292533,-0.11710771186056133
2023-05-08T16:15:00-04:00,1.10026,1.10045,1.10019,1.10036,1.1017278883027473,1.1003926666666666,1.1005211111111095,1.1007599999999989,1.1014180000000013,1.1027660000000015,1.1028877,1.1025514499999995,1.1006047298867092,1.1008021386656064,772,-22867,-23863.8,-0.08043209553624277,-97.2319466992533,-0.037246654614499074
2023-05-08T16:30:00-04:00,1.10036,1.10037,1.1002399999999999,1.1003,1.1015560994724725,1.1003484444444445,1.1004311111111096,1.1006237777777765,1.1013295000000014,1.1026812000000015,1.1028679000000001,1.1025446999999995,1.1005437839093675,1.1006997109324854,-422,-23289,-23578.4,-0.07860809921544663,-97.25495735031294,-0.0735621327569432
2023-05-08T16:45:00-04:00,1.1003,1.10045,1.1002399999999999,1.10028,1.1014014895252253,1.100318222222222,1.1003733333333316,1.1005204444444432,1.1012450000000014,1.1025872000000014,1.1028526,1.1025381999999995,1.100491027127494,1.1006145687459883,-629,-23918,-23722.2,-0.07841095660590794,-97.26639059579152,-0.047238372093030154
2023-05-08T17:00:00-04:00,1.10028,1.10029,1.09994,1.09998,1.1012623405727027,1.1002395555555555,1.1003077777777763,1.1004399999999988,1.1011230000000014,1.1024864000000014,1.1028331,1.1025303999999994,1.100388821701995,1.1005388549967907,-64,-23982,-23539,-0.07725877928882623,-97.28384069940151,-0.05360858464251165
2023-05-08T17:15:00-04:00,1.09998,1.10034,1.09997,1.10026,1.1011036597039783,1.10023,1.100256666666665,1.1003779999999987,1.1010025000000012,1.1024196000000013,1.1028186,1.1025241999999995,1.1003630573615961,1.1004782839974325,101,-23881,-23587.4,-0.0707399475494355,-97.2581311410459,-0.04179082782178074
2023-05-08T17:30:00-04:00,1.10026,1.10047,1.10026,1.10039,1.1009640205395008,1.1002566666666667,1.1002622222222205,1.1003262222222208,1.1008890000000013,1.1023714000000013,1.1028048,1.1025175999999994,1.1003684458892768,1.100431027197946,201,-23680,-23750,-0.06388286728108761,-97.2343822089753,0.00454405002089204
2023-05-08T17:45:00-04:00,1.10039,1.1004099999999999,1.10028,1.10037,1.1008411380747607,1.100278222222222,1.1002633333333316,1.1002926666666653,1.1007725000000013,1.1023198000000014,1.1027909,1.1025121999999994,1.1003687567114215,1.100396021758357,-2334,-26014,-24295,-0.05371104521774592,-97.27680353232411,0.0009087934857742477
2023-05-08T18:00:00-04:00,1.10037,1.1004099999999999,1.10027,1.10034,1.1007330015057895,1.1002935555555555,1.1002822222222206,1.1002744444444432,1.1006540000000014,1.1022614000000015,1.1027741999999998,1.1025066999999993,1.1003630053691373,1.1003704174066855,-225,-26239,-24759.2,-0.04368875128217291,-97.28293783260492,0.015452157393857628
2023-05-08T18:15:00-04:00,1.10034,1.10034,1.10027,1.1003,1.1006378413250948,1.100297111111111,1.1002866666666649,1.1002702222222207,1.1005510000000016,1.1021954000000014,1.1027567999999999,1.1025018499999992,1.1003504042953098,1.1003627339253486,-546,-26785,-25319.8,-0.03208531162471295,-97.30278624309624,0.0036355043353425557
2023-05-08T18:30:00-04:00,1.1003,1.10034,1.10012,1.10012,1.1005541003660835,1.1002637777777777,1.1002599999999982,1.1002708888888875,1.1004675000000015,1.1021104000000015,1.1027371999999998,1.1024954499999995,1.100304323436248,1.1003509871402788,-534,-27319,-26007.4,-0.023668239645480597,-97.39014423637083,-0.02181104365844069
2023-05-08T18:45:00-04:00,1.10012,1.10017,1.1001,1.10011,1.1004804083221535,1.100233777777778,1.1002388888888872,1.1002662222222208,1.1003955000000014,1.1020266000000014,1.102718,1.1024911999999993,1.1002654587489984,1.100330389712223,-477,-27796,-26830.6,-0.018672007048214385,-97.39448012700097,-0.017268017813335864
2023-05-08T19:00:00-04:00,1.10011,1.1002399999999999,1.10001,1.1000699999999999,1.1004155593234952,1.1002,1.100215555555554,1.1002566666666653,1.1003605000000014,1.1019358000000015,1.1026983,1.1024866499999992,1.1002263669991987,1.1003019117697785,-450,-28246,-27277,-0.014358676093702206,-97.41084212716461,-0.019086050823430716
2023-05-08T19:15:00-04:00,1.1000699999999999,1.1000699999999999,1.09962,1.09967,1.1003584922046759,1.100090888888889,1.1001811111111095,1.100236444444443,1.1002885000000013,1.1018336000000013,1.1026772999999999,1.1024784999999993,1.1001150935993589,1.100252329415823,-566,-28812,-27791.6,-0.015142676120725949,-97.61664721229553,-0.028182330587831823
2023-05-08T19:30:00-04:00,1.09967,1.09981,1.09964,1.09971,1.1002551032960213,1.0999966666666667,1.1001199999999984,1.1002031111111097,1.1002340000000015,1.1017270000000012,1.1026593999999998,1.1024704999999992,1.100034074879487,1.1001890635326583,534,-28278,-28090.2,-0.0115383882957648,-97.59722320327462,-0.049988184610914733
2023-05-08T19:45:00-04:00,1.09971,1.09977,1.09952,1.09965,1.1001661888345784,1.0999026666666667,1.1000377777777761,1.1001586666666654,1.1001880000000015,1.1016284000000012,1.1026396,1.1024617499999991,1.0999572599035896,1.1001196508261266,-616,-28894,-28405.2,-0.012105955896604364,-97.63083206379237,-0.067248884486406
2023-05-08T20:00:00-04:00,1.09965,1.09975,1.09858,1.09867,1.1000627986210458,1.0996291111111112,1.0998488888888873,1.1000806666666654,1.1000855000000014,1.1015144000000012,1.1026080999999999,1.1024496999999993,1.0996998079228717,1.1000065206609013,-2874,-31768,-29199.6,-0.019517427387529165,-100.19211974623673,-0.15449348855385323
2023-05-08T20:15:00-04:00,1.09867,1.09899,1.0985,1.09872,1.0997958948692577,1.0994033333333333,1.0996688888888873,1.099971333333332,1.1000045000000014,1.1014188000000014,1.1025747,1.1024356999999994,1.0995038463382973,1.099862016528721,3040,-28728,-29296,-0.025860990466444515,-100.05377065142241,-0.14722722067726127
2023-05-08T20:30:00-04:00,1.09872,1.09882,1.0986,1.09867,1.09975,1.0992035555555555,1.0994877777777763,1.0998326666666653,1.0999200000000013,1.1013222000000014,1.102541,1.1024197999999994,1.0993370770706379,1.099706413222977,-2058,-30786,-29690.8,-0.033815668027227436,-100.14742508567296,-0.14814141597746253
2023-05-08T20:45:00-04:00,1.09867,1.09912,1.09863,1.09898,1.0995,1.099102,1.0993611111111095,1.0996808888888876,1.0998605000000015,1.1012246000000012,1.1025126,1.1024039999999993,1.0992656616565104,1.0995527305783817,1747,-29039,-29843,-0.039844345982141934,-99.65449272199683,-0.10362505908445614
2023-05-08T21:00:00-04:00,1.09898,1.09949,1.0988499999999999,1.09943,1.0985,1.0991157777777778,1.099285555555554,1.0995304444444431,1.0998190000000014,1.1011376000000013,1.1024862,1.1023910999999993,1.0992985293252082,1.0994209844627054,1178,-27861,-29636.4,-0.0429153331394086,-99.17213635518414,-0.061812000618121275
2023-05-08T21:15:00-04:00,1.09943,1.09948,1.09896,1.09923,1.0985198,1.0991046666666666,1.0991922222222206,1.0993991111111097,1.0997625000000013,1.1010484000000011,1.1024553,1.1023756999999994,1.0992848234601666,1.0993379875701643,-1422,-29283,-29139.4,-0.04645904568014585,-99.43081585274193,-0.07635877716872126
2023-05-08T21:30:00-04:00,1.09923,1.09941,1.09883,1.09892,1.0985392040000002,1.0990502222222223,1.0991088888888876,1.0992871111111098,1.0996935000000012,1.1009436000000012,1.1024228999999999,1.1023588999999994,1.0992118587681332,1.0992795900561316,-1254,-30537,-29501.2,-0.05068378729355816,-99.78446340602926,-0.06820227886548041
2023-05-08T21:45:00-04:00,1.09892,1.099,1.09869,1.09875,1.0985582199200001,1.0989784444444441,1.0990022222222207,1.0991899999999988,1.0996170000000014,1.1008434000000014,1.1023862,1.1023411999999995,1.0991194870145065,1.0992360720449053,-1369,-31906,-29725.2,-0.05234139738155376,-99.99624406340196,-0.0872957416046114
2023-05-08T22:00:00-04:00,1.09875,1.09892,1.09848,1.09871,1.09949,1.09892,1.0988977777777762,1.099097333333332,1.0995535000000012,1.1007396000000012,1.1023538,1.1023247999999994,1.0990375896116051,1.0991904576359244,-1107,-33013,-30520,-0.05464021774673869,-100.0365444046987,-0.08548174419132823
2023-05-08T22:15:00-04:00,1.09871,1.09906,1.0987,1.09906,1.0994698,1.0989524444444445,1.0989411111111094,1.0990284444444431,1.0994935000000012,1.1006340000000012,1.102322,1.1023088999999995,1.0990420716892841,1.0991391661087395,1123,-31890,-31325.8,-0.0560239375006042,-99.67880669411099,0.03549746511690411
2023-05-08T22:30:00-04:00,1.09906,1.09926,1.09897,1.09901,1.0994500040000001,1.098966222222222,1.0989733333333318,1.0989846666666654,1.0994245000000011,1.1005502000000011,1.1022836999999999,1.1022899999999995,1.0990356573514273,1.0990893328869915,-1245,-33135,-32096.2,-0.04752071126883094,-99.73544600406663,0.026394349788856443
2023-05-08T22:45:00-04:00,1.09901,1.09922,1.099,1.09905,1.0994306039200001,1.0989815555555555,1.099015555555554,1.0989659999999986,1.0993585000000012,1.1004798000000011,1.1022429,1.1022727999999995,1.099038525881142,1.0990546663095935,818,-32317,-32452.2,-0.038717853872734485,-99.70567375449653,0.034587273703664156
2023-05-08T23:00:00-04:00,1.09905,1.09906,1.0988,1.09901,1.0994115918416,1.0989804444444444,1.0990188888888874,1.0989693333333321,1.0992920000000013,1.100415600000001,1.1022036,1.1022523999999996,1.0990328207049136,1.0990373330476748,-1005,-33322,-32735.4,-0.02973640507006789,-99.74225079830713,0.0027298040000704733
2023-05-08T23:15:00-04:00,1.09901,1.09912,1.0988,1.09894,1.099392960004768,1.0989646666666668,1.0989644444444429,1.0989826666666653,1.0992240000000013,1.100362800000001,1.1021604999999999,1.1022308999999995,1.099014256563931,1.09903266643814,-1030,-34352,-33003.2,-0.02403748270506761,-99.80785529690132,-0.04456854915727963
2023-05-08T23:30:00-04:00,1.09894,1.09912,1.09892,1.09901,1.0993747008046726,1.0989737777777777,1.0989399999999985,1.0989824444444432,1.0991685000000013,1.100315600000001,1.1021145999999997,1.1022076999999997,1.0990134052511447,1.099026933150512,905,-33447,-33314.6,-0.022271328988827797,-99.75020883758597,-0.020014009806854523
2023-05-08T23:45:00-04:00,1.09901,1.0994,1.09895,1.09936,1.09848,1.0990577777777777,1.0989888888888872,1.0989855555555543,1.0991310000000012,1.100268600000001,1.1020762999999998,1.1021867999999997,1.0990827242009158,1.0990363465204098,1129,-32318,-33151.2,-0.01779685505139986,-99.3906579690772,0.04003931132384486
2023-05-09T00:00:00-04:00,1.09936,1.09953,1.09925,1.09927,1.0984984,1.099114,1.0990466666666652,1.0989917777777767,1.0990910000000012,1.100212600000001,1.1020334999999999,1.1021665999999997,1.0991201793607326,1.0990526772163278,-939,-33257,-33339.2,-0.010973971368876964,-99.46752996733066,0.0473265073947737
2023-05-09T00:15:00-04:00,1.09927,1.09938,1.09915,1.09926,1.098539664,1.0991566666666668,1.0991077777777762,1.0990095555555544,1.0990705000000012,1.1001584000000009,1.1019889999999999,1.1021477999999996,1.0991481434885861,1.099075741773062,-843,-34100,-33494.8,-0.0028248244882700885,-99.47519869293953,0.05005870520882019
2023-05-09T00:30:00-04:00,1.09926,1.09943,1.09918,1.09932,1.09857927744,1.0991991111111112,1.099136666666665,1.0990439999999988,1.099051000000001,1.100096400000001,1.1019432999999998,1.1021294499999996,1.099182514790869,1.0991093934184497,1020,-33080,-33240.4,0.004241633605165953,-99.41952487600798,0.02365657925865276
2023-05-09T00:45:00-04:00,1.09932,1.09943,1.09883,1.09887,1.0986173063424,1.099145777777778,1.0991211111111094,1.0990802222222211,1.0990120000000012,1.1000204000000011,1.1018929,1.1021082999999996,1.0991200118326951,1.0991307147347598,-784,-33864,-33323.8,0.006152542321469655,-99.74045053914524,-0.01273873759110736
2023-05-09T01:00:00-04:00,1.09887,1.09899,1.09844,1.09864,1.09953,1.0990495555555555,1.0990755555555538,1.0990975555555544,1.099010500000001,1.099940000000001,1.1018397999999998,1.1020838499999996,1.099024009466156,1.0991189717878078,-1465,-35329,-33926,0.007162392629093086,-100.04708371686411,-0.03730494517993007
2023-05-09T01:15:00-04:00,1.09864,1.09925,1.09863,1.0992,1.0995081999999998,1.0990744444444445,1.0990966666666653,1.0991075555555543,1.099034500000001,1.099870000000001,1.1017913,1.1020601999999997,1.0990592075729249,1.0991067774302463,1640,-33689,-34012.4,0.006230661875665342,-99.21114109689776,0.017288286730777012
2023-05-09T01:30:00-04:00,1.0992,1.09942,1.099,1.09924,1.0994868359999999,1.0991031111111111,1.0991299999999984,1.099111999999999,1.099063000000001,1.099800600000001,1.1017415,1.1020359499999997,1.0990953660583398,1.099096221944197,1556,-32133,-33619,0.006070209051737396,-99.15451809835331,0.02729903361420705
2023-05-09T01:45:00-04:00,1.09924,1.09944,1.09906,1.09942,1.09946589928,1.099161111111111,1.099175555555554,1.0991197777777768,1.0990850000000012,1.099741800000001,1.1016921999999998,1.1020109999999996,1.099160292846672,1.0990917775553577,1427,-30706,-33144.2,0.007187829821299646,-98.92084756234652,0.037306302945380065
2023-05-09T02:00:00-04:00,1.09942,1.09967,1.09905,1.0995,1.09844,1.099226,1.0991911111111097,1.0991337777777768,1.0990885000000012,1.099696000000001,1.1016458,1.1019874499999995,1.0992282342773376,1.0991134220442862,2282,-28424,-32056.2,0.009392925844415704,-98.75479637171904,0.012734681996800775
2023-05-09T02:15:00-04:00,1.0995,1.09992,1.0993,1.09966,1.0984646,1.099319777777778,1.0992344444444428,1.0991655555555546,1.0991100000000011,1.099658200000001,1.1016005999999998,1.1019636999999998,1.0993145874218702,1.0991715376354292,2264,-26160,-30222.4,0.011125827125944555,-98.42533752678919,0.035478090005195494
2023-05-09T02:30:00-04:00,1.09966,1.1000699999999999,1.0996299999999999,1.09967,1.098522816,1.0994068888888888,1.0992799999999985,1.0992022222222213,1.0991475000000013,1.099636200000001,1.101558,1.1019408999999998,1.0993856699374962,1.0992368301083435,2236,-23924,-28269.4,0.01285857688306821,-98.40500396914442,0.03729781853246925
2023-05-09T02:45:00-04:00,1.09967,1.09972,1.09872,1.09941,1.09861564704,1.099432888888889,1.0992899999999983,1.0992342222222213,1.0991805000000012,1.099602200000001,1.1015132,1.1019170999999999,1.099390535949997,1.0992958640866748,-3620,-27544,-27351.6,0.012100149204861953,-99.26089710072002,0.008186879161656613
2023-05-09T03:00:00-04:00,1.09941,1.10003,1.09904,1.0995,1.0987029082175999,1.0994748888888888,1.0993599999999983,1.09927111111111,1.0992200000000012,1.099576200000001,1.1014620999999998,1.1018925499999996,1.0994124287599976,1.09934629126934,5382,-22162,-25642.8,0.01048818811676014,-98.8203153341365,0.05733162248490799
2023-05-09T03:15:00-04:00,1.0995,1.09954,1.0980699999999999,1.0983,1.1000699999999999,1.099262888888889,1.0993222222222205,1.099297333333332,1.0991820000000012,1.099530800000001,1.1014023,1.1018622499999997,1.099189943007998,1.099338633015472,-4659,-26821,-25322.2,0.007078894583380252,-103.90517208720551,-0.030947353091095076
2023-05-09T03:30:00-04:00,1.0983,1.09836,1.09725,1.09775,1.10003,1.0989484444444444,1.0991611111111093,1.0992826666666655,1.0991190000000013,1.099471400000001,1.1013361,1.1018296999999997,1.0989019544063985,1.0992561064123776,-4577,-31398,-26369.8,0.004657431809795878,-106.19721433431489,-0.1319141193595298
2023-05-09T03:45:00-04:00,1.09775,1.09788,1.09751,1.0977999999999999,1.0999188,1.0986762222222224,1.0990011111111093,1.0992268888888876,1.0990565000000012,1.099420600000001,1.1012659,1.1017987999999996,1.0986815635251188,1.0991152851299022,3152,-28246,-27234.2,-0.00283793280641786,-106.05364794852612,-0.1309995997234551
2023-05-09T04:00:00-04:00,1.0977999999999999,1.09862,1.09762,1.09773,1.099812048,1.098422,1.0988133333333314,1.0991315555555543,1.0989925000000011,1.099368000000001,1.1011955,1.1017697499999997,1.098491250820095,1.0989354281039216,-3618,-31864,-28098.2,-0.010858421949786779,-106.2843457076801,-0.1537174146368057
2023-05-09T04:15:00-04:00,1.09773,1.09788,1.09749,1.09767,1.09970956608,1.0981933333333334,1.098609999999998,1.0989815555555542,1.0989290000000014,1.0993180000000011,1.1011278,1.1017422999999997,1.098327000656076,1.0987183424831375,-2783,-34647,-30595.2,-0.020977124058402,-106.43645961547207,-0.16643929058663015
2023-05-09T04:30:00-04:00,1.09767,1.098,1.09749,1.09781,1.0996111834368,1.0980333333333334,1.0984044444444425,1.0987979999999986,1.0988690000000012,1.099269000000001,1.1010632,1.1017131499999997,1.0982236005248607,1.09852507398651,2748,-31899,-31610.8,-0.03146072674279754,-106.08597176393192,-0.16823381772549054
2023-05-09T04:45:00-04:00,1.09781,1.09798,1.09741,1.09787,1.099516736099328,1.0979264444444443,1.0982044444444423,1.0986066666666654,1.0987945000000012,1.099219200000001,1.1009926,1.1016798499999998,1.0981528804198886,1.0983752591892082,3000,-28899,-31111,-0.042812103877528075,-105.92200896526927,-0.16368546927714894
2023-05-09T05:00:00-04:00,1.09787,1.09843,1.09786,1.09811,1.099426066655355,1.0979075555555555,1.098059999999998,1.0984184444444431,1.0987365000000011,1.099175400000001,1.1009282999999999,1.1016532999999997,1.098144304335911,1.0982678073513665,2670,-26229,-30707.6,-0.05159486868338983,-105.33833330239476,-0.11824524062907185
2023-05-09T05:15:00-04:00,1.09811,1.09837,1.09776,1.09832,1.0993390239891407,1.0979595555555557,1.097928888888887,1.0982415555555542,1.0986895000000012,1.0991362000000011,1.1008617,1.1016264499999997,1.0981794434687286,1.0982054458810933,2388,-23841,-29103,-0.057400300350408905,-104.88165774165849,-0.1073215097771677
2023-05-09T05:30:00-04:00,1.09832,1.09833,1.09782,1.09797,1.0992554630295752,1.0979677777777777,1.0978922222222203,1.098097999999999,1.098622000000001,1.0990960000000012,1.1007912,1.1015996999999997,1.098137554774983,1.0981675567048748,-1966,-25807,-27335,-0.06573837453234757,-105.5081600360719,-0.030046435400178775
2023-05-09T05:45:00-04:00,1.09797,1.09842,1.09796,1.09842,1.0991752445083922,1.0980733333333332,1.0979666666666648,1.098010444444443,1.098599500000001,1.099059200000001,1.1007394,1.1015783499999998,1.0981940438199864,1.0981616453638998,1731,-24076,-25770.4,-0.06074762709322442,-104.79871442280368,0.061033933044859795
2023-05-09T06:00:00-04:00,1.09842,1.09843,1.09789,1.09792,1.0990982347280565,1.098064,1.0979799999999982,1.0979655555555543,1.0985635000000014,1.099009800000001,1.1006905999999999,1.1015539499999998,1.098139235055989,1.0981589162911198,-1739,-25815,-25153.6,-0.055084740252552826,-105.59030598158803,0.010930952814731283
2023-05-09T06:15:00-04:00,1.09792,1.0984099999999999,1.09784,1.0982399999999999,1.0990243053389341,1.0981159999999999,1.0980366666666648,1.0979608888888877,1.098515500000001,1.098967200000001,1.1006434999999999,1.1015317499999997,1.0981593880447913,1.098161933032896,2153,-23662,-24640.2,-0.049346518413264207,-104.96279213722804,0.04645951190181451
2023-05-09T06:30:00-04:00,1.0982399999999999,1.09827,1.09772,1.09796,1.0989533331253767,1.0981006666666666,1.0980688888888872,1.0979888888888876,1.0984515000000012,1.0989196000000012,1.1005905,1.1015066999999998,1.098119510435833,1.098149946426317,-1733,-25395,-24951,-0.041880036951177826,-105.40462634468699,0.026419597875511174
2023-05-09T06:45:00-04:00,1.09796,1.09829,1.09786,1.09796,1.0988851998003617,1.0980788888888888,1.0980855555555538,1.0980275555555543,1.0983785000000013,1.098872800000001,1.1005341,1.1014825,1.0980876083486664,1.0981399571410537,0,-25395,-24868.6,-0.03369316932982539,-105.40462634468699,0.0136635665552413
2023-05-09T07:00:00-04:00,1.09796,1.09826,1.09786,1.09787,1.0988197918083473,1.0980357777777776,1.0980855555555538,1.0980513333333322,1.098297000000001,1.0988278000000011,1.1004691,1.1014579,1.0980440866789332,1.0981099657128428,-1656,-27051,-25463.6,-0.026429151145587373,-105.54036899469267,0
2023-05-09T07:15:00-04:00,1.09787,1.09788,1.09737,1.09741,1.0987570001360134,1.0979006666666666,1.0980077777777761,1.0980568888888877,1.098184500000001,1.098773800000001,1.1004002,1.10143125,1.0979172693431465,1.0980655725702744,-1687,-28738,-26048.2,-0.021558013037976703,-106.24721042400564,-0.06374589066668393
2023-05-09T07:30:00-04:00,1.09741,1.09742,1.09638,1.0965,1.0986967201305728,1.097599111111111,1.097805555555554,1.0980106666666656,1.098026000000001,1.0987024000000012,1.1003190999999999,1.1013996,1.097633815474517,1.0979604580562197,-3050,-31788,-27673.4,-0.022519328765304072,-108.77634720971007,-0.1657076261927246
2023-05-09T07:45:00-04:00,1.0965,1.09653,1.09589,1.09635,1.0985577169227385,1.0973080000000002,1.0976255555555539,1.097921999999999,1.0978730000000012,1.098636000000001,1.1002347999999997,1.1013677,1.0973770523796136,1.0978119664449757,-2676,-34464,-29487.2,-0.026065983804425288,-109.14242108111932,-0.14754501489111313
2023-05-09T08:00:00-04:00,1.09635,1.09647,1.09584,1.09617,1.0983442995689194,1.097016888888889,1.097375555555554,1.0977799999999989,1.097706500000001,1.098565200000001,1.1001460999999997,1.1013339,1.0971356419036908,1.0976215731559806,-2960,-37424,-31893,-0.028412011470657486,-109.62839727485266,-0.2048396788113712
2023-05-09T08:15:00-04:00,1.09617,1.09647,1.09586,1.0962399999999999,1.0980938696120275,1.0967897777777778,1.0971888888888874,1.0976006666666658,1.097603500000001,1.098497000000001,1.1000626999999998,1.10129975,1.0969565135229526,1.0974040585247846,4247,-33177,-33118.2,-0.03413394231851365,-109.35718934177739,-0.15301661323230525
2023-05-09T08:30:00-04:00,1.0962399999999999,1.09671,1.09586,1.0962,1.0978684826508247,1.096592,1.0969622222222208,1.0973915555555547,1.097526000000001,1.098447600000001,1.0999809999999999,1.10126785,1.0968052108183621,1.0971816468198277,-3818,-36995,-34769.6,-0.04069719766386294,-109.49650190107033,-0.18575174825173185
2023-05-09T08:45:00-04:00,1.0962,1.09633,1.09497,1.095,1.0976656343857423,1.0961995555555555,1.096633333333332,1.0971571111111103,1.097386000000001,1.098373200000001,1.0998959999999998,1.1012304499999999,1.0964441686546897,1.096943717455862,-3622,-40617,-36535.4,-0.058293325557409584,-113.461471797075,-0.269590877627607
2023-05-09T09:00:00-04:00,1.095,1.09528,1.09431,1.09472,1.0973421582594531,1.0958168888888888,1.0962733333333317,1.096886666666666,1.0972355000000011,1.0982942000000009,1.0998081999999998,1.1011921999999998,1.0960993349237518,1.0966881739646899,-5026,-45643,-38771.2,-0.07446260031490103,-114.74665901168714,-0.2950927174031961
2023-05-09T09:15:00-04:00,1.09472,1.09482,1.0941,1.09464,1.0969176561031297,1.0954902222222223,1.095914444444443,1.0965944444444438,1.097084000000001,1.0982074000000008,1.099716,1.1011547499999998,1.0958074679390015,1.096422539171752,-4068,-49711,-41228.6,-0.09132202080355822,-115.04394050832502,-0.29420605354002244
2023-05-09T09:30:00-04:00,1.09464,1.0956299999999999,1.09433,1.09538,1.096466831126629,1.0953833333333334,1.0956888888888874,1.0962944444444436,1.0969625000000012,1.0981264000000008,1.099632,1.1011245499999998,1.0957219743512012,1.0961756313374018,5151,-44560,-43505.2,-0.10408880299830389,-111.56175458418575,-0.18498100071987464
2023-05-09T09:45:00-04:00,1.09538,1.09635,1.09537,1.09619,1.0941,1.0954835555555555,1.095654444444443,1.096032888888888,1.0968785000000012,1.0980656000000009,1.099557,1.10110085,1.095815579480961,1.0959777050699215,4580,-39980,-44102.2,-0.10818547420843494,-108.17498469611047,-0.028271773825812353
2023-05-09T10:00:00-04:00,1.09619,1.09632,1.09548,1.09551,1.0941450000000001,1.0954546666666667,1.0955611111111097,1.0958184444444434,1.096748500000001,1.0979974000000008,1.0994704999999998,1.10107195,1.0957544635847687,1.0958397640559372,-3359,-43339,-44646.6,-0.10697657456146925,-110.25867456739195,-0.07661786838144315
2023-05-09T10:15:00-04:00,1.09551,1.09645,1.09543,1.0964,1.0941891000000001,1.0956224444444445,1.0955866666666652,1.09568111111111,1.0966525000000011,1.0979504000000009,1.0993969,1.10104835,1.095883570867815,1.0957966112447497,4089,-39250,-43368,-0.09910396124936395,-106.9367423166592,0.020982146929760206
2023-05-09T10:30:00-04:00,1.0964,1.0964,1.09569,1.09629,1.0942795360000002,1.095763111111111,1.0955922222222205,1.0956166666666656,1.0965685000000012,1.0979020000000008,1.0993207999999997,1.1010436499999998,1.095964856694252,1.0958280889957996,-4142,-43392,-42104.2,-0.08920359853995125,-107.35230233125263,0.0045610450266461286
2023-05-09T10:45:00-04:00,1.09629,1.09629,1.09531,1.09559,1.0943663545600002,1.0957626666666667,1.0955244444444427,1.0955837777777766,1.0964270000000012,1.097832600000001,1.0992332999999999,1.1010336499999998,1.0958898853554015,1.0958616711966398,-5004,-48396,-42871.4,-0.0848049416857389,-110.54744230333996,-0.05564677978471076
2023-05-09T11:00:00-04:00,1.09559,1.09602,1.09544,1.09565,1.0944497003776001,1.0957877777777778,1.095596666666665,1.095572222222221,1.0963135000000013,1.097765400000001,1.0991577999999997,1.1010172999999996,1.0958419082843212,1.095866936957312,4236,-44160,-43707.4,-0.07780078256824599,-110.31545771056366,0.05936073059361091
2023-05-09T11:15:00-04:00,1.09565,1.0957999999999999,1.09539,1.09573,1.0945297123624962,1.0958144444444444,1.095708888888887,1.0956017777777765,1.096188000000001,1.0976990000000009,1.0990893999999998,1.1010029999999997,1.0958195266274569,1.0958799495658496,3209,-40951,-43229.8,-0.06163669533488126,-110.08114930915787,0.09226103478516676
2023-05-09T11:30:00-04:00,1.09573,1.09578,1.09508,1.09555,1.0946065238679963,1.0957826666666668,1.0958099999999984,1.0956464444444431,1.0960675000000013,1.0976298000000009,1.0990226999999997,1.1009892,1.0957656213019655,1.0958563596526796,-2573,-43524,-44084.6,-0.04238615319048908,-110.50382642852138,0.08313235401592911
2023-05-09T11:45:00-04:00,1.09555,1.09565,1.09521,1.09527,1.0946802629132764,1.0956746666666668,1.0957977777777763,1.0956875555555545,1.0959330000000012,1.0975564000000009,1.0989595999999997,1.1009699499999999,1.0956664970415724,1.0957966877221437,-1852,-45376,-44481.4,-0.0249558797077859,-110.97715945759363,-0.010042177144009795
2023-05-09T12:00:00-04:00,1.09527,1.09561,1.09491,1.09555,1.0947510523967452,1.095625111111111,1.0957266666666652,1.095727999999999,1.0958170000000014,1.0974872000000009,1.0989014,1.1009515999999997,1.095643197633258,1.0957473501777149,2142,-43234,-43449,-0.01293548637991537,-110.42956845263583,-0.05838403926326403
2023-05-09T12:15:00-04:00,1.09555,1.0961,1.09548,1.09586,1.0948190103008755,1.095651777777778,1.095765555555554,1.0957617777777766,1.0957395000000012,1.0974172000000009,1.0988428999999997,1.1009280999999997,1.0956865581066064,1.0957162801421718,2103,-41131,-42843.2,-0.007213564978589097,-109.83449748371605,0.031948590154363944
2023-05-09T12:30:00-04:00,1.09586,1.09601,1.09532,1.09556,1.0948842498888405,1.0956106666666667,1.0956722222222206,1.0957544444444434,1.0956925000000013,1.0973430000000008,1.0987777999999997,1.1009054499999997,1.095661246485285,1.0956846241137375,-1912,-43043,-43261.6,0.001282031781364754,-110.35792200874656,-0.07661437431593869
2023-05-09T12:45:00-04:00,1.09556,1.09587,1.09539,1.09552,1.0949468798932869,1.0955802222222222,1.095586666666665,1.095709777777777,1.0956510000000013,1.097268200000001,1.0987132999999998,1.1008797,1.0956329971882282,1.0956580992909901,-2208,-45251,-43607,-0.002490289825392115,-110.43853831456283,-0.07023688987402397
2023-05-09T13:00:00-04:00,1.09552,1.09594,1.09541,1.09572,1.0950070046975553,1.095606888888889,1.0956011111111095,1.0956704444444436,1.0956285000000012,1.0971962000000008,1.0986462999999995,1.1008483999999998,1.0956503977505825,1.095654879432792,2437,-42814,-43094.6,-0.004954638976305567,-109.9936354373904,0.011865752699455405
2023-05-09T13:15:00-04:00,1.09572,1.09647,1.09565,1.09604,1.095064724509653,1.0956946666666667,1.095644444444443,1.095653999999999,1.0956185000000014,1.0971396000000009,1.0985799999999997,1.1008190499999997,1.095728318200466,1.0956719035462334,2007,-40807,-42609.2,-0.00028250294128340383,-109.40750029337573,0.035595308720840636
2023-05-09T13:30:00-04:00,1.09604,1.09625,1.09591,1.09602,1.0951490410390738,1.0957697777777777,1.095676666666665,1.0956362222222213,1.0956095000000012,1.097087200000001,1.0985135999999998,1.1007890499999997,1.0957866545603727,1.095691922836987,-1899,-42706,-42924.2,0.004050696289500078,-109.44215231337485,0.026466374015487522
2023-05-09T13:45:00-04:00,1.09602,1.09646,1.09568,1.09636,1.0952282985767294,1.0959064444444446,1.0957666666666652,1.0956551111111101,1.0956775000000012,1.097030400000001,1.0984501999999998,1.1007585499999997,1.0959013236482982,1.0957399382695896,1979,-40727,-42461,0.009105310851866206,-108.82824015848715,0.07393546620418762
2023-05-09T14:00:00-04:00,1.09636,1.09652,1.0961,1.09646,1.0953028006621257,1.0960451111111111,1.0958988888888874,1.0957175555555547,1.0957645000000011,1.096974800000001,1.0983876999999997,1.1007295,1.0960130589186385,1.0958159506156717,2026,-38701,-41151,0.011064749645927238,-108.6434468424231,0.10864900892017716
2023-05-09T14:15:00-04:00,1.09646,1.0971,1.09645,1.09706,1.0954001766091557,1.0962773333333333,1.0960666666666654,1.0958106666666658,1.0958855000000012,1.096927600000001,1.0983346999999997,1.1007038,1.096222447134911,1.0959303604925374,2205,-36496,-39887.4,0.017229878739013306,-107.43683647816006,0.13783031354113462
2023-05-09T14:30:00-04:00,1.09706,1.09724,1.09676,1.0968,1.09557015894824,1.096424,1.0961711111111099,1.0959159999999992,1.095956500000001,1.0968736000000008,1.0982847999999996,1.1006744499999999,1.0963379577079286,1.09605228839403,-2318,-38814,-39488.8,0.019248726129731667,-107.98619567455755,0.08577738032229855
2023-05-09T14:45:00-04:00,1.0968,1.09695,1.09657,1.09664,1.0957705398744513,1.0965177777777777,1.0962911111111098,1.0960388888888883,1.0959790000000011,1.096813200000001,1.0982356999999998,1.1006415499999997,1.096398366166343,1.096174630715224,-2506,-41320,-39211.6,0.020890024535356638,-108.35176824932036,0.09857972178611575
2023-05-09T15:00:00-04:00,1.09664,1.09692,1.09654,1.09683,1.0959468750895172,1.0966255555555555,1.0964366666666652,1.0961728888888882,1.0960450000000015,1.096756400000001,1.0981962999999997,1.1006095499999997,1.0964846929330745,1.0962913045721794,2056,-39264,-38919,0.029696203708540175,-107.99555290061903,0.1195779173360525
2023-05-09T15:15:00-04:00,1.09683,1.09698,1.09663,1.09666,1.096102050078775,1.0966702222222222,1.0965411111111096,1.0963013333333325,1.0960580000000013,1.0967014000000008,1.0981518,1.1005824499999997,1.0965197543464595,1.0963926436577434,-1312,-40576,-39294,0.03509928941206409,-108.19890255371021,0.0857883400868781
2023-05-09T15:30:00-04:00,1.09666,1.09671,1.09639,1.09645,1.096238604069322,1.096652,1.096586666666665,1.0964053333333323,1.0960660000000013,1.096640400000001,1.0981082999999998,1.1005571499999998,1.0965058034771675,1.0964493149261947,-1203,-41779,-40350.6,0.041542106239519594,-108.42926565622152,0.03740739389073588
2023-05-09T15:45:00-04:00,1.09645,1.09646,1.09613,1.09629,1.09724,1.0965926666666665,1.096616666666665,1.0964944444444433,1.0961010000000013,1.0966002000000008,1.0980654999999997,1.1005327999999999,1.096462642781734,1.0964742519409558,-2165,-43944,-41376.6,0.04382296858795097,-108.74519433513973,0.02463458696009128
2023-05-09T16:00:00-04:00,1.09629,1.09637,1.09623,1.09626,1.0972178,1.0965213333333332,1.096605555555554,1.096557333333332,1.0961315000000014,1.0965704000000007,1.0980208999999999,1.1005061499999997,1.0964221142253874,1.0964790015527648,-1312,-45256,-42163.8,0.04310052705934518,-108.78109724404155,-0.009121091612243148
2023-05-09T16:15:00-04:00,1.09626,1.0964,1.09615,1.09619,1.097196044,1.0964382222222222,1.096575555555554,1.09658511111111,1.0961545000000013,1.0965382000000008,1.0979793999999998,1.1004777,1.09637569138031,1.0964572012422118,-943,-46199,-43550.8,0.03920270456955233,-108.84131106193148,-0.024624701311492664
2023-05-09T16:30:00-04:00,1.09619,1.09628,1.09618,1.09619,1.09717472312,1.0963611111111111,1.0964788888888877,1.0965726666666655,1.0961865000000013,1.0965074000000008,1.0979377,1.1004464,1.096338553104248,1.0964209609937696,0,-46199,-44675.4,0.03474044366288327,-108.84131106193148,-0.07930286401836968
2023-05-09T16:45:00-04:00,1.09619,1.0962,1.09594,1.09604,1.0971538286576,1.0962733333333332,1.0963944444444431,1.0965342222222212,1.0962250000000013,1.0964748000000006,1.0978963999999998,1.1004133999999999,1.0962788424833985,1.0963755687950156,-876,-47075,-45734.6,0.023306053883257027,-108.96118079254394,-0.06929248723560302
2023-05-09T17:00:00-04:00,1.09604,1.09625,1.0959,1.09617,1.097105275511296,1.0962284444444443,1.0963422222222208,1.0964793333333325,1.0962560000000015,1.0964420000000008,1.0978554999999997,1.1003811000000001,1.0962570739867188,1.0963344550360126,113,-46962,-46338.2,0.01364860362448847,-108.94777799702551,-0.04285818500145631
2023-05-09T17:15:00-04:00,1.09617,1.09635,1.09604,1.09621,1.0970329589806183,1.0962020000000001,1.0962733333333319,1.096412888888888,1.0962735000000012,1.0964088000000007,1.0978139999999996,1.1003508499999999,1.096247659189375,1.09629956402881,95,-46867,-46660.4,0.006858856547359437,-108.94431138144583,-0.05652653556157882
2023-05-09T17:30:00-04:00,1.09621,1.0964099999999999,1.09621,1.09637,1.0969649814417812,1.0962213333333333,1.0962411111111097,1.096345999999999,1.0963140000000013,1.0963740000000008,1.0977746999999995,1.1003213,1.0962721273515001,1.0962788512230481,199,-46668,-46754.2,0.0004474012502783338,-108.91526585184837,-0.026443929750323843
2023-05-09T17:45:00-04:00,1.09637,1.0964099999999999,1.09432,1.0946,1.0969010825552743,1.0958931111111112,1.096035555555554,1.0962573333333323,1.0962680000000011,1.096299600000001,1.0977179,1.10028525,1.0959377018812002,1.0961986809784388,-503,-47171,-46948.6,-0.014174088914097917,-109.72731835237286,-0.1687263441105301
2023-05-09T18:00:00-04:00,1.0946,1.09642,1.0946,1.09631,1.0966945959508523,1.0959479999999997,1.0960377777777763,1.096185999999999,1.096297500000001,1.0962664000000009,1.0976811999999996,1.10025715,1.09601216150496,1.096145344782751,841,-46330,-46799.6,-0.01888220967467067,-108.41349595149592,0.0018243348019145462
2023-05-09T18:15:00-04:00,1.09631,1.09661,1.0963,1.0965799999999999,1.09432,1.0960564444444443,1.0960733333333321,1.0961322222222212,1.096324500000001,1.0962296000000007,1.0976443999999999,1.1002315,1.0961257292039681,1.0961190758262007,855,-45475,-46502.2,-0.01997174072528031,-108.20292594848583,0.029190155620005834
2023-05-09T18:30:00-04:00,1.0965799999999999,1.09673,1.09654,1.09665,1.0943658,1.0961717777777777,1.0961244444444431,1.0961024444444434,1.096356000000001,1.0962042000000007,1.0976069999999998,1.1002059,1.0962305833631745,1.0961156606609606,623,-44852,-46099.2,-0.019063429228170604,-108.16315684819217,0.04196352822046406
2023-05-09T18:45:00-04:00,1.09665,1.09669,1.09645,1.09651,1.094460368,1.0962488888888888,1.0961599999999987,1.0960862222222212,1.0963635000000012,1.0961696000000007,1.0975683999999999,1.10017965,1.0962864666905396,1.0961185285287687,-552,-45404,-45846.4,-0.018272531308074248,-108.23362600425828,0.02919201963164214
2023-05-09T19:00:00-04:00,1.09651,1.09662,1.09646,1.09657,1.09455115328,1.0963308888888887,1.0962188888888875,1.0961228888888879,1.096369000000001,1.0961418000000007,1.0975306999999999,1.10015245,1.0963431733524318,1.0961996228230149,516,-44888,-45389.8,-0.015718490052039943,-108.20539096764213,0.04835589941974212
2023-05-09T19:15:00-04:00,1.09657,1.09688,1.09654,1.09676,1.0946383071488002,1.0964391111111111,1.0962844444444433,1.0961722222222214,1.0963540000000012,1.096117800000001,1.0974952999999998,1.10012605,1.0964265386819454,1.096282498258412,510,-44378,-44999.4,-0.01045424497942612,-108.11702451588806,0.05382376821112313
2023-05-09T19:30:00-04:00,1.09676,1.09683,1.09648,1.09652,1.0947728087198723,1.096486222222222,1.0963188888888875,1.0962213333333324,1.096340000000001,1.0960908000000007,1.0974593,1.10009825,1.0964452309455563,1.0963463986067297,-459,-44837,-44871.8,-0.004916694174677375,-108.21746581571665,0.028279253062828517
2023-05-09T19:45:00-04:00,1.09652,1.09654,1.09638,1.09647,1.09489924019668,1.0965164444444446,1.096329999999999,1.0962624444444435,1.0963315000000011,1.0960720000000008,1.0974228999999998,1.10007045,1.0964501847564452,1.0963903188853839,-508,-45345,-44970.4,-0.0011119185068200162,-108.2406300078882,0.009121008418689765
2023-05-09T20:00:00-04:00,1.09647,1.09698,1.09644,1.09692,1.0950180857848792,1.0966344444444445,1.0965877777777766,1.096347999999999,1.096336000000001,1.0960804000000008,1.0973914,1.10004485,1.096544147805156,1.096441855108307,1627,-43718,-44633.2,0.0026885515048544984,-107.57289628056348,0.21194957061939318
2023-05-09T20:15:00-04:00,1.09692,1.09715,1.09682,1.0968499999999999,1.095175038922089,1.0966868888888888,1.0966477777777766,1.0964337777777768,1.096345500000001,1.0960904000000007,1.0973632,1.10002025,1.0966053182441249,1.0964942840866456,-1114,-44832,-44622,0.023124128881817363,-107.64398624154515,0.0492561410549922
2023-05-09T20:30:00-04:00,1.0968499999999999,1.09706,1.0968,1.09703,1.09537253502988,1.096763333333333,1.0966977777777764,1.0965164444444433,1.096374500000001,1.0961076000000007,1.0973364,1.0999979,1.0966902545953,1.0965470272693165,946,-43886,-44523.6,0.02808381189314772,-107.48874167756642,0.0410366776705814
2023-05-09T20:45:00-04:00,1.09703,1.09721,1.09682,1.09692,1.095550281526892,1.0968077777777776,1.0967277777777766,1.096598222222221,1.0964060000000009,1.0961212000000007,1.0973091,1.0999743499999999,1.0967362036762398,1.0966052218154532,-1365,-45251,-44606.4,0.029142983468385623,-107.6256112253455,0.02462043496101696
2023-05-09T21:00:00-04:00,1.09692,1.09734,1.09692,1.09716,1.095749447743665,1.0968942222222222,1.0967999999999987,1.096692222222221,1.0964510000000007,1.0961404000000008,1.097294,1.09995105,1.0968209629409917,1.0966793774523624,1665,-43586,-44254.6,0.03001483586733701,-107.26131847838124,0.05927898514375768
2023-05-09T21:15:00-04:00,1.09716,1.09732,1.09703,1.09721,1.0959721250595518,1.0969762222222221,1.0968711111111098,1.0967488888888879,1.0965020000000008,1.0961846000000006,1.0972789,1.0999268,1.0968987703527935,1.0967503019618898,1076,-42510,-44013,0.0322718916644229,-107.21228278623049,0.05836380714409239
2023-05-09T21:30:00-04:00,1.09721,1.0973,1.09681,1.09698,1.0961636275512145,1.096998,1.0968955555555544,1.0967984444444432,1.096541500000001,1.0962298000000006,1.097262,1.0999015,1.0969150162822348,1.0968122415695118,-1977,-44487,-43944,0.032579117923208376,-107.62670664310374,0.020059083117556165
2023-05-09T21:45:00-04:00,1.09698,1.09741,1.09696,1.09711,1.0963283196940445,1.0970408888888887,1.09696111111111,1.0968511111111099,1.0965950000000009,1.0962792000000008,1.0972432999999997,1.09987795,1.0969540130257878,1.0968649932556094,1338,-43149,-43796.6,0.031774444435740096,-107.46814404396798,0.05380658811513611
2023-05-09T22:00:00-04:00,1.09711,1.09738,1.09711,1.09715,1.0965013885429975,1.0970786666666665,1.0970366666666653,1.0969128888888875,1.0966440000000008,1.0963146000000008,1.0972205,1.09985335,1.0969932104206301,1.0969163946044875,1241,-41908,-43128,0.032697831651741456,-107.42289789727344,0.06201720065300591
2023-05-09T22:15:00-04:00,1.09715,1.0973,1.0970199999999999,1.09722,1.096646766376118,1.0971153333333334,1.0970699999999987,1.0969668888888875,1.096694500000001,1.0963352000000008,1.0972004,1.09982785,1.097038568336504,1.0969599156835899,1177,-40731,-42557,0.03497596623546637,-107.34780333408699,0.027349305327661912
2023-05-09T22:30:00-04:00,1.09722,1.09736,1.09714,1.0973,1.096768883755939,1.0971613333333334,1.0971199999999988,1.0970166666666654,1.096741000000001,1.0963710000000009,1.0971842,1.09980355,1.0970908546692033,1.096998332546872,973,-39758,-42006.6,0.033706465015479546,-107.27686040559512,0.04102657610430428
2023-05-09T22:45:00-04:00,1.0973,1.09749,1.09721,1.09744,1.096871462354989,1.0972253333333333,1.0971655555555544,1.0970706666666654,1.0968830000000012,1.0963918000000008,1.0971711,1.0997786500000002,1.0971606837353627,1.0970474660374976,923,-38835,-40876.2,0.03443865256815268,-107.15909862668322,0.03737363609017269
2023-05-09T23:00:00-04:00,1.09744,1.09761,1.09726,1.09748,1.096982799131091,1.0972882222222222,1.0972277777777766,1.0971239999999987,1.0969415000000011,1.096415600000001,1.0971587999999999,1.0997563000000001,1.0972245469882902,1.097101572829998,1031,-37804,-39807.2,0.026034137409173912,-107.12152026249015,0.05105203661161398
2023-05-09T23:15:00-04:00,1.09748,1.0976,1.09739,1.09759,1.0971082393048728,1.0973606666666667,1.0972755555555544,1.0971717777777763,1.096992000000001,1.096455600000001,1.0971441,1.0997330500000002,1.0972976375906323,1.0971624582639983,636,-37168,-38859.2,0.026583991783379054,-107.05777422611588,0.03919209595684791
2023-05-09T23:30:00-04:00,1.09759,1.09773,1.0975,1.09768,1.0972085914438983,1.0974415555555554,1.0973277777777766,1.097223333333332,1.097043500000001,1.096496200000001,1.0971308,1.09970725,1.0973741100725058,1.0972295666111986,703,-36465,-38006,0.026547996485684663,-107.00012975049206,0.04283592019758938
2023-05-09T23:45:00-04:00,1.09768,1.09768,1.09749,1.09762,1.0973128731551187,1.0975000000000001,1.0973988888888877,1.0972791111111098,1.0970990000000012,1.096534000000001,1.0971165,1.0996797,1.0974232880580046,1.0972960532889589,-794,-37259,-37506.2,0.026073757438053964,-107.0435303772685,0.0583419934729871
2023-05-10T00:00:00-04:00,1.09762,1.09762,1.09743,1.09751,1.097396298524095,1.0975222222222223,1.0974433333333322,1.0973346666666655,1.097146000000001,1.0965732000000008,1.0971015,1.09965255,1.0974406304464037,1.0973520426311674,-562,-37821,-37303.4,0.02656308798500367,-107.09985223729294,0.036459425217157435
2023-05-10T00:15:00-04:00,1.09751,1.09772,1.0974599999999999,1.09765,1.09773,1.0975635555555556,1.097498888888888,1.0973888888888876,1.097190500000001,1.0966208000000008,1.0970886,1.0996245500000001,1.097482504357123,1.0974036341049338,627,-37194,-37181.4,0.026796212072879886,-107.01987118928425,0.04557261996991705
2023-05-10T00:30:00-04:00,1.09765,1.09772,1.09749,1.09752,1.0977246,1.0975677777777777,1.0975322222222212,1.0974402222222213,1.0972405000000012,1.096660200000001,1.0970737000000002,1.0995941500000002,1.0974900034856985,1.097442107283947,-734,-37928,-37333.4,0.02686910868422696,-107.10680236042256,0.02734182752774894
2023-05-10T00:45:00-04:00,1.09752,1.09754,1.09718,1.09721,1.09772,1.0975033333333333,1.0975222222222212,1.09747911111111,1.0972775000000012,1.0966872000000008,1.0970522,1.09956425,1.0974340027885587,1.0974540858271575,-735,-38663,-37773,0.023782637112512686,-107.31440677765416,-0.008201950241494895
2023-05-10T01:00:00-04:00,1.09721,1.09723,1.09695,1.097,1.09772,1.0973988888888888,1.0974733333333324,1.0974939999999989,1.0972815000000014,1.096716000000001,1.0970295,1.0995315,1.097347202230847,1.097438868661726,-858,-39521,-38225.4,0.01874792503432558,-107.47862329044573,-0.0400933080623994
2023-05-10T01:15:00-04:00,1.097,1.09705,1.09659,1.09661,1.0976738,1.0972262222222222,1.0973766666666656,1.0974806666666657,1.0972695000000012,1.0967378000000008,1.0970030000000002,1.099496,1.0971997617846776,1.097390694929381,-1172,-40693,-38799.8,0.012529163831296462,-107.89528691852217,-0.0792725152166715
2023-05-10T01:30:00-04:00,1.09661,1.0967,1.09622,1.09655,1.0975870959999998,1.0970608888888889,1.0972611111111101,1.0974331111111102,1.0972455000000012,1.096754400000001,1.0969753000000002,1.0994593,1.097069809427742,1.0973081559435047,-1424,-42117,-39784.4,0.005355451841308878,-107.97319975900352,-0.09475304986380632
2023-05-10T01:45:00-04:00,1.09655,1.09672,1.09639,1.09665,1.0974503863999998,1.0969386666666667,1.0971466666666658,1.097355999999999,1.0972320000000013,1.0967666000000007,1.0969531000000001,1.0994229999999998,1.0969858475421936,1.097207324754804,1937,-40180,-40234.8,-0.0015623942128991785,-107.79655482717189,-0.09383426863931987
2023-05-10T02:00:00-04:00,1.09665,1.09725,1.0964099999999999,1.09715,1.0973273477599998,1.0969393333333335,1.0970944444444435,1.0972704444444434,1.0972315000000012,1.0967892000000008,1.0969382,1.099389,1.097018678033755,1.0971242598038429,2030,-38150,-40132.2,-0.007390918847900103,-106.87100884622961,-0.04281991946210623
2023-05-10T02:15:00-04:00,1.09715,1.09725,1.09665,1.09669,1.09622,1.0968584444444445,1.0970033333333324,1.0971764444444436,1.0972055000000012,1.0967958000000007,1.0969131,1.0993521999999998,1.096952942427004,1.0970454078430745,-2424,-40574,-40342.8,-0.013827332809065123,-107.88731472965513,-0.07471458118833021
2023-05-10T02:30:00-04:00,1.09669,1.0975,1.09656,1.09739,1.0962406,1.0969357777777777,1.0969744444444436,1.0970959999999992,1.0972260000000011,1.0968144000000006,1.0968946,1.09931805,1.0970403539416032,1.0970135262744596,2163,-38411,-39886.4,-0.015702102727658603,-106.50670580644045,-0.023686967612620322
2023-05-10T02:45:00-04:00,1.09739,1.09752,1.09678,1.09694,1.096290976,1.0969288888888888,1.096909999999999,1.097025777777777,1.097217500000001,1.0968120000000008,1.0968698,1.099281,1.0970202831532825,1.0970036210195677,-2334,-40745,-39612,-0.021999473991641306,-107.46379489965265,-0.052846417377362134
2023-05-10T03:00:00-04:00,1.09694,1.09811,1.09683,1.09766,1.09636471744,1.097078888888889,1.096959999999999,1.0969884444444435,1.097243000000001,1.0968292000000008,1.0968514,1.0992486,1.097148226522626,1.097036096815654,4543,-36202,-38816.4,-0.023109963063096112,-104.48189980967486,0.04101311508280652
2023-05-10T03:15:00-04:00,1.09766,1.09798,1.0974599999999999,1.09792,1.0965043400448,1.097270888888889,1.0970622222222213,1.0969819999999992,1.097278000000001,1.096854800000001,1.0968339999999999,1.0992173,1.0973025812181008,1.0970928774525235,3045,-33157,-37817.8,-0.019980228080104558,-103.7606382168321,0.0838650865998206
2023-05-10T03:30:00-04:00,1.09792,1.09825,1.09749,1.09754,1.096632792841216,1.0973664444444444,1.0971655555555546,1.0970144444444438,1.0972900000000012,1.0968690000000008,1.0968127,1.09918535,1.0973500649744805,1.0971723019620188,-3024,-36181,-36939.2,-0.01644743979760034,-104.80727185134113,0.08480681372592583
2023-05-10T03:45:00-04:00,1.09754,1.09755,1.09627,1.09646,1.09825,1.0972253333333333,1.0971555555555546,1.0970506666666657,1.097241000000001,1.0968650000000009,1.0967832,1.0991482000000001,1.0971720519795845,1.0971986415696149,-3746,-39927,-37242.4,-0.014169617042761453,-108.493406297466,-0.008207560074773013
2023-05-10T04:00:00-04:00,1.09646,1.09648,1.09499,1.09576,1.09825,1.0969462222222224,1.0970566666666657,1.0970799999999994,1.0971550000000012,1.0968512000000008,1.0967457999999999,1.0991039500000002,1.0968896415836675,1.097172513255692,-5450,-45377,-38168.8,-0.014079506679061335,-111.97278539018217,-0.08115624857519131
2023-05-10T04:15:00-04:00,1.09576,1.09614,1.09568,1.09576,1.0981196,1.0966868888888888,1.0969022222222211,1.0970684444444436,1.0970635000000013,1.0968406000000008,1.0967204,1.0990613500000002,1.0966637132669341,1.0970756106045534,0,-45377,-40003.8,-0.014727291194075197,-111.97278539018217,-0.12669188351638355
2023-05-10T04:30:00-04:00,1.09576,1.09591,1.09539,1.09551,1.097994416,1.0964084444444444,1.09677111111111,1.0970102222222216,1.0969550000000012,1.0968256000000007,1.096698,1.09901705,1.0964329706135474,1.096901688483643,-3244,-48621,-43096.6,-0.020649587312116174,-112.71291096512583,-0.10759649490739943
2023-05-10T04:45:00-04:00,1.09551,1.09577,1.0951,1.0951899999999999,1.0978742393599998,1.096092222222222,1.0965266666666655,1.0968824444444438,1.0968335000000011,1.0968056000000008,1.0966719,1.0989689,1.0961843764908379,1.0966685507869145,-2736,-51357,-46131.8,-0.023517112965052447,-113.51210038375301,-0.20047567409947253
2023-05-10T05:00:00-04:00,1.0951899999999999,1.09542,1.09477,1.09489,1.0977588697855998,1.095764888888889,1.0962988888888878,1.0967111111111103,1.0967025000000015,1.0967796000000007,1.0966435,1.0989195,1.0959255011926703,1.0964192406295314,-2542,-53899,-48926.2,-0.03446140860625869,-114.2084179176968,-0.18688351231608905
2023-05-10T05:15:00-04:00,1.09489,1.09552,1.09489,1.09548,1.0975795375984638,1.095601111111111,1.0960566666666656,1.0965111111111103,1.0965940000000014,1.0967684000000009,1.0966216,1.0988747000000003,1.0958364009541361,1.0962085925036251,2157,-51742,-50199.2,-0.03896301835078942,-113.04608197527318,-0.1986043037006059
2023-05-10T05:30:00-04:00,1.09548,1.09562,1.09527,1.09549,1.097410965342556,1.0954877777777776,1.0957866666666656,1.096287999999999,1.0964925000000014,1.096754800000001,1.0965984,1.0988308,1.0957671207633088,1.0960292740029,2234,-49508,-51025.4,-0.04937602513879149,-113.02568908813682,-0.22132760128241877
2023-05-10T05:45:00-04:00,1.09549,1.09592,1.09537,1.09566,1.0972525074220028,1.0954624444444445,1.0955777777777767,1.0960493333333325,1.0964150000000012,1.096743800000001,1.0965763000000002,1.0987844500000001,1.0957456966106471,1.0958918192023201,2113,-47395,-50780.2,-0.061913938062605006,-112.69779015706487,-0.1712921624724276
2023-05-10T06:00:00-04:00,1.09566,1.09605,1.09556,1.09582,1.0971035569766825,1.095510888888889,1.0955066666666657,1.0958453333333327,1.0963560000000014,1.096732800000001,1.0965534000000001,1.09874085,1.0957605572885176,1.095807055361856,2594,-44801,-49469,-0.0715684247649845,-112.31898651359899,-0.05836966236798186
2023-05-10T06:15:00-04:00,1.09582,1.09594,1.09549,1.09556,1.0969635435580816,1.0955215555555557,1.0954844444444434,1.0956824444444435,1.0963035000000014,1.096752000000001,1.0965258000000002,1.09869375,1.095720445830814,1.0957660442894848,-1913,-46714,-48032,-0.07352749549572872,-112.77287492592936,-0.018252172008466995
2023-05-10T06:30:00-04:00,1.09556,1.09559,1.09513,1.09542,1.0968319309445966,1.0955086666666667,1.0954466666666653,1.0955604444444436,1.0962470000000013,1.096734200000001,1.0965003000000002,1.09864575,1.0956603566646512,1.095730835431588,-1846,-48560,-47395.6,-0.07146366286456458,-113.00877254906278,-0.031028692414397947
2023-05-10T06:45:00-04:00,1.09542,1.09555,1.09522,1.09547,1.0967082150879208,1.0955133333333333,1.095442222222221,1.0954915555555547,1.0961880000000013,1.096712000000001,1.0964708,1.0986051,1.095622285331721,1.0957018683452702,1953,-46607,-46815.4,-0.06942100509938888,-112.9196286590482,-0.003651267446215918
2023-05-10T07:00:00-04:00,1.09547,1.09551,1.09459,1.09469,1.0965919221826457,1.0953628888888889,1.0953866666666654,1.0954533333333323,1.0960650000000014,1.096672800000001,1.0964385,1.0985645499999999,1.0954358282653769,1.0956398946762163,-2723,-49330,-47202.4,-0.06839296303615118,-114.85846769617382,-0.04565417872697386
2023-05-10T07:15:00-04:00,1.09469,1.09501,1.0945799999999999,1.09492,1.096431768408034,1.0952695555555556,1.095389999999999,1.095429999999999,1.0959765000000012,1.0966410000000009,1.0964053,1.0985243999999998,1.0953326626123014,1.0955543157409733,2518,-46812,-47604.6,-0.061174250159228144,-114.32942294377827,0.0027400012786649337
2023-05-10T07:30:00-04:00,1.09492,1.09521,1.09466,1.09513,1.0962465915672306,1.0952175555555557,1.0953511111111098,1.0954033333333322,1.0958635000000014,1.096612200000001,1.096377,1.0984837499999998,1.095292130089841,1.0954686525927786,1874,-44938,-47249.4,-0.05221019993342607,-113.96999942425165,-0.03194946507467708
2023-05-10T07:45:00-04:00,1.09513,1.0953,1.0948499999999999,1.09491,1.0960799324105075,1.0951293333333334,1.0952866666666656,1.0953713333333321,1.0957620000000012,1.0965752000000009,1.0963465,1.0984402999999998,1.0952157040718729,1.0953797220742227,-2660,-47598,-47057,-0.04664051819515617,-114.50436520730909,-0.052944344539888534
2023-05-10T08:00:00-04:00,1.09491,1.09513,1.09469,1.09496,1.0959299391694568,1.0950639999999998,1.0952088888888876,1.0953246666666654,1.095627000000001,1.0965440000000009,1.0963174,1.0983932499999998,1.0951645632574982,1.0952881776593784,2763,-44835,-46702.6,-0.042876637317370014,-114.37819045322001,-0.06388843254295538
2023-05-10T08:15:00-04:00,1.09496,1.09508,1.09416,1.09455,1.095794945252511,1.094932222222222,1.0950677777777764,1.0952608888888877,1.0954585000000012,1.096505600000001,1.0962888,1.0983444999999998,1.0950416506059986,1.0952093421275026,-3400,-48235,-46483.6,-0.03949652042044938,-115.65129632010107,-0.11589494625030611
2023-05-10T08:30:00-04:00,1.09455,1.09969,1.09455,1.09941,1.09416,1.0958006666666664,1.0954955555555541,1.0952819999999988,1.0955520000000012,1.0965554000000008,1.0963178999999998,1.0983184999999995,1.095915320484799,1.0953258737020022,21404,-26831,-42487.4,-0.013203770071841255,-20.61366441657738,0.3514184526634697
2023-05-10T08:45:00-04:00,1.09941,1.10057,1.09866,1.10008,1.09416,1.0967175555555555,1.096013333333332,1.0954144444444431,1.0957330000000012,1.0966200000000008,1.0963551999999999,1.0982949999999996,1.096748256387839,1.0956170989616019,9799,-17032,-36906.2,0.017009167741513048,-14.64197960381463,0.4254076062149574
2023-05-10T09:00:00-04:00,1.10008,1.10064,1.09895,1.09985,1.0944164,1.0974848888888888,1.0964999999999985,1.0956571111111097,1.0959375000000011,1.0966764000000009,1.0963919999999998,1.0982690499999999,1.0973686051102711,1.0960476791692817,-8455,-25487,-32484,0.04269914936274268,-16.40971467762708,0.3998283841638795
2023-05-10T09:15:00-04:00,1.09985,1.09988,1.09777,1.09839,1.094789816,1.0978628888888888,1.0969111111111096,1.0959975555555541,1.0960690000000013,1.096705800000001,1.0964135,1.0982380999999999,1.0975728840882168,1.0965293433354253,-7558,-33045,-30126,0.05790901910490143,-26.44261007245376,0.33799523152673694
2023-05-10T09:30:00-04:00,1.09839,1.09875,1.0972,1.09762,1.09514082704,1.0980046666666665,1.0972111111111098,1.096426222222221,1.0961745000000014,1.096715000000001,1.0964277,1.0982043499999996,1.0975823072705735,1.0970374746683402,-9163,-42208,-28920.6,0.07655415091880237,-32.866111743080246,0.24659335841889335
2023-05-10T09:45:00-04:00,1.09762,1.09892,1.09762,1.09858,1.0954707774176,1.0982784444444442,1.0975944444444432,1.0968459999999989,1.0963440000000013,1.096742400000001,1.0964635,1.0981797499999997,1.0977818458164588,1.0974107797346722,8770,-33438,-30242,0.09659426802194088,-25.195697574243415,0.31503109219909536
2023-05-10T10:00:00-04:00,1.09858,1.0994,1.09825,1.09853,1.0957809307725441,1.0984655555555556,1.0979966666666654,1.0972426666666655,1.0965260000000012,1.096773400000001,1.0965016,1.0981549,1.097931476653167,1.0976474237877376,-8201,-41639,-35163.4,0.11308376267785787,-25.568952139226433,0.3306207816167499
2023-05-10T10:15:00-04:00,1.09853,1.10069,1.09832,1.09867,1.0960724749261914,1.0986002222222222,1.0984088888888877,1.0976244444444432,1.0966855000000013,1.0968046000000011,1.0965419,1.0981289499999998,1.0980791813225335,1.0977895390301902,9820,-31819,-36429.8,0.13093817020918322,-24.317461510840968,0.33882516256302536
2023-05-10T10:30:00-04:00,1.09867,1.09877,1.09742,1.09747,1.096441876932096,1.0984124444444443,1.0987333333333322,1.097988888888888,1.0967845000000014,1.096811000000001,1.0965628,1.0980973999999997,1.0979573450580267,1.0978664312241522,-7832,-39651,-37751,0.14517276144775837,-32.871804489169946,0.2667763007628737
2023-05-10T10:45:00-04:00,1.09747,1.09747,1.0964,1.09722,1.10069,1.0981097777777777,1.0984899999999989,1.0982446666666656,1.0968625000000012,1.096811000000001,1.0965730999999999,1.0980650499999998,1.0978098760464214,1.0979119449793218,-6968,-46619,-38633.2,0.1619942942511629,-34.45909161319068,-0.1991977515212627
2023-05-10T11:00:00-04:00,1.09722,1.09792,1.09709,1.09747,1.1006042,1.0979057777777779,1.0981999999999987,1.0983657777777769,1.0969450000000012,1.0968144000000009,1.0965927,1.0980315999999999,1.0977419008371372,1.0979039559834576,5290,-41329,-40211.4,0.1364375169309507,-33.25377271634295,-0.23725547232928526
2023-05-10T11:15:00-04:00,1.09747,1.09799,1.0973,1.09755,1.100520116,1.0977757777777777,1.097944444444443,1.0983553333333322,1.0970445000000013,1.096816600000001,1.0966042,1.0980005499999999,1.0977035206697097,1.097858364786766,3726,-37603,-39404.2,0.10585398357818665,-32.98216620318059,-0.20911942537618483
2023-05-10T11:30:00-04:00,1.09755,1.09782,1.09687,1.09736,1.10043771368,1.097658888888889,1.0978299999999988,1.0982395555555544,1.0971415000000013,1.096814200000001,1.0966149,1.09796785,1.0976348165357677,1.0977694918294127,-3956,-41559,-41352.2,0.07533558321486764,-33.667000607080666,-0.09377361410792946
2023-05-10T11:45:00-04:00,1.09736,1.0974599999999999,1.09651,1.09651,1.1003569594064,1.0973948888888891,1.0977066666666653,1.0980342222222212,1.0971935000000013,1.096792600000001,1.0966241,1.0979287,1.097409853228614,1.0976599934635303,-2526,-44085,-42239,0.05346507321829448,-35.62360554985194,-0.1011278948998692
2023-05-10T12:00:00-04:00,1.09651,1.09707,1.0965,1.09693,1.100277820218272,1.0972395555555554,1.097523333333332,1.0978408888888878,1.0973055000000014,1.096777600000001,1.0966369000000002,1.09789735,1.0973138825828912,1.0975607947708244,2453,-41632,-41241.6,0.04083625568558474,-34.68402451547955,-0.15019388665367378
2023-05-10T12:15:00-04:00,1.09693,1.09735,1.09666,1.09723,1.1002002638139066,1.097180888888889,1.0973788888888878,1.0976766666666655,1.097421000000001,1.096769800000001,1.0966519000000001,1.0978706500000002,1.097297106066313,1.0974718358166595,2416,-39216,-40819,0.01750614277275908,-34.023271322477335,-0.11833996340564927
2023-05-10T12:30:00-04:00,1.09723,1.09753,1.09712,1.09722,1.1001242585376285,1.0971491111111111,1.0972177777777763,1.0975313333333323,1.0975255000000013,1.096764000000001,1.0966686,1.0978456500000002,1.0972816848530504,1.0973874686533276,-1823,-41039,-41506.2,-0.00441298223866616,-34.03988588824724,-0.13197775492185562
2023-05-10T12:45:00-04:00,1.09722,1.0974,1.0969,1.09703,1.100049773366876,1.0971115555555555,1.0971688888888875,1.09739911111111,1.0976315000000012,1.096751600000001,1.0966862,1.0978229000000002,1.0972313478824403,1.0973067749226622,-2238,-43277,-41849.8,-0.027599474824624097,-34.42742895162587,-0.04009221208780158
2023-05-10T13:00:00-04:00,1.09703,1.09725,1.09675,1.09692,1.0999767778995384,1.0970617777777778,1.0971355555555542,1.097284888888888,1.0977295000000011,1.0967396000000011,1.0966999000000002,1.0978006500000002,1.0971690783059522,1.0972586199381298,-2988,-46265,-42285.8,-0.04132835565116854,-34.72703789577522,-0.027341827527769178
2023-05-10T13:15:00-04:00,1.09692,1.0971,1.0964099999999999,1.0965799999999999,1.0999052423415476,1.0969506666666666,1.097036666666665,1.0971875555555544,1.0978310000000013,1.0967270000000011,1.0967071,1.097775,1.0970512626447617,1.097206095950504,-2434,-48699,-43699.2,-0.054183800648712754,-35.48147759967342,-0.08109561081396825
2023-05-10T13:30:00-04:00,1.0965799999999999,1.09665,1.09616,1.09637,1.0998351374947166,1.0968173333333333,1.096905555555554,1.0970928888888876,1.0976790000000014,1.096714400000001,1.0967152,1.0977465000000002,1.0969150101158094,1.0971296767604035,-2821,-51520,-46160,-0.07209476948539123,-36.02171178231353,-0.1075121862329697
2023-05-10T13:45:00-04:00,1.09637,1.09704,1.0962399999999999,1.09675,1.0996881319949279,1.0967862222222222,1.0968377777777762,1.0970168888888878,1.0975125000000014,1.0967172000000012,1.0967275,1.0977204,1.0968820080926476,1.097049741408323,2553,-48967,-47745.6,-0.06785152316686373,-35.136846271583074,-0.05558795655026605
2023-05-10T14:00:00-04:00,1.09675,1.09725,1.09675,1.09723,1.0995470067151307,1.0968646666666666,1.0969177777777763,1.0969666666666655,1.0973815000000013,1.0967308000000011,1.0967426,1.0976944499999999,1.096951606474118,1.0969937931266585,2033,-46934,-48477,-0.056678647730653016,-34.247090174022034,0.06566287585155009
2023-05-10T14:15:00-04:00,1.09723,1.09747,1.09714,1.09738,1.0994115264465254,1.096957111111111,1.0969677777777764,1.0969331111111098,1.0973310000000014,1.0967454000000012,1.096756,1.097668,1.0970372851792944,1.096967434501327,2356,-44578,-48139.6,-0.03803860358484668,-33.92500638119808,0.04102358400263111
2023-05-10T14:30:00-04:00,1.09738,1.09794,1.09729,1.09793,1.0992814653886644,1.0971495555555555,1.097045555555554,1.0969348888888875,1.0973465000000013,1.0967610000000012,1.0967751000000001,1.09764435,1.0972158281434357,1.0970003476010617,2342,-42236,-46847,-0.026930445593395497,-32.751210613095765,0.06379701612243058
2023-05-10T14:45:00-04:00,1.09793,1.09825,1.09762,1.09768,1.0991566067731178,1.0972764444444445,1.097096666666665,1.0969731111111096,1.0973015000000015,1.0967808000000012,1.0967883,1.09761925,1.0973086625147486,1.0970790780808497,-2177,-44413,-45425.6,-0.02308999805157195,-33.246916168094884,0.04192413554254433
2023-05-10T15:00:00-04:00,1.09768,1.09804,1.09758,1.09789,1.099036742502193,1.0974351111111111,1.0971922222222206,1.0970439999999986,1.0972695000000012,1.0967908000000013,1.0968026000000002,1.0975951499999999,1.0974249300117989,1.09718766246468,1817,-42596,-44151.4,-0.013990675197583608,-32.899301198340424,0.07839348057939008
2023-05-10T15:15:00-04:00,1.09789,1.09847,1.09784,1.09837,1.0989216728021052,1.0976706666666667,1.0973533333333316,1.0971311111111095,1.0972545000000014,1.0968194000000013,1.0968157,1.0975751999999999,1.097613944009439,1.0973201299717439,1883,-40713,-42907.2,-0.001084892395987665,-32.07604932429105,0.13218830908363177
2023-05-10T15:30:00-04:00,1.09837,1.09848,1.09828,1.09828,1.098811205890021,1.097856,1.0975422222222209,1.0972459999999984,1.0972950000000012,1.0968318000000012,1.0968305,1.0975576499999997,1.0977471552075513,1.0974621039773953,-1358,-42071,-42405.8,0.013001570516869263,-32.187323303005144,0.15502744897773396
2023-05-10T15:45:00-04:00,1.09828,1.09832,1.09795,1.09823,1.0987051576544202,1.0979935555555556,1.0977488888888873,1.0973866666666652,1.0973455000000012,1.096838000000001,1.0968464,1.0975410499999998,1.097843724166041,1.0975876831819165,-1709,-43780,-42714.6,0.024739488971882037,-32.265126777528764,0.16965075658764583
2023-05-10T16:00:00-04:00,1.09823,1.09836,1.09806,1.09809,1.0986033513482434,1.098061777777778,1.0978977777777763,1.0975468888888873,1.097376500000001,1.0968490000000013,1.096859,1.09752765,1.097892979332833,1.097704546545533,-875,-44655,-42763,0.03663701453683549,-32.37666989691179,0.12217916571690167
2023-05-10T16:15:00-04:00,1.09809,1.09838,1.09809,1.09827,1.0985056172943137,1.0981362222222222,1.0980133333333317,1.0977111111111095,1.0974125000000012,1.0968852000000013,1.0968751,1.09751345,1.0979683834662664,1.0978132372364269,543,-44112,-43066.2,0.047015074330326354,-32.28766079929681,0.09478413823903394
2023-05-10T16:30:00-04:00,1.09827,1.09845,1.09825,1.09838,1.09616,1.0982095555555558,1.098124444444443,1.097865333333332,1.097463500000001,1.0969376000000013,1.0968944,1.09750135,1.098050706773013,1.0979005897891416,689,-43423,-43608.2,0.05389074237758005,-32.218652267697216,0.09112613679854653
2023-05-10T16:45:00-04:00,1.09838,1.0984,1.09803,1.09803,1.0962058000000001,1.0981906666666665,1.0981355555555539,1.0979839999999985,1.097539500000001,1.0969830000000014,1.0969118,1.0974886499999998,1.0980465654184104,1.0979604718313134,-1329,-44752,-44144.4,0.05690471335042268,-32.642139585383084,0.009108048782708277
2023-05-10T17:00:00-04:00,1.09803,1.09813,1.09786,1.09813,1.0962506840000001,1.0981895555555554,1.0981855555555537,1.0980713333333318,1.097599500000001,1.097035400000001,1.0969305,1.0974757,1.0980632523347282,1.0980043774650508,63,-44689,-44326.2,0.05169439609322014,-32.63640203722866,0.040995554259899196
2023-05-10T17:15:00-04:00,1.09813,1.0982,1.09806,1.0982,1.09629467032,1.0981924444444444,1.0982199999999984,1.098135777777776,1.0976480000000008,1.0970956000000012,1.0969506,1.097465,1.0980906018677825,1.0980439019720407,39,-44650,-44325.2,0.05091931997096134,-32.633915992771264,0.02823597992513207
2023-05-10T17:30:00-04:00,1.0982,1.09826,1.09817,1.0982399999999999,1.0963377769136,1.0981964444444445,1.0982055555555539,1.0981742222222206,1.097699000000001,1.0971626000000012,1.0969711,1.0974544,1.098120481494226,1.0980743215776325,795,-43855,-44273.8,0.04972409245512046,-32.60495951854084,-0.011835720203591277
2023-05-10T17:45:00-04:00,1.0982399999999999,1.09827,1.09816,1.09825,1.096380021375328,1.0982053333333335,1.0982022222222207,1.0981897777777763,1.097760000000001,1.0972180000000014,1.0969932,1.0974447999999999,1.0981463851953808,1.0980934572621062,895,-42960,-44181.2,0.04416058663312858,-32.59681011586013,-0.002731543868592207
2023-05-10T18:00:00-04:00,1.09825,1.09856,1.09822,1.0983,1.0964214209478216,1.098224888888889,1.0982099999999986,1.0982046666666652,1.0978290000000013,1.0972742000000013,1.0970145,1.097435,1.0981771081563045,1.0981195658096847,425,-42535,-43737.8,0.03883141388514373,-32.57746115159876,0.00637389253617316
2023-05-10T18:15:00-04:00,1.0983,1.09842,1.09825,1.0984,1.0965069641099088,1.0982628888888888,1.0982444444444428,1.098216444444443,1.0979200000000013,1.0973290000000013,1.0970364,1.0974252,1.0982216865250436,1.098151252647748,284,-42251,-43250.2,0.033957956155288425,-32.551603007193776,0.028230837180926196
2023-05-10T18:30:00-04:00,1.0984,1.09846,1.09836,1.09838,1.0965890855455125,1.0982899999999998,1.098256666666665,1.0982237777777761,1.0980205000000012,1.0973802000000012,1.0970565,1.0974156000000002,1.0982533492200348,1.0981838021181982,-358,-42609,-42842,0.028789796320269238,-32.55812157966287,0.01001575204638499
2023-05-10T18:45:00-04:00,1.09838,1.09864,1.09838,1.09863,1.096667922123692,1.0983646666666667,1.0982844444444426,1.098239555555554,1.0981145000000014,1.0974416000000011,1.0970968,1.0974073500000001,1.0983286793760278,1.0982254416945587,238,-42371,-42545.2,0.02226458690392798,-32.50395089192272,0.022760793168127926
2023-05-10T19:00:00-04:00,1.09863,1.09872,1.0985,1.09856,1.0967862467962703,1.0984197777777778,1.0983433333333317,1.0982677777777763,1.0981810000000014,1.0975044000000012,1.0971193000000001,1.09740025,1.0983749435008223,1.098271153355647,-437,-42808,-42514.8,0.016053181040637535,-32.53179466098055,0.04826826225147941
2023-05-10T19:15:00-04:00,1.09856,1.09861,1.09849,1.0986,1.0969409470525686,1.0984711111111112,1.098395555555554,1.0983048888888873,1.0982420000000013,1.0975670000000013,1.0971395000000002,1.09739195,1.098419954800658,1.0983197226845178,345,-42463,-42500.4,0.015302082800388087,-32.51923276176702,0.04280003278300114
2023-05-10T19:30:00-04:00,1.0986,1.0986,1.09821,1.0983,1.0970832712883631,1.098452,1.098406666666665,1.0983373333333317,1.0982605000000014,1.0976392000000013,1.097156,1.0973815,1.0983959638405263,1.0983545781476143,-435,-42898,-42629.8,0.012860347723728143,-32.6380203095551,0.009105809506464122
2023-05-10T19:45:00-04:00,1.0983,1.09842,1.09823,1.09825,1.0972142095852941,1.0984206666666667,1.098407777777776,1.0983675555555539,1.0982890000000014,1.0977058000000013,1.0971734,1.0973709,1.098366771072421,1.0983772625180914,-469,-43367,-42781.4,0.011927958771196913,-32.65937148865011,0.0009105477855537508
2023-05-10T20:00:00-04:00,1.09825,1.09847,1.09822,1.09836,1.0973346728184705,1.098411111111111,1.0984199999999984,1.098394666666665,1.0983125000000014,1.0977704000000015,1.0971913,1.097361,1.0983654168579369,1.0983846100144734,1165,-42202,-42747.6,0.010071912501434209,-32.54268585241058,0.010015934441161348
2023-05-10T20:15:00-04:00,1.09836,1.0988499999999999,1.09834,1.0986,1.097445498992993,1.0984471111111112,1.0984533333333317,1.098416666666665,1.0983240000000012,1.0978442000000015,1.0972097,1.0973525,1.0984123334863496,1.098392088011579,1304,-40898,-42365.6,0.010179992499469026,-32.257751950957484,0.027314941272873254
2023-05-10T20:30:00-04:00,1.0986,1.09882,1.0985,1.09852,1.0975859490936937,1.0984604444444446,1.0984666666666651,1.0984308888888872,1.0983360000000013,1.0979154000000013,1.0972297000000002,1.0973445,1.0984338667890796,1.0983948704092632,-1319,-42217,-42316.4,0.011532625189716442,-32.3538014685254,0.010924981791687724
2023-05-10T20:45:00-04:00,1.09852,1.09931,1.09852,1.09927,1.0977123541843243,1.098621111111111,1.0985655555555538,1.098462666666665,1.0983880000000013,1.0980098000000014,1.0972577000000001,1.0973403,1.0986010934312638,1.0984358963274108,1909,-40308,-41798.4,0.015160849371803158,-31.050456968652792,0.08102842367851358
2023-05-10T21:00:00-04:00,1.09927,1.09942,1.09878,1.09941,1.0979040716822055,1.09879,1.0986522222222206,1.098511555555554,1.0984540000000012,1.0980098000000014,1.0972826000000002,1.097337,1.098762874745011,1.098515117061929,1756,-38552,-40835.4,0.019421541524232738,-30.826817644373907,0.07099751508697222
2023-05-10T21:15:00-04:00,1.09941,1.0997999999999999,1.09926,1.0992899999999999,1.0981163016466968,1.0989175555555555,1.0987333333333316,1.0985742222222206,1.0985050000000012,1.0979940000000015,1.0973070000000003,1.0973351,1.0988682997960089,1.0986156936495433,-1731,-40283,-40451.6,0.020226830070872105,-31.01575534732386,0.06645062627438623
2023-05-10T21:30:00-04:00,1.0992899999999999,1.09937,1.0987,1.09886,1.0983856933832252,1.098942888888889,1.0987622222222206,1.0986359999999984,1.0985290000000012,1.0979742000000015,1.0973253000000003,1.09733085,1.098866639836807,1.0987065549196349,-1991,-42274,-40726.8,0.020399705925247494,-31.79455802905467,0.02366648461677835
2023-05-10T21:45:00-04:00,1.09886,1.09898,1.09839,1.09845,1.0997999999999999,1.0988804444444444,1.0987788888888872,1.0986984444444428,1.0985500000000012,1.0979754000000015,1.0973406000000003,1.09732485,1.0987833118694457,1.098776443935708,-1715,-43989,-41081.2,0.018730739870792632,-32.43444846095686,0.013657470636426519
2023-05-10T22:00:00-04:00,1.09845,1.09851,1.09778,1.09793,1.0997717999999999,1.0987106666666666,1.0987433333333316,1.098733999999998,1.0985400000000012,1.0979816000000013,1.0973483000000004,1.09732115,1.0986126494955566,1.0987787551485666,-1848,-45837,-42187,0.01579613792237904,-33.30928117978769,-0.02913726382880728
2023-05-10T22:15:00-04:00,1.09793,1.09823,1.09757,1.0976299999999999,1.0996921279999998,1.098488,1.0986622222222207,1.0987359999999984,1.0985115000000012,1.0979626000000016,1.0973525000000004,1.0973157,1.0984161195964453,1.0987094041188534,-1504,-47341,-43944.8,0.012319867455283628,-33.72023634086379,-0.0664627262464146
2023-05-10T22:30:00-04:00,1.0976299999999999,1.09784,1.09749,1.09762,1.0995648003199998,1.0982795555555556,1.0985533333333317,1.0986999999999985,1.0984805000000013,1.0979444000000016,1.0973589000000004,1.0973104500000002,1.0982568956771561,1.0985871232950828,-1459,-48800,-45648.2,0.008097850471627381,-33.73352861603828,-0.08920444201711095
2023-05-10T22:45:00-04:00,1.09762,1.09814,1.0975,1.09805,1.0993988162943997,1.0981788888888888,1.0985011111111094,1.0986477777777761,1.0984705000000012,1.0979320000000015,1.0973683000000003,1.0973058000000002,1.098215516541725,1.0984568986360663,1637,-47163,-46626,0.003914571308985429,-33.09222288181342,-0.04278483778174002
2023-05-10T23:00:00-04:00,1.09805,1.09817,1.09784,1.09796,1.0992461109908478,1.0980706666666666,1.098355555555554,1.0985631111111096,1.098453500000001,1.0979418000000016,1.0973764000000004,1.0972984500000003,1.0981644132333799,1.0983331189088532,-1200,-48363,-47500.8,0.00007369717490275924,-33.19057905867231,-0.1191699946327947
2023-05-10T23:15:00-04:00,1.09796,1.09798,1.09776,1.09782,1.09910562211158,1.0979635555555556,1.0981788888888873,1.0984502222222206,1.0984245000000012,1.0979538000000015,1.0973824000000003,1.0972914000000002,1.098095530586704,1.098229695127083,-855,-49218,-48177,-0.011046135824952744,-33.299599423712955,-0.14462302507708502
2023-05-10T23:30:00-04:00,1.09782,1.09782,1.09739,1.09756,1.0989763723426536,1.0978397777777777,1.097986666666665,1.0983151111111094,1.098383500000001,1.0979556000000015,1.0973850000000005,1.0972846000000003,1.0979884244693632,1.0981441561016665,-869,-50087,-48726.2,-0.024247758068629315,-33.505407297499126,-0.15737430523335857
2023-05-10T23:45:00-04:00,1.09756,1.0976,1.09734,1.09744,1.0988177351083883,1.0977304444444445,1.0978288888888872,1.0981702222222205,1.0983240000000012,1.0979534000000015,1.0973850000000005,1.0972780500000003,1.0978787395754905,1.0980685248813333,-744,-50831,-49132.4,-0.03701694897614496,-33.58675136980505,-0.12922483300875243
2023-05-11T00:00:00-04:00,1.09744,1.09747,1.09696,1.09714,1.0986404068953817,1.0975926666666667,1.0976833333333316,1.098006666666665,1.0982530000000013,1.0979490000000016,1.0973816000000003,1.0972702000000003,1.0977309916603923,1.0979716199050669,-975,-51806,-50061,-0.04621997760969249,-33.853280747265295,-0.11925895580134939
2023-05-11T00:15:00-04:00,1.09714,1.09737,1.09713,1.09721,1.0984051499300282,1.097498,1.0976033333333317,1.0978562222222206,1.0981835000000013,1.0979630000000014,1.0973778000000005,1.0972609500000003,1.097626793328314,1.0978640959240535,584,-51222,-50632.8,-0.051660135797502345,-33.816020233566036,-0.06557795123551173
2023-05-11T00:30:00-04:00,1.09721,1.09749,1.09711,1.09747,1.0982028289398242,1.0974713333333332,1.097585555555554,1.0977375555555535,1.0981420000000013,1.0979738000000012,1.0973757000000004,1.0972532500000005,1.097595434662651,1.0977640767392431,828,-50394,-50868,-0.050951514105499696,-33.61981349100997,-0.01457686105517688
2023-05-11T00:45:00-04:00,1.09747,1.09762,1.09738,1.09753,1.0980288328882488,1.097460222222222,1.0975755555555538,1.0976553333333314,1.0981060000000011,1.0979798000000014,1.0973748000000003,1.0972456500000005,1.0975823477301208,1.0976828613913947,941,-49453,-50741.2,-0.0485248068438857,-33.56836789340826,-0.008199559045949009
2023-05-11T01:00:00-04:00,1.09753,1.09774,1.09743,1.09772,1.097879196283894,1.0974891111111111,1.097538888888887,1.0975973333333315,1.098074000000001,1.0979898000000015,1.0973769000000002,1.0972392000000004,1.0976098781840966,1.097629089113116,1197,-48256,-50226.2,-0.04531687990893479,-33.36114804520351,-0.030053276262459946
2023-05-11T01:15:00-04:00,1.09772,1.09792,1.09768,1.09783,1.09696,1.0975473333333334,1.0975244444444427,1.0975655555555537,1.0980355000000013,1.0980058000000015,1.0973787000000004,1.0972336500000004,1.0976539025472773,1.097613671290493,897,-47359,-49336.8,-0.045023029743695694,-33.27126173539768,-0.011840139895803441
2023-05-11T01:30:00-04:00,1.09783,1.09823,1.09777,1.09808,1.0969792,1.0976584444444444,1.0975533333333314,1.0975555555555538,1.0980135000000013,1.0980290000000015,1.0973843000000003,1.0972290000000005,1.0977391220378219,1.0976361370323946,1138,-46221,-48336.6,-0.04167608100855105,-33.01211414424072,0.02368329963016951
2023-05-11T01:45:00-04:00,1.09808,1.09823,1.09775,1.09783,1.0970292320000001,1.097713777777778,1.0975833333333316,1.097555111111109,1.0979415000000012,1.0980540000000014,1.0973905000000004,1.0972213500000005,1.0977572976302574,1.097668509625916,-1568,-47789,-47815.6,-0.038593813020102306,-33.369100884733015,0.024600021866685414
2023-05-11T02:00:00-04:00,1.09783,1.0979,1.09726,1.09739,1.09707726272,1.0976751111111114,1.097577777777776,1.0975555555555534,1.0978405000000013,1.0980744000000016,1.0973944000000002,1.0972119500000006,1.097683838104206,1.0976888077007332,-2217,-50006,-47926.2,-0.03199136718849763,-34.25765375721782,-0.004556057734352992
2023-05-11T02:15:00-04:00,1.09739,1.09745,1.0967,1.09692,1.09823,1.0975435555555555,1.0975533333333314,1.0975584444444424,1.0977220000000012,1.0980778000000015,1.0973975000000005,1.0972002500000007,1.0975310704833647,1.0976730461605866,-2179,-52185,-48712,-0.02593072791251971,-35.19089535774308,-0.020052135552446268
2023-05-11T02:30:00-04:00,1.09692,1.09692,1.09425,1.09539,1.0981994,1.097110888888889,1.0973511111111094,1.0975237777777758,1.0975485000000011,1.0980410000000014,1.0973859000000004,1.0971806000000006,1.0971028563866918,1.0975628369284696,-5768,-57953,-50830.8,-0.024958969328555243,-43.236185807364656,-0.1658752654459887
2023-05-11T02:45:00-04:00,1.09539,1.09543,1.0929,1.09303,1.098041424,1.0962466666666668,1.096857777777776,1.0973846666666645,1.097277500000001,1.0979540000000017,1.0973497000000003,1.0971514000000004,1.0962882851093534,1.097272669542776,-5413,-63366,-54259.8,-0.03775820170102926,-54.89840656892059,-0.404566867431456
2023-05-11T03:00:00-04:00,1.09303,1.09358,1.0924099999999999,1.09327,1.09773293856,1.095529111111111,1.0963844444444426,1.0971448888888868,1.097044500000001,1.0978608000000016,1.0973109000000003,1.0971245500000004,1.0956846280874828,1.0968581356342209,7868,-55498,-55801.6,-0.05356611145877137,-53.17080531369417,-0.38814428762766673
2023-05-11T03:15:00-04:00,1.09327,1.09333,1.09242,1.09301,1.0973071034752,1.0948542222222222,1.0958611111111094,1.0968015555555535,1.096813500000001,1.0977674000000015,1.0972741000000004,1.0970936000000002,1.0951497024699863,1.0963513085073768,-6341,-61839,-58168.2,-0.07342655824669413,-54.67881339952798,-0.42907116568888165
2023-05-11T03:30:00-04:00,1.09301,1.09352,1.0927499999999999,1.09325,1.096915335197184,1.094332,1.0953522222222203,1.0963613333333313,1.096595000000001,1.0976746000000015,1.0972327000000002,1.0970636500000004,1.094769761975989,1.095799046805902,5005,-56834,-59098,-0.09518218356257409,-53.57982985866368,-0.4171866318100278
2023-05-11T03:45:00-04:00,1.09325,1.09386,1.09297,1.093,1.0965549083814095,1.0938615555555555,1.094787777777776,1.0958486666666645,1.096342500000001,1.0975672000000014,1.0971933000000003,1.0970315500000003,1.0944158095807912,1.0952616374447217,-4308,-61142,-59735.8,-0.11918835695261351,-54.56496592086387,-0.4626256739035383
2023-05-11T04:00:00-04:00,1.093,1.09365,1.09181,1.09276,1.0962233157108967,1.093456,1.0942244444444427,1.095321999999998,1.096082500000001,1.0974568000000016,1.0971443000000003,1.0969978500000004,1.0940846476646329,1.0948209099557775,-7376,-68518,-60766.2,-0.14476787399954705,-56.18458165736902,-0.46182013608665545
2023-05-11T04:15:00-04:00,1.09276,1.09346,1.09234,1.09329,1.095781984139807,1.093269111111111,1.0937688888888872,1.0947988888888869,1.095856000000001,1.0973580000000016,1.0970980000000004,1.0969660000000003,1.0939257181317064,1.0944691279646224,5245,-63273,-62321.2,-0.16593134720310757,-53.640701939955555,-0.37361375627625476
2023-05-11T04:30:00-04:00,1.09329,1.0933,1.0925799999999999,1.09323,1.0953847857258263,1.0931613333333332,1.0933588888888872,1.0942984444444426,1.095639500000001,1.0972608000000015,1.0970549000000003,1.0969338000000004,1.093786574505365,1.094196502371698,-4348,-67621,-63477.6,-0.18398242529986228,-53.879321153522625,-0.33639645553002695
2023-05-11T04:45:00-04:00,1.09323,1.09333,1.09282,1.09284,1.0950273071532437,1.0930575555555555,1.0930755555555538,1.093843111111109,1.095409500000001,1.0971522000000016,1.0970187000000002,1.0969009500000002,1.093597259604292,1.0939620018973586,-3755,-71376,-66386,-0.20074651291870946,-55.218883734132,-0.23279379946868714
2023-05-11T05:00:00-04:00,1.09284,1.09344,1.0928,1.09283,1.0947055764379194,1.0930084444444446,1.0930533333333317,1.0934962222222202,1.0951940000000011,1.0970412000000016,1.0969894000000002,1.0968676000000002,1.0934438076834336,1.093767601517887,-3079,-74455,-69048.6,-0.20411703480966636,-55.24705803229111,-0.018297759439354636
2023-05-11T05:15:00-04:00,1.09283,1.09315,1.09257,1.09293,1.0944160187941274,1.0929837777777778,1.0930155555555539,1.0932544444444425,1.094980000000001,1.0969392000000016,1.0969611000000004,1.0968407500000001,1.093341046146747,1.0936188812143097,2890,-71565,-69658,-0.18676068550368838,-54.98260701978233,-0.031099362463070147
2023-05-11T05:30:00-04:00,1.09293,1.09308,1.09236,1.09273,1.0941554169147147,1.0929266666666666,1.0929844444444425,1.0930975555555533,1.094743000000001,1.0968312000000016,1.0969333000000003,1.0968156500000001,1.0932188369173976,1.093477504971448,-2174,-73739,-71751.2,-0.17224439628336652,-55.38043670695347,-0.025617331954882205
2023-05-11T05:45:00-04:00,1.09273,1.09304,1.09238,1.09276,1.0939208752232432,1.092881777777778,1.0929299999999982,1.0930117777777757,1.0945045000000009,1.0967224000000015,1.0969090000000004,1.0967904500000003,1.0931270695339181,1.0933456039771587,2163,-71576,-72542.2,-0.15407423648022978,-55.32105332771071,-0.04482048936657685
2023-05-11T06:00:00-04:00,1.09276,1.0931,1.09201,1.09222,1.093709787700919,1.0927397777777779,1.0928433333333316,1.0929653333333313,1.094229500000001,1.0966020000000016,1.0968823000000003,1.0967629000000003,1.0929456556271344,1.0932152831817272,-2963,-74539,-73174.8,-0.14041669440531593,-56.7852540671228,-0.07136322049405333
2023-05-11T06:15:00-04:00,1.09222,1.09267,1.0919699999999999,1.092,1.0935198089308271,1.0925711111111112,1.092758888888887,1.0929064444444423,1.093938000000001,1.0964770000000015,1.0968475000000002,1.09673455,1.0927565245017075,1.0930778265453818,-2466,-77005,-73684.8,-0.12469648455221585,-57.28196718352766,-0.06954866576374244
2023-05-11T06:30:00-04:00,1.092,1.09242,1.09177,1.0924099999999999,1.0933488280377444,1.0925013333333333,1.0926611111111093,1.0928355555555533,1.093654500000001,1.0963592000000018,1.0968167000000002,1.09670755,1.092687219601366,1.0929470612363057,2575,-74430,-74257.8,-0.10433077636003993,-56.31516315422411,-0.08049099506994611
2023-05-11T06:45:00-04:00,1.0924099999999999,1.09259,1.09219,1.09225,1.093159368673215,1.092419111111111,1.0925522222222201,1.092749111111109,1.0933755000000012,1.0962362000000017,1.0967826000000003,1.0966794500000001,1.0925997756810928,1.0928232489890446,-2477,-76907,-74891.4,-0.0884811633530466,-56.67795734321894,-0.08964261866212792
2023-05-11T07:00:00-04:00,1.09225,1.09303,1.09213,1.09293,1.09177,1.0924946666666668,1.0925622222222204,1.0926755555555536,1.093152500000001,1.0961272000000017,1.0967537000000003,1.09665355,1.0926658205448743,1.092730999191236,7466,-69441,-74464.4,-0.06990284158307898,-52.02986395800484,0.008235423300750656
2023-05-11T07:15:00-04:00,1.09293,1.09347,1.0925,1.09338,1.0917952,1.0926582222222223,1.0926233333333315,1.0926315555555535,1.092975500000001,1.0960222000000015,1.0967319000000002,1.09662885,1.0928086564358994,1.092703599352989,4261,-65180,-72592.6,-0.04750738681918884,-50.27545150706995,0.05032804736327246
2023-05-11T07:30:00-04:00,1.09338,1.09383,1.09257,1.09284,1.091862192,1.0927015555555557,1.0926133333333317,1.0926024444444424,1.0928480000000012,1.0959078000000018,1.0967061000000002,1.0966032,1.0928149251487196,1.0927152794823913,-3750,-68930,-70977.6,-0.02964838023111343,-52.127506602279254,-0.008234745134631082
2023-05-11T07:45:00-04:00,1.09284,1.09321,1.09248,1.09315,1.09198026048,1.092808888888889,1.0926599999999984,1.0926022222222203,1.0928540000000013,1.0957988000000016,1.0966829000000002,1.09657685,1.0928819401189758,1.0927542235859131,4317,-64613,-69014.2,-0.01787790995330876,-50.90292660886747,0.038435844170114024
2023-05-11T08:00:00-04:00,1.09315,1.09339,1.09278,1.09321,1.0920912448512,1.092918888888889,1.0927099999999983,1.092633777777776,1.0928510000000011,1.0956970000000017,1.0966681000000003,1.0965532999999998,1.0929475520951806,1.092823778868731,4228,-60385,-65709.8,-0.014269972187640402,-50.67086330556985,0.04118013104433375
2023-05-11T08:15:00-04:00,1.09321,1.0936299999999999,1.09259,1.09308,1.0921955701601278,1.092992888888889,1.092805555555554,1.0926824444444425,1.0928545000000012,1.0955936000000017,1.0966497000000002,1.0965274999999999,1.0929740416761444,1.0928854230949847,-7609,-67994,-65420.4,-0.010514115406795201,-51.575694033426096,0.07873871564337614
2023-05-11T08:30:00-04:00,1.09308,1.0948,1.09308,1.09365,1.0922936359505202,1.0931617777777778,1.0929888888888872,1.0927555555555537,1.092874500000001,1.0954994000000018,1.0966349000000002,1.09650595,1.0931092333409156,1.092945538475988,11728,-56266,-63637.6,-0.0002178578990612417,-45.459984295804404,0.15109890109889462
2023-05-11T08:45:00-04:00,1.09365,1.09432,1.09312,1.09327,1.0924941450744785,1.093218,1.0930844444444427,1.092849777777776,1.0928880000000014,1.095392800000002,1.0966185000000004,1.0964825,1.0931413866727324,1.0930108307807906,-6223,-62489,-62349.4,0.011315529420454676,-47.62222998683928,0.07872502082552182
2023-05-11T09:00:00-04:00,1.09327,1.09332,1.09209,1.09254,1.0948,1.093109111111111,1.093116666666665,1.0929411111111091,1.0928770000000014,1.0952732000000018,1.0965943000000002,1.09645585,1.0930211093381859,1.0930386646246326,-7851,-70340,-63494.8,0.014509614253491884,-52.86451231416848,0.02655069810026308
2023-05-11T09:15:00-04:00,1.09254,1.09254,1.09125,1.09184,1.0947458,1.0928537777777778,1.0929955555555537,1.0929982222222203,1.0928045000000015,1.0951246000000021,1.0965672000000004,1.0964280000000002,1.0927848874705486,1.0930061316997062,-6965,-77305,-66878.8,0.014767283473543657,-57.3270491549258,-0.09973191329728669
2023-05-11T09:30:00-04:00,1.09184,1.09202,1.09083,1.09089,1.0946059680000002,1.0924326666666666,1.092718888888887,1.0929808888888868,1.0926875000000016,1.0949542000000019,1.0964820000000004,1.09639995,1.092405909976439,1.0928925053597651,-8184,-85489,-70377.8,0.006558597253404083,-64.44787271881799,-0.22773418207760368
2023-05-11T09:45:00-04:00,1.09089,1.09096,1.09006,1.09015,1.0943794099200002,1.0919188888888889,1.0924199999999982,1.0928671111111092,1.0925530000000014,1.094771400000002,1.0963827000000004,1.09636895,1.0919547279811512,1.0926616042878121,-7733,-93222,-77769,-0.009579888336229506,-69.69351618424504,-0.24614765198931968
2023-05-11T10:00:00-04:00,1.09015,1.09095,1.08999,1.09091,1.0940338571264001,1.0916168888888889,1.0921711111111092,1.0926844444444426,1.0924570000000016,1.094612400000002,1.0962933000000004,1.0963426500000002,1.091745782384921,1.0923824834302498,6712,-86510,-82573.2,-0.018834476725310908,-65.01423351672165,-0.20491240909298994
2023-05-11T10:15:00-04:00,1.09091,1.09114,1.09028,1.09089,1.09362947141376,1.0913606666666666,1.0919133333333315,1.0924437777777758,1.0923550000000015,1.094461200000002,1.0962183000000005,1.0963159,1.0915746259079369,1.0920931867442,-5802,-92312,-86967.6,-0.031067962857867525,-65.12060342808076,-0.21221906129655782
2023-05-11T10:30:00-04:00,1.09089,1.09185,1.09076,1.09155,1.0932655242723839,1.0912879999999998,1.0917433333333313,1.0921933333333314,1.0922960000000015,1.0943336000000021,1.0961576000000004,1.09629265,1.0915697007263494,1.09185014939536,5267,-87045,-88915.6,-0.04025084300941981,-61.93401266274186,-0.13997145680096892
2023-05-11T10:45:00-04:00,1.09155,1.0921,1.09139,1.09173,1.0929379718451455,1.0912853333333332,1.091529999999998,1.0919555555555536,1.0922445000000016,1.094215600000002,1.0960891000000004,1.0962763000000002,1.0916017605810795,1.0916893195162882,6602,-80443,-87906.4,-0.04825254548733186,-60.84532226834815,-0.17555890824303222
2023-05-11T11:00:00-04:00,1.09173,1.09198,1.09124,1.09158,1.0926431746606309,1.0912953333333333,1.0913422222222202,1.091739999999998,1.0922125000000014,1.094094800000002,1.0960196000000004,1.0962606000000001,1.0915974084648636,1.091617855613031,-5038,-85481,-86358.2,-0.06206273240815756,-61.53752638475099,-0.154582125184078
2023-05-11T11:15:00-04:00,1.09158,1.092,1.09153,1.09174,1.0923778571945677,1.0913748888888888,1.0912533333333314,1.0915564444444423,1.0921995000000013,1.093968600000002,1.0959503000000004,1.0962461000000001,1.0916259267718909,1.0915938844904247,3314,-82167,-85489.6,-0.07397980204898495,-61.05177179049331,-0.07322386365717813
2023-05-11T11:30:00-04:00,1.09174,1.09177,1.09093,1.09108,1.092139071475111,1.0913402222222222,1.0911688888888869,1.0914075555555534,1.0921330000000016,1.093831000000002,1.0958864000000004,1.0962246,1.0915167414175126,1.0915823075923397,-3034,-85201,-84067.4,-0.08333961919444116,-62.88594476207963,-0.06960726846423211
2023-05-11T11:45:00-04:00,1.09108,1.09171,1.091,1.09155,1.092,1.0914164444444443,1.0912422222222202,1.0913073333333312,1.0920980000000016,1.093705600000002,1.0958297000000004,1.0962014,1.09152339313401,1.091573046073872,3220,-81981,-83054.6,-0.08224830940318156,-61.498878735757174,0.06050105876853808
2023-05-11T12:00:00-04:00,1.09155,1.0924,1.09154,1.09239,1.08999,1.0916460000000001,1.0914911111111092,1.0912995555555534,1.0920710000000016,1.093602200000002,1.0957789000000004,1.0961858,1.091696714507208,1.0915920368590977,3033,-78948,-82755.6,-0.06912338915200851,-59.164839983524246,0.20547631059946062
2023-05-11T12:15:00-04:00,1.09239,1.09284,1.09223,1.0927,1.0900382,1.0918877777777778,1.091689999999998,1.091369111111109,1.0920370000000017,1.093507400000002,1.0957304000000003,1.0961673,1.0918973716057665,1.0916520294872782,3027,-75921,-80843.6,-0.04477172003975325,-58.30583358471055,0.16408319659733234
2023-05-11T12:30:00-04:00,1.0927,1.09288,1.09259,1.0927499999999999,1.090150272,1.0920997777777777,1.0918966666666645,1.0914977777777755,1.0920325000000015,1.093419600000002,1.0956843000000003,1.0961496,1.0920678972846132,1.091740423589823,2019,-73902,-79190.6,-0.025177153586228684,-58.21344775145369,0.17050298380221407
2023-05-11T12:45:00-04:00,1.0927499999999999,1.0929,1.09234,1.09252,1.09031405568,1.0922244444444442,1.0920044444444423,1.0916648888888867,1.0920010000000016,1.093325800000002,1.0956444000000003,1.09613425,1.0921583178276906,1.0918687388718582,-2135,-76037,-77357.8,-0.008856167725526517,-58.66281860480524,0.0888644587971156
2023-05-11T13:00:00-04:00,1.09252,1.0925799999999999,1.09186,1.09187,1.0905209312256,1.0921975555555554,1.0920199999999978,1.091820444444442,1.0919340000000015,1.0932138000000018,1.0955938000000003,1.09611535,1.0921006542621525,1.0919841910974868,-3570,-79607,-76883,-0.00034449842547532055,-60.786807181673524,0.012823683511473252
2023-05-11T13:15:00-04:00,1.09187,1.09202,1.09156,1.09159,1.0907112567275519,1.0921115555555556,1.0920211111111089,1.0919264444444419,1.0918595000000015,1.093095000000002,1.0955374000000004,1.0960946500000002,1.091998523409722,1.0920445528779896,-1893,-81500,-77393.4,0.005438226414341212,-61.27224958782049,0.000916103263165825
2023-05-11T13:30:00-04:00,1.09159,1.09174,1.09139,1.09142,1.0908863561893478,1.0919913333333333,1.0919855555555533,1.091985555555553,1.0917480000000015,1.0929690000000019,1.0954794000000003,1.0960740000000002,1.0918828187277776,1.092041642302392,-1739,-83239,-78857,0.011213065249126046,-61.54307471447061,-0.029311008115474012
2023-05-11T13:45:00-04:00,1.09142,1.09148,1.09107,1.09127,1.0910474476942,1.091848222222222,1.0920066666666646,1.092007555555553,1.0916480000000015,1.0928378000000019,1.0954218000000002,1.096054,1.091760254982222,1.0919801138419136,-1711,-84950,-81066.6,0.017290239171556632,-61.778227084777335,0.01741393848296298
2023-05-11T14:00:00-04:00,1.09127,1.09133,1.09118,1.09127,1.0929,1.0917008888888888,1.0919755555555535,1.0920017777777755,1.0915845000000015,1.0927016000000018,1.0953653,1.0960326,1.0916622039857777,1.0918808910735314,0,-84950,-82849.2,0.0277566574755943,-61.778227084777335,-0.025651596353814116
2023-05-11T14:15:00-04:00,1.09127,1.09158,1.09126,1.0915,1.0928655999999999,1.0916057777777777,1.0918766666666646,1.0919731111111086,1.0915675000000014,1.0925750000000019,1.0953145000000002,1.0960108000000002,1.0916297631886223,1.0917867128588252,1843,-83107,-83549.2,0.03183675570467966,-61.389789759459205,-0.08147273409680218
2023-05-11T14:30:00-04:00,1.0915,1.09174,1.0914,1.09173,1.0928318879999999,1.0915764444444445,1.091768888888887,1.0919226666666642,1.0916095000000015,1.0924618000000017,1.0952681000000002,1.0959916500000002,1.0916498105508978,1.0917169702870602,1737,-81370,-83523.2,0.02627046627248635,-61.023770519880365,-0.08877093438271395
2023-05-11T14:45:00-04:00,1.09173,1.09187,1.09159,1.09185,1.09279885024,1.0915926666666667,1.091668888888887,1.091859333333331,1.0916945000000013,1.0923604000000018,1.0952191000000002,1.0959733,1.0916898484407183,1.0916783762296483,1936,-79434,-82762.2,0.014295037000521734,-60.81097065178129,-0.0823610157858523
2023-05-11T15:00:00-04:00,1.09185,1.09217,1.0917,1.09206,1.0927664732351998,1.0916708888888889,1.0916177777777758,1.0917815555555532,1.0917520000000014,1.092293800000002,1.0951674000000002,1.0959550000000002,1.0917638787525745,1.0916791009837188,1434,-78000,-81372.2,-0.00035767329155309306,-60.535163535419095,-0.04210449236626377
2023-05-11T15:15:00-04:00,1.09206,1.09208,1.09186,1.09193,1.0927347437704957,1.0917333333333334,1.0916244444444425,1.0917113333333313,1.0918040000000016,1.0922718000000018,1.0951129000000002,1.0959344500000001,1.0917971030020597,1.0917060807869752,-1147,-79147,-80211.6,-0.01021068200455691,-60.67170365226245,0.005495159680197371
2023-05-11T15:30:00-04:00,1.09193,1.0921,1.09172,1.09177,1.0927036488950859,1.0917624444444445,1.0916444444444424,1.091664888888887,1.0918150000000015,1.0922418000000018,1.0950513000000002,1.0959132000000003,1.0917916824016478,1.0917384646295802,-1092,-80239,-79638,-0.014964333768690202,-60.831713909330375,0.01648970767411271
2023-05-11T15:45:00-04:00,1.09177,1.09192,1.09162,1.09171,1.0926731759171842,1.0917755555555557,1.0916766666666646,1.0916464444444425,1.0918140000000016,1.092215800000002,1.0949916,1.0958899500000003,1.0917753459213182,1.0917635717036644,-1036,-81275,-79619,-0.014562973411065471,-60.88864897807191,0.02657088930016872
2023-05-11T16:00:00-04:00,1.09171,1.09176,1.09152,1.09157,1.0926433123988404,1.0917542222222223,1.0917099999999982,1.0916546666666647,1.0918135000000015,1.0921822000000019,1.0949284,1.0958655000000002,1.0917342767370546,1.0917724573629317,-1021,-82296,-80191.4,-0.01249135876231157,-61.0195811853431,0.02749090509222896
2023-05-11T16:15:00-04:00,1.09157,1.09162,1.0915,1.09153,1.0926140461508635,1.0917182222222221,1.0917388888888868,1.0916788888888869,1.0918030000000016,1.0921528000000018,1.09486,1.0958378500000001,1.0916934213896436,1.0917583658903454,-784,-83080,-81207.4,-0.009891921597280516,-61.04831044686552,0.023825451079927697
2023-05-11T16:30:00-04:00,1.09153,1.09158,1.09152,1.09156,1.0925853652278463,1.0916824444444444,1.0917455555555535,1.091703111111109,1.0918270000000017,1.0921288000000018,1.0947928,1.0958116500000004,1.091666737111715,1.0917322927122766,278,-82802,-81938.4,-0.006450734965037376,-61.040669795669444,0.005497022446190658
2023-05-11T16:45:00-04:00,1.09156,1.09169,1.09146,1.09153,1.0925572579232894,1.0916393333333332,1.0917233333333314,1.091718888888887,1.0918260000000015,1.0920936000000019,1.0947258,1.0957861000000002,1.091639389689372,1.0917018341698213,-734,-83536,-82597.8,-0.00813849573899175,-61.06084275913471,-0.0183195478735768
2023-05-11T17:00:00-04:00,1.09153,1.09181,1.09144,1.09171,1.0925297127648237,1.0916366666666666,1.091707777777776,1.091725111111109,1.0917920000000017,1.092063200000002,1.094662,1.0957605000000001,1.0916535117514976,1.0916774673358574,133,-83403,-83023.4,-0.009019448949979868,-61.03891024239215,-0.012822274121905846
2023-05-11T17:15:00-04:00,1.09171,1.09193,1.09159,1.09159,1.0925027185095273,1.0916131111111111,1.0916555555555536,1.0917142222222203,1.0917365000000017,1.0920382000000017,1.0945951999999999,1.0957351500000003,1.091640809401198,1.091658773868686,-211,-83614,-83287,-0.007911920350350819,-61.06210321488482,-0.04303792831895412
2023-05-11T17:30:00-04:00,1.09159,1.09165,1.09154,1.09164,1.0924762641393369,1.09161,1.0916233333333314,1.0916911111111092,1.0916810000000017,1.0920144000000018,1.0945278,1.0957111000000004,1.0916406475209584,1.091648219094949,68,-83546,-83380.2,-0.007135887626290313,-61.05898849232416,-0.026558479023391927
2023-05-11T17:45:00-04:00,1.09164,1.09169,1.09152,1.09152,1.09245033885655,1.091589333333333,1.0915955555555537,1.0916611111111092,1.0916310000000018,1.0919862000000018,1.0944627000000002,1.0956872500000003,1.0916165180167667,1.0916381752759592,-422,-83968,-83613.4,-0.0055266838064496745,-61.10537741174811,-0.02289859585808929
2023-05-11T18:00:00-04:00,1.09152,1.09182,1.09143,1.0917999999999999,1.092424932079419,1.0916302222222223,1.0916055555555537,1.0916375555555535,1.0916275000000017,1.0919676000000016,1.0943994000000001,1.0956649500000004,1.0916532144134135,1.0916409402207674,320,-83648,-83635.8,-0.002111285694415457,-61.02329004733889,0.008243947568486456
2023-05-11T18:15:00-04:00,1.0917999999999999,1.09187,1.09158,1.09159,1.0924000334378308,1.091627111111111,1.091607777777776,1.0916175555555536,1.0916275000000017,1.0919442000000017,1.0943333000000002,1.09564195,1.0916405715307307,1.0916383521766142,-596,-84244,-83804,-0.001989169495512002,-61.13792642762822,0.001832223311389194
2023-05-11T18:30:00-04:00,1.09159,1.09165,1.09144,1.09157,1.0923756327690741,1.0916195555555555,1.0916122222222204,1.091608888888887,1.0916350000000017,1.0919312000000019,1.0942666,1.0956188500000001,1.0916264572245846,1.0916354817412914,-557,-84801,-84041.4,-0.0019019268787184255,-61.148131724488834,0.003664580909369418
2023-05-11T18:45:00-04:00,1.09157,1.09173,1.0915,1.09164,1.0923517201136927,1.091625111111111,1.0916211111111094,1.0916084444444425,1.0916535000000018,1.0919240000000017,1.0942005000000001,1.0955968500000004,1.0916291657796677,1.0916331853930332,586,-84215,-84175.2,-0.0018539246930822453,-61.11055282437248,0.0073289603869560955
2023-05-11T19:00:00-04:00,1.09164,1.09164,1.09144,1.0916299999999999,1.092328285711419,1.091626888888889,1.0916322222222206,1.091615777777776,1.0916715000000017,1.0919084000000019,1.0941337999999998,1.0955741500000002,1.091629332623734,1.0916357483144268,-603,-84818,-84345.2,-0.002783024423377086,-61.116076623427155,0.009161452273413374
2023-05-11T19:15:00-04:00,1.0916299999999999,1.09174,1.09162,1.09166,1.0923053199971906,1.0916324444444443,1.091626666666665,1.0916199999999985,1.091679500000002,1.0918966000000017,1.0940663999999998,1.0955514000000004,1.0916354660989873,1.0916321986515416,310,-84508,-84517.2,-0.003293334944311936,-61.10755725331085,-0.0045799708713745845
2023-05-11T19:30:00-04:00,1.09166,1.09166,1.09122,1.09129,1.0922828135972469,1.091565111111111,1.0915933333333314,1.0916171111111095,1.0916575000000017,1.0918638000000018,1.0939955,1.0955260000000002,1.0915663728791898,1.0916173589212335,-469,-84977,-84663.8,-0.006224678166211973,-61.26651700268336,-0.027482846123541526
2023-05-11T19:45:00-04:00,1.09129,1.0914,1.09113,1.09124,1.092260757325302,1.0914944444444443,1.091548888888887,1.0916044444444428,1.0916270000000017,1.091821000000002,1.0939215999999998,1.0955092000000004,1.0915010983033517,1.091592287136987,-716,-85693,-84842.2,-0.007293541943679088,-61.29932221486351,-0.03664211644864204
2023-05-11T20:00:00-04:00,1.09124,1.09174,1.09122,1.09173,1.09221552703229,1.0915306666666669,1.0915722222222204,1.091594666666665,1.0916105000000016,1.091798800000002,1.0938533,1.0954863000000004,1.0915468786426814,1.0915758297095894,1140,-84553,-84909.8,-0.005945663700465397,-60.78742748959673,0.019239226033425268
2023-05-11T20:15:00-04:00,1.09173,1.09187,1.09155,1.09179,1.0921721059509983,1.0915742222222222,1.0915711111111095,1.0915824444444426,1.0916035000000015,1.091771600000002,1.0937852,1.0954623500000003,1.091595502914145,1.0915690637676716,1053,-83500,-84646.2,-0.002294538474912422,-60.72955603786421,-0.0009159186664080847
2023-05-11T20:30:00-04:00,1.09179,1.0919699999999999,1.09171,1.09185,1.0921304217129584,1.09163,1.0915999999999983,1.0915771111111092,1.0916075000000016,1.0917444000000018,1.0937206999999998,1.0954383500000002,1.0916464023313162,1.0915712510141375,1241,-82259,-84196.4,-0.0014875291834193936,-60.661356109306574,0.02381846664039859
2023-05-11T20:45:00-04:00,1.09185,1.09216,1.09171,1.09213,1.09113,1.0917360000000003,1.0916622222222205,1.0915908888888872,1.0916285000000014,1.0917254000000018,1.0936594999999998,1.09541645,1.0917431218650528,1.0916066008113101,1392,-80867,-83374.4,0.0018888270428728234,-60.304383997752716,0.051302252718571965
2023-05-11T21:00:00-04:00,1.09213,1.09224,1.09192,1.09196,1.0911506,1.0917955555555556,1.091697777777776,1.091620666666665,1.0916480000000015,1.0916916000000019,1.0935954999999997,1.0953934000000003,1.0917864974920424,1.0916636806490483,-1692,-82559,-82747.6,0.00437086387384236,-60.56775923696417,0.029313693158925836
2023-05-11T21:15:00-04:00,1.09196,1.09204,1.09176,1.09177,1.091194176,1.09181,1.0917133333333318,1.0916488888888873,1.0916600000000014,1.091661600000002,1.0935271999999996,1.09536845,1.0917831979936339,1.0917109445192388,-1385,-83944,-82625.8,0.004689259153855667,-60.8087479178684,0.012824858239516046
2023-05-11T21:30:00-04:00,1.09177,1.09216,1.09171,1.09209,1.09123600896,1.0918853333333336,1.0917611111111092,1.0916868888888873,1.0916865000000013,1.0916526000000017,1.0934628999999996,1.0953463,1.091844558394907,1.091760755615391,2176,-81768,-82279.4,0.006460114572238027,-60.17095790715167,0.03938955352398461
2023-05-11T21:45:00-04:00,1.09209,1.09242,1.092,1.0924099999999999,1.0912761686016,1.092015111111111,1.0918855555555538,1.0917439999999983,1.0917305000000015,1.0916640000000017,1.0933942999999997,1.0953260000000002,1.0919576467159255,1.091823004492313,1296,-80472,-81922,0.009622204174006525,-59.79120898535965,0.10263083140134957
2023-05-11T22:00:00-04:00,1.0924099999999999,1.0925,1.09222,1.09236,1.091344798485504,1.0921100000000001,1.0920099999999981,1.091813555555554,1.0917630000000014,1.0916934000000018,1.0933237999999996,1.0953032000000003,1.0920381173727405,1.0918820035938506,-2162,-82634,-82275.4,0.015802349809082773,-59.89016450572266,0.10263553388805487
2023-05-11T22:15:00-04:00,1.09236,1.09253,1.0923,1.09242,1.0914372146066638,1.0921920000000003,1.0920866666666647,1.0918913333333315,1.0918045000000014,1.091738800000002,1.0932550999999997,1.09528105,1.0921144938981924,1.0919476028750803,1628,-81006,-81964.8,0.023513063685536986,-59.8007434357458,0.0632024401637637
2023-05-11T22:30:00-04:00,1.09242,1.09244,1.09191,1.09203,1.0915464931459975,1.0921806666666665,1.0921133333333313,1.0919713333333314,1.0918240000000012,1.0917612000000019,1.0931867999999998,1.0952560500000001,1.0920975951185539,1.0920104823000645,-1294,-82300,-81636,0.024341289211777358,-60.26270861397383,0.021982249333664713
2023-05-11T22:45:00-04:00,1.09203,1.09209,1.09177,1.09185,1.0916448438313977,1.092128,1.092113333333331,1.0920417777777758,1.0918405000000013,1.0917804000000018,1.0931208,1.0952307000000001,1.092048076094843,1.0920511858400517,-1256,-83556,-81993.6,0.02397470727271001,-60.46973589344425,0
2023-05-11T23:00:00-04:00,1.09185,1.09194,1.0915,1.09193,1.09253,1.0920913333333333,1.0920911111111091,1.0920828888888867,1.0918470000000011,1.0917880000000018,1.0930607999999997,1.09520455,1.0920244608758745,1.0920645486720413,1215,-82341,-82367.4,0.022918834615519343,-60.380712675969235,-0.01831283821522877
2023-05-11T23:15:00-04:00,1.09193,1.09201,1.09175,1.09198,1.0925094,1.092069111111111,1.0920933333333314,1.0920995555555535,1.0918665000000012,1.0917930000000018,1.0930042999999996,1.0951784,1.0920155687006996,1.0920600389376331,1212,-81129,-82066.4,0.02075980900985241,-60.32521461290671,0.001831568921930197
2023-05-11T23:30:00-04:00,1.09198,1.092,1.09175,1.09192,1.092489212,1.0920344444444443,1.092109999999998,1.0921042222222201,1.0918840000000012,1.0917998000000018,1.0929472999999996,1.0951531,1.0919964549605596,1.0920364311501065,-1163,-82292,-82323.6,0.018953956191437877,-60.38911688217899,0.013739157514869847
2023-05-11T23:45:00-04:00,1.09192,1.09225,1.09183,1.09222,1.09246942776,1.0920564444444445,1.0921244444444425,1.0921064444444424,1.0919130000000012,1.0918094000000018,1.0928889999999998,1.09512865,1.0920411639684477,1.0920251449200855,895,-81397,-82143,0.020239948713335894,-60.143219746857746,0.011903780823921423
2023-05-12T00:00:00-04:00,1.09222,1.09254,1.09216,1.09251,1.0915,1.0921335555555556,1.0921355555555534,1.0921108888888869,1.0919570000000012,1.0918380000000019,1.0928344999999997,1.09510545,1.0921349311747581,1.0920425159360683,1330,-80067,-81445.2,0.02029151223453123,-59.7900857628617,0.009154072189032601
2023-05-12T00:15:00-04:00,1.09251,1.09255,1.09235,1.09239,1.0915207999999998,1.0921844444444444,1.0921388888888868,1.0921204444444423,1.0919935000000014,1.091854800000002,1.0927801999999998,1.0950813,1.0921859449398066,1.0920748127488547,-1255,-81322,-81241.4,0.016793471696044823,-59.92793347134963,0.0027463473580115064
2023-05-12T00:30:00-04:00,1.09239,1.09254,1.09232,1.09248,1.091561968,1.0922526666666668,1.0921455555555533,1.0921308888888868,1.0920530000000013,1.0918566000000018,1.0927293999999999,1.0950572,1.0922447559518453,1.0921206501990839,1464,-79858,-80987.2,0.014316020817842787,-59.80731720792733,0.005492393035640961
2023-05-12T00:45:00-04:00,1.09248,1.09268,1.09237,1.09261,1.09160148928,1.0923455555555557,1.0922099999999977,1.0921508888888867,1.0921215000000015,1.091854800000002,1.0926810999999998,1.09503305,1.0923178047614763,1.0921849201592673,1520,-78338,-80196.4,0.010299267409099372,-59.626444331535744,0.05311209399009413
2023-05-12T01:00:00-04:00,1.09261,1.09261,1.09218,1.09235,1.0916661999231998,1.0923735555555556,1.0922655555555534,1.092179111111109,1.0921525000000014,1.0918468000000017,1.0926331999999999,1.0950073999999999,1.0923242438091811,1.092241536127414,-1494,-79832,-79883.4,0.008389005693634126,-59.98196002331984,0.045793836149649214
2023-05-12T01:15:00-04:00,1.09235,1.09281,1.0923,1.09281,1.0917270279278077,1.0924824444444445,1.092363333333331,1.0922246666666644,1.0922035000000014,1.0918526000000017,1.0925891999999997,1.0949835,1.092421395047345,1.0922988289019315,1423,-78409,-79551.8,0.012469556406535711,-59.382719853044584,0.08059124669163699
2023-05-12T01:30:00-04:00,1.09281,1.09291,1.09266,1.0928,1.091813665693583,1.0925697777777779,1.0924544444444422,1.0922877777777755,1.0922510000000014,1.0918712000000017,1.0925424999999997,1.0949590999999999,1.092497116037876,1.0923610631215452,-1559,-79968,-79281,0.016030958016603914,-59.396985827916794,0.07509295042034131
2023-05-12T01:45:00-04:00,1.0928,1.09304,1.09236,1.09242,1.0919232991242247,1.092562888888889,1.0925099999999976,1.0923606666666643,1.0922655000000012,1.0918878000000019,1.0924914,1.0949331,1.0924816928303007,1.0924084504972364,-1119,-81087,-79526.8,0.017573887931797122,-59.78609636964451,0.045790900432261056
2023-05-12T02:00:00-04:00,1.09242,1.09259,1.09196,1.09239,1.09304,1.092538888888889,1.0925288888888867,1.0924244444444422,1.0922870000000011,1.0919072000000016,1.0924380999999999,1.0949075,1.0924633542642406,1.0924375603977894,-3558,-84645,-80788.2,0.02074314338413574,-59.883806041748564,0.015564629836480149
2023-05-12T02:15:00-04:00,1.09239,1.09293,1.09233,1.09267,1.09304,1.092567111111111,1.0925466666666643,1.0924806666666644,1.0923320000000012,1.0919352000000015,1.0923864999999997,1.0948826,1.0925046834113925,1.0924736483182316,2863,-81782,-81178.2,0.021766983849469557,-59.14996556353093,0.014645174872535534
2023-05-12T02:30:00-04:00,1.09267,1.09316,1.09246,1.09297,1.09196,1.0926517777777778,1.0926111111111088,1.09253022222222,1.0923760000000011,1.0919692000000016,1.0923353999999998,1.0948598499999997,1.092597746729114,1.0925089186545853,2086,-79696,-81435.6,0.020745775538565728,-58.57724003798348,0.053094590759712644
2023-05-12T02:45:00-04:00,1.09297,1.09344,1.09281,1.09288,1.091984,1.0927055555555556,1.0926555555555533,1.0925704444444422,1.0923995000000013,1.0919968000000015,1.0922858999999998,1.0948381999999999,1.092654197383291,1.0925403349236682,-3825,-83521,-82146.2,0.021786891248745187,-58.892207511930344,0.03661394258935432
2023-05-12T03:00:00-04:00,1.09288,1.09331,1.09266,1.09309,1.09204224,1.0927924444444446,1.0927088888888865,1.09261022222222,1.0924360000000013,1.0920240000000017,1.0922428999999998,1.09481865,1.0927413579066327,1.0925922679389346,5044,-78477,-81624.2,0.024406000066378216,-57.92298856749079,0.043931503464165064
2023-05-12T03:15:00-04:00,1.09309,1.09355,1.09287,1.09289,1.0920981504,1.0928286666666667,1.0927688888888865,1.0926582222222199,1.0924595000000012,1.0920448000000018,1.0922026,1.09480005,1.0927710863253062,1.0926538143511477,-3534,-82011,-81097.4,0.02465825197109239,-58.56959589168177,0.04943470499381929
2023-05-12T03:30:00-04:00,1.09289,1.09333,1.09255,1.09308,1.092185261376,1.0928908888888886,1.0927988888888864,1.0927086666666643,1.0925120000000013,1.0920652000000017,1.0921794999999999,1.0947826999999999,1.092832869060245,1.0927194514809182,3424,-78587,-80458.4,0.028462745840003845,-57.974330128429784,0.024706948142860376
2023-05-12T03:45:00-04:00,1.09308,1.09317,1.09061,1.09077,1.09355,1.092485111111111,1.092573333333331,1.092701111111109,1.092458000000001,1.0920420000000017,1.0921569,1.0947532999999998,1.0924202952481958,1.0926839611847348,-5059,-83646,-81248.4,0.015282675000030204,-68.66548722580616,-0.1857613469985337
2023-05-12T04:00:00-04:00,1.09077,1.09113,1.09044,1.0907499999999999,1.0934912,1.0921204444444446,1.0923877777777755,1.0926475555555535,1.092399000000001,1.0920216000000018,1.0921317,1.0947212999999998,1.0920862361985566,1.0925703689477877,-3844,-87490,-82042.2,0.001312123718111453,-68.73596954563574,-0.15287160615880893
2023-05-12T04:15:00-04:00,1.0907499999999999,1.09132,1.09065,1.09108,1.0933691520000002,1.091858888888889,1.09224222222222,1.09255422222222,1.0923540000000012,1.0920090000000018,1.0921124,1.0946932499999997,1.0918849889588453,1.0923990951582305,3323,-84167,-83180.2,-0.007249643184913953,-67.73061543149359,-0.11992054119864905
2023-05-12T04:30:00-04:00,1.09108,1.09127,1.09079,1.09088,1.0932519859200003,1.0915864444444443,1.0920433333333308,1.092409111111109,1.092302000000001,1.0919952000000017,1.0920887,1.0946607,1.0916839911670764,1.0921816761265846,-2626,-86793,-84136.6,-0.016278692612503583,-68.21197335208598,-0.1638189023218317
2023-05-12T04:45:00-04:00,1.09088,1.0914,1.09079,1.09135,1.0931395064832004,1.0914477777777778,1.091863333333331,1.0922219999999978,1.0922585000000011,1.0919916000000018,1.0920721999999998,1.0946327499999997,1.091617192933661,1.0919385409012676,2166,-84627,-85344.6,-0.025879143180508917,-67.27876346648908,-0.14821998773982403
2023-05-12T05:00:00-04:00,1.09135,1.09173,1.09081,1.09082,1.0930315262238723,1.091239111111111,1.091634444444442,1.09203422222222,1.092174000000001,1.0919768000000016,1.0920527999999998,1.09459855,1.0914577543469288,1.0917460327210142,-2334,-86961,-86007.6,-0.03946199837013133,-68.41224035291445,-0.18849278969330327
2023-05-12T05:15:00-04:00,1.09082,1.09086,1.08988,1.09084,1.0929278651749175,1.091080222222222,1.0913844444444418,1.0918335555555534,1.092096500000001,1.0919630000000018,1.0920283,1.09456315,1.091334203477543,1.0915956261768114,2988,-83973,-85304.2,-0.05086263730504247,-68.35745587884871,-0.2058384945429803
2023-05-12T05:30:00-04:00,1.09084,1.09092,1.09026,1.0904,1.0927449932644224,1.0908833333333334,1.0911077777777751,1.0916066666666642,1.091992500000001,1.0919368000000018,1.0919999999999999,1.0945274499999997,1.0911473627820345,1.0914481009414492,-2541,-86514,-85773.6,-0.06682269093449147,-69.38239079139316,-0.22783628727501226
2023-05-12T05:45:00-04:00,1.0904,1.09108,1.09039,1.09107,1.0925730936685571,1.0908757777777778,1.0908844444444419,1.0913748888888866,1.0919155000000011,1.0919264000000017,1.0919823,1.0945004999999999,1.0911318902256275,1.0913376807531594,2461,-84053,-85225.6,-0.07734534855111096,-67.87022094546518,-0.18388407069931453
2023-05-12T06:00:00-04:00,1.09107,1.09134,1.09086,1.09111,1.0924115080484438,1.090920888888889,1.0909222222222197,1.0911866666666643,1.0918535000000011,1.0919158000000018,1.0919651000000001,1.09447725,1.091127512180502,1.0912397446025275,1870,-82183,-84736.8,-0.08885091729305829,-67.80166439089024,0.031170640923385035
2023-05-12T06:15:00-04:00,1.09111,1.09148,1.09096,1.09115,1.0922596175655372,1.0909664444444445,1.0909666666666642,1.0910531111111088,1.091770500000001,1.0919084000000019,1.0919473,1.0944542,1.0911320097444015,1.091174595682022,1776,-80407,-83426,-0.08014141525151305,-67.73655638161522,0.03667201466882219
2023-05-12T06:30:00-04:00,1.09115,1.09135,1.09072,1.09079,1.092116840511605,1.090931111111111,1.090934444444442,1.0909631111111087,1.091670000000001,1.0918882000000019,1.0919279,1.0944306,1.0910636077955211,1.0911204765456177,-1942,-82349,-83101.2,-0.07097120325207903,-68.37727488961161,-0.026579169263493373
2023-05-12T06:45:00-04:00,1.09079,1.09109,1.0905,1.09053,1.0919826300809088,1.090850222222222,1.090895555555553,1.0909206666666644,1.0915755000000011,1.0918670000000017,1.0919055999999998,1.0944073,1.090956886236417,1.0910823812364943,-1892,-84241,-82646.6,-0.06611431809455377,-68.8282507878137,-0.032084188911710956
2023-05-12T07:00:00-04:00,1.09053,1.0905799999999999,1.09024,1.09034,1.0918564722760542,1.090739111111111,1.090783333333331,1.0909004444444421,1.0914730000000012,1.0918424000000018,1.0918867999999997,1.09438455,1.0908335089891337,1.0910227049891956,-1666,-85907,-83017.4,-0.06199325098096865,-69.11851332071042,-0.09254592935354884
2023-05-12T07:15:00-04:00,1.09034,1.09035,1.08898,1.08906,1.091737883939491,1.0903944444444444,1.0905877777777753,1.0908335555555533,1.091292500000001,1.0917908000000018,1.0918573999999999,1.09435245,1.090478807191307,1.0908929639913567,-3112,-89019,-84384.6,-0.06845555472160242,-72.77183246886652,-0.161346509964979
2023-05-12T07:30:00-04:00,1.08906,1.08951,1.0889,1.08949,1.0915172532243316,1.090174888888889,1.0904377777777752,1.0907277777777753,1.0911185000000012,1.0917480000000017,1.0918281999999997,1.0943224500000002,1.0902810457530456,1.0907227711930854,2897,-86122,-85527.6,-0.06677622937287976,-71.62799282734039,-0.12375783799640298
2023-05-12T07:45:00-04:00,1.08949,1.08965,1.08902,1.0892,1.0912555279018985,1.0899273333333332,1.090304444444442,1.0906017777777754,1.0909345000000013,1.0916988000000019,1.0917976999999999,1.09429015,1.0900648366024366,1.0905230169544686,-2279,-88401,-86738,-0.06536435521430581,-72.2346161097939,-0.1100513573000816
2023-05-12T08:00:00-04:00,1.0892,1.08951,1.08865,1.08895,1.0910199751117087,1.0896564444444445,1.0900688888888863,1.090436444444442,1.0907275000000012,1.0916520000000018,1.0917578999999997,1.0942558,1.0898418692819494,1.090300013563575,-3411,-91812,-88252.2,-0.06151222910772938,-73.01753017516255,-0.19430467339399854
2023-05-12T08:15:00-04:00,1.08895,1.08911,1.08869,1.08883,1.0907355780983037,1.089408666666667,1.089815555555553,1.0902428888888864,1.0905245000000012,1.091603800000002,1.0917123999999998,1.09422215,1.0896394954255595,1.09006121085086,-3652,-95464,-90163.6,-0.0634622488033555,-73.41997289521437,-0.20896151625409534
2023-05-12T08:30:00-04:00,1.08883,1.08897,1.08811,1.08874,1.0904853087265072,1.0891935555555554,1.0895477777777751,1.0900348888888867,1.0903075000000013,1.0915440000000018,1.0916713999999998,1.09418875,1.0894595963404476,1.0898573686806883,-4008,-99472,-92254.2,-0.067085225136308,-73.7512642813809,-0.22086789167392412
2023-05-12T08:45:00-04:00,1.08874,1.08897,1.0884,1.08868,1.0901527655047962,1.0890199999999999,1.0893133333333307,1.0898099999999977,1.0902030000000011,1.0914818000000017,1.0916266999999997,1.0941548,1.089303677072358,1.0896618949445507,-3422,-102894,-95608.6,-0.07053557506206311,-73.93984925116231,-0.19343778362469718
2023-05-12T09:00:00-04:00,1.08868,1.08944,1.0886,1.08906,1.0898667783341247,1.0889693333333332,1.0891499999999974,1.0895791111111088,1.0901185000000013,1.0914260000000018,1.0915852,1.09412665,1.0892549416578865,1.0894999159556407,4222,-98672,-97662.8,-0.07894074726372559,-72.46617470951622,-0.1347968419025687
2023-05-12T09:15:00-04:00,1.08906,1.0892,1.0883,1.08893,1.0896208293673473,1.0889253333333333,1.0889933333333306,1.0893639999999976,1.0900110000000012,1.091362000000002,1.0915437,1.0940967,1.0891899533263092,1.0893695327645125,-3808,-102480,-99796.4,-0.08567447021349672,-72.9207318505368,-0.12931746060862973
2023-05-12T09:30:00-04:00,1.08893,1.08895,1.08789,1.08807,1.08944,1.0887406666666666,1.0888833333333308,1.0891775555555532,1.0898705000000013,1.0912842000000018,1.0914878999999997,1.0940614,1.0889659626610473,1.08923482621161,-4647,-107127,-102129,-0.09336215156300724,-76.59077492033867,-0.09090408241968527
2023-05-12T09:45:00-04:00,1.08807,1.08916,1.08805,1.08889,1.0892,1.0887419999999999,1.0888166666666639,1.0890313333333308,1.0897475000000012,1.0912266000000017,1.0914440999999997,1.0940313,1.088950770128838,1.0891330609692882,4486,-102641,-102762.8,-0.08623499648251369,-73.20999978638663,-0.05507163902377772
2023-05-12T10:00:00-04:00,1.08889,1.08973,1.08803,1.0887499999999999,1.08789,1.0887286666666667,1.0887666666666638,1.0889219999999975,1.0896440000000012,1.0911598000000018,1.0914061999999998,1.09400025,1.0889106161030704,1.0890544487754306,-8620,-111261,-104436.2,-0.08167385518942537,-74.31828436976994,-0.04131472640470634
2023-05-12T10:15:00-04:00,1.0887499999999999,1.08876,1.08766,1.08811,1.08973,1.0885973333333334,1.0886733333333307,1.0888266666666642,1.0895075000000012,1.0910738000000018,1.0913688999999998,1.09396805,1.0887504928824563,1.0889535590203445,-5900,-117161,-108134,-0.0798435732019476,-77.78648184393742,-0.07713852793977445
2023-05-12T10:30:00-04:00,1.08811,1.08812,1.08733,1.0874,1.08973,1.0883426666666665,1.088514444444442,1.0887308888888865,1.089357500000001,1.0909746000000018,1.0913339999999998,1.0939079999999999,1.088480394305965,1.0888116472162757,-5566,-122727,-112183.4,-0.07904692591634638,-81.4183389172112,-0.1313336333495626
2023-05-12T10:45:00-04:00,1.0874,1.08757,1.08615,1.08624,1.089634,1.0878877777777778,1.0882366666666643,1.088601555555553,1.089116000000001,1.0908510000000018,1.0912948999999998,1.0938388,1.0880323154447722,1.0886249177730207,-6899,-129626,-116683.2,-0.0846529526229971,-88.77794899629784,-0.2296232341973241
2023-05-12T11:00:00-04:00,1.08624,1.08647,1.0859,1.08595,1.0894249599999999,1.0874304444444445,1.0879333333333308,1.0884248888888866,1.088858000000001,1.0907294000000016,1.0912452999999998,1.0937693000000002,1.0876158523558177,1.0883579342184166,-5049,-134675,-123090,-0.08790345749801241,-90.12591077270142,-0.2507623911525996
2023-05-12T11:15:00-04:00,1.08595,1.08624,1.08564,1.08613,1.0891429631999998,1.0870697777777778,1.0876077777777753,1.0881931111111087,1.088607000000001,1.0906150000000017,1.0911976999999997,1.0937080000000001,1.087318681884654,1.0880395473747335,3086,-131589,-127155.6,-0.08956278820755537,-89.61439550956756,-0.2690393550401151
2023-05-12T11:30:00-04:00,1.08613,1.08633,1.08582,1.08599,1.0887926668799999,1.0867462222222222,1.0872811111111085,1.0879146666666641,1.0883670000000012,1.0904962000000018,1.0911421,1.09364985,1.0870529455077234,1.087700037899787,-2495,-134084,-130540.2,-0.09521338797171024,-89.93599605462208,-0.2699898065073001
2023-05-12T11:45:00-04:00,1.08599,1.08603,1.08542,1.08555,1.088477400192,1.0864,1.0870011111111084,1.0876119999999976,1.088118000000001,1.0903676000000018,1.0910802999999998,1.0935847,1.0867523564061787,1.0873544303198297,-2311,-136395,-133273.8,-0.1033654824399852,-90.87232143515044,-0.2316027461468543
2023-05-12T12:00:00-04:00,1.08555,1.0856999999999999,1.08535,1.08548,1.0881105121689598,1.0860957777777778,1.0866222222222197,1.0872891111111085,1.087875000000001,1.0902388000000016,1.0910193,1.09351945,1.086497885124943,1.087047544255864,-2546,-138941,-135136.8,-0.10509089699496711,-91.03649627739634,-0.3131629457520882
2023-05-12T12:15:00-04:00,1.08548,1.08557,1.0851,1.08514,1.0877240404653055,1.0857993333333336,1.0862211111111086,1.086946666666664,1.087679000000001,1.0900972000000015,1.0909532999999998,1.0934518000000002,1.0862263080999544,1.0867696354046914,-2079,-141020,-136405.8,-0.11682537570077318,-91.68769206174981,-0.3315729047072231
2023-05-12T12:30:00-04:00,1.08514,1.08538,1.08484,1.08487,1.0873041939908565,1.0855291111111112,1.0858611111111085,1.0865973333333305,1.087448000000001,1.0899444000000016,1.0908912,1.0933888000000003,1.0859550464799634,1.0864969083237532,-2251,-143271,-138742.2,-0.13417723181727062,-92.24777647482092,-0.297764012829577
2023-05-12T12:45:00-04:00,1.08487,1.08526,1.08487,1.08517,1.0868606390725024,1.085390888888889,1.0856133333333309,1.086263777777775,1.0872465000000011,1.0898000000000017,1.0908273999999998,1.09332855,1.0857980371839708,1.0862459266590025,1630,-141641,-140253.6,-0.1423220416103882,-91.79703122423795,-0.20507632885782182
2023-05-12T13:00:00-04:00,1.08517,1.08562,1.08503,1.0853,1.086496924039452,1.0853282222222222,1.0855088888888864,1.0859653333333308,1.0870640000000011,1.0896564000000017,1.0907565,1.0932677000000002,1.0856984297471766,1.0860351413272022,2352,-139289,-140832.4,-0.14458023418937146,-91.51526891971432,-0.08653704522022415
2023-05-12T13:15:00-04:00,1.0853,1.08568,1.08517,1.08563,1.0861986777123507,1.0853524444444445,1.0854733333333308,1.0857355555555528,1.086904000000001,1.0895168000000017,1.0906858,1.0932081,1.0856847437977413,1.0858725130617617,1564,-137725,-140589.2,-0.13566882245546263,-91.03971377367151,-0.029467286707479712
2023-05-12T13:30:00-04:00,1.08563,1.08564,1.0852,1.08538,1.0859541157241275,1.0853337777777776,1.0853899999999976,1.0855693333333307,1.086736000000001,1.0893774000000018,1.0906120999999998,1.0931482000000001,1.085623795038193,1.0857520104494096,-1907,-139632,-140311.6,-0.1258179084151559,-91.47885970736914,-0.06905250752672594
2023-05-12T13:45:00-04:00,1.08538,1.08558,1.08526,1.08546,1.0857535748937845,1.0853477777777778,1.0853311111111088,1.0854633333333308,1.086575000000001,1.0892304000000017,1.0905414999999998,1.09309295,1.0855910360305545,1.0856792083595277,1463,-138169,-139291.2,-0.1176283447368589,-91.3710265060939,-0.04880339597969773
2023-05-12T14:00:00-04:00,1.08546,1.08546,1.08518,1.08534,1.08564,1.0853495555555557,1.0853077777777755,1.0854022222222197,1.086389000000001,1.0890812000000019,1.0904762,1.093035,1.0855408288244437,1.0856277666876224,-1764,-139933,-138949.6,-0.10898967604614306,-91.56604060150065,-0.019345032472022797
2023-05-12T14:15:00-04:00,1.08534,1.08539,1.08491,1.08491,1.08558,1.08527,1.085244444444442,1.0853493333333308,1.086188000000001,1.0889310000000016,1.0904093999999998,1.0929734,1.085414663059555,1.0855710133500982,-2079,-142012,-139494.2,-0.09670933151667012,-92.38971797448963,-0.05251133139255992
2023-05-12T14:30:00-04:00,1.08491,1.08517,1.08488,1.08496,1.08546,1.0852131111111112,1.0852244444444419,1.0852995555555531,1.086032500000001,1.0887824000000017,1.0903447999999998,1.0929121,1.085323730447644,1.0854988106800787,1664,-140348,-140018.8,-0.0841081831859671,-92.31302958559118,-0.016587721400010046
2023-05-12T14:45:00-04:00,1.08496,1.08537,1.0849,1.08531,1.08484,1.0852302222222223,1.0852733333333309,1.0852762222222196,1.085853500000001,1.0886352000000017,1.0902851999999998,1.0928535,1.085320984358115,1.085438248544063,2204,-138144,-139721.2,-0.07045088213771145,-91.60203563189688,0.0405578548581854
2023-05-12T15:00:00-04:00,1.08531,1.0855,1.08524,1.08535,1.0848506,1.0852455555555556,1.085293333333331,1.0852686666666642,1.085683500000001,1.0884828000000017,1.090226,1.09279565,1.085326787486492,1.0853853988352506,1710,-136434,-139374.2,-0.05051656797818274,-91.53901216394758,0.016587262825185824
2023-05-12T15:15:00-04:00,1.08535,1.08546,1.08511,1.08513,1.084876576,1.085212888888889,1.0852744444444422,1.0852619999999973,1.085534500000001,1.0883278000000016,1.0901623,1.0927384,1.0852874299891937,1.0853347190682006,-1359,-137793,-138946.2,-0.03501500078938989,-91.81448090674957,-0.015663871740532895
2023-05-12T15:30:00-04:00,1.08513,1.0854,1.08513,1.08524,1.0849015129600001,1.0852060000000001,1.0852311111111088,1.085259333333331,1.085426500000001,1.0881708000000017,1.0900973999999999,1.0926827499999998,1.085277943991355,1.0853073752545606,1015,-136778,-137899.4,-0.022982172694732066,-91.71159000888474,-0.0359238414561234
2023-05-12T15:45:00-04:00,1.08524,1.08532,1.08505,1.08517,1.0849254524416,1.0851937777777778,1.0852077777777756,1.0852559999999976,1.085373000000001,1.0880164000000017,1.0900306,1.09262485,1.0852563551930838,1.0852939002036486,-1727,-138505,-137530.8,-0.017439029205342158,-91.82298472341796,-0.01934806242975211
2023-05-12T16:00:00-04:00,1.08517,1.0852,1.08496,1.085,1.0849484343439362,1.0851522222222223,1.0851566666666643,1.085232666666664,1.085325500000001,1.0878548000000015,1.08996,1.0925637,1.0852050841544671,1.085270720162919,-972,-139477,-137797.4,-0.01550074015693311,-91.9752557961531,-0.04237834650748318
2023-05-12T16:15:00-04:00,1.085,1.0850899999999999,1.08478,1.08503,1.0855,1.085126888888889,1.0851222222222199,1.0851984444444418,1.085270500000001,1.0877400000000015,1.0898910000000002,1.09250195,1.0851700673235738,1.0852393761303354,821,-138656,-138241.8,-0.015426776777599061,-91.95255533532364,-0.028562478117459274
2023-05-12T16:30:00-04:00,1.08503,1.08512,1.08486,1.08493,1.0854856,1.0850884444444444,1.0851244444444421,1.0851684444444418,1.085217500000001,1.0876236000000015,1.0898226,1.09243695,1.085122053858859,1.0852063009042685,-436,-139092,-138501.6,-0.013940116733574152,-91.99273855606407,0.0018434708869776275
2023-05-12T16:45:00-04:00,1.08493,1.08504,1.08484,1.08489,1.085471488,1.0850415555555555,1.0851166666666643,1.085145555555553,1.0851845000000009,1.0874998000000016,1.0897544000000001,1.0923729999999998,1.0850756430870871,1.0851658407234148,-677,-139769,-139099.8,-0.009298247769475593,-92.01769869174105,-0.00645185075947634
2023-05-14T17:00:00-04:00,1.08608,1.08619,1.0850899999999999,1.08538,1.08478,1.0850942222222222,1.0851244444444421,1.0851288888888861,1.085179500000001,1.0873898000000015,1.0896925,1.09231045,1.0851365144696696,1.0851418725787323,143,-139626,-139324,-0.004682069079536552,-91.95311149856937,0.006449770111766637
2023-05-14T17:15:00-04:00,1.08538,1.0854,1.08532,1.08539,1.0848082000000001,1.0851473333333332,1.0851288888888866,1.0851233333333306,1.0851920000000008,1.0872706000000014,1.0896311,1.0922455500000001,1.0851872115757357,1.085138298062986,53,-139573,-139343.2,-0.003549961428637231,-91.95262319032709,0.0036854470908038884
2023-05-14T17:30:00-04:00,1.08539,1.08551,1.08518,1.08528,1.084835836,1.0851775555555554,1.0851455555555534,1.0851279999999972,1.085212500000001,1.0871598000000013,1.0895683,1.0921805500000001,1.0852057692605885,1.085145438450389,-84,-139657,-139543.4,-0.004809312513986183,-91.96113625936219,0.013823228553269609
2023-05-14T17:45:00-04:00,1.08528,1.08539,1.08517,1.08524,1.0848629192800001,1.0851964444444444,1.0851455555555534,1.0851322222222195,1.085216000000001,1.0870478000000015,1.0895054000000002,1.0921156,1.085212615408471,1.0851635507603112,-30,-139687,-139662.4,-0.005419164711362324,-91.96224196480226,0
2023-05-14T18:00:00-04:00,1.08524,1.08531,1.08447,1.08514,1.08619,1.0851953333333333,1.08514222222222,1.0851373333333307,1.085208000000001,1.0869426000000015,1.0894397,1.0920508500000001,1.0851980923267768,1.0851880406082492,-786,-140473,-139803.2,-0.006209010656604514,-92.03466834053481,-0.002764543804194227
2023-05-14T18:15:00-04:00,1.08514,1.08518,1.08502,1.08511,1.0861555999999999,1.085188888888889,1.0851544444444423,1.0851433333333307,1.085182000000001,1.0868234000000014,1.0893749000000001,1.0919850500000001,1.0851804738614215,1.0851968324865997,-792,-141265,-140131,-0.005928228503956771,-92.0565641327828,0.01013824884793129
2023-05-14T18:30:00-04:00,1.08511,1.08532,1.08508,1.08508,1.0861218879999999,1.085174,1.0851599999999977,1.0851495555555528,1.0851670000000007,1.0867028000000016,1.0893093,1.09191855,1.085160379089137,1.0851914659892798,-579,-141844,-140585.2,-0.0027776900149689534,-92.07257172648296,0.00460816751611527
2023-05-14T18:45:00-04:00,1.08508,1.08532,1.08499,1.085,1.08608885024,1.085142,1.0851677777777757,1.0851539999999973,1.085144000000001,1.0865798000000018,1.0892441000000002,1.0918534000000002,1.0851283032713097,1.0851759727914243,-732,-142576,-141169,-0.0013866740621865622,-92.12654009747871,0.0064520291631731536
2023-05-14T19:00:00-04:00,1.085,1.0852,1.08476,1.08515,1.0860564732351998,1.0851384444444443,1.0851966666666644,1.0851642222222195,1.0851345000000008,1.0864670000000016,1.0891776000000002,1.0917885,1.0851326426170478,1.0851599782331394,774,-141802,-141592,0.002001050551632176,-92.01953548918371,0.02396556332901483
2023-05-14T19:15:00-04:00,1.08515,1.08522,1.08511,1.08518,1.0860247437704957,1.0851351111111112,1.0851744444444422,1.085170666666664,1.0851480000000007,1.0863600000000018,1.0891135,1.0917234,1.0851421140936381,1.0851487825865118,635,-141167,-141730.8,0.005375666966756216,-92.00198031248004,-0.018426726123567595
2023-05-14T19:30:00-04:00,1.08518,1.08526,1.08494,1.08502,1.0859936488950859,1.0851042222222222,1.085133333333331,1.0851664444444418,1.0851510000000009,1.0862536000000018,1.089048,1.0916573,1.0851176912749105,1.0851362260692095,-451,-141618,-141801.4,0.0015753919391752586,-92.0684761933477,-0.034089129253077825
2023-05-14T19:45:00-04:00,1.08502,1.08534,1.08496,1.08529,1.0859631759171842,1.0851355555555557,1.085134444444442,1.0851613333333305,1.085150000000001,1.0861782000000018,1.0889845000000002,1.0915925,1.0851521530199284,1.0851345808553678,564,-141054,-141643.4,-0.0007942668849920701,-91.9281285499863,0.0009214212000650074
2023-05-14T20:00:00-04:00,1.08529,1.08557,1.0852,1.08522,1.0859333123988404,1.0851526666666669,1.08513222222222,1.0851542222222192,1.0851435000000007,1.0860928000000016,1.0889204000000001,1.0915271,1.0851657224159428,1.0851420646842942,-1244,-142298,-141587.8,-0.0009522463798358947,-92.00836516877024,-0.0018429103239752478
2023-05-14T20:15:00-04:00,1.08522,1.08529,1.08496,1.0850899999999999,1.0859040461508636,1.0851442222222223,1.0851266666666644,1.0851402222222195,1.0851415000000009,1.0860106000000016,1.0888547000000002,1.0914605499999999,1.0851505779327542,1.0851456517474358,-1130,-143428,-141913,-0.0011936127673271516,-92.14372942670892,-0.004607700388899637
2023-05-14T20:30:00-04:00,1.0850899999999999,1.08528,1.0848,1.0851,1.0858753652278463,1.0851388888888889,1.0851255555555532,1.0851304444444416,1.0851345000000008,1.0859336000000015,1.0887928000000002,1.09139415,1.0851404623462033,1.0851453213979487,1465,-141963,-142072.2,-0.0014305818913007218,-92.13022824247525,-0.0009215655555718325
2023-05-14T20:45:00-04:00,1.0851,1.08534,1.08487,1.0853,1.0858472579232894,1.0851737777777777,1.0851499999999978,1.085133777777775,1.0851410000000008,1.0858630000000016,1.0887334000000002,1.0913274999999998,1.0851723698769626,1.0851562571183593,1921,-140042,-141757,0.00005704759402270662,-91.77615949305128,0.020275002764762684
2023-05-14T21:00:00-04:00,1.0853,1.0856999999999999,1.08524,1.08568,1.0858197127648237,1.0852797777777778,1.0852255555555532,1.0851519999999972,1.0851750000000009,1.0858018000000016,1.0886729000000002,1.0912631,1.0852738959015702,1.0851806056946876,1963,-138079,-141162,0.003348180003150949,-91.08884722916103,0.06267281105990911
2023-05-14T21:15:00-04:00,1.08568,1.08608,1.08565,1.08599,1.08447,1.0854326666666667,1.0853188888888865,1.0851893333333307,1.0852230000000007,1.0857480000000017,1.0886149000000003,1.0912000499999999,1.085417116721256,1.0852308845557501,2022,-136057,-139913.8,0.008126553073449175,-90.51149478645226,0.07740865318158337
2023-05-14T21:30:00-04:00,1.08599,1.08617,1.0858,1.08602,1.0845022,1.085572888888889,1.0854122222222198,1.0852464444444418,1.0852775000000008,1.0856872000000017,1.0885566000000002,1.09113865,1.085537693377005,1.0853083076446004,2386,-133671,-137962.4,0.011798786159906012,-90.44558257731595,0.07740651320517812
2023-05-14T21:45:00-04:00,1.08602,1.08644,1.08593,1.08632,1.084568912,1.0857544444444445,1.0855566666666643,1.0853326666666638,1.0853490000000008,1.0856350000000017,1.0884985000000003,1.091079,1.085694154701604,1.0854190461156805,1672,-131999,-135969.6,0.01620314612192532,-89.98371263016953,0.11981345965971657
2023-05-14T22:00:00-04:00,1.08632,1.08633,1.08564,1.08567,1.08468117728,1.0857771111111112,1.0855988888888866,1.0854224444444418,1.085363500000001,1.0855870000000016,1.0884356000000002,1.09101555,1.085689323761283,1.0855224368925445,-1424,-133423,-134645.8,0.018769208494907052,-90.83576359121237,0.035013682978726875
2023-05-14T22:15:00-04:00,1.08567,1.0858,1.0855299999999999,1.08572,1.0847867066432,1.0858013333333332,1.085654444444442,1.0855082222222197,1.085380000000001,1.0855236000000017,1.0883751000000002,1.09095115,1.0856954590090264,1.0856067495140356,1525,-131898,-133409.6,0.02123898619714448,-90.765530463282,0.046073607194849424
2023-05-14T22:30:00-04:00,1.08572,1.08584,1.08562,1.08568,1.084885904244608,1.0858064444444444,1.0857199999999976,1.0855884444444417,1.0854000000000008,1.0854622000000018,1.0883110000000003,1.0908869499999998,1.0856923672072212,1.0856617996112286,-1246,-133144,-132827,0.024204502379714932,-90.81143548483458,0.05437336995088799
2023-05-14T22:45:00-04:00,1.08568,1.08583,1.08552,1.0855299999999999,1.0849791499899315,1.0857684444444444,1.0857677777777752,1.0856595555555528,1.0854145000000008,1.0854106000000017,1.0882422,1.0908182499999999,1.0856598937657769,1.0856862396889828,-1265,-134409,-132974.6,0.027161216362798432,-90.9862107408954,0.039627684084409774
2023-05-14T23:00:00-04:00,1.0855299999999999,1.08601,1.08548,1.08592,1.0850668009905355,1.0857988888888888,1.0858366666666643,1.0857155555555529,1.085453500000001,1.0853810000000017,1.0881778000000002,1.0907508,1.0857119150126215,1.0856897917511863,1124,-133285,-133231.8,0.03173174240309768,-90.58238956598534,0.05712706164194831
2023-05-14T23:15:00-04:00,1.08592,1.08608,1.08588,1.08605,1.0851491929311035,1.0858415555555556,1.0858777777777755,1.0857713333333308,1.0855005000000009,1.0853772000000017,1.0881141,1.0906846000000001,1.0857795320100971,1.0857078334009491,989,-132296,-133006.4,0.03464776671509292,-90.4639922623166,0.03408002357969028
2023-05-14T23:30:00-04:00,1.08605,1.08621,1.08596,1.08599,1.0852266413552372,1.085864,1.0858777777777755,1.0858159999999977,1.085546000000001,1.0853780000000015,1.0880537000000001,1.09062025,1.0858216256080777,1.0857330667207594,-949,-133245,-133275.8,0.03364186699429779,-90.51642078770672,0
2023-05-14T23:45:00-04:00,1.08599,1.08607,1.08584,1.08599,1.0852994428739229,1.0858864444444445,1.085874444444442,1.0858468888888866,1.0855955000000008,1.0853752000000016,1.0879951,1.09055795,1.0858553004864622,1.0857656533766076,0,-133245,-133296,0.029648755028724622,-90.51642078770672,-0.00276238006666309
2023-05-15T00:00:00-04:00,1.08599,1.08604,1.08576,1.08577,1.0853678763014876,1.0858655555555554,1.085813333333331,1.0858559999999977,1.085626500000001,1.0853708000000015,1.0879335,1.09049715,1.0858382403891698,1.0858013227012862,-888,-134133,-133240.8,0.023967351063878733,-90.69631194692559,-0.05062964872229642
2023-05-15T00:15:00-04:00,1.08577,1.08619,1.08572,1.08613,1.0854322037233983,1.085928888888889,1.085864444444442,1.0858615555555535,1.085674000000001,1.0853824000000016,1.0878750000000001,1.09043965,1.0858965923113357,1.085838258161029,645,-133488,-133281.4,0.017917719725712374,-90.4824545001366,0.0423701493087335
2023-05-15T00:30:00-04:00,1.08613,1.08623,1.08608,1.0861399999999999,1.0854926714999944,1.0859839999999998,1.0859111111111086,1.08586822222222,1.085730000000001,1.0853956000000016,1.0878172000000002,1.09038225,1.0859452738490685,1.0858714065288235,685,-132803,-133382.8,0.018035388309202247,-90.47614770444926,0.038684006926266896
2023-05-15T00:45:00-04:00,1.0861399999999999,1.08635,1.08582,1.08629,1.0855495112099947,1.0860597777777778,1.0859788888888864,1.0858884444444423,1.085780000000001,1.0854186000000015,1.0877579000000004,1.0903234499999999,1.0860142190792548,1.0859099252230586,772,-132031,-133140,0.01771422080462208,-90.36953161444238,0.05618598482057323
2023-05-15T01:00:00-04:00,1.08629,1.08643,1.08615,1.08643,1.085602940537395,1.08615,1.0860788888888864,1.0859293333333313,1.0858405000000009,1.0854498000000015,1.0876971000000002,1.0902658,1.0860973752634038,1.085958340178447,1346,-130685,-132628,0.019621060054821934,-90.19606044191936,0.0829088095216275
2023-05-15T01:15:00-04:00,1.08643,1.08673,1.08643,1.08663,1.0856531641051514,1.0862602222222222,1.0861577777777756,1.08599822222222,1.085917500000001,1.0854790000000016,1.0876395000000003,1.09020985,1.086203900210723,1.0860314721427575,1483,-129202,-131641.8,0.023566619773226098,-89.92305619866396,0.06538234860763117
2023-05-15T01:30:00-04:00,1.08663,1.0867499999999999,1.08642,1.08669,1.0857393109767393,1.0863666666666667,1.0862288888888865,1.0860711111111088,1.085997000000001,1.0855068000000017,1.0875816000000003,1.0901554999999998,1.0863011201685784,1.086112377714206,1713,-127489,-130442,0.023639511266001403,-89.82847018502554,0.05892914690851931
2023-05-15T01:45:00-04:00,1.08669,1.08693,1.08657,1.0867499999999999,1.0858403798790652,1.0864708888888888,1.0863133333333308,1.0861515555555532,1.0860695000000011,1.0855292000000014,1.0875230000000002,1.09010205,1.0863908961348627,1.0862015021713651,1845,-125644,-129010.2,0.022848558909765566,-89.72660120675215,0.06998222819730125
2023-05-15T02:00:00-04:00,1.0867499999999999,1.08718,1.08652,1.08717,1.0859711342935774,1.086642222222222,1.086444444444442,1.0862446666666643,1.086144000000001,1.0855650000000014,1.0874712000000002,1.0900522000000001,1.0865467169078902,1.086308001737092,2962,-122682,-127140.4,0.025512351503184184,-88.58186690723501,0.10865661746424542
2023-05-15T02:15:00-04:00,1.08717,1.0872,1.0865,1.08653,1.0861403754924766,1.0866593333333332,1.0865288888888864,1.0863346666666645,1.086171000000001,1.0855864000000015,1.0874084000000002,1.0899988,1.0865433735263121,1.0863972013896739,-2188,-124870,-125977.4,0.02675650093542268,-89.86990833589837,0.06999640807906776
2023-05-15T02:30:00-04:00,1.08653,1.08663,1.086,1.08625,1.0872,1.0866035555555553,1.0865422222222199,1.0864115555555531,1.086182500000001,1.0856046000000015,1.0873429000000001,1.0899427,1.0864846988210497,1.086453361111739,-2209,-127079,-125552.8,0.030035506870625617,-90.4391701142203,0.011048401204266336
2023-05-15T02:45:00-04:00,1.08625,1.08703,1.08613,1.08696,1.0872,1.0866871111111112,1.086633333333331,1.0864924444444422,1.086214500000001,1.0856456000000014,1.0872883,1.08988985,1.0865797590568398,1.0865090888893914,1995,-125084,-125071.8,0.03355456079435854,-89.1351885261881,0.07549671313090789
2023-05-15T03:00:00-04:00,1.08696,1.0872,1.08653,1.08682,1.086,1.0867244444444444,1.0866922222222197,1.08656822222222,1.0862720000000012,1.0856828000000014,1.0872326,1.08983535,1.0866278072454718,1.086556471111513,-3616,-128700,-125683,0.03762201839375568,-89.6009278358224,0.04878991797769651
2023-05-15T03:15:00-04:00,1.08682,1.0872,1.08643,1.08717,1.086024,1.08682,1.0867744444444418,1.0866342222222198,1.0863445000000012,1.0857200000000016,1.0871776000000002,1.08978205,1.0867362457963774,1.0865943768892106,3105,-125595,-126265.6,0.03914501672545956,-88.60099224391185,0.06811299393425835
2023-05-15T03:30:00-04:00,1.08717,1.08771,1.08707,1.08755,1.0860475200000002,1.086975111111111,1.0868766666666643,1.0867037777777753,1.0864380000000011,1.0857640000000017,1.0871234,1.0897294,1.0868989966371019,1.0866655015113682,2898,-122697,-125831,0.04142990141335729,-87.58805038569268,0.0846654334962252
2023-05-15T03:45:00-04:00,1.08755,1.08763,1.08722,1.08738,1.0861140192,1.0870757777777778,1.086953333333331,1.0867859999999976,1.0865305000000012,1.0858090000000016,1.0870684,1.08967715,1.0869951973096814,1.0867676012090948,-2579,-125276,-125470.4,0.04087895673856342,-87.99118587371623,0.06349556911355396
2023-05-15T04:00:00-04:00,1.08738,1.0879,1.08713,1.08789,1.086177858432,1.087263111111111,1.0870799999999976,1.0868753333333312,1.0866290000000012,1.0858620000000017,1.0870164,1.08962965,1.0871741578477452,1.0868864809672758,2732,-122544,-124962.4,0.04157591428014306,-86.7098306896959,0.10489993098690048
2023-05-15T04:15:00-04:00,1.08789,1.08801,1.08733,1.08748,1.08628118692608,1.0873431111111111,1.0871144444444418,1.0869597777777755,1.0867005000000012,1.0859082000000015,1.0869623,1.08958245,1.0872353262781962,1.0870079847738208,-2702,-125246,-124271.6,0.04145475515844395,-87.72815055659427,0.02851439977188779
2023-05-15T04:30:00-04:00,1.08748,1.08782,1.0873,1.08744,1.0864194919719936,1.0874082222222223,1.0872155555555532,1.087047999999998,1.086773000000001,1.0859570000000014,1.0869059,1.0895427,1.087276261022557,1.0871159878190568,-2360,-127606,-124673.8,0.037845973853607925,-87.81495675073127,0.0837528646240754
2023-05-15T04:45:00-04:00,1.08744,1.08754,1.0866,1.08684,1.0865467326142342,1.087333111111111,1.0872811111111087,1.0871288888888866,1.086815500000001,1.0859932000000014,1.0868666,1.08951175,1.0871890088180456,1.0871739902552455,-2497,-130103,-126155,0.03697261012260685,-89.19268793589995,0.054315304948224674
2023-05-15T05:00:00-04:00,1.08684,1.08685,1.0855299999999999,1.08577,1.08801,1.0870308888888887,1.0871488888888863,1.087167999999998,1.086815500000001,1.0860100000000015,1.0868168,1.08947425,1.0869052070544365,1.0871559922041967,-3519,-133622,-127824.2,0.033520169940739274,-92.65716292761948,-0.10947964966512332
2023-05-15T05:15:00-04:00,1.08577,1.08618,1.08567,1.08598,1.0879603999999998,1.0867971111111112,1.0870555555555532,1.0871631111111089,1.086808000000001,1.0860318000000015,1.0867658,1.0894391,1.0867201656435492,1.0870651937633573,2521,-131101,-129535.6,0.023582208446266947,-92.16957347497286,-0.07728970758726854
2023-05-15T05:30:00-04:00,1.08598,1.08669,1.0859699999999999,1.08668,1.0879117919999999,1.086722,1.0870011111111089,1.0871404444444424,1.086835000000001,1.0860578000000016,1.0867238,1.08940625,1.0867121325148394,1.086960555010686,1869,-129232,-130332.8,0.019883590298216465,-90.96485515603489,-0.0450711480265165
2023-05-15T05:45:00-04:00,1.08668,1.08697,1.08647,1.08688,1.08786415616,1.0866977777777778,1.0869266666666644,1.0870826666666644,1.0868645000000012,1.0860876000000017,1.0866791,1.08937565,1.0867457060118715,1.0868544440085488,2188,-127044,-130220.4,0.013972391710739912,-90.56216071056801,-0.061606362925837745
2023-05-15T06:00:00-04:00,1.08688,1.08723,1.08682,1.08709,1.0878174730368,1.0867304444444446,1.0868944444444422,1.0870053333333312,1.0868975000000012,1.0861238000000017,1.0866418,1.0893473,1.0868145648094971,1.086779555206839,1831,-125213,-129242.4,0.006234561464608087,-90.20838660487127,-0.026669609520142315
2023-05-15T06:15:00-04:00,1.08709,1.0874,1.08666,1.08737,1.087771723576064,1.0868255555555555,1.086836666666664,1.0869428888888868,1.0869345000000012,1.0861664000000018,1.0866071,1.0893177,1.0869256518475976,1.0867836441654712,2550,-122663,-127050.6,0.0020240680087637215,-89.5515872598307,-0.047798950261522394
2023-05-15T06:30:00-04:00,1.08737,1.08754,1.08715,1.08745,1.0877268891045426,1.0869482222222222,1.0868333333333309,1.0868984444444423,1.0869725000000012,1.0862126000000019,1.0865776,1.0892888,1.087030521478078,1.0868457153323772,1714,-120949,-125020.2,-0.005616367900935875,-89.42548482919518,-0.0027586714238399318
2023-05-15T06:45:00-04:00,1.08745,1.08791,1.08738,1.08779,1.0855299999999999,1.0871395555555554,1.0868722222222198,1.0868726666666644,1.0870245000000012,1.0862662000000016,1.0865448,1.08926355,1.0871824171824624,1.0869397722659015,1835,-119114,-122996.6,-0.007583045519231232,-88.85175730149275,0.03218568380784894
2023-05-15T07:00:00-04:00,1.08779,1.0879,1.08734,1.08742,1.0855776,1.087249111111111,1.086936666666664,1.0868746666666642,1.087037000000001,1.0863130000000019,1.0865079,1.0892365000000002,1.0872299337459699,1.0870366178127213,-1916,-121030,-121793.8,-0.010701811948542061,-89.50346397281714,0.05336572080527262
2023-05-15T07:15:00-04:00,1.08742,1.08785,1.0874,1.08771,1.085624248,1.0874037777777776,1.0871522222222196,1.0869262222222198,1.0870960000000012,1.0863672000000018,1.0864735,1.0892104,1.087325946996776,1.0871388942501772,1740,-119290,-120609.2,-0.00506385672259127,-89.03942983697283,0.17867504167549786
2023-05-15T07:30:00-04:00,1.08771,1.08789,1.08734,1.08784,1.08566996304,1.0875413333333332,1.087358888888886,1.087030666666664,1.0871755000000012,1.0864210000000016,1.086444,1.08918595,1.0874287575974209,1.087239515400142,2647,-116643,-119405.2,0.008239245616302814,-88.72306793904056,0.1712738724470039
2023-05-15T07:45:00-04:00,1.08784,1.08804,1.08742,1.08775,1.0857147637792,1.0876195555555557,1.087477777777775,1.0871595555555529,1.0872150000000012,1.0864724000000017,1.0864162,1.0891609000000002,1.0874930060779366,1.0873320123201136,-2206,-118849,-118985.2,0.017949075083988266,-88.90557639616645,0.09846504950858617
2023-05-15T08:00:00-04:00,1.08775,1.08794,1.08737,1.08738,1.085807773228032,1.0876,1.0875333333333306,1.087291777777775,1.0872430000000013,1.0865196000000017,1.0863866,1.0891367000000003,1.0874704048623494,1.0873896098560911,-2216,-121065,-119375.4,0.02254761804658322,-89.65935253958172,0.04600323862799434
2023-05-15T08:15:00-04:00,1.08738,1.08782,1.08738,1.08769,1.0858970622989108,1.0876313333333334,1.0875999999999972,1.0874244444444419,1.0872690000000014,1.0865676000000017,1.0863729,1.0891151500000003,1.0875143238898795,1.087446487884873,2389,-118676,-118904.6,0.026186299822048106,-88.97827508735703,0.05519322227231931
2023-05-15T08:30:00-04:00,1.08769,1.08908,1.0873599999999999,1.08767,1.0859827798069543,1.0876453333333334,1.0876333333333303,1.087520666666664,1.0872750000000013,1.086616600000002,1.0863547,1.0890914500000002,1.0875454591119036,1.0874903903078985,-7559,-126235,-120293.6,0.029330290959917668,-89.11726689568569,0.0275895049523131
2023-05-15T08:45:00-04:00,1.08767,1.0881399999999999,1.0874,1.08789,1.086168613018537,1.0876966666666668,1.0876822222222193,1.0875853333333305,1.0873005000000011,1.0866726000000018,1.0863416000000001,1.0890696500000003,1.0876143672895229,1.087527512246319,3741,-122494,-121463.8,0.03262327670146224,-88.36058518156247,0.04046163041978904
2023-05-15T09:00:00-04:00,1.08789,1.08794,1.08738,1.08776,1.0863432962374249,1.087712222222222,1.087678888888886,1.0876255555555527,1.0872940000000013,1.0867258000000017,1.0863297,1.0890438000000002,1.0876434938316184,1.0875576097970554,-3823,-126317,-122957.4,0.03380957240097126,-88.81742364868677,-0.002757885253585204
2023-05-15T09:15:00-04:00,1.08776,1.08812,1.0876,1.08791,1.0865074984631793,1.0877584444444446,1.0877333333333306,1.0876655555555526,1.0873155000000012,1.0867780000000018,1.0863205,1.0890164500000004,1.0876967950652947,1.0876028878376442,2492,-123825,-123509.4,0.03482558086071437,-88.47378166883857,0.04506078608080405
2023-05-15T09:30:00-04:00,1.08791,1.08794,1.08725,1.08784,1.0866618485553885,1.0877797777777778,1.087747777777775,1.0876951111111084,1.0873355000000013,1.0868212000000017,1.0863115,1.0889914500000004,1.0877254360522357,1.0876451102701157,-4092,-127917,-125357.6,0.03711108142856524,-88.73707550748337,0.011951715071109347
2023-05-15T09:45:00-04:00,1.08784,1.08819,1.0877,1.08794,1.0868069376420653,1.0878182222222221,1.087758888888886,1.0877202222222195,1.087390500000001,1.0868602000000016,1.0863041,1.0889654000000002,1.0877683488417886,1.0876896882160927,3651,-124266,-124963.8,0.03703582056226109,-88.40145629877624,0.009192528312986193
2023-05-15T10:00:00-04:00,1.08794,1.08817,1.08739,1.08749,1.0869433213835413,1.0877644444444443,1.0877299999999972,1.0877297777777748,1.087476500000001,1.0868896000000017,1.0862884000000002,1.0889368000000001,1.0877126790734308,1.0877093505728743,-3940,-128206,-126106.2,0.030969595319582453,-90.03114175937091,-0.023902551137662785
2023-05-15T10:15:00-04:00,1.08749,1.08771,1.0867499999999999,1.08724,1.08908,1.0876664444444444,1.0877144444444415,1.087736888888886,1.0875395000000012,1.0869080000000018,1.0862715,1.0889076000000002,1.0876181432587446,1.0877042804582995,-3886,-132092,-127261.2,0.019840809361466125,-90.92448330733947,-0.012874983906272784
2023-05-15T10:30:00-04:00,1.08724,1.08767,1.08715,1.08743,1.0890334000000002,1.0876095555555556,1.087685555555553,1.0877273333333304,1.087577000000001,1.0869432000000017,1.0862651,1.0888765000000002,1.0875805146069957,1.0876810243666397,3495,-128597,-128215.6,0.013950299103939238,-90.31371659529826,-0.023903869668761228
2023-05-15T10:45:00-04:00,1.08743,1.08749,1.08644,1.08647,1.088987732,1.0873664444444446,1.0875522222222194,1.0876882222222193,1.0875565000000011,1.0869582000000018,1.0862409000000002,1.0888425000000002,1.0873584116855965,1.087607619493312,-4116,-132713,-129174.8,0.0036518067905799275,-93.94738496935395,-0.11032758097583531
2023-05-15T11:00:00-04:00,1.08647,1.0872,1.08638,1.08707,1.08888582272,1.0872700000000002,1.0874611111111083,1.0876286666666637,1.087555500000001,1.0869860000000018,1.0862241000000001,1.0888151500000003,1.0873007293484773,1.0875140955946496,3469,-129244,-130170.4,-0.0026972353337311196,-92.03163948167388,-0.07537526772008593
2023-05-15T11:15:00-04:00,1.08707,1.08739,1.08697,1.08702,1.0887354733568,1.087181777777778,1.0873788888888862,1.0875584444444413,1.087538000000001,1.0870158000000019,1.0862132000000002,1.0887910500000002,1.0872445834787818,1.0874204764757198,-2108,-131352,-130799.6,-0.010390517962643918,-92.12859735927123,-0.06802971243656347
2023-05-15T11:30:00-04:00,1.08702,1.08748,1.0869199999999999,1.08725,1.088594144955392,1.087156,1.0873055555555529,1.0874766666666638,1.0875280000000012,1.0870424000000016,1.0862117,1.0887728500000002,1.0872456667830255,1.087345981180576,2232,-129120,-130205.2,-0.014554683179423253,-91.65633373946672,-0.060666783097855795
2023-05-15T11:45:00-04:00,1.08725,1.08751,1.08723,1.0873,1.0884612962580684,1.0871548888888887,1.087245555555553,1.0873886666666637,1.087503500000001,1.0870674000000018,1.0862223,1.0887586000000002,1.0872565334264204,1.087281184944461,2002,-127118,-129909.4,-0.019507081661708,-91.56426659759524,-0.04963965289012952
2023-05-15T12:00:00-04:00,1.0873,1.08748,1.08677,1.08693,1.0883364184825843,1.0870917777777778,1.0871333333333306,1.0873048888888859,1.0874790000000012,1.087086200000002,1.0862321000000001,1.0887387000000002,1.0871912267411363,1.0872477479555687,-1982,-129100,-129186.8,-0.024109996934726853,-92.23872626833925,-0.09283600198539951
2023-05-15T12:15:00-04:00,1.08693,1.08716,1.08684,1.08706,1.0882190333736292,1.087077111111111,1.0870855555555528,1.0872297777777749,1.0874465000000013,1.087107600000002,1.0862414,1.0887195500000002,1.087164981392909,1.0872205983644552,1414,-127686,-128875.2,-0.030626221720791953,-92.06960774184725,-0.03954059347673564
2023-05-15T12:30:00-04:00,1.08706,1.08716,1.08688,1.08697,1.0881086913712115,1.087054,1.087055555555553,1.087165111111108,1.0874030000000012,1.087131600000002,1.0862512000000002,1.0886966500000002,1.0871259851143271,1.0871968786915642,-1267,-128953,-128395.4,-0.03216864673599448,-92.17450535559433,-0.02483352341709213
2023-05-15T12:45:00-04:00,1.08697,1.08788,1.08688,1.08787,1.0880049698889387,1.087216888888889,1.087104444444442,1.0871248888888858,1.0874090000000012,1.0871664000000019,1.0862744,1.0886773500000002,1.0872747880914617,1.0872027029532516,1805,-127148,-128001,-0.02650647466505675,-90.6799838876607,0.04046237458962839
2023-05-15T13:00:00-04:00,1.08787,1.08788,1.0875299999999999,1.0877,1.0879074716956023,1.0873359999999999,1.0872411111111084,1.087123999999997,1.0874250000000012,1.0871976000000019,1.0862966,1.0886579500000002,1.0873598304731693,1.0872233623626013,-1918,-129066,-128390.6,-0.023804644270258527,-90.97970720018886,0.11321067309726382
2023-05-15T13:15:00-04:00,1.0877,1.08789,1.08768,1.08777,1.08638,1.0874417777777776,1.0873188888888865,1.0871611111111084,1.0874290000000013,1.0872272000000018,1.0863228999999999,1.0886381,1.0874418643785355,1.0872734898900809,1417,-127649,-128100.4,-0.013557380430270676,-90.88851477580711,0.06439327734183842
2023-05-15T13:30:00-04:00,1.08777,1.08786,1.0875,1.08768,1.0864102,1.087514,1.0873922222222197,1.0872224444444416,1.0874295000000012,1.087252200000002,1.0863509999999998,1.0886211000000001,1.0874894915028284,1.087338391912065,-1237,-128886,-128340.4,-0.007904096379999066,-90.9908617793096,0.06071645415906633
2023-05-15T13:45:00-04:00,1.08768,1.08773,1.08747,1.08761,1.086439796,1.0875575555555554,1.0874322222222197,1.087297777777775,1.0874155000000012,1.087271800000002,1.0863754,1.0886014000000004,1.0875135932022626,1.087415913529652,-1069,-129955,-128540.8,-0.0022157802085729,-91.05965958748848,0.033111060013788544
2023-05-15T14:00:00-04:00,1.08761,1.0877999999999999,1.08749,1.08767,1.08646880008,1.087605111111111,1.0874733333333308,1.0873715555555528,1.0874110000000012,1.087291400000002,1.0863991,1.0885778000000002,1.0875448745618101,1.0874699308237217,1116,-128839,-128879,0.0026099164564750868,-90.9980934010798,0.03402924675802276
2023-05-15T14:15:00-04:00,1.08767,1.08771,1.0875,1.08754,1.0864972240784,1.0876184444444446,1.0875411111111086,1.0874315555555527,1.0873925000000013,1.0873072000000021,1.0864182,1.0885520000000002,1.0875438996494482,1.0875067446589775,-1167,-130006,-129067,0.005780407571364552,-91.13757504532848,0.05612136936141237
2023-05-15T14:30:00-04:00,1.08754,1.08765,1.0874,1.08756,1.0865250795968322,1.0876222222222223,1.0875966666666643,1.0874871111111084,1.0873785000000011,1.087315000000002,1.08644,1.08852605,1.0875471197195585,1.087527795727182,1028,-128978,-129332.8,0.013106837144656804,-91.11866999356015,0.04599562121687552
2023-05-15T14:45:00-04:00,1.08756,1.08768,1.0873599999999999,1.08742,1.0865523780048956,1.0875868888888889,1.0876466666666642,1.0875379999999972,1.087352500000001,1.087332800000002,1.0864596,1.0885005500000002,1.0875216957756468,1.0875342365817458,-1246,-130224,-129600.4,0.01825706952363828,-91.27906574184074,0.04139948664637124
2023-05-15T15:00:00-04:00,1.08742,1.08752,1.0873599999999999,1.0875,1.0865791304447976,1.0875575555555554,1.087605555555553,1.0875726666666639,1.0873530000000013,1.087357800000002,1.0864812,1.0884787000000002,1.0875173566205174,1.087534989265397,1214,-129010,-129411.4,0.025058518779739882,-91.18975342461296,-0.03401141680531511
2023-05-15T15:15:00-04:00,1.0875,1.08761,1.08741,1.08755,1.0866053478359017,1.0875464444444445,1.0875888888888865,1.087595777777775,1.0873685000000013,1.087369600000002,1.0865076,1.0884585000000002,1.087523885296414,1.0875307914123176,992,-128018,-129247.2,0.021852792756335067,-91.14414422921057,-0.013790567251987908
2023-05-15T15:30:00-04:00,1.08755,1.08768,1.08744,1.08767,1.0866310408791837,1.0875626666666665,1.0875777777777753,1.0876031111111084,1.0873805000000014,1.0873866000000019,1.0865346999999999,1.0884397500000005,1.0875531082371312,1.0875326331298543,1067,-126951,-128636.2,0.01969341853579294,-91.02641171116552,-0.009193119869088962
2023-05-15T15:45:00-04:00,1.08767,1.0877,1.08748,1.0875,1.0866562200616001,1.0875471111111112,1.0875577777777754,1.0875953333333306,1.087432000000001,1.087393200000002,1.0865565999999998,1.0884209000000005,1.087542486589705,1.0875317065038836,-1296,-128247,-128490,0.0169037942011897,-91.22897314983719,-0.01654898499559328
2023-05-15T16:00:00-04:00,1.0875,1.08764,1.08747,1.08752,1.0866808956603682,1.0875395555555556,1.0875477777777753,1.0875755555555529,1.087454500000001,1.087392600000002,1.0865783,1.0884021500000005,1.087537989271764,1.087534965203107,765,-127482,-127941.6,0.010833695332370856,-91.21490418431985,-0.008275025054929936
2023-05-15T16:15:00-04:00,1.08752,1.08763,1.08727,1.08731,1.0867050777471607,1.087492,1.0875077777777753,1.0875559999999973,1.0874690000000011,1.087391200000002,1.0866001,1.0883812000000004,1.0874923914174113,1.0875299721624856,-681,-128163,-127772.2,0.007023874165885894,-91.34640521418599,-0.03309827429274651
2023-05-15T16:30:00-04:00,1.08731,1.08742,1.08729,1.08737,1.0867287761922175,1.0874644444444443,1.0874888888888863,1.0875359999999974,1.087475000000001,1.087380800000002,1.0866213999999998,1.0883594000000005,1.087467913133929,1.0875187777299886,464,-127699,-127708.4,0.0027324378469642586,-91.32080074076077,-0.01563160895231472
2023-05-15T16:45:00-04:00,1.08737,1.08746,1.08734,1.08741,1.086752000668373,1.0874486666666667,1.0874722222222197,1.0875148888888861,1.0874805000000012,1.0873794000000019,1.0866438,1.0883372000000004,1.0874563305071432,1.087499422183991,592,-127107,-127739.6,0.0008363653402351811,-91.29902342485173,-0.013792342491457436
2023-05-15T17:00:00-04:00,1.08741,1.08747,1.08723,1.08735,1.0867747606550056,1.0874242222222221,1.087464444444442,1.0874962222222195,1.0875015000000012,1.0873776000000017,1.0866672999999998,1.0883136500000006,1.0874350644057145,1.087477937747193,-139,-127246,-127539.4,-0.001313659961687737,-91.3066930250945,-0.006437255154403495
2023-05-15T17:15:00-04:00,1.08735,1.08742,1.08729,1.08742,1.0867970654419055,1.0874153333333334,1.087455555555553,1.087477777777775,1.0875195000000013,1.0873892000000018,1.0866912,1.0882911000000004,1.0874320515245717,1.0874567501977546,95,-127151,-127473.2,-0.003459230343077665,-91.30057723900906,-0.0073563218390674
2023-05-15T17:30:00-04:00,1.08742,1.08746,1.08732,1.08733,1.0868189241330675,1.0873902222222223,1.0874311111111088,1.0874624444444418,1.0875375000000012,1.0874204000000018,1.0867151999999998,1.0882689000000003,1.0874116412196573,1.0874406001582035,-120,-127271,-127294.8,-0.006204647399046707,-91.31050900410443,-0.020228954990585166
2023-05-15T17:45:00-04:00,1.08733,1.08754,1.08733,1.08747,1.086840345650406,1.087398,1.0874088888888864,1.0874464444444418,1.0875175000000012,1.087450200000002,1.0867409999999997,1.0882477000000004,1.0874233129757258,1.087431680126563,172,-127099,-127174.8,-0.009129433029300646,-91.2883630134668,-0.01838793016263922
2023-05-15T18:00:00-04:00,1.08747,1.08758,1.08744,1.0875,1.086861338737398,1.0874162222222223,1.0874088888888864,1.0874337777777752,1.0875075000000012,1.087466600000002,1.0867622,1.0882273500000004,1.0874386503805806,1.0874281441012505,316,-126783,-127110,-0.009072657890221115,-91.27964553160524,0
2023-05-15T18:15:00-04:00,1.0875,1.0877,1.08748,1.08764,1.08688191196265,1.0874624444444445,1.0874222222222196,1.0874253333333308,1.0875010000000012,1.087481800000002,1.0867847,1.0882079000000002,1.0874789203044646,1.0874369152810004,381,-126402,-126941.2,-0.007522619307654884,-91.23059725574316,0.011034279829327089
2023-05-15T18:30:00-04:00,1.08764,1.08768,1.08751,1.08751,1.086902073723397,1.0874800000000002,1.0874444444444418,1.0874231111111086,1.0874925000000013,1.087490200000002,1.0868069999999999,1.0881876500000005,1.0874851362435716,1.0874475322248005,-359,-126761,-126863.2,-0.006476181968830427,-91.27350667430076,0.018394018265258112
2023-05-15T18:45:00-04:00,1.08751,1.08772,1.0875,1.08759,1.0869218322489291,1.087509111111111,1.0874688888888864,1.087430666666664,1.0874915000000014,1.0874946000000019,1.0868305,1.0881679500000003,1.0875061089948572,1.0874664257798403,679,-126082,-126625.4,-0.003507398377331537,-91.22355770831419,0.020232303631708526
2023-05-15T19:00:00-04:00,1.08759,1.08759,1.08746,1.08759,1.0869411956039505,1.0875333333333332,1.087488888888886,1.0874466666666638,1.0874875000000013,1.087497400000002,1.0868550000000001,1.0881473500000005,1.0875228871958857,1.0874863406238726,0,-126082,-126422,-0.0013968302898545721,-91.22355770831419,0.016553094049169034
2023-05-15T19:15:00-04:00,1.08759,1.0876,1.08743,1.08746,1.0869601716918715,1.0875275555555557,1.0875011111111084,1.0874651111111082,1.0874835000000014,1.0874908000000019,1.0868785,1.0881267000000003,1.0875103097567087,1.087500672499098,-325,-126407,-126346.8,-0.000017515274343519897,-91.26240506807291,0.010116337885690394
2023-05-15T19:30:00-04:00,1.08746,1.08752,1.08739,1.08742,1.086978768258034,1.0875113333333333,1.0875011111111084,1.0874808888888858,1.0874765000000015,1.087490800000002,1.0869019,1.0881056000000005,1.087492247805367,1.0875033379992787,-550,-126957,-126457.8,0.001151635344170855,-91.2826356972455,0
2023-05-15T19:45:00-04:00,1.08742,1.08747,1.0873,1.08735,1.0869969928928733,1.0874811111111111,1.0875033333333306,1.0874926666666638,1.0874730000000015,1.0874836000000019,1.0869254000000002,1.0880847500000004,1.0874637982442936,1.087499070399423,-294,-127251,-126555.8,0.0014275154925698606,-91.30156122739945,0.0018393679931696012
2023-05-15T20:00:00-04:00,1.08735,1.08783,1.08735,1.08767,1.0870148530350159,1.0875144444444445,1.0875255555555527,1.087503999999997,1.0874815000000013,1.087480200000002,1.0869506000000002,1.0880641000000004,1.0875050385954348,1.0874988563195385,1119,-126132,-126565.8,0.00345927881486495,-90.9722468392081,0.018391311944235517
2023-05-15T20:15:00-04:00,1.08767,1.08799,1.0875,1.08793,1.0870323559743156,1.0875953333333335,1.0875733333333306,1.0875208888888859,1.0875005000000013,1.087483800000002,1.0869781,1.0880458000000004,1.0875900308763478,1.087512285055631,1086,-125046,-126358.6,0.005806224482893441,-90.71264604117178,0.0395402298850715
2023-05-15T20:30:00-04:00,1.08793,1.08803,1.08774,1.08789,1.087070661735343,1.0876586666666666,1.0876011111111084,1.087540888888886,1.0875115000000013,1.087494000000002,1.0870068000000002,1.0880274000000005,1.0876500247010783,1.087540228044505,-955,-126001,-126277.4,0.007903528783360786,-90.74775859436917,0.022985546688250112
2023-05-15T20:45:00-04:00,1.08789,1.08821,1.08785,1.08817,1.0871282220312224,1.0877724444444443,1.0876744444444417,1.0875755555555524,1.0875450000000015,1.087503600000002,1.0870356,1.0880100500000003,1.0877540197608626,1.087592582435604,1130,-124871,-125860.2,0.010587431694051415,-90.45692036623943,0.06068909711176035
2023-05-15T21:00:00-04:00,1.08817,1.08818,1.08783,1.0879699999999999,1.0872147642687247,1.0878315555555556,1.087716666666664,1.0876182222222193,1.0875675000000014,1.087509600000002,1.0870631,1.0879917500000003,1.0877972158086902,1.0876592659484834,-1173,-126044,-125618.8,0.012758949983160078,-90.67251168009686,0.03493963717943572
2023-05-15T21:15:00-04:00,1.0879699999999999,1.08802,1.08781,1.08789,1.0872943831272266,1.0878662222222222,1.0877499999999973,1.0876631111111081,1.0875965000000014,1.087509600000002,1.0870911,1.0879729000000002,1.0878157726469522,1.0877214127587869,-1236,-127280,-125848.4,0.01389713493099009,-90.76339653905421,0.027583924089037867
2023-05-15T21:30:00-04:00,1.08789,1.08793,1.08751,1.08778,1.0873676324770485,1.0878722222222221,1.087785555555553,1.0877055555555526,1.0876170000000012,1.087510000000002,1.0871179,1.0879553500000003,1.0878086181175617,1.0877651302070297,-1455,-128735,-126586.2,0.013585986862410816,-90.91051619269574,0.029426369705540977
2023-05-15T21:45:00-04:00,1.08778,1.0877999999999999,1.08751,1.08774,1.0874350218788846,1.087863111111111,1.0878211111111085,1.0877495555555527,1.0876335000000013,1.0875066000000018,1.0871423000000002,1.0879378500000003,1.0877948944940494,1.0877941041656238,-1129,-129864,-127358.8,0.014540229281222119,-90.95203194036534,0.029427452134398478
2023-05-15T22:00:00-04:00,1.08774,1.08775,1.08682,1.08715,1.08821,1.087728888888889,1.087798888888886,1.0877744444444415,1.0876235000000014,1.087492800000002,1.0871570000000002,1.0879149500000005,1.0876659155952395,1.0877764833324992,-2370,-132234,-128831.4,0.013196251108865768,-92.23754134518606,-0.018393341610335033
2023-05-15T22:15:00-04:00,1.08715,1.08767,1.08712,1.0876,1.0881821999999999,1.087689111111111,1.0877911111111083,1.0877893333333304,1.0876325000000013,1.0874860000000017,1.0871731000000002,1.0878940000000004,1.0876527324761915,1.0877475866659994,1616,-130618,-129746.2,0.01440013099790302,-91.56863641026472,-0.006435775556925768
2023-05-15T22:30:00-04:00,1.0876,1.08816,1.08754,1.08815,1.08682,1.087760888888889,1.0878155555555529,1.0878024444444414,1.0876735000000015,1.0874992000000019,1.0871944,1.0878755000000004,1.0877521859809531,1.0877348693327995,1442,-129176,-130125.4,0.015616791005617015,-90.83941610868318,0.020221889275954055
2023-05-15T22:45:00-04:00,1.08815,1.08837,1.08801,1.08835,1.0868468,1.0878677777777777,1.087866666666664,1.0878186666666636,1.0877175000000014,1.087521400000002,1.0872147,1.0878566000000005,1.0878717487847624,1.0877474954662398,1042,-128134,-130005.2,0.015011938628417808,-90.64789839513269,0.042283686769793355
2023-05-15T23:00:00-04:00,1.08835,1.08845,1.08829,1.08844,1.086907728,1.0879824444444444,1.0878966666666638,1.0878337777777747,1.0877645000000016,1.087541600000002,1.0872424,1.0878390000000004,1.0879853990278099,1.0877855963729917,921,-127213,-129475,0.015821184715239297,-90.57173723374146,0.024812299548783043
2023-05-15T23:15:00-04:00,1.08844,1.08846,1.0879699999999999,1.08804,1.0870002643199999,1.088011111111111,1.0879044444444417,1.0878548888888857,1.0877845000000013,1.087573000000002,1.0872656,1.0878203500000003,1.087996319222248,1.0878516770983935,-998,-128211,-128670.4,0.012261784949934282,-90.938500674997,0.006434000937527184
2023-05-15T23:30:00-04:00,1.08804,1.08825,1.08802,1.08825,1.0871170431744,1.0880802222222221,1.0879444444444415,1.0878855555555522,1.0878215000000013,1.087596600000002,1.0872913,1.0878011500000004,1.0880470553777983,1.0879305416787148,680,-127531,-128053,0.012165151895910864,-90.80725550018722,0.03309158095027217
2023-05-15T23:45:00-04:00,1.08825,1.08836,1.08823,1.08824,1.087224479720448,1.0881393333333331,1.0879955555555525,1.0879215555555521,1.0878540000000014,1.087621000000002,1.0873184,1.0877803000000006,1.0880856443022386,1.087997233342972,-885,-128416,-127901,0.012186650102663371,-90.81538782272328,0.04228796263951599
2023-05-16T00:00:00-04:00,1.08824,1.08827,1.08802,1.08808,1.0873233213428122,1.088156222222222,1.0880333333333305,1.0879548888888855,1.0878785000000013,1.0876376000000019,1.08734,1.0877589000000005,1.0880845154417909,1.0880397866743778,-804,-129220,-128118.2,0.012799209985894991,-90.93359704127813,0.0312574696159015
2023-05-16T00:15:00-04:00,1.08808,1.08819,1.0879699999999999,1.08811,1.0874142556353872,1.0881715555555556,1.088139999999997,1.088003555555552,1.0879110000000014,1.087653800000002,1.0873606,1.0877373500000005,1.0880896123534327,1.0880606293395023,781,-128439,-128363.4,0.013923857814753771,-90.91206369814162,0.08830428183781905
2023-05-16T00:30:00-04:00,1.08811,1.0883,1.08807,1.08828,1.0874979151845563,1.0881995555555555,1.0882155555555526,1.0880657777777745,1.0879540000000012,1.087680800000002,1.0873835,1.0877186000000005,1.088127689882746,1.0880869034716019,771,-127668,-128254.8,0.020720898168242647,-90.79160712665528,0.0625229863920572
2023-05-16T00:45:00-04:00,1.08828,1.08834,1.08821,1.08828,1.0875748819697917,1.0882124444444443,1.0882299999999971,1.0881228888888856,1.0880005000000013,1.087705200000002,1.0874063999999999,1.0877007500000004,1.088158151906197,1.0881091227772814,0,-127668,-128282.2,0.023206182246031982,-90.79160712665528,0.011946882323205761
2023-05-16T01:00:00-04:00,1.08828,1.08829,1.08774,1.08781,1.0876456914122083,1.0881284444444443,1.0881699999999972,1.0881577777777742,1.0880075000000013,1.087722000000002,1.0874268,1.0876801500000004,1.0880885215249576,1.0881096982218252,-770,-128438,-128286.6,0.018067369228265323,-91.12415022218214,-0.04961639178572931
2023-05-16T01:15:00-04:00,1.08781,1.0879699999999999,1.08773,1.08793,1.0877108360992316,1.0880804444444445,1.0881133333333304,1.0881737777777745,1.0880075000000011,1.087723200000002,1.0874448,1.0876599000000005,1.088056817219966,1.0881041585774605,1032,-127406,-127923.8,0.013068931831510706,-91.01030681202768,-0.04685605086178479
2023-05-16T01:30:00-04:00,1.08793,1.08793,1.08698,1.08732,1.08846,1.0879217777777777,1.0880333333333303,1.088152444444441,1.0879790000000014,1.0877156000000021,1.0874566,1.0876369000000006,1.0879094537759728,1.0880681268619683,-1858,-129264,-128088.8,0.0054448041731185596,-92.05208339691825,-0.06617403771918605
2023-05-16T01:45:00-04:00,1.08732,1.08762,1.08705,1.08711,1.0884304,1.0877371111111112,1.0879066666666637,1.0880906666666632,1.0879260000000013,1.0877024000000022,1.0874648,1.0876113500000004,1.0877495630207783,1.0879925014895748,-1602,-130866,-128728.4,0.0003107671177280296,-92.36148633257663,-0.10475534114403115
2023-05-16T02:00:00-04:00,1.08711,1.08728,1.08646,1.08672,1.088401392,1.0874997777777777,1.0877377777777748,1.0879922222222187,1.0878635000000014,1.087683200000002,1.0874677000000001,1.0875824000000005,1.0875436504166227,1.08786960119166,-3777,-134643,-130123.4,-0.0074063568602942996,-93.71648260710306,-0.13967507167538298
2023-05-16T02:15:00-04:00,1.08672,1.0869,1.08626,1.08652,1.08832373632,1.0872562222222222,1.0875644444444417,1.087871111111108,1.0877950000000014,1.087661400000002,1.0874666000000002,1.0875530500000004,1.0873389203332982,1.087719680953328,-3452,-138095,-132054.8,-0.016871105889150317,-94.35178884974138,-0.14337181089625817
2023-05-16T02:30:00-04:00,1.08652,1.08712,1.0865,1.08712,1.0881999121408,1.0871673333333334,1.0874544444444416,1.0877393333333303,1.0877620000000014,1.087650400000002,1.0874709000000002,1.0875262500000005,1.0872951362666385,1.0875673447626624,2663,-135432,-133660,-0.022326294859401696,-92.88122227020266,-0.09098344836457936
2023-05-16T02:45:00-04:00,1.08712,1.08769,1.08702,1.08763,1.088083517412352,1.0872024444444446,1.0873822222222194,1.087609111111108,1.0877565000000016,1.087652200000002,1.0874797000000003,1.0875013500000004,1.0873621090133108,1.0874578758101303,2841,-132591,-134325.4,-0.026082536914112768,-91.54842552283343,-0.059727276068642025
2023-05-16T03:00:00-04:00,1.08763,1.08834,1.0871899999999999,1.08829,1.08626,1.087384,1.0873833333333305,1.0875044444444413,1.0878135000000013,1.0876668000000018,1.0874909000000001,1.0874810500000003,1.0875476872106487,1.0874175006481044,4791,-127800,-133712.2,-0.028397674253654328,-88.64113168209767,0.0009188811702930783
2023-05-16T03:15:00-04:00,1.08829,1.08832,1.08769,1.08776,1.0863016,1.0874593333333333,1.087377777777775,1.0874324444444414,1.0878215000000013,1.0876736000000018,1.0875032000000002,1.0874558000000003,1.087590149768519,1.0874268005184837,-3481,-131281,-133039.8,-0.03584744022833776,-90.33638754220823,-0.0045963909138437295
2023-05-16T03:30:00-04:00,1.08776,1.08881,1.08769,1.08841,1.0863423680000002,1.0876657777777778,1.0874311111111081,1.0874057777777746,1.0878345000000011,1.087691800000002,1.0875248000000002,1.0874338500000003,1.0877541198148153,1.087509840414787,3395,-127886,-130998,-0.03387635895015214,-88.307677164919,0.04412048569301664
2023-05-16T03:45:00-04:00,1.08841,1.08945,1.08841,1.08884,1.08644107328,1.0879475555555556,1.087599999999997,1.0874348888888856,1.0878590000000012,1.087717600000002,1.0875436000000003,1.0874159500000002,1.0879712958518521,1.0876450723318298,3591,-124295,-128770.6,-0.028530745401799805,-86.88897465391695,0.13979325313614813
2023-05-16T04:00:00-04:00,1.08884,1.08945,1.08877,1.08941,1.0866216088832001,1.0883095555555555,1.0878555555555525,1.0875295555555522,1.0879075000000011,1.087752400000002,1.0875695,1.0874010500000002,1.0882590366814817,1.087824457865464,3287,-121008,-126454,-0.01395831938153911,-85.16825351949879,0.21157012629816382
2023-05-16T04:15:00-04:00,1.08941,1.08963,1.0892,1.08955,1.0867913123502082,1.0886484444444446,1.0881699999999972,1.0876868888888855,1.087983000000001,1.0877934000000018,1.0875933000000002,1.0873854500000002,1.0885172293451855,1.0880183662923713,2808,-118200,-124534,0.003610866739359908,-84.80739764338229,0.26041666666667684
2023-05-16T04:30:00-04:00,1.08955,1.08979,1.08924,1.08968,1.0870184073621916,1.0889504444444444,1.0885211111111082,1.0879155555555522,1.0880545000000013,1.087836600000002,1.0876146000000002,1.0873690000000003,1.0887497834761484,1.088250293033897,2929,-115271,-121332,0.02363744423259281,-84.45792308966755,0.29083680005890844
2023-05-16T04:45:00-04:00,1.08968,1.08968,1.08896,1.08911,1.0872955666259725,1.0890682222222223,1.0887422222222194,1.0881777777777746,1.0880980000000011,1.0878726000000019,1.0876319000000003,1.0873501500000002,1.0888218267809187,1.0884638344271178,-2600,-117871,-119329,0.04367576651414898,-85.81795539272889,0.18305246890867025
2023-05-16T05:00:00-04:00,1.08911,1.09046,1.08889,1.08991,1.0875450099633752,1.0893017777777778,1.0889955555555526,1.0884568888888855,1.0881895000000013,1.087923400000002,1.0876521000000001,1.0873342500000005,1.089039461424735,1.0886774675416944,3291,-114580,-117386,0.06200367847365106,-83.40056871920675,0.20963011318185756
2023-05-16T05:15:00-04:00,1.08991,1.09004,1.08928,1.08985,1.0878948087677702,1.0894726666666668,1.089168888888886,1.0887195555555524,1.0882765000000014,1.087972200000002,1.0876758000000002,1.0873190500000005,1.089201569139788,1.0888659740333557,-2992,-117572,-116698.8,0.0746533156206624,-83.56527956689128,0.14334414540242085
2023-05-16T05:30:00-04:00,1.08985,1.09006,1.0894,1.08963,1.0882026317156377,1.0895648888888891,1.0893766666666638,1.0889608888888858,1.0883440000000013,1.088017800000002,1.0876977,1.0873018000000003,1.0892872553118305,1.0890199792266846,-2586,-120158,-117090.4,0.08031009190051451,-84.08729635819256,0.1719129219680847
2023-05-16T05:45:00-04:00,1.08963,1.08995,1.0893599999999999,1.0893599999999999,1.0884735159097612,1.0895615555555556,1.0894822222222191,1.089153111111108,1.088398000000001,1.0880566000000018,1.0877229000000002,1.0872947500000003,1.0893018042494644,1.0891303833813477,-1959,-122117,-118459.6,0.09028169112683411,-84.57271801508566,0.08728328479155688
2023-05-16T06:00:00-04:00,1.0893599999999999,1.08939,1.089,1.0893,1.0887118940005898,1.089525111111111,1.0895333333333304,1.0893113333333297,1.0884725000000013,1.088096000000002,1.0877582000000001,1.0872875000000004,1.0893014433995716,1.0892263067050785,-2150,-124267,-119738.8,0.0939920182909238,-84.69113616886392,0.04224679475404145
2023-05-16T06:15:00-04:00,1.0893,1.08957,1.08915,1.08932,1.088921666720519,1.0894824444444444,1.0895233333333303,1.0894168888888855,1.0885420000000012,1.0881330000000018,1.0877916,1.0872787000000004,1.0893051547196573,1.0892794453640628,1334,-122933,-121409.4,0.09178971571964335,-84.66664337532663,-0.00826135247518597
2023-05-16T06:30:00-04:00,1.08932,1.08971,1.08922,1.08929,1.089,1.0894357777777777,1.0894944444444414,1.0894819999999965,1.088640500000001,1.088168800000002,1.0878177,1.0872707500000005,1.0893021237757259,1.0892995562912504,-1623,-124556,-122806.2,0.08473267649837055,-84.71134098484445,-0.023863062732313978
2023-05-16T06:45:00-04:00,1.08929,1.0897,1.08914,1.0895,1.09046,1.0894368888888888,1.0894744444444415,1.089501555555552,1.088760000000001,1.088206000000002,1.0878439,1.0872615000000003,1.0893416990205806,1.0893104450330007,2060,-122496,-123273.8,0.07472998135361932,-84.314201563754,-0.016518610968364014
2023-05-16T07:00:00-04:00,1.0895,1.08962,1.08921,1.08957,1.0904336,1.089456,1.0895255555555527,1.0895102222222188,1.088902500000001,1.088247200000002,1.0878687,1.0872552500000003,1.0893873592164645,1.0893275560264006,2009,-120487,-122947.8,0.06295274345648291,-84.1851240052409,0.04223632140003351
2023-05-16T07:15:00-04:00,1.08957,1.08972,1.08924,1.08961,1.090407728,1.089472888888889,1.0894922222222194,1.0895019999999966,1.089057000000001,1.088287600000002,1.0878911,1.0872491000000004,1.0894318873731716,1.0893536448211207,2011,-118476,-121789.6,0.054898489832404404,-84.11129671557609,-0.027525208503451384
2023-05-16T07:30:00-04:00,1.08961,1.08963,1.08888,1.08897,1.09038237344,1.0893684444444445,1.0893944444444417,1.089476222222219,1.089149500000001,1.088315200000002,1.0879063,1.0872419500000003,1.0893395098985372,1.0893605158568966,-2074,-120550,-121313,0.035548582844661766,-85.32949405223778,-0.08074505665917255
2023-05-16T07:45:00-04:00,1.08897,1.08897,1.08851,1.08868,1.0903222785024,1.0892255555555557,1.0892888888888859,1.0894351111111078,1.0892020000000011,1.088339600000002,1.0879152,1.0872300000000004,1.0892076079188298,1.0893416126855175,-2526,-123076,-121017,0.01798294571412005,-86.00218475997055,-0.08718555840055857
2023-05-16T08:00:00-04:00,1.08868,1.08872,1.08801,1.08811,1.090213541792256,1.088989777777778,1.0891499999999972,1.089370222222219,1.0891930000000012,1.088353400000002,1.0879221000000001,1.0872150000000003,1.0889880863350638,1.089270890148414,-2877,-125953,-121708.4,0.001928109075950498,-87.50849515420992,-0.11474627304104919
2023-05-16T08:15:00-04:00,1.08811,1.08844,1.08777,1.08805,1.0900372584488756,1.0887697777777778,1.089011111111108,1.08926733333333,1.0892075000000012,1.0883674000000019,1.0879255,1.0871995000000003,1.088800469068051,1.0891535121187315,-2304,-128257,-123262.4,-0.009050402874018457,-87.6355411330171,-0.11475259340860859
2023-05-16T08:30:00-04:00,1.08805,1.08897,1.08681,1.08848,1.089810532603988,1.0886635555555555,1.0889177777777748,1.0891524444444411,1.0892110000000013,1.088383600000002,1.0879319,1.0871879500000003,1.0887363752544408,1.0890144096949854,9676,-118581,-123283.4,-0.019726633972480895,-83.81156245556723,-0.07711232695628226
2023-05-16T08:45:00-04:00,1.08848,1.08863,1.08747,1.08815,1.0894504686915094,1.08851,1.088791111111108,1.0890317777777745,1.0891765000000013,1.088388000000002,1.0879359000000002,1.0871760500000003,1.0886191002035526,1.0888703277559884,-5312,-123893,-123952,-0.029332334165565355,-85.42202842646213,-0.1046553259462715
2023-05-16T09:00:00-04:00,1.08815,1.08891,1.08808,1.08847,1.0891336124485282,1.0884457777777778,1.0886766666666636,1.08890933333333,1.0891295000000014,1.0883996000000018,1.0879468,1.0871667000000005,1.088589280162842,1.088746662204791,4901,-118992,-123135.2,-0.03524396642174559,-83.98075654298974,-0.09453877925652726
2023-05-16T09:15:00-04:00,1.08847,1.0885,1.08741,1.08751,1.08891,1.0882124444444445,1.0884477777777746,1.0887688888888856,1.0890275000000016,1.0883864000000019,1.0879450000000002,1.0871589500000005,1.0883734241302736,1.0886237297638328,-5298,-124290,-122802.6,-0.04521187052081302,-88.65344389312376,-0.18906541112548536
2023-05-16T09:30:00-04:00,1.08751,1.08874,1.0873599999999999,1.08873,1.08681,1.0882688888888887,1.088349999999997,1.0886366666666631,1.0889800000000014,1.0884016000000019,1.0879556000000001,1.0871551500000003,1.088444739304219,1.0885525838110666,5946,-118344,-120820,-0.04934129976972535,-81.98305005766478,-0.0807628417507174
2023-05-16T09:45:00-04:00,1.08873,1.08891,1.08751,1.0875299999999999,1.0868486000000002,1.088104888888889,1.0881899999999969,1.0884911111111077,1.0889010000000015,1.0883944000000019,1.087952,1.0871468000000004,1.0882617914433752,1.088457667048853,-5283,-123627,-121829.2,-0.05904545082822428,-87.80598136294752,-0.1322350477974699
2023-05-16T10:00:00-04:00,1.0875299999999999,1.08761,1.08604,1.08606,1.08891,1.087678888888889,1.087898888888886,1.0883126666666634,1.0887085000000014,1.0883600000000018,1.087935,1.0871323500000003,1.0878214331547003,1.0882981336390827,-6159,-129786,-123007.8,-0.07244113911416358,-96.13102067220717,-0.2406584120219042
2023-05-16T10:15:00-04:00,1.08606,1.08717,1.08596,1.08714,1.08891,1.0875271111111111,1.087791111111108,1.088135555555552,1.0885730000000016,1.0883480000000019,1.0879273,1.0871239000000004,1.0876851465237602,1.0881173069112662,4783,-125003,-124210,-0.07447954644758573,-91.37470886622974,-0.0891453989026767
2023-05-16T10:30:00-04:00,1.08714,1.08729,1.08644,1.08671,1.088792,1.087310888888889,1.0876422222222193,1.0879744444444412,1.0884270000000016,1.0883392000000018,1.087916,1.0871137500000005,1.0874901172190081,1.0879406455290133,-4523,-129526,-125257.2,-0.07361481693407322,-93.16370568356669,-0.12315610495840236
2023-05-16T10:45:00-04:00,1.08671,1.08724,1.08623,1.08663,1.0886787199999999,1.0871084444444443,1.0874366666666637,1.0877917777777744,1.0882905000000014,1.0883198000000018,1.0879029000000002,1.0871035000000004,1.0873180937752065,1.0877153164232107,-5313,-134839,-128556.2,-0.07354572291511896,-93.55483119083213,-0.16996178156694725
2023-05-16T11:00:00-04:00,1.08663,1.0868,1.0855299999999999,1.08566,1.0885699711999999,1.0867531111111113,1.087159999999997,1.0875857777777744,1.0881085000000015,1.088270000000002,1.0878846000000002,1.0870865000000003,1.0869864750201652,1.0874602531385686,-4353,-139192,-131669.2,-0.08328129437616147,-97.44061568049248,-0.22882874603684064
2023-05-16T11:15:00-04:00,1.08566,1.08646,1.08555,1.0864,1.088387572928,1.0866011111111111,1.086929999999997,1.0873919999999966,1.0879625000000015,1.088231000000002,1.0878762000000002,1.0870738500000003,1.086869180016132,1.087269802510855,3483,-135709,-132853.8,-0.08668376182830398,-95.06655750389956,-0.19017520005144986
2023-05-16T11:30:00-04:00,1.0864,1.08647,1.08549,1.08562,1.08821611855232,1.0863391111111111,1.086719999999997,1.0871777777777742,1.0877790000000016,1.0881746000000019,1.0878581,1.0870616000000004,1.0866193440129057,1.0870566420086838,-3843,-139552,-135763.6,-0.09670004688132733,-97.82570698843566,-0.17379150536546306
2023-05-16T11:45:00-04:00,1.08562,1.08661,1.08555,1.08645,1.0879980290681344,1.0862851111111111,1.0864666666666638,1.0869426666666633,1.0876265000000014,1.0881428000000022,1.0878579000000002,1.0870494000000004,1.0865854752103246,1.0868757136069473,3368,-136184,-137095.2,-0.094024042521526,-95.25073600411369,-0.20941831308038356
2023-05-16T12:00:00-04:00,1.08645,1.08687,1.0864,1.0865,1.0877973867426836,1.0862917777777779,1.0863522222222193,1.0867257777777743,1.0874730000000015,1.0881078000000022,1.0878522000000002,1.0870381500000004,1.0865683801682597,1.086725770885558,3552,-132632,-136653.8,-0.10140535740782257,-95.08726782794325,-0.09471003098763846
2023-05-16T12:15:00-04:00,1.0865,1.08678,1.08638,1.0866,1.0876127958032689,1.0863413333333334,1.0864122222222192,1.0865762222222188,1.0873225000000013,1.0880750000000021,1.0878480000000001,1.0870306000000003,1.0865747041346079,1.0866434167084464,1999,-130633,-134942,-0.09696506315003066,-94.90328255412827,0.049721009888955024
2023-05-16T12:30:00-04:00,1.0866,1.08683,1.08639,1.08683,1.0874429721390073,1.0864248888888888,1.0863777777777748,1.0864657777777744,1.0872155000000014,1.088050000000002,1.0878438,1.0870277500000003,1.0866257633076863,1.0865947333667572,1738,-128895,-133579.2,-0.07771988956462,-94.53540108900778,-0.028515186636498747
2023-05-16T12:45:00-04:00,1.08683,1.08721,1.08664,1.08668,1.0872867343678867,1.0864853333333333,1.0863744444444414,1.0863966666666631,1.0871155000000015,1.0880214000000021,1.0878376,1.0870299500000002,1.0866366106461491,1.0865981866934058,-2544,-131439,-131956.6,-0.07192854974743797,-94.88651395854549,-0.002760626109999401
2023-05-16T13:00:00-04:00,1.08668,1.08676,1.08612,1.08634,1.08721,1.0864784444444444,1.0863422222222194,1.0863717777777744,1.0870270000000015,1.0879826000000021,1.0878317000000002,1.0870319000000004,1.0865772885169194,1.086596549354725,-1905,-133344,-131388.6,-0.06508926283411391,-95.48254959001015,-0.02668801708032186
2023-05-16T13:15:00-04:00,1.08634,1.08681,1.08627,1.0868,1.08721,1.0865699999999998,1.086468888888886,1.0863951111111076,1.0869645000000014,1.087953000000002,1.0878291000000002,1.0870352500000002,1.0866218308135356,1.0866072394837802,1818,-131526,-131167.4,-0.05779035139434008,-94.71273535137415,0.10500525026250565
2023-05-16T13:30:00-04:00,1.0868,1.0871,1.0866,1.08661,1.08549,1.0865982222222224,1.0864922222222195,1.0864111111111077,1.0868710000000015,1.087929000000002,1.0878255000000001,1.0870383500000005,1.0866194646508285,1.0866161915870243,-1494,-133020,-131644.8,-0.04274530248526556,-94.97392416256284,0.019329896907220496
2023-05-16T13:45:00-04:00,1.08661,1.08703,1.0866,1.08669,1.0855222,1.0866377777777778,1.0866111111111083,1.0864577777777744,1.0867980000000015,1.0879042000000019,1.0878137,1.0870440500000003,1.0866335717206628,1.08661775326962,1366,-131654,-132196.6,-0.032237839722941974,-94.87335450095489,0.09856119084024836
2023-05-16T14:00:00-04:00,1.08669,1.08674,1.08643,1.08648,1.085553756,1.0866115555555556,1.0866144444444417,1.0865057777777742,1.0866985000000016,1.087887400000002,1.0878015,1.0870490500000003,1.0866028573765303,1.086611002615696,-1811,-133465,-132601.8,-0.01700957478685477,-95.22332551384733,0.00276128675962764
2023-05-16T14:15:00-04:00,1.08648,1.08685,1.08646,1.08682,1.0855846808799998,1.0866526666666665,1.0866499999999972,1.0865673333333299,1.0866640000000016,1.087881600000002,1.087792,1.0870574500000003,1.0866462859012243,1.0866248020925569,1086,-132379,-132408.8,-0.00637576525608834,-94.88347572369932,0.029452369995386647
2023-05-16T14:30:00-04:00,1.08682,1.08702,1.08677,1.08687,1.0856149872624,1.0866966666666664,1.0866799999999972,1.0866095555555524,1.0865710000000015,1.0878846000000018,1.0877839000000002,1.0870674500000002,1.0866910287209794,1.0866386416740457,1457,-130922,-132288,-0.00016651950135877406,-94.81644530467855,0.024848150193262697
2023-05-16T14:45:00-04:00,1.08687,1.08699,1.08668,1.08676,1.085644687517152,1.0867126666666667,1.0866722222222194,1.086645555555552,1.0865325000000017,1.087889400000002,1.0877754000000002,1.0870754000000002,1.0867048229767835,1.0866557133392367,-1210,-132132,-132110.4,0.009939443023124201,-94.93890705263375,-0.006440749703266794
2023-05-16T15:00:00-04:00,1.08676,1.08697,1.08671,1.08681,1.0856737937668088,1.0867402222222222,1.086686666666664,1.0866606666666634,1.0865700000000016,1.0878832000000016,1.0877668,1.0870829500000003,1.0867258583814268,1.0866741706713896,1200,-130932,-131966,0.012911165397054582,-94.8836970706689,0.011963043398237151
2023-05-16T15:15:00-04:00,1.08681,1.0869,1.08671,1.0868,1.0857023178914726,1.0867628888888887,1.086737777777775,1.08668533333333,1.0865530000000017,1.087866600000002,1.0877594000000002,1.0870888000000003,1.0867406867051415,1.0867017365371119,-881,-131813,-131635.6,0.010772102970508185,-94.89180336339722,0.04234401752673241
2023-05-16T15:30:00-04:00,1.0868,1.08682,1.08599,1.08609,1.0857302715336432,1.0866333333333336,1.0866588888888857,1.0866871111111078,1.0865220000000018,1.0878226000000017,1.0877447,1.0870923500000003,1.0866105493641132,1.0866945892296895,-1184,-132997,-131759.2,0.013073499538770664,-95.6653035474237,-0.06532940743466953
2023-05-16T15:45:00-04:00,1.08609,1.08632,1.08579,1.08629,1.0857576661029704,1.0865595555555554,1.0866233333333304,1.0866757777777745,1.0865050000000016,1.087793200000002,1.0877334,1.0870965000000001,1.0865464394912905,1.0866656713837517,2383,-130614,-131697.6,0.010220570607676362,-95.22648171866186,-0.02944938846505167
2023-05-16T16:00:00-04:00,1.08629,1.08647,1.08612,1.08613,1.085784512780911,1.086460888888889,1.0865611111111082,1.086653555555552,1.0865285000000016,1.0877476000000017,1.0877197,1.08710045,1.0864631515930323,1.0866173371070016,-1116,-131730,-131617.2,0.007994309314091229,-95.39085771402215,-0.051532635802288965
2023-05-16T16:15:00-04:00,1.08613,1.0863099999999999,1.08605,1.0862,1.08579,1.0863886666666667,1.086529999999997,1.0866222222222188,1.0865185000000017,1.087694800000002,1.0877062000000002,1.0871069000000002,1.086410521274426,1.0865542696856012,1113,-130617,-131554.2,0.0011175990292212952,-95.31912596920337,-0.025771298137088207
2023-05-16T16:30:00-04:00,1.0862,1.08625,1.08612,1.08624,1.0858162,1.0863306666666668,1.0864655555555527,1.0865677777777742,1.0865495000000016,1.0876314000000018,1.0876919000000003,1.0871133000000002,1.0863764170195407,1.0864814157484812,554,-130063,-131204.2,-0.0003900667101107251,-95.29872456982939,-0.05336670285786082
2023-05-16T16:45:00-04:00,1.08624,1.0863099999999999,1.08612,1.08618,1.085841876,1.0862735555555556,1.0863888888888862,1.0865137777777742,1.0865360000000015,1.0875640000000018,1.0876787000000003,1.0871176500000002,1.0863371336156324,1.086426732598785,-932,-130995,-130803.8,-0.008734650265506813,-95.35020490566691,-0.06348505341025877
2023-05-16T17:00:00-04:00,1.08618,1.08627,1.08589,1.08624,1.08586703848,1.0862437777777778,1.0863311111111082,1.08645533333333,1.0865230000000017,1.0874952000000018,1.0876659000000002,1.0871221000000002,1.086317706892506,1.0863809860790283,74,-130921,-130865.2,-0.013612681093288378,-95.34611718539955,-0.04784865103609389
2023-05-16T17:15:00-04:00,1.08624,1.08639,1.0859699999999999,1.08619,1.08589,1.0862155555555555,1.0862622222222196,1.086395555555552,1.0865025000000017,1.0874368000000019,1.0876547000000003,1.0871274000000002,1.0862921655140048,1.086346788863223,-116,-131037,-130726.6,-0.017500378013368522,-95.35145670521102,-0.05704769002862183
2023-05-16T17:30:00-04:00,1.08619,1.08625,1.08605,1.0861399999999999,1.08589,1.0861911111111113,1.086188888888886,1.08632733333333,1.0864680000000018,1.0873614000000018,1.0876424000000002,1.0871319000000002,1.0862617324112038,1.0863170310905783,-294,-131331,-130869.4,-0.021651292349808282,-95.36499024906618,-0.06072874493928091
2023-05-16T17:45:00-04:00,1.0861399999999999,1.08622,1.08603,1.08621,1.0859142,1.0861953333333334,1.0862022222222194,1.0862746666666632,1.0864445000000018,1.0872886000000017,1.0876304000000003,1.0871371000000003,1.086251385928963,1.086292024872463,256,-131075,-131071.8,-0.024364940257851603,-95.34849145517221,0.011048808109815757
2023-05-16T18:00:00-04:00,1.08621,1.08626,1.08605,1.08619,1.085937916,1.086192888888889,1.0861911111111082,1.0862351111111077,1.0864370000000019,1.087219800000002,1.0876188000000002,1.08714305,1.0862391087431704,1.0862724198979705,-209,-131284,-131129.6,-0.02129731738825254,-95.35233969814547,-0.009205644901452557
2023-05-16T18:15:00-04:00,1.08619,1.08638,1.08616,1.08625,1.08596115768,1.0862046666666667,1.0862044444444416,1.0862097777777744,1.0864095000000018,1.0871576000000018,1.0876071000000003,1.0871491500000001,1.0862412869945364,1.0862571359183764,437,-130847,-131114.8,-0.021271102902025756,-95.3282002750243,0.011048401204266336
2023-05-16T18:30:00-04:00,1.08625,1.08628,1.08619,1.08621,1.0859839345264,1.0862057777777776,1.0862055555555528,1.0861984444444412,1.0863895000000017,1.087095800000002,1.0875959000000004,1.08715555,1.0862350295956291,1.0862457087347015,-358,-131205,-131148.4,-0.017949189985206067,-95.34138324395411,0.0009206407659587062
2023-05-16T18:45:00-04:00,1.08621,1.08627,1.08613,1.08624,1.086006255835872,1.0862126666666667,1.0862055555555528,1.0862017777777746,1.0863670000000019,1.087034200000002,1.0875836000000003,1.0871623000000001,1.0862360236765034,1.0862405669877613,246,-130959,-131074,-0.015959477567052696,-95.33458897765198,0
2023-05-16T19:00:00-04:00,1.08624,1.08634,1.08605,1.0862,1.0860281307191546,1.0862115555555556,1.0862077777777752,1.0862028888888857,1.086353000000002,1.086972400000002,1.0875706000000003,1.0871664,1.0862288189412028,1.0862360535902091,-483,-131442,-131147.4,-0.01418017545714175,-95.35237510226534,0.001841315435759361
2023-05-16T19:15:00-04:00,1.0862,1.08645,1.08613,1.08644,1.0860495681047715,1.086258,1.0862299999999971,1.0862106666666635,1.086334000000002,1.086911200000002,1.0875586000000004,1.0871716500000002,1.0862710551529622,1.0862424428721673,419,-131023,-131095.2,-0.011611545795211477,-95.25979546683908,0.018412137280893536
2023-05-16T19:30:00-04:00,1.08644,1.08655,1.08635,1.08647,1.08605,1.0863060000000002,1.0862611111111085,1.086221999999997,1.086314000000002,1.086849200000002,1.0875482000000003,1.0871776000000002,1.0863108441223697,1.0862563542977342,379,-130644,-131054.6,-0.007960321130535285,-95.24933009369377,0.02577817877167512
2023-05-16T19:45:00-04:00,1.08647,1.08656,1.08632,1.08653,1.086071,1.0863597777777778,1.0863044444444419,1.0862417777777749,1.0863025000000017,1.086787600000002,1.0875376000000003,1.0871840500000003,1.0863546752978956,1.0862802834381875,584,-130060,-130825.6,-0.0033402285820785115,-95.21707885804072,0.03590697331836711
2023-05-16T20:00:00-04:00,1.08653,1.08669,1.08639,1.08668,1.08609158,1.086434888888889,1.0863566666666642,1.086271999999997,1.086296000000002,1.086741800000002,1.0875285000000003,1.0871917500000001,1.0864197402383164,1.08631702675055,1374,-128686,-130371,0.0019813498867045807,-95.02739242508432,0.0432697176420943
2023-05-16T20:15:00-04:00,1.08668,1.08684,1.08647,1.08682,1.0861117484,1.0865275555555556,1.086426666666664,1.086315777777775,1.0862970000000018,1.0867046000000018,1.0875221000000004,1.0872003000000001,1.0864997921906532,1.0863712214004402,1122,-127564,-129595.4,0.007552797252814367,-94.88284205146947,0.058000902236248576
2023-05-16T20:30:00-04:00,1.08682,1.0869,1.08667,1.08684,1.086131513432,1.086610222222222,1.0864922222222195,1.0863682222222193,1.0863345000000018,1.0866792000000018,1.0875163000000005,1.0872091000000002,1.0865678337525226,1.0864305771203522,1047,-126517,-128694.2,0.013360931898738502,-94.86357483150651,0.054315304948224674
2023-05-16T20:45:00-04:00,1.08684,1.08718,1.08679,1.08705,1.08615088316336,1.0867217777777778,1.086585555555553,1.0864331111111083,1.086372500000002,1.086659200000002,1.0875133000000003,1.0872193500000003,1.0866642670020181,1.0865012616962821,1502,-125015,-127568.4,0.016516362507911553,-94.57335732018923,0.07733311238159969
2023-05-16T21:00:00-04:00,1.08705,1.08711,1.08678,1.087,1.0861920478368257,1.0868046666666666,1.0866699999999974,1.0865062222222193,1.086416000000002,1.086629600000002,1.0875066000000004,1.0872286000000002,1.0867314136016144,1.0865766093570257,-1489,-126504,-126857.2,0.020675492944175797,-94.64184543021192,0.06996612166739136
2023-05-16T21:15:00-04:00,1.087,1.08709,1.08672,1.08705,1.0862315659233526,1.0868806666666666,1.0867644444444418,1.0865877777777748,1.086458500000002,1.086607600000002,1.0874978000000004,1.08723795,1.0867951308812915,1.0866516874856207,1622,-124882,-126096.4,0.024097790217742544,-94.56723641457238,0.07825446510771657
2023-05-16T21:30:00-04:00,1.08705,1.08706,1.08619,1.08643,1.08718,1.0868137777777778,1.0867633333333309,1.0866551111111085,1.0864680000000018,1.086566800000002,1.0874832000000005,1.087245,1.0867221047050333,1.0866961499884968,-2425,-127307,-126045,0.025206437700557898,-95.95033746788194,-0.0009204373918546364
2023-05-16T21:45:00-04:00,1.08643,1.08699,1.08641,1.08699,1.0871602,1.086859111111111,1.0868211111111086,1.0867208888888862,1.0865085000000019,1.0865564000000019,1.0874714000000005,1.0872535,1.0867756837640266,1.0867377199907975,1803,-125504,-125842.4,0.026980652032446664,-95.02098168794231,0.04786142277281967
2023-05-16T22:00:00-04:00,1.08699,1.08713,1.08683,1.08712,1.087140796,1.086918888888889,1.086886666666664,1.0867811111111085,1.0865525000000018,1.086524200000002,1.0874629000000002,1.0872629999999999,1.0868445470112214,1.0867737759926381,1280,-124224,-125684.2,0.028842163114047567,-94.86789840290727,0.05430130783320207
2023-05-16T22:15:00-04:00,1.08712,1.0873599999999999,1.08699,1.08713,1.08619,1.0869675555555556,1.086936666666664,1.0868344444444418,1.0865995000000017,1.086516200000002,1.0874553000000005,1.0872732,1.086901637608977,1.0868078207941108,1180,-123044,-124992.2,0.03046255222809922,-94.85704403540431,0.04141053484004853
2023-05-16T22:30:00-04:00,1.08713,1.08723,1.08705,1.0871,1.0862133999999999,1.0870002222222221,1.086967777777775,1.0868751111111083,1.0866475000000018,1.086537000000002,1.0874485000000005,1.0872832000000001,1.0869413100871816,1.0868370566352887,-2338,-125382,-125092.2,0.030338633135687885,-94.92156253825121,0.025763235862429658
2023-05-16T22:45:00-04:00,1.0871,1.08734,1.08687,1.08698,1.086236332,1.0870026666666668,1.0869833333333307,1.0869191111111083,1.0866860000000018,1.086533800000002,1.0874409000000003,1.0872916000000001,1.0869490480697452,1.086882445308231,-2403,-127785,-125187.8,0.028128920640889784,-95.1868187244344,0.012881380884033435
2023-05-16T23:00:00-04:00,1.08698,1.08712,1.08681,1.08698,1.08625880536,1.087002,1.0869755555555531,1.0869499999999972,1.0867255000000018,1.0865392000000018,1.0874392000000004,1.0872981,1.0869552384557961,1.086918356246585,0,-127785,-125644,0.02604214594646679,-95.1868187244344,-0.006439446207627477
2023-05-16T23:15:00-04:00,1.08698,1.08702,1.0867,1.0867499999999999,1.0862808292528,1.086956888888889,1.0869477777777752,1.0869622222222195,1.086750500000002,1.0865416000000019,1.0874307,1.0873019000000002,1.086914190764637,1.086932284997268,-1166,-128951,-126589.4,0.020827070897935597,-95.43353899527673,-0.02299908003680621
2023-05-16T23:30:00-04:00,1.0867499999999999,1.08677,1.08661,1.08671,1.0863024126677439,1.0869093333333335,1.0869099999999974,1.0869568888888863,1.086775500000002,1.0865626000000017,1.0874163000000001,1.08730535,1.0868733526117096,1.0869266279978145,-633,-129584,-127897.4,0.016142516865535732,-95.45683782205371,-0.03127731015132763
2023-05-16T23:45:00-04:00,1.08671,1.08677,1.08644,1.08654,1.086323564414389,1.0868353333333334,1.0869222222222197,1.0869477777777752,1.086790500000002,1.0865654000000018,1.0873982000000002,1.08730645,1.0868066820893676,1.0868997023982518,-932,-130516,-128924.2,0.010003483473246378,-95.60263568900994,0.010124904503746628
2023-05-17T00:00:00-04:00,1.08654,1.08657,1.0863,1.0863099999999999,1.0873599999999999,1.0867128888888888,1.0868466666666643,1.0869204444444418,1.0867960000000019,1.0865792000000019,1.0873769000000002,1.0873096500000001,1.086707345671494,1.0868513619186015,-842,-131358,-129638.8,0.00859254092083901,-95.78087118885362,-0.06255807321134638
2023-05-17T00:15:00-04:00,1.0863099999999999,1.08667,1.0863,1.08659,1.0873388,1.0866615555555557,1.0867877777777752,1.0868828888888862,1.0868035000000018,1.086582000000002,1.0873624000000002,1.0873140000000001,1.0866838765371951,1.0867970895348813,1003,-130355,-130152.8,0.003202978112408564,-95.52234461724878,-0.04875266759880615
2023-05-17T00:30:00-04:00,1.08659,1.08676,1.08657,1.08663,1.087318024,1.0866299999999998,1.0867322222222198,1.086839777777775,1.0868115000000018,1.086584600000002,1.0873462000000003,1.0873187500000001,1.0866731012297561,1.0867488716279052,1350,-129005,-130163.6,-0.0021382220333247106,-95.47264785950202,-0.045992659571527324
2023-05-17T00:45:00-04:00,1.08663,1.08663,1.08638,1.08647,1.08729766352,1.0865775555555557,1.08666222222222,1.0867902222222194,1.0868085000000016,1.0865820000000017,1.0873285000000001,1.0873234500000002,1.0866324809838048,1.0867006973023243,-813,-129818,-130210.4,-0.008211123136164804,-95.59235742025402,-0.05795235028975333
2023-05-17T01:00:00-04:00,1.08647,1.08653,1.08629,1.08646,1.0872777102496,1.086537111111111,1.086604444444442,1.0867266666666642,1.0867975000000016,1.0865746000000018,1.0873123000000002,1.08732615,1.086597984787044,1.0866589578418595,-1193,-131011,-130309.4,-0.013793327061773192,-95.60333793513254,-0.04783896667832673
2023-05-17T01:15:00-04:00,1.08646,1.08647,1.08595,1.08601,1.087238201839616,1.0864182222222223,1.0864966666666642,1.0866566666666642,1.0867570000000017,1.0865612000000018,1.0872913000000002,1.08732595,1.0864803878296352,1.0866135662734877,-1288,-132299,-130497.6,-0.019783576870684758,-96.13681362682858,-0.08923807245764755
2023-05-17T01:30:00-04:00,1.08601,1.08627,1.08592,1.08603,1.0871609097292392,1.0863248888888888,1.0864166666666644,1.0865824444444419,1.0867165000000019,1.086555000000002,1.0872688000000001,1.0873261500000002,1.0863903102637082,1.0865548530187905,1977,-130322,-130491,-0.02506444673957043,-96.1004051223026,-0.06625258799170296
2023-05-17T01:45:00-04:00,1.08603,1.08605,1.08523,1.08531,1.0870616369509,1.0861035555555556,1.0862611111111087,1.0864882222222196,1.0866295000000017,1.0865252000000019,1.0872391000000001,1.0873227500000002,1.0861742482109666,1.0864550824150325,-1841,-132163,-131122.6,-0.03161311922536237,-97.3209238925024,-0.1288292184667545
2023-05-17T02:00:00-04:00,1.08531,1.08552,1.08501,1.08531,1.08687847325581,1.0859133333333333,1.086124444444442,1.086380666666664,1.0865450000000016,1.086499200000002,1.0872141000000002,1.0873204500000002,1.0860013985687733,1.086328865932026,0,-132163,-131591.6,-0.03687455900846128,-97.3209238925024,-0.11320337953504374
2023-05-17T02:15:00-04:00,1.08531,1.0861,1.08528,1.08602,1.086654256465113,1.0858924444444444,1.0860922222222198,1.0862782222222198,1.0864935000000018,1.086485800000002,1.0871950000000004,1.0873199000000002,1.0860051188550186,1.0862102927456212,2619,-129544,-131298.2,-0.037367006589837784,-95.6075977460558,-0.02669587870864684
2023-05-17T02:30:00-04:00,1.08602,1.08643,1.08579,1.08591,1.0864569456892994,1.085856,1.0860166666666642,1.0861822222222195,1.0864675000000017,1.086474400000002,1.0871809000000003,1.0873187500000001,1.0859860950840148,1.086111434196497,-1988,-131532,-131144.8,-0.03605399420925948,-95.8089568370487,-0.06258110234771293
2023-05-17T02:45:00-04:00,1.08591,1.08608,1.08515,1.08539,1.08643,1.0857306666666666,1.0858788888888864,1.086074666666664,1.0863875000000018,1.0864458000000021,1.0871637000000003,1.0873142500000004,1.0858668760672119,1.0860067473571977,-2587,-134119,-131904.2,-0.04254267197431319,-97.04777036671472,-0.1141142799296824
2023-05-17T03:00:00-04:00,1.08539,1.08638,1.08529,1.08601,1.08501,1.0857568888888889,1.0858277777777756,1.0859879999999975,1.0863320000000019,1.086428600000002,1.0871566000000004,1.0873121500000003,1.0858955008537694,1.0859509978857584,4473,-129646,-131400.8,-0.04395592835201267,-94.49268878313711,-0.04233895091444098
2023-05-17T03:15:00-04:00,1.08601,1.0861399999999999,1.08387,1.08442,1.08638,1.0854753333333331,1.085601111111109,1.0858833333333309,1.0861965000000018,1.086381800000002,1.0871356000000003,1.0873011000000004,1.0856004006830156,1.0858707983086069,-4666,-134312,-131830.6,-0.05099719171313964,-101.32406234323317,-0.18776577140438136
2023-05-17T03:30:00-04:00,1.08442,1.08462,1.08386,1.08417,1.08638,1.085189111111111,1.0853966666666643,1.0857442222222198,1.0860500000000017,1.086329000000002,1.0871061000000004,1.0872885000000003,1.0853143205464124,1.0857326386468855,-4147,-138459,-133613.6,-0.05911057913634177,-102.28010336055065,-0.16942753749964015
2023-05-17T03:45:00-04:00,1.08417,1.08423,1.08311,1.08317,1.0862792,1.0847437777777778,1.0850788888888865,1.0855566666666643,1.0858595000000018,1.0862564000000021,1.0870615000000003,1.0872706000000003,1.08488545643713,1.0855125109175088,-3763,-142222,-135751.6,-0.0680401873867506,-105.75096125184115,-0.26334447483035317
2023-05-17T04:00:00-04:00,1.08317,1.08404,1.08313,1.08382,1.0860890479999998,1.084492,1.084913333333331,1.0853635555555532,1.0857015000000019,1.086211000000002,1.0870168000000004,1.0872538500000002,1.0846723651497039,1.0852736087340071,3656,-138566,-136641,-0.07454494340378932,-103.55703047458536,-0.1372879638075749
2023-05-17T04:15:00-04:00,1.08382,1.08438,1.08351,1.08432,1.0859103051199999,1.0843733333333332,1.084803333333331,1.0851586666666644,1.0855800000000015,1.086171600000002,1.0869824000000003,1.0872428000000003,1.084601892119763,1.0850148869872058,3135,-135431,-137798,-0.07200521090337854,-102.11075710815936,-0.09121817729497068
2023-05-17T04:30:00-04:00,1.08432,1.08482,1.08398,1.08415,1.0857422868128,1.0842426666666667,1.0845955555555533,1.0849575555555533,1.0854520000000016,1.086132000000002,1.0869398000000003,1.0872323000000002,1.0845115136958106,1.0847971095897646,-2796,-138227,-138581,-0.0712939912044692,-102.54911478854892,-0.1721883574888159
2023-05-17T04:45:00-04:00,1.08415,1.08426,1.08271,1.0829,1.085584349604032,1.0839035555555556,1.084261111111109,1.084730444444442,1.0852700000000017,1.086066000000002,1.0868804000000003,1.087212,1.0841892109566484,1.084572087671812,-3637,-141864,-139262,-0.0833364777197335,-106.74249208873792,-0.2771868755237503
2023-05-17T05:00:00-04:00,1.0829,1.0829,1.08205,1.08212,1.0853544016357095,1.0834753333333333,1.0838977777777759,1.0844942222222198,1.0850605000000018,1.085983600000002,1.0868075000000001,1.0871885000000001,1.0837753687653187,1.0843500701374498,-3992,-145856,-139988.8,-0.09888307283981801,-109.61788224480036,-0.3012741963718208
2023-05-17T05:15:00-04:00,1.08212,1.08278,1.08211,1.08272,1.0850239614721386,1.0832397777777778,1.0835322222222201,1.0842179999999977,1.0848670000000016,1.0859144000000018,1.0867392000000002,1.0871662500000001,1.0835642950122548,1.0841284561099598,3031,-142825,-140840.6,-0.10775138441872952,-107.93729229174542,-0.3029438034640579
2023-05-17T05:30:00-04:00,1.08272,1.08324,1.08259,1.0829199999999999,1.0847265653249247,1.0831173333333333,1.0833655555555533,1.0839304444444422,1.0846815000000016,1.085848000000002,1.0866716000000003,1.0871431,1.0834354360098037,1.0838951648879678,2503,-140322,-141818.8,-0.12014349265545365,-107.47493822051746,-0.13832279006289602
2023-05-17T05:45:00-04:00,1.0829199999999999,1.08323,1.08259,1.08308,1.0844589087924323,1.0830602222222223,1.0832444444444422,1.08366022222222,1.0845120000000015,1.0857858000000018,1.0866113000000004,1.0871216000000001,1.083364348807843,1.0836657319103744,2185,-138137,-141800.8,-0.11693084734359627,-107.15210735581799,-0.10053773854654116
2023-05-17T06:00:00-04:00,1.08308,1.08312,1.08269,1.08287,1.084218017913189,1.0829853333333332,1.0832111111111091,1.08345022222222,1.0843325000000017,1.0857204000000018,1.0865409000000001,1.0870965000000001,1.0832654790462743,1.0834809855282996,-2026,-140163,-141460.6,-0.11312903683332926,-107.54493152393123,-0.027696483469812398
2023-05-17T06:15:00-04:00,1.08287,1.08327,1.08277,1.08304,1.0840012161218702,1.082951111111111,1.0831244444444423,1.0832955555555535,1.0841840000000018,1.0856570000000019,1.0864728000000003,1.0870743000000003,1.0832203832370195,1.0833699884226398,2454,-137709,-139831.2,-0.09932502374865751,-107.15967752298927,-0.07196766990828762
2023-05-17T06:30:00-04:00,1.08304,1.08312,1.08245,1.0827499999999999,1.0838060945096832,1.0828762222222221,1.0829499999999979,1.0831791111111089,1.0840200000000018,1.085588200000002,1.0864040000000004,1.08705085,1.0831263065896155,1.083282390738112,-2333,-140042,-139274.6,-0.0948897126163273,-107.78437282510211,-0.14479120554818425
2023-05-17T06:45:00-04:00,1.0827499999999999,1.08317,1.08267,1.08302,1.0836304850587148,1.082890222222222,1.0828244444444424,1.0830708888888867,1.0839055000000015,1.0855236000000017,1.0863406000000004,1.0870317500000002,1.0831050452716924,1.0832163125904894,2036,-138006,-138811.4,-0.09367221621353684,-107.27666559813333,-0.10422911958675952
2023-05-17T07:00:00-04:00,1.08302,1.08327,1.08272,1.08324,1.0834724365528434,1.0829733333333333,1.08286222222222,1.0829944444444424,1.0838020000000017,1.0854642000000019,1.0862800000000004,1.0870191,1.083132036217354,1.0831698500723916,2140,-135866,-138357.2,-0.09298218251551531,-106.84195525114089,0.031397174254317754
2023-05-17T07:15:00-04:00,1.08324,1.08392,1.08313,1.08378,1.08205,1.0831568888888887,1.0830466666666645,1.0829615555555534,1.0836900000000016,1.085415000000002,1.0862246000000004,1.0870081,1.0832616289738832,1.0831690800579135,2135,-133731,-137070.8,-0.0781464879774827,-105.77764817237721,0.15340258012050373
2023-05-17T07:30:00-04:00,1.08378,1.0841399999999999,1.08367,1.08408,1.0820874,1.0833635555555556,1.0831977777777757,1.0829762222222201,1.0835985000000017,1.0853726000000021,1.0861725000000004,1.0869951000000002,1.0834253031791066,1.0832100640463307,2018,-131713,-135871.6,-0.0515425865677949,-105.21904771841061,0.125609575882964
2023-05-17T07:45:00-04:00,1.08408,1.08416,1.08246,1.0825,1.0821695040000001,1.083224,1.083151111111109,1.0830164444444423,1.0834540000000017,1.085293800000002,1.0861025000000004,1.0869732,1.0832402425432852,1.0832328512370648,-3044,-134757,-134814.6,-0.03859461459659791,-109.6555468697645,-0.038784028367733994
2023-05-17T08:00:00-04:00,1.0825,1.08307,1.08244,1.08281,1.0822889337600001,1.0831557777777776,1.083121111111109,1.0830757777777755,1.0832940000000018,1.085220600000002,1.0860349000000005,1.0869518000000002,1.083154194034628,1.083242680989652,2610,-132147,-133642.8,-0.028274574112260142,-108.90811038015704,-0.02492890645196961
2023-05-17T08:15:00-04:00,1.08281,1.08317,1.08264,1.08264,1.0824011977344001,1.0830595555555556,1.0830955555555535,1.0831224444444423,1.0832050000000017,1.085142800000002,1.0859652000000006,1.0869281500000003,1.0830513552277026,1.0832265447917215,-2656,-134803,-133430.2,-0.017526414905211715,-109.32509951029068,-0.02123985335266029
2023-05-17T08:30:00-04:00,1.08264,1.0829,1.08136,1.08195,1.08416,1.0828304444444445,1.0829744444444425,1.083107999999998,1.083094000000002,1.085048200000002,1.0858950000000005,1.0869006500000002,1.082831084182162,1.0831404358333774,-4234,-139037,-134491.4,-0.015163072269663567,-112.02355883194916,-0.10064263554439683
2023-05-17T08:45:00-04:00,1.08195,1.08314,1.08159,1.08238,1.084104,1.0827115555555553,1.0829333333333313,1.083055111111109,1.083054500000002,1.084959400000002,1.0858320000000006,1.0868736000000003,1.0827408673457295,1.0830035486667022,4582,-134455,-135039.8,-0.01338799327826873,-110.20253198227988,-0.034172246594318306
2023-05-17T09:00:00-04:00,1.08238,1.08389,1.08238,1.08339,1.08404912,1.0828028888888888,1.0829744444444425,1.0830197777777757,1.083033000000002,1.084890400000002,1.0857848000000003,1.0868534500000002,1.0828706938765835,1.0829296389333618,5322,-129133,-133915,-0.008446005360383693,-105.23642026550671,0.034163727354987114
2023-05-17T09:15:00-04:00,1.08339,1.08364,1.08307,1.0830899999999999,1.0839953376,1.082826,1.0829577777777757,1.0829871111111091,1.082971500000002,1.0848112000000019,1.0857352000000005,1.0868303500000003,1.0829145551012669,1.0828817111466897,-3607,-132740,-134033.6,-0.004590272052703358,-106.2352295585597,-0.01384734684835258
2023-05-17T09:30:00-04:00,1.0830899999999999,1.08311,1.08186,1.08225,1.083942630848,1.0826844444444443,1.0827877777777757,1.0829255555555535,1.0828765000000018,1.084716200000002,1.0856729000000005,1.0868024000000003,1.0827816440810134,1.0828277689173518,-4679,-137419,-134556.8,-0.0046302647824903245,-109.86406926717096,-0.14117256269722928
2023-05-17T09:45:00-04:00,1.08225,1.08232,1.08148,1.08155,1.08389097823104,1.082436888888889,1.0825066666666645,1.082831999999998,1.082809000000002,1.0846062000000019,1.0856069000000004,1.0867714000000002,1.0825353152648107,1.0827686151338813,-4876,-142295,-135208.4,-0.013791235177439156,-113.01786922097057,-0.2333776105084423
2023-05-17T10:00:00-04:00,1.08155,1.08192,1.08101,1.0818699999999999,1.0838403586664191,1.0823095555555555,1.0824366666666647,1.0827326666666646,1.082796500000002,1.084515000000002,1.0855409000000005,1.0867438500000002,1.0824022522118486,1.0827008921071053,5623,-136672,-135651.8,-0.029672729191743217,-111.35418284493682,-0.05819861431871875
2023-05-17T10:15:00-04:00,1.0818699999999999,1.08303,1.08178,1.08295,1.0837271443197625,1.0824122222222223,1.0824522222222202,1.08262822222222,1.0828080000000022,1.084434200000002,1.0854953000000005,1.08672015,1.0825118017694788,1.0826291136856845,4687,-131985,-136222.2,-0.029165904389215385,-106.67528427117018,0.012929322780545894
2023-05-17T10:30:00-04:00,1.08295,1.08328,1.08222,1.08293,1.083618458546972,1.0825077777777776,1.0824844444444424,1.0825335555555533,1.082808500000002,1.084350400000002,1.0854373000000004,1.0866964500000003,1.082595441415583,1.0825652909485477,-4307,-136292,-136932.6,-0.02898093107499849,-106.7548262629524,0.026786374048612782
2023-05-17T10:45:00-04:00,1.08293,1.08294,1.08194,1.08206,1.083514120205093,1.082422888888889,1.0824966666666649,1.0824753333333312,1.082757500000002,1.084249000000002,1.0853826000000004,1.0866673000000002,1.0824883531324663,1.0825066327588382,-5846,-142138,-137876.4,-0.030556468115503957,-111.45136251183236,0.010166828411669162
2023-05-17T11:00:00-04:00,1.08206,1.0823099999999999,1.08177,1.08219,1.0834139553968893,1.0823615555555557,1.0824755555555536,1.082469111111109,1.082723500000002,1.0841508000000022,1.0853439000000003,1.0866394500000003,1.082428682505973,1.082485306207071,4429,-137709,-136959.2,-0.024426779913468134,-110.91925708329805,-0.01755390897835441
2023-05-17T11:15:00-04:00,1.08219,1.08299,1.0821399999999999,1.0827499999999999,1.0833177971810137,1.0824164444444446,1.0824044444444425,1.0824626666666648,1.082709000000002,1.084066200000002,1.0853000000000004,1.0866136500000003,1.0824929460047783,1.0825034449656568,4127,-133582,-136341.2,-0.02048183551013774,-108.78366167029334,-0.05907383306105797
2023-05-17T11:30:00-04:00,1.0827499999999999,1.08334,1.0826,1.08333,1.08101,1.0826015555555555,1.0824311111111091,1.0824584444444425,1.082738000000002,1.083993200000002,1.0852662000000004,1.0865911000000004,1.0826603568038227,1.0825331559725255,2936,-130646,-136073.4,-0.02231115016542416,-107.21092558163015,0.022158823366480902
2023-05-17T11:45:00-04:00,1.08333,1.08363,1.08272,1.08293,1.0810566,1.0827013333333333,1.0825066666666647,1.082462888888887,1.082733500000002,1.0839168000000021,1.0852292000000006,1.0865660500000003,1.082714285443058,1.0825569247780205,-2990,-133636,-135542.2,-0.0245803333583015,-108.31492897856356,0.06283206283206412
2023-05-17T12:00:00-04:00,1.08293,1.08347,1.08289,1.08341,1.081159536,1.082882,1.0827133333333314,1.0825062222222204,1.0827420000000019,1.083850800000002,1.0852067000000005,1.0865456500000004,1.0828534283544464,1.0826299398224166,2136,-131500,-133414.6,-0.01558179054687835,-107.368164183055,0.17197540566778907
2023-05-17T12:15:00-04:00,1.08341,1.08344,1.08302,1.0833599999999999,1.0812583545599999,1.0830113333333333,1.082878888888887,1.082586888888887,1.0827210000000018,1.083787200000002,1.0851763000000003,1.0865262500000004,1.082954742683557,1.0827351518579333,-1841,-133341,-132541,0.0006069081986288331,-107.45312740104283,0.13772449554937205
2023-05-17T12:30:00-04:00,1.0833599999999999,1.08402,1.08331,1.08402,1.0813532203776,1.0832395555555554,1.082997777777776,1.0827055555555538,1.0827180000000018,1.0837414000000019,1.0851603000000005,1.0865092000000005,1.0831677941468456,1.0828701214863468,1966,-131375,-132099.6,0.01940766385036958,-106.25540919102936,0.0988041922526344
2023-05-17T12:45:00-04:00,1.08402,1.08453,1.08396,1.08417,1.081513227154944,1.083474,1.0831355555555537,1.0828464444444426,1.0828015000000017,1.083693000000002,1.0851375000000005,1.0864977000000002,1.0833682353174765,1.0830116971890777,2894,-128481,-131666.6,0.0302790022047267,-105.85495532486428,0.11450416924456151
2023-05-17T13:00:00-04:00,1.08417,1.08479,1.08417,1.08468,1.0817545689825483,1.0837828888888887,1.083426666666665,1.0830304444444425,1.0828950000000017,1.083654000000002,1.0851193000000006,1.0864857500000005,1.0836305882539812,1.0831949577512625,2281,-126200,-130179.4,0.03685021268035858,-104.78195939249203,0.24213075060533304
2023-05-17T13:15:00-04:00,1.08468,1.08468,1.08416,1.08441,1.0820581120842934,1.0839795555555556,1.0836733333333315,1.0832224444444427,1.0829835000000019,1.0836128000000018,1.0850974000000004,1.0864727000000005,1.083786470603185,1.08338156620101,-1935,-128135,-129506.4,0.05151191765489711,-105.26362218704894,0.20513957807779695
2023-05-17T13:30:00-04:00,1.08441,1.0849,1.08425,1.0843099999999999,1.082331300875864,1.084106888888889,1.083846666666665,1.0834159999999984,1.083101500000002,1.083569800000002,1.0850722000000004,1.0864580000000006,1.083891176482548,1.0835688529608083,-2277,-130412,-128920.6,0.06373994349283311,-105.47359811866197,0.14407758023551198
2023-05-17T13:45:00-04:00,1.0843099999999999,1.08442,1.08416,1.08438,1.0826395447707602,1.0842135555555557,1.0839633333333316,1.0836091111111092,1.083201500000002,1.0835372000000019,1.0850492000000005,1.0864434000000005,1.0839889411860384,1.0837330823686468,1411,-129001,-128445.8,0.06809865820595648,-105.38250793227614,0.09692337514884619
2023-05-17T14:00:00-04:00,1.08438,1.08453,1.08408,1.08415,1.082910799398269,1.0842508888888889,1.0840988888888872,1.083801777777776,1.083239500000002,1.083499600000002,1.0850273000000004,1.0864295000000004,1.0840211529488306,1.0838636658949174,-1693,-130694,-128888.4,0.06788235366531647,-105.74159791918103,0.1126573278051212
2023-05-17T14:15:00-04:00,1.08415,1.08418,1.08369,1.08391,1.0831495034704768,1.084213111111111,1.0841544444444426,1.0839473333333316,1.0832805000000019,1.083471600000002,1.0849984000000004,1.0864137500000004,1.0839989223590645,1.083937332715934,-2875,-133569,-130362.2,0.07464162787332876,-106.37804121577288,0.046150580112786936
2023-05-17T14:30:00-04:00,1.08391,1.08406,1.08367,1.08381,1.0833595630540196,1.0841442222222222,1.0842044444444425,1.084053555555554,1.083358500000002,1.083441600000002,1.0849704000000004,1.0863979500000005,1.0839611378872516,1.0839722661727476,-1599,-135168,-131768.8,0.07516675150409134,-106.5255626889579,0.04153743907842836
2023-05-17T14:45:00-04:00,1.08381,1.08394,1.08364,1.08374,1.0835444154875373,1.0840513333333333,1.0841733333333314,1.0841188888888873,1.0834680000000019,1.0833960000000018,1.0849409000000003,1.0863773000000005,1.0839169103098012,1.083977412938198,-2002,-137170,-133120.4,0.0721201921154916,-106.65486579559101,-0.02582978173834966
2023-05-17T15:00:00-04:00,1.08374,1.08425,1.08369,1.08417,1.0849,1.0840506666666667,1.0841733333333314,1.0841608888888872,1.083583000000002,1.083361200000002,1.0849178000000004,1.0863596500000003,1.083967528247841,1.0839731303505586,1668,-135502,-134420.6,0.06198159142791534,-105.99304654004978,0
2023-05-17T15:15:00-04:00,1.08417,1.08428,1.08399,1.08406,1.0848758,1.084028,1.0841044444444423,1.084161999999998,1.083638500000002,1.083334600000002,1.0848902000000005,1.0863411000000005,1.0839860225982727,1.083966104280447,-1353,-136855,-135652.8,0.051336543075892464,-106.1303220595717,-0.057159715307746516
2023-05-17T15:30:00-04:00,1.08406,1.08418,1.0839,1.08411,1.084852084,1.0840291111111109,1.084071111111109,1.0841453333333315,1.0836975000000018,1.083296600000002,1.0848626000000006,1.0863232500000004,1.084010818078618,1.0839684834243577,1823,-135032,-135945.4,0.04097661893908611,-106.0462399976934,-0.02766481312420477
2023-05-17T15:45:00-04:00,1.08411,1.08417,1.08391,1.0839699999999999,1.08482884232,1.0840088888888888,1.0840333333333314,1.0841111111111092,1.0837930000000018,1.083287600000002,1.0848347000000005,1.0863050500000004,1.0840026544628945,1.0839767867394863,-1718,-136750,-136261.8,0.03234478370619264,-106.26809940310434,-0.03135634643229399
2023-05-17T16:00:00-04:00,1.0839699999999999,1.084,1.08385,1.08386,1.0848060654736,1.0839742222222222,1.0839755555555535,1.0840715555555536,1.083876500000002,1.083281400000002,1.0848052000000006,1.0862860000000003,1.0839741235703155,1.0839882293915892,-1020,-137770,-136381.8,0.02028144458729297,-106.37160780278315,-0.04795366937787989
2023-05-17T16:15:00-04:00,1.08386,1.08387,1.08369,1.0836999999999999,1.084783744164128,1.083919111111111,1.0839255555555534,1.0840219999999978,1.0839240000000019,1.0832920000000021,1.0847742000000005,1.0862668000000004,1.0839192988562525,1.0839785835132716,-474,-138244,-136930.2,0.007372185070976863,-106.44157993940603,-0.041507171516862194
2023-05-17T16:30:00-04:00,1.0836999999999999,1.0838,1.08367,1.08371,1.0847618692808454,1.0838759999999998,1.0839033333333314,1.0839817777777756,1.0839430000000019,1.083289800000002,1.0847504000000006,1.0862475500000002,1.083877439085002,1.0839568668106174,327,-137917,-137142.6,-0.0009050095793543601,-106.43856249915501,-0.018451716470922676
2023-05-17T16:45:00-04:00,1.08371,1.08389,1.0836999999999999,1.08388,1.0847181945096116,1.0838713333333332,1.0839111111111093,1.0839497777777758,1.0839905000000019,1.0832810000000022,1.0847263000000005,1.0862298500000003,1.0838779512680015,1.083930293448494,917,-137000,-137536.2,-0.0035979851281960143,-106.29471405261488,0.006458696635020391
2023-05-17T17:00:00-04:00,1.08388,1.08399,1.0836,1.08398,1.0846762667292271,1.083885111111111,1.083937777777776,1.0839306666666648,1.0840190000000018,1.0832776000000022,1.0847048000000006,1.0862122500000002,1.083898361014401,1.0839094347587954,94,-136906,-137567.4,-0.0066421276947681756,-106.28604150583848,0.02214553306143706
2023-05-17T17:15:00-04:00,1.08398,1.08409,1.08384,1.08409,1.0846116907254735,1.0839155555555555,1.0839288888888872,1.0839213333333315,1.084055500000002,1.083301400000002,1.0846837000000005,1.0861949500000003,1.083936688811521,1.0839019478070364,71,-136835,-137380.4,-0.006400324716389961,-106.27883657585822,-0.007378916590578969
2023-05-17T17:30:00-04:00,1.08409,1.08465,1.0839699999999999,1.08398,1.0836,1.0839257777777778,1.0839199999999982,1.0839202222222206,1.0840535000000018,1.083338600000002,1.0846611000000004,1.0861765000000003,1.0839453510492167,1.0839071582456294,-185,-137020,-137135.6,-0.010876302267924515,-106.29760808006914,-0.007379665332184566
2023-05-17T17:45:00-04:00,1.08398,1.08408,1.08387,1.08392,1.083621,1.0839257777777775,1.083898888888887,1.0839193333333317,1.084041000000002,1.083362600000002,1.0846385000000003,1.0861586000000003,1.0839402808393734,1.0839197265965035,-61,-137081,-136968.4,-0.011728535790991026,-106.30098452612903,-0.017525896818580446
2023-05-17T18:00:00-04:00,1.08392,1.08426,1.08391,1.0842,1.0836415799999999,1.083986,1.0839244444444427,1.0839219999999985,1.0840170000000018,1.0833882000000021,1.0846181000000004,1.0861420000000002,1.0839922246714988,1.0839425812772032,590,-136491,-136866.6,-0.011030080359978978,-106.14857475419011,0.021218299399445976
2023-05-17T18:15:00-04:00,1.0842,1.08421,1.08398,1.08404,1.0836617484,1.0840091111111112,1.0839444444444426,1.0839233333333318,1.0839985000000019,1.083407400000002,1.0845966000000005,1.0861256500000003,1.084001779737199,1.0839632650217628,-318,-136809,-136847.2,-0.007573235027549744,-106.19550336514754,0.016607310907298632
2023-05-17T18:30:00-04:00,1.08404,1.0842,1.08404,1.0841399999999999,1.083681513432,1.0840482222222223,1.0839933333333316,1.083936222222221,1.0839900000000018,1.083432800000002,1.0845766000000006,1.0861095000000003,1.0840294237897592,1.0839818120174103,393,-136416,-136763.4,-0.0038042339452930003,-106.15925009036064,0.04060164252099253
2023-05-17T18:45:00-04:00,1.0841399999999999,1.08415,1.0838,1.08384,1.0837008831633599,1.0840175555555553,1.0840077777777761,1.0839537777777766,1.0839630000000018,1.083448800000002,1.0845529000000005,1.0860916500000002,1.0839915390318073,1.0839910496139284,-334,-136750,-136709.4,-0.00044808299535998306,-106.25167357810207,0.011995829142479398
2023-05-17T19:00:00-04:00,1.08384,1.08384,1.08369,1.08379,1.08465,1.083974,1.083997777777776,1.0839735555555543,1.083945000000002,1.0834696000000021,1.0845289000000005,1.0860738500000002,1.0839512312254458,1.083993239691143,-411,-137161,-136725.4,0.00288186337082424,-106.27063394125526,-0.00830350223271243
2023-05-17T19:15:00-04:00,1.08379,1.08383,1.08352,1.08352,1.0846307999999998,1.0838784444444445,1.083946666666665,1.0839779999999988,1.0839255000000019,1.083479600000002,1.0845016000000003,1.0860543500000004,1.0838649849803565,1.0839677917529145,-603,-137764,-136980,0.0023283991773668357,-106.42085677040112,-0.0424362073100892
2023-05-17T19:30:00-04:00,1.08352,1.08366,1.08346,1.08359,1.0845863679999999,1.083807111111111,1.0838911111111096,1.0839673333333324,1.083914500000002,1.0834866000000019,1.0844754000000005,1.0860356500000001,1.0838099879842853,1.0839294334023317,476,-137288,-137075.8,0.0001361913005843585,-106.39010514606561,-0.04612163196782047
2023-05-17T19:45:00-04:00,1.08359,1.08385,1.08356,1.0838,1.0845187859199998,1.083788888888889,1.0838711111111097,1.0839428888888878,1.0839175000000019,1.0834870000000019,1.0844510000000005,1.0860173000000002,1.0838079903874283,1.0838851467218655,517,-136771,-137146.8,-0.00249537718182652,-106.28991042296921,-0.016605472425676393
2023-05-17T20:00:00-04:00,1.0838,1.08391,1.08366,1.08379,1.0844552587647998,1.0837726666666665,1.0838566666666654,1.0839126666666659,1.0838985000000019,1.083481200000002,1.0844269000000006,1.0859987500000003,1.0838043923099425,1.0838477173774925,-1139,-137910,-137378.8,-0.004467945456617723,-106.30041974203183,-0.0119935050557203
2023-05-17T20:15:00-04:00,1.08379,1.08387,1.08349,1.0838,1.0843955432389119,1.0837613333333334,1.0838122222222208,1.0838755555555548,1.083885500000002,1.0835072000000021,1.0844005000000005,1.0859795500000002,1.083803513847954,1.083818173901994,1033,-136877,-137322,-0.003949604973428944,-106.29088837525407,-0.03689356207341413
2023-05-17T20:30:00-04:00,1.0838,1.08402,1.08373,1.08399,1.0843394106445772,1.083796888888889,1.0838066666666653,1.083847555555555,1.0838795000000019,1.0835308000000021,1.0843757000000007,1.0859619500000002,1.0838408110783633,1.0838133391215954,1167,-135710,-136911.2,-0.005579548100366062,-106.08630265833223,-0.004612375927076812
2023-05-17T20:45:00-04:00,1.08399,1.08434,1.0839699999999999,1.08422,1.08346,1.0838795555555556,1.0838155555555542,1.0838324444444438,1.0838920000000019,1.083562400000002,1.0843526000000008,1.0859451000000002,1.0839166488626906,1.0838346712972764,1540,-134170,-136287.6,-0.004402110376820639,-105.75954687645239,0.007379120777766711
2023-05-17T21:00:00-04:00,1.08422,1.08422,1.08379,1.08415,1.0834776000000002,1.0839464444444444,1.0838499999999989,1.0838282222222215,1.0839065000000019,1.083606400000002,1.0843273000000007,1.0859279000000002,1.0839633190901525,1.0838657370378215,-1940,-136110,-136155.4,-0.005100608514313127,-105.88479820920776,0.0286020076764128
2023-05-17T21:15:00-04:00,1.08415,1.0848,1.0841,1.08468,1.0834948480000002,1.0841124444444445,1.0839488888888877,1.083846666666666,1.0839555000000018,1.083652400000002,1.0843059000000006,1.0859140000000003,1.0841066552721221,1.0839261896302572,1912,-134198,-135413,-0.0009533093671873123,-104.95009360191148,0.0821192297400841
2023-05-17T21:30:00-04:00,1.08468,1.08468,1.08405,1.08418,1.08354705408,1.084158666666667,1.084022222222221,1.0838886666666663,1.0839790000000018,1.083668200000002,1.0842793000000006,1.0858978000000001,1.0841213242176977,1.0839897517042059,-3747,-137945,-135626.6,0.0005359506470419341,-106.67733112818708,0.06091258121676415
2023-05-17T21:45:00-04:00,1.08418,1.08457,1.08418,1.08451,1.0835971719168,1.0842562222222223,1.0841244444444433,1.0839522222222218,1.084010500000002,1.083696600000002,1.0842539000000007,1.0858836000000003,1.0841990593741582,1.0840614013633647,1912,-136033,-135691.2,0.006154430069646022,-106.09536134457153,0.08490296145221272
2023-05-17T22:00:00-04:00,1.08451,1.08471,1.08437,1.08458,1.0836452850401281,1.0843473333333333,1.0842111111111101,1.0840313333333331,1.084040500000002,1.083743200000002,1.0842297000000007,1.0858681500000003,1.0842752474993265,1.0841331210906922,1818,-134215,-135700.2,0.012211841181240213,-105.9780180282351,0.07196899797010545
2023-05-17T22:15:00-04:00,1.08458,1.0848,1.0844,1.0844799999999999,1.083691473638523,1.0844011111111111,1.0842877777777769,1.0841188888888886,1.0840600000000022,1.083801800000002,1.0842040000000006,1.0858509,1.084316197999461,1.0842036968725537,-1115,-135330,-135544.2,0.016287954161989603,-106.08082280058959,0.0636654702479131
2023-05-17T22:30:00-04:00,1.0844799999999999,1.08458,1.08437,1.08456,1.083735814692982,1.0844555555555555,1.0843722222222212,1.0842035555555554,1.084089000000002,1.083855600000002,1.0841853000000006,1.08583425,1.084364958399569,1.084255357498043,1175,-134155,-135535.6,0.02132588589195847,-105.99414531460543,0.07012363904778297
2023-05-17T22:45:00-04:00,1.08456,1.08472,1.08451,1.08462,1.083778382105263,1.084505111111111,1.0844422222222212,1.0842875555555556,1.084124000000002,1.0838890000000019,1.0841616000000007,1.0858165000000002,1.0844159667196551,1.0843142859984345,864,-133291,-134604.8,0.026077904280151817,-105.94634712916621,0.058118617330409725
2023-05-17T23:00:00-04:00,1.08462,1.08471,1.08442,1.08445,1.0838192468210524,1.0845066666666665,1.0844677777777767,1.084356222222222,1.084136500000002,1.0839194000000019,1.0841349000000007,1.0857989000000001,1.0844227733757241,1.0843590287987477,-1218,-134509,-134300,0.027992355579079566,-106.13725269978082,0.021213406873139443
2023-05-17T23:15:00-04:00,1.08445,1.08447,1.08409,1.08415,1.0838584769482102,1.0844431111111112,1.0844677777777767,1.0844075555555555,1.0841420000000022,1.0839612000000018,1.0841051000000008,1.0857802,1.0843682187005792,1.0843776230389983,-863,-135372,-134531.4,0.02756635955407402,-106.37599123083339,0
2023-05-17T23:30:00-04:00,1.08415,1.08423,1.08383,1.08391,1.0848,1.0843315555555555,1.0843822222222212,1.0844264444444445,1.084130500000002,1.083995600000002,1.0840732000000006,1.08576085,1.0842765749604633,1.0843696984311986,-854,-136226,-134710.6,0.025923770410976175,-106.56504256136886,-0.0709886786886602
2023-05-17T23:45:00-04:00,1.08391,1.08404,1.08376,1.0839699999999999,1.0847806,1.084249111111111,1.084358888888888,1.0844237777777779,1.0841370000000021,1.084020000000002,1.0840431000000006,1.085742,1.0842152599683705,1.0843397587449588,989,-135237,-134927,0.02012159929177531,-106.51029631859967,-0.019369477393056826
2023-05-18T00:00:00-04:00,1.0839699999999999,1.08403,1.08351,1.08364,1.084739776,1.0841053333333333,1.0842622222222211,1.0843877777777777,1.0841295000000022,1.084026200000002,1.0840097000000006,1.08572445,1.0841002079746964,1.084276606995967,-964,-136201,-135509,0.016019235381485634,-106.80377307533642,-0.08022056043744626
2023-05-18T00:15:00-04:00,1.08364,1.0839,1.08364,1.08375,1.08466598944,1.0840028888888888,1.084169999999999,1.0843282222222221,1.084141000000002,1.084042600000002,1.0839797000000007,1.0857052,1.0840301663797571,1.0841980855967737,916,-135285,-135664.2,0.009184612019486409,-106.71079016588305,-0.07652731933099526
2023-05-18T00:30:00-04:00,1.08375,1.08384,1.08346,1.08351,1.0845966300735999,1.0838708888888888,1.0840622222222212,1.084247111111111,1.0841370000000021,1.084044600000002,1.0839477000000006,1.085682,1.0839261331038057,1.084109668477419,-767,-136052,-135800.2,-0.0006412979165509688,-106.88064483716335,-0.08944378872823062
2023-05-18T00:45:00-04:00,1.08351,1.08354,1.08325,1.0833,1.0845056996677118,1.0837184444444443,1.0839222222222213,1.084155111111111,1.0841120000000022,1.084043400000002,1.0839153000000008,1.08565675,1.0838009064830445,1.0840145347819352,-881,-136933,-135941.6,-0.010252112356652845,-107.05139545321676,-0.11617614516486308
2023-05-18T01:00:00-04:00,1.0833,1.08339,1.08298,1.08315,1.0843801297009406,1.083564,1.0837588888888878,1.084035111111111,1.084080000000002,1.084026000000002,1.0838837000000008,1.0856303,1.0836707251864357,1.0839056278255481,-1682,-138615,-136617.2,-0.02040377959681991,-107.28429492704652,-0.13553133816450558
2023-05-18T01:15:00-04:00,1.08315,1.08332,1.08311,1.08318,1.0842121141368277,1.0834482222222221,1.0836177777777767,1.0839062222222222,1.0840490000000018,1.084006200000002,1.0838496000000009,1.085606,1.0835725801491485,1.0838001022604389,1351,-137264,-136829.8,-0.03100842617395598,-107.246876286969,-0.11711005578863778
2023-05-18T01:30:00-04:00,1.08318,1.08359,1.08311,1.08316,1.0840642604404085,1.0833566666666667,1.0835077777777766,1.0837737777777776,1.0840075000000018,1.083975800000002,1.0838149000000008,1.0855805500000002,1.0834900641193188,1.083692081808351,-1844,-139108,-137594.4,-0.04009815437774319,-107.28092418297912,-0.09131577733708864
2023-05-18T01:45:00-04:00,1.08316,1.08328,1.08269,1.08303,1.0839341491875594,1.083261111111111,1.0834099999999989,1.0836433333333333,1.083948000000002,1.083948200000002,1.083780500000001,1.0855545,1.083398051295455,1.0835864654466811,-1698,-140806,-138545.2,-0.046214984022289414,-107.48471678979615,-0.08118755247206798
2023-05-18T02:00:00-04:00,1.08303,1.08345,1.08258,1.08264,1.083759968301301,1.0831071111111112,1.0832622222222212,1.0835113333333335,1.0838725000000018,1.0839148000000018,1.083742300000001,1.0855273,1.083246441036364,1.083475572357345,-3057,-143863,-139931.2,-0.05099377899605639,-108.58554502170078,-0.12269712261407893
2023-05-18T02:15:00-04:00,1.08264,1.08344,1.0826,1.08327,1.0835711733730928,1.0831086666666667,1.0832211111111099,1.0834037777777779,1.0838020000000017,1.083892600000002,1.083714900000001,1.0855031000000002,1.0832511528290911,1.083391657885876,2490,-141373,-140482.8,-0.053587935706619,-107.13658691928468,-0.034144180724224045
2023-05-18T02:30:00-04:00,1.08327,1.08343,1.08281,1.08306,1.08258,1.0830764444444443,1.0831444444444434,1.083309111111111,1.0837460000000019,1.083870800000002,1.0836852000000008,1.085477,1.083212922263273,1.083319726308701,-2306,-143679,-141765.8,-0.051825423676530875,-107.5836222844292,-0.06366782006921148
2023-05-18T02:45:00-04:00,1.08306,1.08313,1.08233,1.08259,1.08344,1.0829655555555555,1.0830422222222211,1.083216,1.0836500000000018,1.0838444000000018,1.083658000000001,1.0854485500000002,1.0830883378106184,1.0832393810469607,-2323,-146002,-143144.6,-0.055546498716064964,-108.59170124589018,-0.08490923018708013
2023-05-18T03:00:00-04:00,1.08259,1.08311,1.08251,1.0828,1.08343,1.082917111111111,1.0829866666666657,1.0831313333333334,1.0835610000000018,1.0838242000000018,1.083632900000001,1.0854235,1.0830306702484946,1.0831659048375688,2895,-143107,-143604.8,-0.054588280789763736,-108.03013130713208,-0.046155266315881564
2023-05-18T03:15:00-04:00,1.0828,1.0829199999999999,1.08191,1.08209,1.083408,1.0827377777777778,1.082868888888888,1.0830526666666667,1.0834415000000017,1.0837912000000018,1.083593600000001,1.0853943000000001,1.0828425361987957,1.083085123870055,-3035,-146142,-144060.6,-0.054818397850523067,-110.02020334259566,-0.09786271522873663
2023-05-18T03:30:00-04:00,1.08209,1.08265,1.08196,1.08237,1.08334808,1.082638,1.0827788888888878,1.0829642222222222,1.0833320000000017,1.0837552000000017,1.083558200000001,1.08536955,1.0827480289590365,1.0829844990960442,2747,-143395,-144465,-0.052748865993724095,-109.30939370568916,-0.07477981498919638
2023-05-18T03:45:00-04:00,1.08237,1.08264,1.0809,1.08163,1.0832905568,1.0824082222222222,1.0826088888888878,1.082857111111111,1.0831825000000017,1.0837066000000017,1.083520600000001,1.08534215,1.0825244231672293,1.0828467992768354,-3608,-147003,-145129.8,-0.054184340171650934,-111.77612874084338,-0.14125336976991482
2023-05-18T04:00:00-04:00,1.08163,1.08222,1.08125,1.08166,1.083147123392,1.0822184444444445,1.0824566666666657,1.08274,1.083043000000002,1.0836576000000018,1.083477100000001,1.0853168499999999,1.0823515385337834,1.0826994394214684,3919,-143084,-144546.2,-0.05502672858696379,-111.66743168177521,-0.1264969576096573
2023-05-18T04:15:00-04:00,1.08166,1.08215,1.08129,1.08176,1.08301229598848,1.0820791111111112,1.082358888888888,1.0826144444444445,1.082923500000002,1.0836134000000017,1.083450500000001,1.08529305,1.0822332308270268,1.0825399515371747,3055,-140029,-143930.6,-0.05493210544764407,-111.38499542639,-0.08128279021650704
2023-05-18T04:30:00-04:00,1.08176,1.08207,1.08134,1.08196,1.0828855582291712,1.0819993333333333,1.0822133333333324,1.0824833333333332,1.0828260000000018,1.0835754000000017,1.083428400000001,1.08526725,1.0821785846616214,1.0824071612297401,2734,-137295,-142161.2,-0.051586535522666274,-110.87952286315976,-0.12093014668549137
2023-05-18T04:45:00-04:00,1.08196,1.082,1.08122,1.08165,1.082766424735421,1.0818866666666669,1.0820566666666658,1.082338888888889,1.0827100000000018,1.0835344000000018,1.083413200000001,1.08523735,1.0820728677292972,1.0822721289837922,-3239,-140534,-141589,-0.056614054692868766,-111.80755162577586,-0.13018669325798307
2023-05-18T05:00:00-04:00,1.08165,1.08195,1.08144,1.08167,1.0826544392512958,1.0818093333333334,1.0819544444444433,1.082208,1.0826115000000018,1.083493600000002,1.0833917000000008,1.08520425,1.0819922941834377,1.082165703187034,2403,-138131,-139814.6,-0.05934235197491044,-111.76311950817795,-0.08498138722877839
2023-05-18T05:15:00-04:00,1.08167,1.08167,1.08071,1.08079,1.082549172896218,1.0815764444444445,1.08173111111111,1.0820628888888888,1.0824635000000016,1.0834318000000018,1.0833564000000009,1.0851694,1.0817518353467501,1.0820457625496271,-2917,-141048,-139407.4,-0.06344075710116018,-114.13626473731436,-0.18562984854082631
2023-05-18T05:30:00-04:00,1.08079,1.08177,1.08079,1.08172,1.0824020390645206,1.0815742222222224,1.0816899999999992,1.0819291111111111,1.0823740000000017,1.0833866000000019,1.083332100000001,1.08513595,1.0817454682774001,1.081948210039702,2500,-138548,-139111.2,-0.06449345145087886,-111.98506052558012,-0.03419308929940961
2023-05-18T05:45:00-04:00,1.08172,1.08199,1.0816,1.08181,1.0822666759393589,1.0815982222222222,1.0816277777777767,1.081812,1.0822995000000017,1.0833410000000017,1.083321200000001,1.0851008,1.0817583746219201,1.0818641680317618,2026,-136522,-138956.6,-0.05960590937929241,-111.81649564742325,-0.05173831499395918
2023-05-18T06:00:00-04:00,1.08181,1.08195,1.08129,1.0813,1.08214214186421,1.0815326666666667,1.08159111111111,1.081718888888889,1.0822070000000017,1.083287400000002,1.083313000000001,1.0850602500000002,1.0816666996975361,1.0817829344254093,-1782,-138304,-138510.6,-0.06069795386936639,-112.65658771534648,-0.030509508796923483
2023-05-18T06:15:00-04:00,1.0813,1.0813,1.08081,1.08085,1.0820275705150733,1.0813844444444445,1.0815011111111101,1.0816282222222222,1.0820905000000016,1.0832260000000018,1.083294300000001,1.08501675,1.081503359758029,1.0816851475403275,-1825,-140129,-138910.2,-0.057791004528321074,-113.41609016609992,-0.07488489913651031
2023-05-18T06:30:00-04:00,1.08085,1.08104,1.08053,1.08081,1.08195,1.0812462222222223,1.0813955555555548,1.0815611111111112,1.0819730000000016,1.0831582000000017,1.083273200000001,1.0849724,1.0813646878064231,1.0816077180322623,-1700,-141829,-139066.4,-0.055222505151060995,-113.47900361384944,-0.08781984913474397
2023-05-18T06:45:00-04:00,1.08081,1.08164,1.08081,1.08152,1.0818079999999999,1.081271111111111,1.0813466666666658,1.0814924444444445,1.0818975000000015,1.0831078000000018,1.083257600000001,1.08493445,1.0813957502451386,1.08153777442581,1719,-140110,-139378.8,-0.05022670677040235,-112.34976720782065,-0.04066693777958482
2023-05-18T07:00:00-04:00,1.08152,1.08156,1.08111,1.08139,1.0816801999999999,1.0812797777777778,1.081317777777777,1.0814304444444445,1.0818350000000017,1.0830528000000017,1.083242800000001,1.08489185,1.0813946001961108,1.081465019540648,-1631,-141741,-140422.6,-0.04828045180873121,-112.54581536226989,-0.024037350344374517
2023-05-18T07:15:00-04:00,1.08139,1.08149,1.08082,1.0811,1.08164,1.0812362222222223,1.0812544444444436,1.0813631111111113,1.0817265000000016,1.0829980000000017,1.083223400000001,1.0848480999999999,1.0813356801568885,1.0813988156325185,-1563,-143304,-141422.6,-0.046589018302649346,-112.96497033873554,-0.05269629369400644
2023-05-18T07:30:00-04:00,1.0811,1.0818,1.08095,1.08165,1.08053,1.0813153333333334,1.0813499999999991,1.081332888888889,1.0816560000000017,1.0829552000000018,1.083212400000001,1.0848082000000001,1.0813985441255107,1.081377852506015,2054,-141250,-141646.8,-0.03964575029762866,-111.92001612543417,0.07957142460608287
2023-05-18T07:45:00-04:00,1.08165,1.08165,1.08128,1.0815,1.0805554,1.0813453333333334,1.0813255555555545,1.081318888888889,1.0816015000000017,1.0829148000000017,1.083197200000001,1.0847689,1.0814188353004086,1.081388682004812,-2045,-143295,-141940,-0.026216595302748037,-112.20361063382431,-0.020337980253680155
2023-05-18T08:00:00-04:00,1.0815,1.08174,1.08125,1.08174,1.080580292,1.0814282222222222,1.081317777777777,1.0813131111111112,1.0815485000000016,1.0828778000000019,1.0831822000000009,1.0847311,1.081483068240327,1.0814061456038497,2018,-141277,-142173.4,-0.02229044319791748,-111.75578816503094,-0.006470637172887522
2023-05-18T08:15:00-04:00,1.08174,1.08178,1.0809199999999999,1.08116,1.08060468616,1.0813966666666668,1.0813022222222213,1.0813100000000002,1.0815020000000015,1.082825000000002,1.0831560000000011,1.0846903,1.0814184545922616,1.0814109164830799,-2313,-143590,-142543.2,-0.021081246012398747,-112.99595678225879,-0.012947378155926108
2023-05-18T08:30:00-04:00,1.08116,1.08124,1.0789199999999999,1.07964,1.0818,1.0810642222222222,1.0811677777777768,1.081292666666667,1.0813655000000015,1.0827420000000019,1.083111600000001,1.08464205,1.0810627636738093,1.081356333186464,-8595,-152185,-144319.4,-0.025645451631025794,-125.0796446730425,-0.11194892908360599
2023-05-18T08:45:00-04:00,1.07964,1.0799,1.07849,1.079,1.08178,1.0806306666666665,1.080966666666666,1.0812160000000002,1.0812340000000014,1.0826460000000018,1.083076600000001,1.08458955,1.0806502109390475,1.081206666549171,-6557,-158742,-147817.8,-0.027917349846629046,-128.9665699444291,-0.1674669923483396
2023-05-18T09:00:00-04:00,1.079,1.07949,1.07873,1.07874,1.0816484,1.0801853333333333,1.080657777777777,1.0810824444444447,1.0810880000000016,1.082541000000002,1.083035900000001,1.0845354,1.0802681687512379,1.080976533239337,-5574,-164316,-152022,-0.03433843887818634,-130.3097024745492,-0.25704563947037545
2023-05-18T09:15:00-04:00,1.07874,1.07941,1.0786,1.07874,1.081522064,1.079801777777778,1.0803633333333325,1.0808915555555558,1.0809370000000016,1.082431400000002,1.082996900000001,1.08448105,1.0799625350009903,1.0806724265914698,0,-164316,-156629.8,-0.047197198299403664,-130.3097024745492,-0.24505497554074304
2023-05-18T09:30:00-04:00,1.07874,1.07886,1.07829,1.07835,1.08140078144,1.079399111111111,1.080057777777777,1.080642666666667,1.0807565000000017,1.082315400000002,1.0829609000000011,1.08442795,1.0796400280007923,1.0803167412731758,-4881,-169197,-161751.2,-0.06030729049388044,-132.0743445569792,-0.2543705485154038
2023-05-18T09:45:00-04:00,1.07835,1.07837,1.07749,1.07777,1.0812141345536,1.0789415555555555,1.0796266666666656,1.080334444444445,1.0805625000000014,1.0821772000000018,1.082914800000001,1.0843733999999998,1.0792660224006339,1.0799573930185407,-5065,-174262,-166166.6,-0.07267030657148384,-134.7985992052846,-0.358711228216161
2023-05-18T10:00:00-04:00,1.07777,1.07832,1.0776,1.07812,1.0809162037893119,1.0786402222222222,1.07925111111111,1.0799913333333335,1.0803850000000017,1.082056000000002,1.0828621000000012,1.08432345,1.079036817920507,1.0796347144148328,5499,-168763,-168170.8,-0.08979535350681002,-133.012828586321,-0.3125288950531612
2023-05-18T10:15:00-04:00,1.07812,1.07866,1.07809,1.07843,1.080642107486167,1.078476,1.0788833333333325,1.0796364444444448,1.0802670000000016,1.0819344000000017,1.0828155000000013,1.08427535,1.0789154543364057,1.0793641715318665,4818,-163945,-168096.6,-0.10394456877377822,-131.62747259626408,-0.3059885000092374
2023-05-18T10:30:00-04:00,1.07843,1.07859,1.07704,1.0772,1.0803899388872735,1.0781393333333336,1.0784433333333323,1.0792524444444447,1.0800410000000018,1.081786800000002,1.082765000000001,1.0842189500000001,1.0785723634691244,1.0790861372254932,-4146,-168091,-168851.6,-0.13016619831799653,-136.35618006916476,-0.3662732620518669
2023-05-18T10:45:00-04:00,1.0772,1.0774299999999999,1.07668,1.07691,1.0800549449985462,1.0778326666666667,1.078139999999999,1.078868888888889,1.0797960000000015,1.081635400000002,1.082718600000001,1.0841627500000002,1.0782398907752995,1.0788061097803947,-4198,-172289,-169470,-0.14833936200830442,-137.48635088238385,-0.25286206513281273
2023-05-18T11:00:00-04:00,1.07691,1.07723,1.07631,1.07669,1.0796499515987206,1.0775426666666665,1.0778833333333324,1.0785202222222225,1.0795655000000017,1.081478000000002,1.082666800000001,1.08410385,1.0779299126202395,1.0785388878243158,-3988,-176277,-169873,-0.15311426430379607,-138.30105220375745,-0.2140871177015787
2023-05-18T11:15:00-04:00,1.07669,1.07732,1.07659,1.07728,1.0791823583748996,1.0774219999999999,1.07772111111111,1.0782142222222224,1.0793870000000019,1.081331200000002,1.082610100000001,1.0840527,1.0777999300961916,1.078291510259453,2907,-173370,-170794.4,-0.15134156998721357,-136.70808672622886,-0.13534308545154689
2023-05-18T11:30:00-04:00,1.07728,1.07744,1.07698,1.07735,1.0787802282024137,1.0773477777777778,1.0775666666666657,1.0779508888888891,1.0792140000000017,1.081189200000002,1.082554300000001,1.0839958,1.0777099440769533,1.0780504082075624,2526,-170844,-172174.2,-0.14880152692957563,-136.54395112545652,-0.12885403340934815
2023-05-18T11:45:00-04:00,1.07735,1.07785,1.07728,1.07753,1.0784343962540759,1.0773404444444443,1.0774755555555546,1.0777573333333337,1.0790145000000018,1.0810568000000018,1.082509000000001,1.0839458,1.0776739552615626,1.07787072656605,2849,-167995,-172155,-0.1455620711671303,-136.06794982597148,-0.07604210135854045
2023-05-18T12:00:00-04:00,1.07753,1.07811,1.07707,1.07714,1.0781369807785053,1.0772733333333333,1.0774055555555548,1.0776104444444448,1.0788020000000018,1.080921400000002,1.082458500000001,1.0839012,1.0775671642092501,1.0777361812528403,-3384,-171379,-171973,-0.1374736675781966,-137.29275099160063,-0.05845403008062096
2023-05-18T12:15:00-04:00,1.07714,1.07738,1.0766,1.07667,1.07811,1.0771262222222222,1.0772444444444436,1.077482666666667,1.078580500000002,1.080775400000002,1.0823977000000011,1.0838488499999999,1.0773877313674,1.0776277450022724,-2741,-174120,-171541.6,-0.1268634083955847,-138.48876079534008,-0.13449337736058614
2023-05-18T12:30:00-04:00,1.07667,1.07674,1.07646,1.07659,1.07811,1.0769953333333333,1.077039999999999,1.0773464444444447,1.0783275000000019,1.0806344000000019,1.082330300000001,1.0837982499999999,1.07722818509392,1.0775133960018182,-1970,-176090,-172085.6,-0.12116194664461057,-138.6351380511382,-0.17061839896887734
2023-05-18T12:45:00-04:00,1.07659,1.07669,1.07626,1.0763,1.077858,1.0768473333333333,1.0769399999999991,1.0772211111111112,1.078067500000002,1.080485400000002,1.0822640000000012,1.0837466,1.077042548075136,1.0773799168014546,-1542,-177632,-173443.2,-0.11731738716623276,-139.05050508965783,-0.08354994430002793
2023-05-18T13:00:00-04:00,1.0763,1.07646,1.07624,1.07626,1.07760232,1.0767113333333334,1.0768677777777769,1.0770995555555556,1.077793500000002,1.080340400000002,1.0821925000000012,1.0836995999999999,1.0768860384601089,1.077222333441164,-2940,-180572,-175958.6,-0.10291722491889885,-139.15976830623325,-0.060357875774209487
2023-05-18T13:15:00-04:00,1.07626,1.07664,1.07624,1.07661,1.0773571024,1.0766597777777778,1.0768588888888881,1.0769902222222223,1.0775660000000022,1.0802066000000021,1.0821250000000011,1.0836506499999998,1.0768308307680872,1.0770750667529314,2585,-177987,-177280.2,-0.08305762338006101,-138.31912571057774,-0.0074301795316997436
2023-05-18T13:30:00-04:00,1.07661,1.07671,1.07632,1.07645,1.077156023968,1.0765779999999998,1.0767666666666658,1.0768946666666666,1.0774065000000022,1.080072600000002,1.082049300000001,1.0836048,1.0767546646144697,1.0769484534023452,-1997,-179984,-178453,-0.06448713240395293,-138.6159091326157,-0.07704589336106754
2023-05-18T13:45:00-04:00,1.07645,1.07667,1.0764,1.0766499999999999,1.0769911396537601,1.0765546666666668,1.0766888888888881,1.0768244444444446,1.0772890000000022,1.079942000000002,1.0819741000000014,1.0835557999999998,1.0767337316915757,1.0768495627218762,2190,-177794,-178793.8,-0.057127627318221026,-138.20901610460703,-0.06497424235393744
2023-05-18T14:00:00-04:00,1.0766499999999999,1.07683,1.07649,1.07656,1.0768559345160833,1.0765288888888889,1.0765811111111103,1.076752666666667,1.0771800000000022,1.079810000000002,1.0818929000000015,1.0835061,1.0766989853532605,1.0767808501775011,-1465,-179259,-179119.2,-0.053681449398993004,-138.33147930063163,-0.09002069547948896
2023-05-18T14:15:00-04:00,1.07656,1.0768,1.07649,1.07676,1.07624,1.0765646666666666,1.076538888888888,1.076686888888889,1.0770810000000022,1.079684600000002,1.0818164000000015,1.0834568999999998,1.0767111882826084,1.0767458801420011,1361,-177898,-178584.4,-0.05208139923486355,-138.0786369137698,-0.03527860816607377
2023-05-18T14:30:00-04:00,1.07676,1.0769,1.0764,1.07646,1.0762512000000002,1.0765488888888888,1.076515555555555,1.0766182222222223,1.0769865000000023,1.079561000000002,1.0817379000000014,1.0834050499999999,1.0766609506260867,1.0767119041136008,-1669,-179567,-178900.4,-0.048319751278464815,-138.54364304326936,-0.019504583577144668
2023-05-18T14:45:00-04:00,1.07646,1.07679,1.07646,1.07669,1.076277152,1.0765837777777778,1.0765266666666662,1.0765702222222224,1.076932500000002,1.0794294000000018,1.0816610000000013,1.0833551,1.0766667605008693,1.076694323290881,1365,-178202,-178544,-0.040797792046528294,-138.25199263359326,0.009288587113013218
2023-05-18T15:00:00-04:00,1.07669,1.07688,1.07657,1.0766,1.07630206592,1.0765984444444443,1.0765599999999995,1.0765444444444447,1.076856500000002,1.0793002000000018,1.0815855000000014,1.0833064,1.0766534084006953,1.0766782586327048,-1653,-179855,-178956.2,-0.035533544842382164,-138.39016610970975,0.02787326953451333
2023-05-18T15:15:00-04:00,1.0766,1.07687,1.0766,1.07683,1.0763259832832,1.0766524444444445,1.0766233333333328,1.0765528888888893,1.076776500000002,1.0791850000000018,1.0815147000000014,1.08325655,1.0766887267205563,1.076676206906164,1217,-178638,-178832,-0.02490939225137045,-138.1301716828103,0.05296118038391833
2023-05-18T15:30:00-04:00,1.07683,1.0774,1.07683,1.07738,1.0763489439518719,1.0768037777777777,1.0767088888888883,1.0765868888888892,1.076785500000002,1.0790766000000018,1.0814504000000014,1.0832104,1.076826981376445,1.0766993655249313,1314,-177324,-178717.2,-0.009866045546407408,-137.4590351060061,0.0715207921159879
2023-05-18T15:45:00-04:00,1.07738,1.07744,1.0770899999999999,1.07739,1.0764120073147596,1.07694,1.0768133333333327,1.0766464444444448,1.0768095000000022,1.0789826000000018,1.0813869000000014,1.0831639,1.076939585101156,1.0767550924199452,1953,-175371,-177878,-0.0034625946905564586,-137.44090779716416,0.08732407450417233
2023-05-18T16:00:00-04:00,1.07739,1.07746,1.07727,1.07745,1.0764942467295788,1.0770673333333334,1.0769022222222215,1.0767215555555558,1.076847500000002,1.0788842000000018,1.0813197000000014,1.08311875,1.077041668080925,1.0768300739359562,992,-174379,-177113.4,0.003435979347107922,-137.38566317822398,0.07430455579808981
2023-05-18T16:15:00-04:00,1.07745,1.07749,1.07711,1.07713,1.076590822056621,1.077112888888889,1.0769655555555548,1.076802666666667,1.076840000000002,1.0787942000000017,1.0812504000000016,1.0830703,1.07705933446474,1.076911259148765,-392,-174771,-176096.6,0.005947622012608041,-137.50208621409575,0.052946421936534836
2023-05-18T16:30:00-04:00,1.07713,1.07733,1.07713,1.07725,1.0766987234098264,1.0771697777777778,1.0770199999999992,1.0768820000000001,1.076835000000002,1.0787060000000017,1.0811818000000015,1.0830221999999998,1.077097467571792,1.0769930073190124,557,-174214,-175211.8,0.012487811780878183,-137.4400324230027,0.0455068910435103
2023-05-18T16:45:00-04:00,1.07725,1.07727,1.0769,1.07695,1.0767936766006472,1.0771557777777778,1.0770744444444438,1.0769551111111113,1.076806000000002,1.0786098000000017,1.0811116000000016,1.08297315,1.0770679740574336,1.0770412058552101,-1179,-175393,-174825.6,0.016021296871724763,-137.7683684638474,0.04551957341657855
2023-05-18T17:00:00-04:00,1.07695,1.07695,1.07657,1.0768199999999999,1.07749,1.0771048888888888,1.0770888888888883,1.0770102222222224,1.0767900000000021,1.0785070000000017,1.0810412000000016,1.0829232,1.077018379245947,1.0770569646841681,-114,-175507,-174852.8,0.022504813615722655,-137.78212954839174,0.012074041739030128
2023-05-18T17:15:00-04:00,1.0768199999999999,1.07691,1.0767,1.07686,1.0774716,1.077059111111111,1.077117777777777,1.0770533333333336,1.0767995000000021,1.0784112000000017,1.0809728000000016,1.0828734999999998,1.0769867033967575,1.0770459717473346,82,-175425,-175062,0.02532209832912613,-137.77908354255976,0.02415010217350241
2023-05-18T17:30:00-04:00,1.07686,1.07716,1.07686,1.07703,1.077453568,1.0770415555555555,1.077139999999999,1.0770882222222224,1.076821500000002,1.078318400000002,1.0809060000000015,1.0828281999999998,1.076995362717406,1.0770331773978679,255,-175170,-175141.8,0.027722966680388553,-137.7388276132839,0.01857303381220601
2023-05-18T17:45:00-04:00,1.07703,1.07716,1.07694,1.07699,1.07743589664,1.0770115555555555,1.077096666666666,1.077103555555556,1.0768560000000023,1.0782424000000017,1.0808371000000014,1.0827816999999997,1.076994290173925,1.0770125419182945,-144,-175314,-175361.8,0.027439458516361724,-137.74417565372846,-0.03619892702668626
2023-05-18T18:00:00-04:00,1.07699,1.07751,1.07697,1.0775,1.07657,1.0770922222222221,1.077108888888888,1.0771104444444446,1.0769180000000023,1.0781580000000017,1.0807723000000014,1.0827385499999997,1.07709543213914,1.0770180335346358,375,-174939,-175271,0.023246024032376834,-137.56659740323403,0.010209859011113195
2023-05-18T18:15:00-04:00,1.0775,1.07759,1.07738,1.07757,1.0765888000000001,1.0771844444444443,1.0771222222222214,1.0771171111111113,1.0769660000000019,1.0780732000000017,1.0807071000000015,1.0826953999999998,1.077190345711312,1.0770524268277089,663,-174276,-175024.8,0.01912368847989738,-137.52352547747995,0.011137407768332448
2023-05-18T18:30:00-04:00,1.07757,1.07766,1.07755,1.07759,1.0766288480000001,1.077278,1.0771733333333326,1.0771282222222225,1.077023000000002,1.0779990000000017,1.0806432000000015,1.08265215,1.0772702765690496,1.0771091414621672,348,-173928,-174725.4,0.01608973109071499,-137.51706650033688,0.04270608004606009
2023-05-18T18:45:00-04:00,1.07759,1.07768,1.07755,1.07764,1.0766907171200002,1.0773713333333332,1.0772166666666658,1.077143555555556,1.077072500000002,1.0779348000000017,1.0805804000000014,1.0826094499999999,1.0773442212552398,1.077178913169734,331,-173597,-174410.8,0.015562757260915135,-137.5017081543983,0.03620329542816342
2023-05-18T19:00:00-04:00,1.07764,1.07765,1.07745,1.07761,1.0767698597504,1.07745,1.0772899999999992,1.0771822222222225,1.0771250000000019,1.0778708000000017,1.0805145000000014,1.0825662999999999,1.0773973770041918,1.0772595305357873,-691,-174288,-174205.6,0.014660202501901105,-137.52094463411322,0.06128418218114888
2023-05-18T19:15:00-04:00,1.07761,1.07767,1.0775,1.07756,1.076842670970368,1.077504,1.0773722222222217,1.0772348888888892,1.0771650000000021,1.0777916000000018,1.0804497000000015,1.0825231499999999,1.0774299016033535,1.0773264244286298,-486,-174774,-174172.6,0.015901814584169182,-137.54349453621134,0.06872086328264566
2023-05-18T19:30:00-04:00,1.07756,1.07756,1.07737,1.0775,1.0769096572927386,1.0775295555555555,1.0774433333333326,1.0772991111111114,1.077217000000002,1.0777138000000017,1.0803833000000016,1.08247995,1.0774439212826827,1.0773771395429041,-523,-175297,-174376.8,0.0189427429623594,-137.57261588444263,0.05943205244878387
2023-05-18T19:45:00-04:00,1.0775,1.07756,1.07744,1.0775,1.0769712847093196,1.0775408888888889,1.0774955555555552,1.077363555555556,1.0772575000000022,1.0776418000000016,1.0803199000000017,1.0824363999999997,1.0774551370261463,1.0774141116343237,0,-175297,-174650.6,0.020285706202645692,-137.57261588444263,0.04363852446078294
2023-05-18T20:00:00-04:00,1.0775,1.07774,1.07725,1.07742,1.077027981932574,1.0775257777777776,1.0775433333333326,1.0774288888888894,1.077298500000002,1.0775572000000018,1.0802562000000016,1.0823925499999998,1.077448109620917,1.077434889307459,-2196,-177493,-175429.8,0.020678464029629282,-137.735659967969,0.039926090307259354
2023-05-18T20:15:00-04:00,1.07742,1.078,1.07734,1.07779,1.0770991837393167,1.0775751111111112,1.077575555555555,1.0774860000000008,1.0773465000000022,1.0774830000000017,1.0801989000000016,1.08235025,1.0775164876967336,1.0774587114459675,1657,-175836,-175739.4,0.02284324091146173,-137.16662467996622,0.026914153132262045
2023-05-18T20:30:00-04:00,1.07779,1.07781,1.07755,1.07764,1.0772072816905987,1.077588,1.0775833333333327,1.077528222222223,1.0773595000000022,1.0774010000000016,1.0801394000000015,1.0823074,1.0775411901573868,1.077480969156774,-1168,-177004,-176185.4,0.020561716753190896,-137.32917953759164,0.0064960977013107735
2023-05-18T20:45:00-04:00,1.07764,1.07775,1.0773,1.07738,1.078,1.0775473333333332,1.0775599999999994,1.0775515555555564,1.0773590000000022,1.0773254000000017,1.0800752000000016,1.0822631,1.0775089521259094,1.0774939753254194,-1560,-178564,-176838.8,0.018798147324047484,-137.7055575488012,-0.019487931402485496
2023-05-18T21:00:00-04:00,1.07738,1.07759,1.07713,1.07734,1.077986,1.0775033333333335,1.077526666666666,1.0775577777777785,1.077353500000002,1.0772794000000017,1.0800107000000017,1.0822188,1.0774751617007274,1.0774979802603355,-1356,-179920,-177763.4,0.016698696812245332,-137.75590190269682,-0.02783861029657093
2023-05-18T21:15:00-04:00,1.07734,1.07735,1.07638,1.07649,1.0779517600000001,1.077296,1.0774022222222215,1.0775295555555562,1.077321500000002,1.0772292000000017,1.0799376000000016,1.08216905,1.077278129360582,1.0774639842082685,-2734,-182654,-178795.6,0.010268056839979814,-139.91297395051836,-0.10393370514379134
2023-05-18T21:30:00-04:00,1.07649,1.0766,1.07597,1.07656,1.0778574544000001,1.0771275555555555,1.0772911111111103,1.0774726666666674,1.077287000000002,1.0771856000000017,1.0798633000000015,1.0821195000000001,1.0771345034884656,1.077387587366615,2616,-180038,-179636,0.0030411541535147004,-139.74286554263716,-0.09280225695089943
2023-05-18T21:45:00-04:00,1.07656,1.07675,1.07622,1.07634,1.077706458048,1.0769373333333334,1.0771622222222215,1.0773884444444453,1.077256500000002,1.0771376000000017,1.0797845000000015,1.08206855,1.0769756027907724,1.077274469893292,-2040,-182078,-180650.8,-0.004261323450223014,-140.15974894904252,-0.10765661252898635
2023-05-18T22:00:00-04:00,1.07634,1.07646,1.07605,1.07641,1.0775675414041601,1.076786888888889,1.0770411111111102,1.0772846666666673,1.0772360000000019,1.0770988000000017,1.0797071000000016,1.0820172,1.076862482232618,1.0771451759146335,1904,-180174,-180972.8,-0.011992994287637067,-140.03592190554323,-0.10116009280740727
2023-05-18T22:15:00-04:00,1.07641,1.07646,1.07613,1.07638,1.0774397380918272,1.0766546666666668,1.0769255555555548,1.077164444444445,1.0772120000000018,1.0770710000000017,1.0796241000000015,1.081965,1.0767659857860945,1.077003340731707,-949,-181123,-181213.4,-0.02044551325959837,-140.06237093518826,-0.0965268883072666
2023-05-18T22:30:00-04:00,1.07638,1.07669,1.07633,1.07668,1.077322159044481,1.0766055555555556,1.0768022222222213,1.0770444444444451,1.0771945000000018,1.0770422000000017,1.0795491000000015,1.0819142,1.0767487886288756,1.0768974725853657,1673,-179450,-180572.6,-0.026519699463908662,-139.59608579425262,-0.1029885228105609
2023-05-18T22:45:00-04:00,1.07668,1.07741,1.07655,1.07721,1.07597,1.0766871111111112,1.0767544444444437,1.0769371111111117,1.0772055000000018,1.0770178000000015,1.0794761000000015,1.0818649999999999,1.0768410309031005,1.0768387780682924,1803,-177647,-180094.4,-0.032699559260879356,-138.7085518937438,-0.039902008091749604
2023-05-18T23:00:00-04:00,1.07721,1.07724,1.07677,1.07693,1.0759988,1.0767222222222221,1.0767044444444436,1.076845555555556,1.0771770000000018,1.0770124000000016,1.0793996000000015,1.08181465,1.0768588247224804,1.0768154224546342,-1556,-179203,-179519.4,-0.039025615090928424,-139.11300413611073,-0.04176799272309319
2023-05-18T23:15:00-04:00,1.07693,1.07697,1.07671,1.07694,1.076027024,1.0767693333333332,1.076659999999999,1.0767693333333337,1.0771455000000019,1.0770130000000016,1.0793242000000014,1.0817641,1.0768750597779844,1.0768179379637075,1179,-178024,-179089.4,-0.04063574247747706,-139.10205634934644,-0.03712848311581821
2023-05-18T23:30:00-04:00,1.07694,1.07714,1.0768199999999999,1.07693,1.07605468352,1.0768233333333332,1.076708888888888,1.0767260000000003,1.077112500000002,1.0770178000000015,1.0792479000000013,1.0817166,1.0768860478223874,1.0768419503709663,-1375,-179399,-178744.6,-0.04161391061990178,-139.11482400585479,0.04087357987533521
2023-05-18T23:45:00-04:00,1.07693,1.07697,1.07669,1.07683,1.0760817898496,1.0768475555555557,1.0767388888888878,1.0767133333333336,1.0770720000000018,1.0770088000000015,1.0791700000000015,1.0816658000000001,1.0768748382579099,1.076867160296773,-1086,-180485,-178951.6,-0.03509868659539615,-139.2156662147263,0.0250798840752018
2023-05-19T00:00:00-04:00,1.07683,1.07691,1.07662,1.07673,1.076108354052608,1.0768457777777778,1.0767822222222214,1.0767188888888892,1.0770280000000017,1.0769964000000014,1.0790928000000013,1.0816138499999999,1.076845870606328,1.0768681282374186,-923,-181408,-179703.8,-0.029498407695966074,-139.30138076576964,0.03623390378503915
2023-05-19T00:15:00-04:00,1.07673,1.07678,1.07631,1.07635,1.0761343869715558,1.0767593333333334,1.0767755555555547,1.0767331111111116,1.0769675000000019,1.0769728000000014,1.0790148000000013,1.08155995,1.0767466964850623,1.0768457025899347,-729,-182137,-180290.6,-0.02383614737808786,-139.55865974935887,-0.005574084224428519
2023-05-19T00:30:00-04:00,1.07635,1.07638,1.07605,1.07612,1.07741,1.076628222222222,1.0767466666666659,1.076750444444445,1.0768985000000018,1.0769524000000015,1.0789369000000013,1.0815050499999999,1.0766213571880499,1.076794962071948,-975,-183112,-181308.2,-0.0201631891796364,-139.76700276046117,-0.024155038183534344
2023-05-19T00:45:00-04:00,1.07612,1.07635,1.07609,1.07634,1.0773828,1.0765468888888887,1.0767088888888883,1.076750444444445,1.0768405000000016,1.0769458000000014,1.0788606000000014,1.08145185,1.0765650857504399,1.0767307696575583,764,-182348,-181898,-0.015406174231965235,-139.61081200106622,-0.03157855630270897
2023-05-19T01:00:00-04:00,1.07634,1.0765,1.07631,1.07645,1.0773561440000001,1.076495111111111,1.0766244444444437,1.076727555555556,1.0767920000000017,1.0769430000000015,1.0787887000000014,1.0813992000000001,1.076542068600352,1.0766642157260469,1124,-181224,-182045.8,-0.012899511171593202,-139.49594123532324,-0.07055263133466028
2023-05-19T01:15:00-04:00,1.07645,1.07645,1.07623,1.07633,1.07733002112,1.0764362222222223,1.076557777777777,1.0766826666666671,1.0767190000000018,1.0769436000000017,1.0787145000000014,1.0813471000000001,1.0764996548802817,1.0765949725808377,-958,-182182,-182200.6,-0.016252310149617605,-139.6027367204827,-0.055713927553316736
2023-05-19T01:30:00-04:00,1.07633,1.0765,1.07615,1.07649,1.0773044206976001,1.0764226666666665,1.076507777777777,1.0766291111111115,1.0766615000000017,1.0769482000000015,1.0786443000000012,1.081296,1.0764977239042253,1.0765451780646704,1320,-180862,-181945.6,-0.014590327572361672,-139.40651437231818,-0.041785057663385285
2023-05-19T01:45:00-04:00,1.07649,1.07711,1.07649,1.07687,1.077279332283648,1.076495111111111,1.0765011111111105,1.0765800000000005,1.076636000000002,1.0769534000000014,1.0785800000000014,1.0812476500000001,1.0765721791233802,1.0765353424517363,2108,-178754,-181074,-0.011835418684383116,-138.66239227178767,-0.00557139275532755
2023-05-19T02:00:00-04:00,1.07687,1.0783,1.07669,1.0781,1.07605,1.0768148888888889,1.0766422222222216,1.0765666666666673,1.0766740000000017,1.0769864000000013,1.0785295000000013,1.0812066000000002,1.0768777432987042,1.076597873961389,3610,-175144,-179633.2,-0.004152879019702592,-134.53905333579704,0.11793876470753085
2023-05-19T02:15:00-04:00,1.0781,1.07919,1.07805,1.07902,1.076095,1.0772904444444444,1.076896666666666,1.0766211111111117,1.0768005000000016,1.0770338000000015,1.0784879000000012,1.0811687500000002,1.0773061946389635,1.0767506991691114,3834,-171310,-177650.4,0.008756218905647819,-131.2672974689942,0.2126809878056825
2023-05-19T02:30:00-04:00,1.07902,1.07915,1.07812,1.07829,1.0762188,1.0775691111111112,1.0771122222222216,1.0767320000000005,1.0768870000000017,1.0770684000000015,1.0784392000000012,1.08112705,1.0775029557111708,1.0769513593352893,-2985,-174295,-176073,0.015282365583022331,-133.28676884116558,0.18023876991685353
2023-05-19T02:45:00-04:00,1.07829,1.07846,1.078,1.07814,1.076337648,1.0777746666666665,1.077336666666666,1.0768977777777784,1.0769770000000018,1.0770960000000014,1.0783903000000012,1.0810854,1.0776303645689367,1.0771778874682316,-2234,-176529,-175206.4,0.024916120885154887,-133.59753867117394,0.18771140764971683
2023-05-19T03:00:00-04:00,1.07814,1.07902,1.07807,1.07816,1.07645174208,1.0779393333333334,1.077538888888888,1.077105333333334,1.0770645000000019,1.0771300000000013,1.0783455000000013,1.0810439,1.0777362916551494,1.0774107099745855,4013,-172516,-173958.8,0.035808238680485875,-133.52309564893227,0.16909155099689063
2023-05-19T03:15:00-04:00,1.07816,1.07845,1.07775,1.07785,1.0765612723967999,1.0780015555555555,1.0776944444444436,1.0773157777777782,1.077138000000002,1.0771532000000013,1.0782913000000014,1.0810031000000002,1.0777590333241196,1.0775869679796686,-2745,-175261,-173982.2,0.043458769873848994,-134.31235698305716,0.13005713224024043
2023-05-19T03:30:00-04:00,1.07785,1.07825,1.07739,1.07763,1.0766664215009278,1.0779886666666667,1.077838888888888,1.0775042222222226,1.077185500000002,1.0771738000000013,1.0782370000000012,1.0809611000000003,1.0777332266592956,1.077672374383735,-3442,-178703,-175460.8,0.04888509879819127,-135.0149037196157,0.12078080142707895
2023-05-19T03:45:00-04:00,1.07763,1.07832,1.07758,1.07775,1.0767673646408906,1.077970888888889,1.077978888888888,1.077677555555556,1.077212500000002,1.0771922000000014,1.0781886000000014,1.0809233000000003,1.0777365813274364,1.077719099506988,3006,-175697,-175741.2,0.05733493770977489,-134.68016916322836,0.11704706964301005
2023-05-19T04:00:00-04:00,1.07775,1.07776,1.07707,1.07771,1.076864270055255,1.0779171111111112,1.0780722222222212,1.0778246666666669,1.077251500000002,1.0771988000000012,1.0781377000000014,1.0808853,1.077731265061949,1.0777392796055905,-3167,-178864,-176208.2,0.06644870736239518,-134.79771033697006,0.07800384447518753
2023-05-19T04:15:00-04:00,1.07771,1.07823,1.0775,1.07811,1.076957299253045,1.0779246666666666,1.0780733333333323,1.077931555555556,1.077310000000002,1.0772132000000014,1.0780979000000013,1.0808457500000002,1.0778070120495593,1.0777534236844724,2716,-176148,-176934.6,0.07273968158281575,-133.78964694329284,0.0009275577404548249
2023-05-19T04:30:00-04:00,1.07811,1.07945,1.07807,1.07906,1.0770466072829232,1.078122,1.0780777777777768,1.0780082222222225,1.077416500000002,1.0772454000000011,1.0780648000000013,1.0808115,1.0780576096396475,1.0778131389475782,3549,-172599,-176402.2,0.07227320260643817,-130.66236865072526,0.0037070675242180827
2023-05-19T04:45:00-04:00,1.07906,1.07927,1.0786499999999999,1.07881,1.0771908108459478,1.0782684444444444,1.0781355555555545,1.0780675555555557,1.0775155000000018,1.0772790000000012,1.0780366000000012,1.0807786000000001,1.078208087711718,1.0779081111580626,-2318,-174917,-175645,0.06200960439557717,-131.1994101498075,0.04822450361220784
2023-05-19T05:00:00-04:00,1.07881,1.07952,1.07875,1.07906,1.077326362195191,1.0784533333333333,1.078237777777777,1.0781193333333339,1.077632000000002,1.0773152000000012,1.0780106000000014,1.0807438500000002,1.0783784701693744,1.0780364889264502,2558,-172359,-174977.4,0.05929462464060783,-130.606627361365,0.08533214610345685
2023-05-19T05:15:00-04:00,1.07906,1.07947,1.07882,1.07887,1.0775018532195757,1.078579777777778,1.078316666666666,1.0781682222222226,1.077758000000002,1.0773536000000012,1.0779817000000014,1.0807161000000003,1.0784767761354994,1.0781855911411604,-1784,-174143,-174033.2,0.05660691663983859,-130.92075261853316,0.06585293462936748
2023-05-19T05:30:00-04:00,1.07887,1.08042,1.07883,1.07971,1.0776633049620097,1.0788584444444445,1.0785233333333326,1.0782582222222228,1.0779375000000018,1.0774114000000012,1.0779592000000013,1.0806938000000001,1.0787234209083996,1.0783688729129284,3831,-170312,-172866,0.05613462767858346,-127.93796507230441,0.17256575590295242
2023-05-19T05:45:00-04:00,1.07971,1.08037,1.07962,1.08025,1.0779389744658088,1.0792037777777779,1.0788144444444436,1.078405555555556,1.0781330000000018,1.0774792000000013,1.0779452000000014,1.0806792000000003,1.0790287367267197,1.0785630983303431,3087,-167225,-171791.2,0.06014399929337876,-126.39405050265148,0.243126119354495
2023-05-19T06:00:00-04:00,1.08025,1.08027,1.0794,1.07963,1.078187077019228,1.0793668888888888,1.0790233333333326,1.078583111111112,1.0782920000000018,1.0775312000000015,1.0779248000000012,1.0806582500000002,1.0791489893813757,1.0787512786642746,-3221,-170446,-170897,0.06415428828104099,-128.24271516360912,0.1744374855022133
2023-05-19T06:15:00-04:00,1.07963,1.07986,1.07903,1.07978,1.078410369317305,1.0795182222222224,1.0792533333333327,1.0787862222222229,1.0784645000000022,1.0775870000000014,1.0779147000000011,1.0806355500000002,1.0792751915051007,1.0789306229314197,3810,-166636,-169752.4,0.06826485651544315,-127.71336714623325,0.19207393454640084
2023-05-19T06:30:00-04:00,1.07978,1.07983,1.07906,1.07943,1.0786113323855746,1.0795535555555555,1.0793999999999992,1.0790028888888894,1.078611500000002,1.0776256000000015,1.077891800000001,1.0806119500000002,1.0793061532040804,1.079096498345136,-3048,-169684,-168860.6,0.07051612629777218,-128.7013461789994,0.1224364860728486
2023-05-19T06:45:00-04:00,1.07943,1.07956,1.07919,1.07944,1.078792199147017,1.0795615555555556,1.0794422222222213,1.0791866666666672,1.078740000000002,1.0776630000000014,1.0778681000000012,1.08059465,1.0793329225632644,1.079218398676109,2145,-167539,-168306,0.06981383712559601,-128.68147458009983,0.03521583600541647
2023-05-19T07:00:00-04:00,1.07944,1.07982,1.07925,1.07947,1.0789549792323154,1.0795671111111111,1.079515555555555,1.0793268888888894,1.0788085000000018,1.0777006000000013,1.0778498000000012,1.0805814000000002,1.0793603380506116,1.0792847189408874,2868,-164671,-167795.2,0.06212956762687223,-128.60176658336084,0.06117852077751253
2023-05-19T07:15:00-04:00,1.07947,1.07991,1.07923,1.07961,1.0791014813090838,1.079586,1.0795766666666657,1.0794375555555562,1.0788380000000017,1.0777400000000015,1.0778374000000013,1.0805658500000002,1.0794102704404893,1.0793369751527102,2801,-161870,-166080,0.06287578710608659,-128.23849571895508,0.05097028895520643
2023-05-19T07:30:00-04:00,1.07961,1.08044,1.0796,1.08021,1.07923,1.0797126666666665,1.0797255555555547,1.0795320000000004,1.0789340000000016,1.0777920000000014,1.077831400000001,1.0805523000000001,1.0795702163523915,1.0793959801221684,3164,-158706,-164494,0.06827920944425508,-126.48008295879188,0.12420402828884822
2023-05-19T07:45:00-04:00,1.08021,1.0809199999999999,1.0798699999999999,1.08085,1.07923,1.0799375555555555,1.0798522222222213,1.0796224444444449,1.0790695000000017,1.0778578000000014,1.0778247000000012,1.0805411500000002,1.0798261730819132,1.079499984097735,3433,-155273,-161611.8,0.07532371589359935,-124.44610808353552,0.1055839067897992
2023-05-19T08:00:00-04:00,1.08085,1.08116,1.08061,1.08079,1.0794666,1.0801251111111112,1.0799122222222215,1.079716444444445,1.0792010000000016,1.0779236000000016,1.077818700000001,1.0805307500000003,1.0800189384655305,1.079637187278188,-4242,-159515,-160007,0.07362928014882125,-124.68158941767136,0.04998842860448831
2023-05-19T08:15:00-04:00,1.08079,1.08156,1.08058,1.08133,1.0797375439999999,1.0804086666666666,1.0801011111111103,1.079833555555556,1.0793750000000017,1.0780002000000015,1.077821000000001,1.0805222,1.0802811507724244,1.0798213498225508,3352,-156163,-158305.4,0.06963933934410585,-123.00681448452066,0.1574613525003763
2023-05-19T08:30:00-04:00,1.08133,1.08237,1.08096,1.08108,1.08006558608,1.0806044444444445,1.0802455555555546,1.0799673333333337,1.0795475000000017,1.0780734000000016,1.0778153000000013,1.08051385,1.0804409206179395,1.0800274798580407,-5275,-161438,-158219,0.06881330899431762,-124.22637743015176,0.12039489525644843
2023-05-19T08:45:00-04:00,1.08108,1.08135,1.08052,1.08057,1.08237,1.0806693333333333,1.0803722222222214,1.080096666666667,1.0796885000000016,1.0781290000000014,1.0778060000000012,1.0805016,1.0804667364943517,1.0802067838864327,-4334,-165772,-159632.2,0.06315412464639139,-126.27094397471835,0.10561129485007281
2023-05-19T09:00:00-04:00,1.08057,1.08078,1.07964,1.07972,1.08237,1.080538888888889,1.0804033333333323,1.0802068888888892,1.0797890000000017,1.0781706000000013,1.0777858000000011,1.0804840000000002,1.0803173891954814,1.0803050271091463,-5179,-170951,-162767.8,0.05714603265763307,-130.34485866788964,0.025939375972731972
2023-05-19T09:15:00-04:00,1.07972,1.07993,1.0793,1.07946,1.0822608,1.0803502222222223,1.0804022222222214,1.080304888888889,1.0798565000000018,1.0782122000000016,1.077768800000001,1.0804624,1.0801459113563852,1.0803304216873173,-4345,-175296,-165924,0.049609177234835176,-131.3911484467209,-0.0009263805385831443
2023-05-19T09:30:00-04:00,1.07946,1.07973,1.0792,1.07941,1.082083152,1.0801517777777776,1.080379999999999,1.080360666666667,1.0798740000000018,1.0782536000000014,1.0777665000000012,1.08043905,1.079998729085108,1.080273937349854,-5026,-180322,-170755.8,0.04331789594016,-131.62395003269958,-0.01852520817702485
2023-05-19T09:45:00-04:00,1.07941,1.07965,1.07891,1.07951,1.08185249984,1.0799777777777777,1.0803022222222214,1.0803720000000003,1.079909000000002,1.0783140000000015,1.077771600000001,1.0804241,1.0799009832680864,1.0801659498798835,4691,-175631,-173594.4,0.04040659717198401,-131.18936076634117,-0.06480221438423298
2023-05-19T10:00:00-04:00,1.07951,1.07952,1.07863,1.0789199999999999,1.0815582498560001,1.0797013333333332,1.0800877777777766,1.0803151111111116,1.079902000000002,1.0783612000000016,1.077773400000001,1.0804046500000002,1.0797047866144691,1.080013559903907,-4609,-180240,-176488,0.027975358401348002,-133.70838328581797,-0.1785631678771531
2023-05-19T10:15:00-04:00,1.0789199999999999,1.0796,1.07888,1.07934,1.08120685987328,1.0795517777777779,1.0799266666666658,1.0802197777777782,1.0799255000000016,1.0784212000000015,1.0777794000000012,1.08038815,1.0796318292915752,1.0798764479231258,3485,-176755,-177648.8,0.012757205638546727,-132.3517488736277,-0.13416112288233156
2023-05-19T10:30:00-04:00,1.07934,1.07952,1.07888,1.07891,1.0808976366884864,1.0793484444444443,1.0796577777777767,1.0800708888888895,1.0798855000000018,1.0784712000000014,1.0777850000000013,1.08037295,1.07948746343326,1.0797447583385007,-3500,-180255,-178640.6,-0.004828591612137542,-133.7461195075334,-0.2237984704021776
2023-05-19T10:45:00-04:00,1.07891,1.07893,1.07843,1.0786,1.0806255202858681,1.0791368888888888,1.0793822222222211,1.0798713333333338,1.0798030000000016,1.0785156000000016,1.0777933000000013,1.0803540500000002,1.079309970746608,1.0796070066708006,-4113,-184368,-179449.8,-0.025215742772811092,-134.92789555928945,-0.22940022940023289
2023-05-19T11:00:00-04:00,1.0786,1.07984,1.0782,1.07967,1.0803181474458465,1.0791944444444443,1.0792822222222211,1.0796673333333338,1.0798050000000017,1.0785754000000016,1.0778088000000012,1.0803354500000002,1.0793819765972865,1.0795032053366405,6658,-177710,-179865.6,-0.035716600964847925,-128.32298178217155,-0.08328937505206724
2023-05-19T11:15:00-04:00,1.07967,1.08267,1.07965,1.0813,1.0782,1.0795979999999998,1.0794577777777767,1.0795413333333337,1.0798810000000016,1.0786572000000014,1.0778375000000013,1.0803265000000002,1.0797655812778293,1.0795153642693127,15362,-162348,-176287.2,-0.03631809643067021,-105.13065449698227,0.14633423480160734
2023-05-19T11:30:00-04:00,1.0813,1.08226,1.08087,1.08163,1.0782,1.0800324444444445,1.0796988888888879,1.0794957777777783,1.0799910000000015,1.0787512000000015,1.0778818000000014,1.0803234000000002,1.0801384650222634,1.0796166914154504,10739,-151609,-171258,-0.02678660008582227,-101.85323842373548,0.20102643914549914
2023-05-19T11:45:00-04:00,1.08163,1.08199,1.08088,1.08188,1.0782894,1.0804686666666665,1.0799733333333323,1.0795588888888892,1.0801130000000014,1.0788500000000014,1.0779315000000014,1.0803250500000001,1.0804867720178106,1.0798165531323605,7725,-143884,-163983.8,-0.015179638210382505,-100.06773876119013,0.2288287119815429
2023-05-19T12:00:00-04:00,1.08188,1.08229,1.08164,1.0818,1.078377012,1.0808339999999999,1.0802277777777767,1.0797280000000002,1.0802295000000015,1.0789474000000014,1.0779826000000012,1.0803247000000002,1.0807494176142485,1.0801044425058888,-5384,-149268,-156963.8,-0.003456171425969144,-100.4658605491881,0.21213328269308532
2023-05-19T12:15:00-04:00,1.0818,1.08183,1.08113,1.08138,1.07846287176,1.0810644444444444,1.08050111111111,1.079971777777778,1.0803180000000014,1.0790384000000015,1.0780236000000014,1.08031685,1.0808755340913987,1.080403154004711,-3960,-153228,-152067.4,0.0054350772747523085,-102.00329815318176,0.22800578356135107
2023-05-19T12:30:00-04:00,1.08138,1.08178,1.08112,1.08175,1.0785470143248,1.081314222222222,1.0807688888888878,1.0802340000000001,1.0803950000000015,1.0791388000000015,1.0780676000000013,1.08031095,1.081050427273119,1.080660123203769,2928,-150300,-149657.8,0.022196648376750866,-101.00146715945158,0.22328459984805746
2023-05-19T12:45:00-04:00,1.08175,1.0825,1.08173,1.08208,1.078629474038304,1.0815764444444445,1.08112111111111,1.0805184444444447,1.0804565000000017,1.0792534000000016,1.0781131000000013,1.0803110500000002,1.081256341818495,1.0808836985630152,2736,-147564,-148848.8,0.03931250710678652,-100.1668195976306,0.29381505408235115
2023-05-19T13:00:00-04:00,1.08208,1.08219,1.0818,1.08183,1.078710284557538,1.0817182222222221,1.0814799999999987,1.0808197777777777,1.0805085000000016,1.0793676000000014,1.0781600000000013,1.08030925,1.081371073454796,1.0810605588504125,-2369,-149933,-150058.6,0.06201588650295305,-100.71414511884869,0.29946226590024716
2023-05-19T13:15:00-04:00,1.08183,1.08215,1.08178,1.08213,1.0787894788663872,1.0818482222222223,1.0817533333333322,1.0811248888888891,1.0805485000000017,1.0794834000000015,1.0782146000000012,1.0803061500000002,1.0815228587638368,1.0812152470803302,1898,-148035,-149812,0.08877460636439678,-100.1878147342227,0.22784739781601127
2023-05-19T13:30:00-04:00,1.08213,1.08288,1.08209,1.08283,1.0788670892890595,1.0820635555555556,1.081923333333332,1.0814093333333337,1.0806360000000017,1.0796110000000014,1.0782770000000013,1.0803036500000003,1.0817842870110694,1.0813969976642643,1887,-146148,-148396,0.11140047061324741,-98.96716656810601,0.14149634698973748
2023-05-19T13:45:00-04:00,1.08283,1.08284,1.08193,1.08196,1.0790276057174972,1.082070888888889,1.0819599999999987,1.0816475555555556,1.0807055000000019,1.0797236000000014,1.0783336000000014,1.0802988000000002,1.0818194296088555,1.0815507981314114,-1842,-147990,-147934,0.11362574841341049,-100.44712187041557,0.030509508796902955
2023-05-19T14:00:00-04:00,1.08196,1.08204,1.08127,1.08141,1.0791817014887974,1.081960888888889,1.0819077777777766,1.081804888888889,1.0807900000000017,1.0798220000000014,1.0783851000000013,1.0802888000000002,1.0817375436870844,1.0816470385051293,-2418,-150408,-148502.8,0.10788472791116394,-101.67628006480365,-0.04344289570007491
2023-05-19T14:15:00-04:00,1.08141,1.0816,1.08133,1.08137,1.0793296334292455,1.0818533333333333,1.0818599999999987,1.081880888888889,1.0808855000000017,1.0799120000000013,1.0784327000000014,1.08027885,1.0816640349496676,1.0817056308041038,-2395,-152803,-149076.8,0.09588860637704683,-101.76486811189041,-0.03974856720282422
2023-05-19T14:30:00-04:00,1.08137,1.08142,1.0808,1.08102,1.0794716480920756,1.0816853333333332,1.0818199999999987,1.081894222222222,1.0809660000000016,1.0799704000000014,1.0784784000000014,1.0802638500000001,1.0815352279597341,1.0817081046432833,-2084,-154887,-150447.2,0.08179312234660029,-102.43938284782693,-0.033290795095148415
2023-05-19T14:45:00-04:00,1.08102,1.08108,1.08078,1.08083,1.0796079821683926,1.0814873333333332,1.0817177777777767,1.081853111111111,1.0810320000000018,1.0800066000000015,1.0785202000000014,1.0802471500000002,1.0813941823677873,1.0816300837146267,-1873,-156760,-152569.6,0.0704444684287237,-102.76858119753392,-0.0850473769355241
2023-05-19T15:00:00-04:00,1.08083,1.0809199999999999,1.08066,1.08074,1.0797388628816569,1.0812917777777777,1.0815688888888877,1.0817748888888887,1.0811230000000018,1.0800556000000012,1.0785620000000014,1.0802274500000002,1.0812633458942298,1.0815188669717017,-1288,-158048,-154581.2,0.055679434466204956,-102.87583210655745,-0.12383557592783315
2023-05-19T15:15:00-04:00,1.08074,1.08075,1.08019,1.0802,1.0798645083663907,1.081018,1.0813877777777765,1.0816708888888888,1.0811660000000018,1.0800968000000015,1.0785964000000015,1.0802064000000002,1.0810506767153838,1.0813814935773614,-1477,-159525,-156404.6,0.03264815664781203,-103.61382644377082,-0.15067062292596992
2023-05-19T15:30:00-04:00,1.0802,1.0802,1.07975,1.0798699999999999,1.08288,1.0807144444444443,1.0811366666666653,1.081526222222222,1.0812140000000017,1.0801310000000013,1.0786305000000014,1.0801842000000001,1.080814541372307,1.0812115948618894,-1654,-161179,-158079.8,0.012183309922644825,-104.11912175945335,-0.20884736584330446
2023-05-19T15:45:00-04:00,1.0798699999999999,1.0806499999999999,1.07986,1.08059,1.0828174000000002,1.080605111111111,1.0808877777777763,1.0813397777777776,1.0813135000000018,1.0801858000000013,1.0786695000000015,1.08016525,1.0807696330978456,1.0810584758895116,2137,-159042,-158910.8,-0.009460525429034219,-102.69428358448774,-0.20686534359040845
2023-05-19T16:00:00-04:00,1.08059,1.08074,1.08026,1.08027,1.0827560520000001,1.0804815555555556,1.0806999999999987,1.0811362222222223,1.081343500000002,1.0802386000000013,1.0787062000000014,1.08014585,1.0806697064782764,1.0809135807116095,-1233,-160275,-159613.8,-0.040490537087433026,-103.05941744654443,-0.1561980110170403
2023-05-19T16:15:00-04:00,1.08027,1.08071,1.08011,1.08066,1.0826959309600002,1.0804735555555556,1.0806166666666652,1.0809457777777776,1.081311500000002,1.0802968000000013,1.0787445000000013,1.0801296000000002,1.080667765182621,1.0807944645692877,611,-159664,-159937,-0.056871002702509686,-102.83883370359135,-0.06935389907620869
2023-05-19T16:30:00-04:00,1.08066,1.08081,1.0805,1.0806,1.0826370123408002,1.0804702222222222,1.0805311111111098,1.0807744444444443,1.0812600000000019,1.0803546000000013,1.0787767000000015,1.0801135500000003,1.080654212146097,1.0807151716554304,-614,-160278,-160087.6,-0.061281121142748175,-102.87292398175467,-0.07120597020445707
2023-05-19T16:45:00-04:00,1.0806,1.08064,1.08019,1.08054,1.0825792720939842,1.0804719999999999,1.0804777777777763,1.0806426666666664,1.081193000000002,1.0804032000000015,1.0788082000000014,1.0800975500000003,1.0806313697168775,1.0806785373243444,-920,-161198,-160091.4,-0.06415998773867122,-102.92400671357028,-0.04440250874174723
2023-05-21T17:00:00-04:00,1.08045,1.08055,1.08045,1.08055,1.0825226866521045,1.0804864444444444,1.0804466666666652,1.0805544444444442,1.0811305000000018,1.0804330000000013,1.0788392000000016,1.0800794500000004,1.080615095773502,1.0806476298594756,123,-161075,-160498,-0.06265302643837879,-102.92286839384127,-0.025906016672377522
2023-05-21T17:15:00-04:00,1.08055,1.08062,1.08053,1.08062,1.0824672329190623,1.080521111111111,1.0804333333333318,1.0805011111111107,1.0810925000000018,1.0804692000000014,1.0788741000000015,1.0800622500000003,1.0806160766188015,1.0806369038875807,30,-161045,-160652,-0.05940123938302995,-102.92092493911913,-0.011103503155256584
2023-05-21T17:30:00-04:00,1.08062,1.08062,1.0806,1.08061,1.0824128882606812,1.0805564444444444,1.0804788888888874,1.0804735555555551,1.0810355000000018,1.0805002000000012,1.0789077000000014,1.0800447500000003,1.0806148612950413,1.0806263231100648,-16,-161061,-160931.4,-0.057214064026455055,-102.92107300226806,0.037955934086282304
2023-05-21T17:45:00-04:00,1.08061,1.08064,1.08055,1.08058,1.0823596304954675,1.0805766666666667,1.0805577777777762,1.0804788888888883,1.080960500000002,1.0805344000000014,1.0789440000000012,1.0800278000000005,1.080607889036033,1.080617058488052,-375,-161436,-161163,-0.048547901903267986,-102.93148378876826,0.0657486549307056
2023-05-21T18:00:00-04:00,1.08058,1.08151,1.08058,1.08132,1.0823074378855582,1.0807291111111113,1.0806388888888874,1.0805111111111105,1.080935000000002,1.0805666000000014,1.0789890000000013,1.0800151000000004,1.0807503112288266,1.0806408467904418,516,-160920,-161107.4,-0.03178780407322402,-102.57811800372691,0.06755568717090844
2023-05-21T18:15:00-04:00,1.08132,1.08181,1.08132,1.08175,1.082256289127847,1.0809513333333334,1.0808033333333318,1.080582444444444,1.080916000000002,1.0805966000000014,1.0790379000000014,1.0800053500000004,1.0809502489830614,1.0807078774323535,475,-160445,-160981.4,-0.02070443537455638,-102.38922849830765,0.13700278634044505
2023-05-21T18:30:00-04:00,1.08175,1.08197,1.08171,1.08177,1.0822061633452902,1.0811446666666666,1.0809266666666653,1.0806811111111105,1.0808630000000021,1.0806394000000012,1.0790853000000014,1.0799956500000005,1.081114199186449,1.0808075019458832,463,-159982,-160768.8,-0.005242269964479504,-102.38066829493353,0.10271500749541432
2023-05-21T18:45:00-04:00,1.08177,1.08197,1.08172,1.08172,1.0821570400783844,1.0813033333333335,1.0810511111111096,1.080795555555555,1.080851000000002,1.0806782000000015,1.0791326000000014,1.0799848500000004,1.0812353593491593,1.0809316015567068,-278,-160260,-160608.6,0.009454169306363181,-102.39351760670957,0.10364612252452432
2023-05-21T19:00:00-04:00,1.08172,1.08238,1.08169,1.0823099999999999,1.07975,1.081555111111111,1.0812477777777763,1.080933555555555,1.0808960000000019,1.0807358000000014,1.0791807000000013,1.0799765000000003,1.0814502874793275,1.0811000812453657,916,-159344,-160190.2,0.02373197799236172,-101.89390587724179,0.1638069853961748
2023-05-21T19:15:00-04:00,1.0823099999999999,1.08242,1.08206,1.0821,1.0798026,1.0817255555555556,1.0814199999999985,1.0810897777777773,1.0809325000000019,1.0807890000000013,1.0792260000000014,1.0799665500000004,1.081580229983462,1.0812660649962926,-511,-159855,-159977.2,0.03512331707204946,-101.99305491956784,0.14344546758596663
2023-05-21T19:30:00-04:00,1.0821,1.08215,1.08173,1.08179,1.079907296,1.0817995555555553,1.0815499999999985,1.0812391111111108,1.080971000000002,1.0808354000000013,1.0792680000000012,1.0799556000000003,1.0816221839867697,1.0814004519970344,-608,-160463,-159980.8,0.04474362611482782,-102.1672347550729,0.10827117765728152
2023-05-21T19:45:00-04:00,1.08179,1.08225,1.08179,1.08217,1.08000780416,1.0819235555555555,1.0817233333333318,1.081398444444444,1.081038000000002,1.0808866000000013,1.0793133000000013,1.0799468500000005,1.0817317471894157,1.0815239615976278,577,-159886,-159961.6,0.05401383779736404,-101.96455216418185,0.14436290613634944
2023-05-21T20:00:00-04:00,1.08217,1.08245,1.08171,1.08185,1.0801042919936001,1.0819488888888886,1.0818644444444427,1.0815611111111108,1.081093500000002,1.0809194000000013,1.0793557000000014,1.0799351000000004,1.0817553977515326,1.0816279692781023,-1992,-161878,-160285.2,0.060988582370127775,-102.55359085496075,0.11752947491161064
2023-05-21T20:15:00-04:00,1.08185,1.0821399999999999,1.08181,1.08185,1.0802450344739842,1.081946,1.0819233333333316,1.0816962222222217,1.0811760000000017,1.0809394000000012,1.0793986000000013,1.0799241500000003,1.081774318201226,1.081692775422482,0,-161878,-160792,0.06784350758384677,-102.55359085496075,0.04901416786889352
2023-05-21T20:30:00-04:00,1.08185,1.0823099999999999,1.08165,1.08225,1.0803773324055452,1.0820113333333334,1.0819788888888873,1.0818079999999994,1.081295000000002,1.0809686000000014,1.0794461000000013,1.0799147000000004,1.0818694545609808,1.0817506203379859,1262,-160616,-160944.2,0.0674101781178078,-102.08698272998969,0.046221400508430315
2023-05-21T20:45:00-04:00,1.08225,1.08249,1.08203,1.08235,1.0805016924612125,1.0820855555555555,1.0820433333333317,1.0819066666666661,1.0813830000000018,1.0809890000000013,1.0794946000000012,1.0799072500000007,1.0819655636487846,1.081819296270389,1748,-158868,-160625.2,0.062030319377379475,-101.92546736847434,0.05361583331022537
2023-05-21T21:00:00-04:00,1.08235,1.08298,1.08235,1.08271,1.0806607570643154,1.082218888888889,1.0821533333333315,1.081992666666666,1.0815050000000017,1.0810216000000015,1.0795475000000012,1.0799018500000006,1.0821144509190277,1.0818958370163112,2361,-156507,-159949.4,0.061381650761374716,-101.1401761040956,0.09152091114151965
2023-05-21T21:15:00-04:00,1.08271,1.0829199999999999,1.08234,1.08286,1.0808926813578839,1.0823602222222222,1.0822144444444428,1.082062666666666,1.0816150000000015,1.0810674000000013,1.0795982000000013,1.0798985500000005,1.0822635607352222,1.0819974696130492,2257,-154250,-158423.8,0.06051170785323121,-100.82748849614914,0.05081723350981239
2023-05-21T21:30:00-04:00,1.08286,1.08286,1.08207,1.08219,1.0811014132220955,1.0823553333333333,1.0822244444444427,1.0821228888888883,1.0816945000000016,1.0811168000000013,1.0796437000000012,1.0798915500000006,1.0822488485881778,1.0820923756904395,-2698,-156948,-157437.8,0.05266241945127237,-102.49682709947724,0.008317161075679093
2023-05-21T21:45:00-04:00,1.08219,1.08262,1.08218,1.08254,1.0812892718998859,1.0824184444444442,1.082307777777776,1.082188666666666,1.0817945000000015,1.0811784000000015,1.0796953000000011,1.0798852500000007,1.0823070788705422,1.082179900552352,2443,-154505,-156215.6,0.04818538828513337,-101.70671630562387,0.06932953715601257
2023-05-21T22:00:00-04:00,1.08254,1.08257,1.08188,1.08199,1.0814583447098973,1.082354888888889,1.0822877777777762,1.082237555555555,1.0818665000000016,1.0812300000000015,1.0797418000000012,1.0798762500000008,1.0822436630964338,1.0822355204418819,-2000,-156505,-155743,0.04364843902699741,-102.72284503989707,-0.016633246162808892
2023-05-21T22:15:00-04:00,1.08199,1.08244,1.08198,1.08243,1.0816105102389075,1.0823833333333335,1.0823522222222204,1.0822773333333326,1.0819570000000014,1.0812884000000016,1.0798012000000012,1.0798694000000006,1.082280930477147,1.0822688163535057,1762,-154743,-155390.2,0.037773286337619026,-102.00631346381967,0.05361186855849008
2023-05-21T22:30:00-04:00,1.08243,1.08244,1.08191,1.08193,1.0817474592150167,1.082298888888889,1.0823611111111093,1.0823066666666663,1.0820230000000015,1.0813486000000014,1.079854900000001,1.0798591000000006,1.0822107443817177,1.0822582530828047,-1994,-156737,-155887.6,0.03274493674824327,-102.92738919158025,0.007394740490833295
2023-05-21T22:45:00-04:00,1.08193,1.0824799999999999,1.08185,1.08227,1.08298,1.0822806666666667,1.0823633333333318,1.0823344444444438,1.0821075000000016,1.0814072000000015,1.079914200000001,1.0798493500000006,1.0822225955053741,1.082253002466244,1699,-155038,-155505.6,0.02931866021392636,-102.39347294930948,0.0018480018480139548
2023-05-21T23:00:00-04:00,1.08227,1.08238,1.08197,1.0821,1.0829574,1.082228,1.0823355555555538,1.0823399999999994,1.0821465000000015,1.0814710000000014,1.0799711000000012,1.0798391000000007,1.0821980764042993,1.0822312019729954,-1430,-156468,-155898.2,0.02124162513626873,-102.6180934229436,-0.02309788885294604
2023-05-21T23:15:00-04:00,1.0821,1.08236,1.0821,1.08225,1.082935252,1.082210888888889,1.0822844444444426,1.0823393333333329,1.0821715000000016,1.0815440000000014,1.080029800000001,1.0798269500000008,1.0822084611234395,1.0822241615783965,1135,-155333,-155663.8,0.01622429393312502,-102.460760459262,-0.04248598424325322
2023-05-21T23:30:00-04:00,1.08225,1.08254,1.08209,1.08244,1.08291354696,1.082242,1.082237777777776,1.082316444444444,1.0822050000000014,1.0815994000000015,1.080087400000001,1.0798182500000009,1.0822547688987516,1.0822189292627176,901,-154432,-155601.6,0.010692659951109618,-102.30258074108218,-0.03878617734516604
2023-05-21T23:45:00-04:00,1.08244,1.08244,1.08197,1.08208,1.0828922760208,1.0822104444444445,1.0822255555555538,1.0822893333333328,1.0822230000000015,1.0816150000000015,1.0801361000000012,1.0798061000000008,1.0822198151190012,1.0822207434101743,-1062,-155494,-155353,0.0021209019730815807,-102.65578276613682,-0.010164573688544017
2023-05-22T00:00:00-04:00,1.08208,1.08234,1.08192,1.08218,1.082871430500384,1.0822013333333333,1.082185555555554,1.0822537777777772,1.0822165000000015,1.0816260000000013,1.080188600000001,1.0797941000000009,1.0822118520952009,1.0822185947281397,1072,-154422,-155229.8,0.000004400122599681806,-102.55671430539456,-0.03325512221258688
2023-05-22T00:15:00-04:00,1.08218,1.08236,1.08206,1.08229,1.0828510018903763,1.0822222222222222,1.0822188888888873,1.0822304444444442,1.0822260000000015,1.0816342000000014,1.0802421000000009,1.0797831500000008,1.0822274816761608,1.082224475782512,767,-153655,-154667.2,-0.002217663691180322,-102.47875130478465,0.027726688786399778
2023-05-22T00:30:00-04:00,1.08229,1.08233,1.08208,1.08219,1.0828309818525688,1.0822164444444446,1.0821922222222207,1.0822119999999995,1.0822460000000014,1.0816420000000015,1.080294700000001,1.0797713000000009,1.0822199853409287,1.0822267806260097,-892,-154547,-154510,-0.0007656189565891055,-102.56116914103924,-0.022172334469667137
2023-05-22T00:45:00-04:00,1.08219,1.08223,1.08176,1.08184,1.0828113622155173,1.0821459999999998,1.0821822222222206,1.0822008888888885,1.0822295000000013,1.0816512000000014,1.080344800000001,1.079757400000001,1.0821439882727428,1.0822046245008081,-1342,-155889,-154801.4,-0.006437345226382224,-102.99519643753995,-0.008318467923076864
2023-05-22T01:00:00-04:00,1.08184,1.0819,1.08172,1.08178,1.0827693077268967,1.0820655555555554,1.082127777777776,1.082181333333333,1.0822260000000015,1.0816518000000015,1.080395300000001,1.0797440500000008,1.0820711906181943,1.0821748996006466,-1507,-157396,-155181.8,-0.006107442587462023,-103.07877626450134,-0.04527520858936323
2023-05-22T01:15:00-04:00,1.08178,1.08196,1.08143,1.08143,1.082706349263283,1.081926,1.0820533333333318,1.0821548888888883,1.0822050000000014,1.0816388000000015,1.080446100000001,1.079730450000001,1.0819429524945554,1.0821211196805176,-1147,-158543,-156006,-0.012021499651128045,-103.44987759748965,-0.061916643563457205
2023-05-22T01:30:00-04:00,1.08143,1.08155,1.08114,1.08147,1.0826042413222203,1.0818093333333332,1.0819666666666647,1.0821044444444439,1.0821660000000013,1.0816316000000015,1.080499600000001,1.0797182500000009,1.0818483619956443,1.0820452957444142,1655,-156888,-156652.6,-0.016171211547049313,-103.3886623547092,-0.07207207207207235
2023-05-22T01:45:00-04:00,1.08147,1.08151,1.08098,1.08101,1.0824578171899983,1.081618,1.081807777777776,1.082027555555555,1.0820990000000015,1.0816092000000015,1.080546300000001,1.079703450000001,1.0816806895965154,1.0819374365955317,-1833,-158721,-157487.4,-0.02217447115040538,-104.16832337165819,-0.13210893906360097
2023-05-22T02:00:00-04:00,1.08101,1.08175,1.08072,1.08119,1.0822804791271985,1.0814944444444443,1.081708888888887,1.0819328888888884,1.0820230000000015,1.0815764000000014,1.080593700000001,1.079691200000001,1.0815825516772124,1.0818251492764255,3010,-155711,-157451.8,-0.02862276698176876,-103.66712541789254,-0.08224900192220866
2023-05-22T02:15:00-04:00,1.08119,1.08223,1.081,1.0821,1.08072,1.0815726666666667,1.081699999999998,1.0818473333333327,1.0819850000000015,1.0815792000000015,1.080651400000001,1.079682950000001,1.08168604134177,1.0817481194211405,3223,-152488,-156470.2,-0.02575414037843436,-100.95443847110252,-0.0073924855384370405
2023-05-22T02:30:00-04:00,1.0821,1.08241,1.08172,1.08189,1.08072,1.0816106666666667,1.0816555555555536,1.081767777777777,1.0819700000000014,1.0815888000000013,1.0807054000000011,1.0796748500000009,1.081726833073416,1.0817048955369128,-2189,-154677,-155697,-0.024166442577182364,-101.3792513349784,-0.03695867096618798
2023-05-22T02:45:00-04:00,1.08189,1.08198,1.081,1.08106,1.0807875999999998,1.0814915555555555,1.081529999999998,1.0816804444444437,1.0818960000000015,1.0815826000000015,1.0807473000000012,1.079663650000001,1.0815934664587328,1.0816539164295302,-2677,-157354,-155790.2,-0.03056276149324473,-103.4329813814714,-0.10441789334590741
2023-05-22T03:00:00-04:00,1.08106,1.08128,1.08028,1.08028,1.08241,1.0812415555555555,1.0813566666666645,1.0815902222222216,1.0818105000000016,1.0815678000000013,1.080769100000001,1.079649300000001,1.0813307731669861,1.0815839331436243,-4134,-161488,-156343.6,-0.03827327869272072,-106.41572054488509,-0.1441987724617324
2023-05-22T03:15:00-04:00,1.08028,1.08067,1.07952,1.08055,1.0823674,1.0810802222222222,1.0812199999999978,1.0814924444444438,1.0817165000000015,1.0815622000000014,1.080784400000001,1.079636150000001,1.0811746185335889,1.0815023465148996,4183,-157305,-156662.4,-0.04386188875512411,-105.37024159498324,-0.11370149198543737
2023-05-22T03:30:00-04:00,1.08055,1.08071,1.07973,1.08067,1.082253504,1.0809702222222222,1.0811355555555535,1.081379555555555,1.0816535000000014,1.0815608000000012,1.080808200000001,1.079623700000001,1.081073694826871,1.0813798772119199,4134,-153171,-156799,-0.04637904468400207,-104.91114206233738,-0.07027731799560508
2023-05-22T03:45:00-04:00,1.08067,1.08118,1.08028,1.08069,1.08214416384,1.0808811111111112,1.0810488888888867,1.0812582222222216,1.0815745000000014,1.0815706000000014,1.0808337000000012,1.0796120000000011,1.080996955861497,1.081233901769536,3339,-149832,-155830,-0.04776399856286964,-104.84934706478984,-0.07212405337179977
2023-05-22T04:00:00-04:00,1.08069,1.0808,1.08011,1.0803099999999999,1.0820391972864,1.0807333333333333,1.0809711111111089,1.0811464444444439,1.0814850000000016,1.0815794000000012,1.0808552000000011,1.079600350000001,1.0808595646891974,1.0810871214156292,-3876,-153708,-155100.8,-0.04986394737528321,-106.2122540964087,-0.06475425759245011
2023-05-22T04:15:00-04:00,1.0803099999999999,1.08066,1.08018,1.08036,1.0819384293949441,1.080611111111111,1.0808788888888867,1.0810508888888881,1.0813905000000017,1.0815748000000012,1.0808803000000011,1.079585800000001,1.080759651751358,1.0809728971325037,2733,-150975,-152998.2,-0.048216517261409485,-106.08576262636743,-0.07676726569799094
2023-05-22T04:30:00-04:00,1.08036,1.0812599999999999,1.0799,1.08121,1.0818416922191463,1.0806773333333333,1.0807799999999976,1.080962888888888,1.0813290000000015,1.0815936000000013,1.0809161000000012,1.079576550000001,1.0808497214010864,1.080907917706003,3093,-147882,-151113.6,-0.04345409885577226,-103.65226823560874,-0.08224748174845739
2023-05-22T04:45:00-04:00,1.08121,1.08128,1.0807,1.08103,1.0817488245303803,1.0807273333333332,1.0806844444444421,1.0808726666666657,1.0812765000000018,1.0816010000000011,1.0809489000000012,1.0795687500000009,1.080885777120869,1.0808703341648027,-3355,-151237,-150726.8,-0.04714278605267066,-104.21080912960736,-0.07949052121750667
2023-05-22T05:00:00-04:00,1.08103,1.0816999999999999,1.0808,1.08154,1.07952,1.0808984444444445,1.0807377777777754,1.0808104444444433,1.0812445000000015,1.0816198000000012,1.0809872000000014,1.079562450000001,1.0810166216966952,1.0808742673318423,2804,-148433,-150447,-0.0480026705338005,-102.88795962496823,0.04440086581688676
2023-05-22T05:15:00-04:00,1.08154,1.08186,1.08136,1.08181,1.0795636,1.081112888888889,1.0809077777777754,1.0807977777777769,1.0812205000000017,1.0816452000000012,1.0810242000000012,1.079561050000001,1.081175297357356,1.080937413865474,2540,-145893,-148884,-0.03943769900506035,-102.25386379864652,0.14162994779131627
2023-05-22T05:30:00-04:00,1.08181,1.08235,1.08179,1.08205,1.079655456,1.0813413333333333,1.081074444444442,1.080836888888888,1.0812135000000016,1.0816752000000012,1.0810541000000011,1.079559450000001,1.0813502378858848,1.0810555310923793,2160,-143733,-147435.6,-0.02201135712031072,-101.77466689715732,0.13881819443802296
2023-05-22T05:45:00-04:00,1.08205,1.08211,1.08173,1.08193,1.07981712864,1.0815124444444444,1.081214444444442,1.080923777777777,1.0812180000000013,1.0817014000000011,1.0810853000000011,1.079560950000001,1.081466190308708,1.0811788248739036,-1992,-145725,-147004.2,-0.008103513577692775,-101.99558090297941,0.11659433499588578
2023-05-22T06:00:00-04:00,1.08193,1.08228,1.08172,1.08201,1.0799691009216,1.0816715555555554,1.0813611111111083,1.08105911111111,1.0812295000000014,1.081729400000001,1.081114800000001,1.079562700000001,1.0815749522469664,1.081316659899123,2288,-143437,-145444.2,0.00354085659673673,-101.82640175090887,0.12214418565916109
2023-05-22T06:15:00-04:00,1.08201,1.08287,1.08197,1.08283,1.0801119548663038,1.0819653333333332,1.0816411111111084,1.081239777777777,1.0812995000000014,1.0817744000000011,1.081154400000001,1.0795680500000011,1.0818259617975732,1.0814785279192987,2503,-140934,-143944.4,0.0187075414116453,-99.9295061584466,0.23326637724357618
2023-05-22T06:30:00-04:00,1.08283,1.08295,1.0823,1.08232,1.0803325984769996,1.0821011111111112,1.0818588888888863,1.0814299999999988,1.0813420000000016,1.081794400000001,1.0811805000000012,1.079569850000001,1.0819247694380585,1.081628422335439,-2499,-143433,-143452.4,0.03337544713816596,-101.10650531805616,0.1814210078122072
2023-05-22T06:45:00-04:00,1.08232,1.08253,1.082,1.08219,1.0805943386292995,1.0821673333333333,1.0819677777777752,1.0816086666666656,1.0814010000000016,1.081803200000001,1.0811999000000012,1.079572550000001,1.0819778155504467,1.0817539378683514,-2068,-145501,-143806,0.047126627601544645,-101.35489766043173,0.09063919127643852
2023-05-22T07:00:00-04:00,1.08219,1.08233,1.08155,1.08164,1.0808299047663696,1.0821017777777777,1.082035555555553,1.0817728888888876,1.0814235000000016,1.0818006000000011,1.0812200000000012,1.079572400000001,1.0819102524403574,1.0818427502946815,-2740,-148241,-144309.2,0.04832745184218483,-102.7474442557617,0.05642766620722824
2023-05-22T07:15:00-04:00,1.08164,1.08204,1.08157,1.0819,1.0810419142897327,1.0820746666666667,1.0820755555555528,1.0819157777777764,1.0814135000000016,1.081804200000001,1.0812412000000011,1.0795779500000011,1.0819082019522859,1.0819094002357452,1611,-146630,-144947.8,0.0532443989244715,-102.36019896157858,0.03328587014813488
2023-05-22T07:30:00-04:00,1.0819,1.08195,1.08123,1.0815299999999999,1.08295,1.0819655555555554,1.0820444444444417,1.081996444444443,1.0813955000000015,1.0817886000000012,1.081262200000001,1.0795770000000011,1.0818325615618287,1.0819107201885962,-3428,-150058,-146772.6,0.055663193863546255,-103.53254391028058,-0.025882548691550086
2023-05-22T07:45:00-04:00,1.0815299999999999,1.0822,1.08138,1.08215,1.0829156,1.0819866666666664,1.082055555555553,1.0820357777777765,1.0814500000000016,1.0817896000000011,1.081289300000001,1.0795787000000012,1.081896049249463,1.0819049761508772,2589,-147469,-147579.8,0.0576616706429565,-102.04836871403067,0.009241717111038213
2023-05-22T08:00:00-04:00,1.08215,1.08236,1.08198,1.08226,1.082881888,1.0820275555555556,1.0820922222222196,1.0820606666666654,1.0815490000000016,1.081799000000001,1.081317200000001,1.0795835000000011,1.0819688393995703,1.0819031809207018,2461,-145008,-147481.2,0.054316669352651344,-101.79820930914214,0.030501049051227108
2023-05-22T08:15:00-04:00,1.08226,1.08276,1.08218,1.0827499999999999,1.08284885024,1.082159111111111,1.0821744444444417,1.0820884444444432,1.0816590000000017,1.0818106000000012,1.081348600000001,1.0795930000000014,1.0821250715196562,1.0819461447365615,3005,-142003,-146233.6,0.05101760036778781,-100.437676719931,0.06839123483146764
2023-05-22T08:30:00-04:00,1.0827499999999999,1.08313,1.0818699999999999,1.08212,1.08123,1.082148222222222,1.082095555555553,1.0820924444444429,1.0817315000000018,1.0818160000000012,1.081367700000001,1.0795995500000013,1.082124057215725,1.0819893157892493,-4252,-146255,-146158.6,0.04511936888363211,-102.91171043039013,-0.06556892587017246
2023-05-22T08:45:00-04:00,1.08212,1.0826,1.08155,1.08193,1.081268,1.0821151111111111,1.0820522222222198,1.0820939999999986,1.081793500000002,1.081817600000001,1.0813785000000011,1.0796016000000013,1.08208524577258,1.0820398526313997,-4202,-150457,-146238.4,0.031250330155717716,-103.64950291181513,-0.03603370537363169
2023-05-22T09:00:00-04:00,1.08193,1.08215,1.0812,1.0813,1.08313,1.0819646666666667,1.0819533333333309,1.082073555555554,1.0818430000000019,1.081798600000001,1.0813836000000012,1.0796011500000013,1.081928196618064,1.0820462821051198,-3797,-154254,-147595.4,0.01913530602634367,-105.86046850108661,-0.0822406416618207
2023-05-22T09:15:00-04:00,1.0813,1.0815,1.08084,1.0809,1.0830913999999998,1.0817539999999999,1.0818711111111086,1.0820293333333317,1.0818700000000019,1.081769600000001,1.0813793000000012,1.0796001500000014,1.0817225572944513,1.081997025684096,-3393,-157647,-150123.2,0.004613130872154286,-107.1156243320307,-0.06841462963647452
2023-05-22T09:30:00-04:00,1.0809,1.08188,1.0809,1.08157,1.083001344,1.0816937777777775,1.0818344444444419,1.0819613333333318,1.0818880000000017,1.081746800000001,1.0813842000000013,1.0795997500000012,1.081692045835561,1.081910420547277,4568,-153079,-152338.4,-0.0013600968704885977,-104.28413205707487,-0.030501894814692992
2023-05-22T09:45:00-04:00,1.08157,1.08177,1.08091,1.08123,1.0829148902399999,1.0815728888888887,1.0818011111111088,1.081902444444443,1.0818980000000018,1.081714200000001,1.0813908000000012,1.0795984000000012,1.0815996366684488,1.0818055364378218,-4772,-157851,-154657.6,-0.007641184753249153,-105.78424762980714,-0.02773848159551441
2023-05-22T10:00:00-04:00,1.08123,1.08243,1.08051,1.08111,1.0828318946303999,1.0814346666666668,1.0816855555555531,1.0818291111111098,1.081876500000002,1.0816926000000011,1.081404700000001,1.0795952500000012,1.081501709334759,1.0816888291502575,-9501,-167352,-158036.6,-0.011875486100329386,-106.83871337714955,-0.09610497620477106
2023-05-22T10:15:00-04:00,1.08111,1.08139,1.07999,1.08061,1.0826925809525758,1.0812195555555555,1.08150222222222,1.0817388888888875,1.0818165000000017,1.081654000000001,1.0814162000000012,1.0795925000000013,1.081323367467807,1.0815678633202062,-5770,-173122,-161810.2,-0.022017647571384524,-109.50726699334002,-0.15245874373994506
2023-05-22T10:30:00-04:00,1.08061,1.08151,1.0806,1.08124,1.0824763744763697,1.0811671111111114,1.0813344444444422,1.0816315555555542,1.0817760000000018,1.0816390000000011,1.0814345000000012,1.0796005000000013,1.0813066939742457,1.081484690656165,5664,-167458,-163772.4,-0.02893795419127856,-106.20513208805552,-0.13945970907410765
2023-05-22T10:45:00-04:00,1.08124,1.08125,1.07971,1.07984,1.08227746451826,1.0808682222222223,1.0810811111111087,1.0814808888888876,1.0816715000000017,1.081587200000001,1.0814378000000011,1.0796047000000013,1.0810133551793966,1.081348952524932,-6229,-173687,-167894,-0.04611417120382573,-114.27050147875548,-0.2106975196835896
2023-05-22T11:00:00-04:00,1.07984,1.08046,1.07978,1.07981,1.082020718066434,1.080614,1.0808455555555532,1.0812897777777766,1.0815615000000016,1.081544800000001,1.0814467000000012,1.0796100500000012,1.0807726841435172,1.0811835620199457,-4382,-178069,-171937.6,-0.058142299381192246,-114.39224173657135,-0.19594613329883834
2023-05-22T11:15:00-04:00,1.07981,1.08024,1.07961,1.0802,1.0817896462597907,1.080484888888889,1.0807233333333308,1.081097333333332,1.0814300000000017,1.081503400000001,1.0814553000000011,1.0796173500000013,1.0806581473148138,1.0810148496159566,2728,-175341,-173535.4,-0.06617372838244762,-113.40695728838111,-0.10172939979653
2023-05-22T11:30:00-04:00,1.0802,1.0804,1.0799,1.07991,1.0815280887086158,1.080322222222222,1.080613333333331,1.0809195555555544,1.0813095000000017,1.081459600000001,1.0814653000000012,1.0796251500000014,1.080508517851851,1.0808518796927653,-2505,-177846,-174480.2,-0.06617783377231817,-114.07947163757599,-0.09159034138218582
2023-05-22T11:45:00-04:00,1.07991,1.0808,1.07975,1.08051,1.081297918063582,1.0803015555555555,1.0804955555555533,1.0807517777777766,1.0812255000000017,1.0814248000000009,1.0814844000000015,1.0796388500000014,1.0805088142814807,1.0806923037542124,2619,-175227,-176034,-0.06181875833993616,-112.6243503774706,-0.09800567693259234
2023-05-22T12:00:00-04:00,1.08051,1.08101,1.08029,1.08076,1.081095367895952,1.0803544444444444,1.080443333333331,1.0806242222222209,1.0811815000000018,1.0813912000000008,1.0814953000000014,1.0796520500000013,1.0805590514251846,1.0806014430033701,2463,-172764,-175849.4,-0.06301620725043802,-112.05448059375767,-0.043469012143574494
2023-05-22T12:15:00-04:00,1.08076,1.0816999999999999,1.08059,1.08155,1.07961,1.0805757777777778,1.0804922222222197,1.0805535555555543,1.0811640000000016,1.0813806000000008,1.0814978000000013,1.0796676500000015,1.0807572411401476,1.0805983544026962,2298,-170466,-174328.8,-0.059660394676311485,-110.37471820432786,0.04069891130412224
2023-05-22T12:30:00-04:00,1.08155,1.08166,1.08099,1.08142,1.0796518,1.0807613333333332,1.08058222222222,1.0805253333333322,1.0811585000000017,1.0813654000000008,1.0814957000000014,1.0796887500000016,1.0808897929121182,1.0806446835221573,-2358,-172824,-173825.4,-0.054680308482252825,-110.65814476805576,0.07495766280156368
2023-05-22T12:45:00-04:00,1.08142,1.08147,1.08096,1.08096,1.079692764,1.0808368888888888,1.0805511111111086,1.0805128888888877,1.0810990000000016,1.0813388000000008,1.0814865000000013,1.0797090000000016,1.0809038343296946,1.080723746817726,-1969,-174793,-173214.8,-0.04893382833855417,-111.49569169709375,-0.025896193259596204
2023-05-22T13:00:00-04:00,1.08096,1.0816999999999999,1.0808,1.08165,1.07973290872,1.0810566666666668,1.08075222222222,1.0805642222222211,1.0810685000000018,1.081328000000001,1.0814850000000014,1.0797338000000016,1.0810530674637557,1.080832597454181,1773,-173020,-172773.4,-0.04294026990384263,-110.36394769176502,0.1676174248036829
2023-05-22T13:15:00-04:00,1.08165,1.08176,1.08094,1.08115,1.0797722505456,1.0811362222222223,1.0809011111111086,1.0806557777777765,1.0809885000000017,1.0813142000000007,1.0814827000000014,1.0797531500000017,1.0810724539710046,1.080935277963345,-3104,-176124,-173445.4,-0.02593544681367686,-111.79879260462947,0.12409590576120974
2023-05-22T13:30:00-04:00,1.08115,1.08145,1.0810899999999999,1.08138,1.079851760523776,1.081232,1.0810322222222197,1.0807637777777765,1.0809515000000016,1.0813062000000009,1.0814790000000014,1.0797733000000016,1.0811339631768038,1.0810106223706764,1502,-174622,-174276.6,-0.005378582142133045,-111.47926247467532,0.10923902980929076
2023-05-22T13:45:00-04:00,1.08138,1.08204,1.08122,1.0818,1.079928090102825,1.0813855555555556,1.0812422222222198,1.0808957777777766,1.0809450000000018,1.0813136000000008,1.0814762000000013,1.0797946500000015,1.081267170541443,1.0810860978965413,1819,-172803,-174272.4,0.01083220305177954,-110.77277631809747,0.1750145845487281
2023-05-22T14:00:00-04:00,1.0818,1.08216,1.08179,1.08197,1.0800548046966554,1.0815311111111112,1.081404444444442,1.0810664444444433,1.0809785000000018,1.0813236000000008,1.0814776000000013,1.0798188000000015,1.0814077364331545,1.0811868783172334,1713,-171090,-173531.8,0.029712517626132886,-110.50358607960607,0.13512137786786024
2023-05-22T14:15:00-04:00,1.08197,1.08198,1.08169,1.08176,1.080223220320923,1.0816022222222221,1.0815155555555531,1.08121911111111,1.0810215000000019,1.081338600000001,1.0814739000000013,1.0798442500000016,1.0814781891465235,1.081271902653787,-1235,-172325,-173392.8,0.03924880172233831,-110.74328773492003,0.0925274806617669
2023-05-22T14:30:00-04:00,1.08176,1.08177,1.08152,1.08166,1.0803781626952491,1.0816311111111112,1.0815277777777752,1.081344444444443,1.0810260000000018,1.081348000000001,1.0814622000000014,1.0798696000000017,1.0815145513172189,1.0813603221230297,-1316,-173641,-172896.2,0.044225003072561934,-110.86494133645826,0.010170588507240026
2023-05-22T14:45:00-04:00,1.08166,1.08197,1.0814,1.08191,1.0805207096796292,1.0817075555555558,1.0815822222222198,1.0814544444444432,1.0810600000000021,1.0813442000000009,1.0814617000000013,1.0798976500000017,1.081593641053775,1.081452257698424,2067,-171574,-172286.6,0.04605674370556794,-110.38720341511541,0.04531079506573574
2023-05-22T15:00:00-04:00,1.08191,1.08199,1.08156,1.08161,1.080651852905259,1.0817131111111113,1.0816544444444418,1.0815368888888874,1.081085000000002,1.081338600000001,1.0814637000000011,1.0799244000000017,1.08159691284302,1.0815182061587394,-1605,-173179,-172361.8,0.04613966288770109,-110.8322496758949,0.06013173475429613
2023-05-22T15:15:00-04:00,1.08161,1.08167,1.08145,1.08158,1.0807725046728383,1.0816982222222222,1.0816466666666642,1.0815853333333318,1.0811335000000022,1.0813490000000008,1.0814658000000013,1.0799492500000014,1.081593530274416,1.0815553649269916,-1358,-174537,-173051.2,0.049803376428585115,-110.8699157477692,-0.006471594323488605
2023-05-22T15:30:00-04:00,1.08158,1.08163,1.08135,1.08137,1.0808835042990113,1.081642888888889,1.0816711111111088,1.081616444444443,1.0811400000000018,1.081370800000001,1.0814693000000013,1.0799738500000016,1.0815488242195328,1.0815694919415935,-1221,-175758,-173737.8,0.04386443998524984,-111.10698559003704,0.02034870277018794
2023-05-22T15:45:00-04:00,1.08137,1.0815,1.08103,1.08111,1.0809856239550903,1.0815306666666666,1.0816411111111088,1.0816391111111097,1.081203500000002,1.081382000000001,1.0814721000000014,1.0799961500000015,1.0814610593756262,1.0815587935532749,-1861,-177619,-174533.4,0.04406729942126949,-111.55443650877888,-0.024968096321366446
2023-05-22T16:00:00-04:00,1.08111,1.08131,1.08096,1.08125,1.08216,1.0814524444444444,1.0815799999999978,1.0816386666666653,1.081275500000002,1.081393600000001,1.0814772000000012,1.0800196000000015,1.0814188475005009,1.0815238348426202,1289,-176330,-175484.6,0.03665220309617063,-111.38751547391652,-0.050841190608250174
2023-05-22T16:15:00-04:00,1.08125,1.08136,1.0811,1.08123,1.082136,1.0813824444444444,1.0814977777777754,1.081607333333332,1.0813270000000021,1.081404400000001,1.0814875000000013,1.0800419500000016,1.0813810780004007,1.081480667874096,-1087,-177417,-176332.2,0.025124698657899368,-111.40762183229816,-0.06839376322820272
2023-05-22T16:30:00-04:00,1.08123,1.08134,1.08118,1.08134,1.08211248,1.081350888888889,1.0814511111111087,1.0815682222222212,1.081398500000002,1.081425000000001,1.0815022000000014,1.0800663500000016,1.0813728624003205,1.081436534299277,693,-176724,-176769.6,0.014276982263570277,-111.33711879409164,-0.03882561751221038
2023-05-22T16:45:00-04:00,1.08134,1.08134,1.08116,1.08124,1.0820894304,1.0813086666666667,1.081404444444442,1.0815148888888877,1.0814350000000021,1.081442600000001,1.0815087000000014,1.0800891000000015,1.0813462899202564,1.0813960274394219,-796,-177520,-177122,0.003610869775014983,-111.41073116392906,-0.03882920695968113
2023-05-22T17:00:00-04:00,1.08124,1.08145,1.08056,1.0814,1.0820668417919999,1.0813077777777775,1.0813477777777754,1.081456222222221,1.0814670000000022,1.081446400000001,1.0815200000000014,1.0801131000000015,1.0813570319362051,1.0813752219515376,131,-177389,-177076,-0.002712449526748853,-111.39134601354617,-0.047138856281946785
2023-05-22T17:15:00-04:00,1.0814,1.08145,1.08136,1.08137,1.08200656812032,1.0813122222222222,1.0813211111111087,1.081404444444443,1.081458000000002,1.0814532000000012,1.0815271000000015,1.0801358000000016,1.0813596255489641,1.0813633775612304,-119,-177508,-177311.6,-0.010391572962601438,-111.3946472896697,-0.02218914396131859
2023-05-22T17:30:00-04:00,1.08137,1.08145,1.0808,1.08125,1.081948705395507,1.0812979999999999,1.081284444444442,1.0813617777777764,1.081449500000002,1.0814474000000012,1.0815336000000015,1.0801551500000017,1.0813377004391713,1.0813547020489842,-694,-178202,-177468.6,-0.01239960000710076,-111.47166070783364,-0.03051091921077881
2023-05-22T17:45:00-04:00,1.08125,1.08133,1.08085,1.08123,1.0818931571796868,1.0812871111111109,1.0812688888888866,1.0813253333333321,1.0814630000000018,1.081435800000001,1.0815405000000013,1.0801743500000016,1.081316160351337,1.0813433616391877,-456,-178658,-177855.4,-0.014799504363983201,-111.48009538991461,-0.012946540037177746
2023-05-22T18:00:00-04:00,1.08123,1.08147,1.0812,1.0814,1.0818398308924992,1.0813133333333331,1.0813011111111086,1.0813046666666655,1.081450500000002,1.0814228000000012,1.0815490000000014,1.0801941000000017,1.0813329282810695,1.0813406893113502,276,-178382,-178027.8,-0.01645923103939848,-111.43670036757894,0.026824282450435333
2023-05-22T18:15:00-04:00,1.0814,1.08147,1.08136,1.08142,1.0817886376567993,1.0813371111111112,1.0813199999999974,1.0812991111111097,1.0814640000000018,1.081412600000001,1.0815570000000014,1.0802155500000017,1.0813503426248556,1.08133935144908,461,-177921,-178134.2,-0.012580122877349068,-111.4281743827444,0.015722543352601478
2023-05-22T18:30:00-04:00,1.08142,1.08145,1.0812599999999999,1.08131,1.0817394921505274,1.0813351111111114,1.0813288888888863,1.0813006666666651,1.081460500000002,1.081398600000001,1.0815640000000015,1.0802358500000018,1.0813422740998846,1.0813358811592644,-523,-178444,-178321.4,-0.012729744141279909,-111.48137295499203,0.007398980790403523
2023-05-22T18:45:00-04:00,1.08131,1.08137,1.08116,1.0812599999999999,1.0816923124645064,1.0813213333333331,1.0813199999999974,1.0813077777777762,1.081433500000002,1.081367200000001,1.0815708000000015,1.0802574000000016,1.0813258192799076,1.0813335049274115,-1095,-179539,-178588.8,-0.01192401566316402,-111.53200598344836,-0.0073982281243716135
2023-05-22T19:00:00-04:00,1.0812599999999999,1.08131,1.08101,1.08105,1.081647019965926,1.0812673333333334,1.0812988888888864,1.0813137777777762,1.081387500000002,1.081341800000001,1.0815681000000015,1.0802785500000018,1.081270655423926,1.0813244039419294,-1675,-181214,-179100,-0.011303529942126599,-111.85732089383042,-0.01757241685471426
2023-05-22T19:15:00-04:00,1.08105,1.0811,1.08086,1.08098,1.081603539167289,1.0812035555555555,1.0812522222222198,1.0813039999999983,1.081348500000002,1.0813176000000009,1.0815604000000014,1.0802991500000017,1.0812125243391408,1.0813003231535436,-885,-182099,-179843.4,-0.009348827521282207,-111.9146262913606,-0.03883854262991168
2023-05-22T19:30:00-04:00,1.08098,1.08103,1.08063,1.08099,1.0815617976005973,1.0811511111111112,1.0812099999999976,1.0812819999999983,1.081315000000002,1.081304600000001,1.0815526000000015,1.0803189500000017,1.0811680194713127,1.081263858522835,756,-181343,-180527.8,-0.00974988506220902,-111.90763263745407,-0.03514060867233666
2023-05-22T19:45:00-04:00,1.08099,1.08111,1.0809,1.08105,1.0815217256965735,1.0811191111111111,1.0811877777777754,1.0812537777777762,1.0812720000000018,1.081287600000001,1.0815459000000016,1.0803392500000017,1.0811444155770502,1.0812242868182682,618,-180725,-180984,-0.01002318632501109,-111.87333074751974,-0.018497109826587557
2023-05-22T20:00:00-04:00,1.08105,1.0819,1.08104,1.0815299999999999,1.08056,1.0811875555555557,1.0812211111111085,1.0812339999999985,1.081268000000002,1.081287600000001,1.0815381000000015,1.0803594000000019,1.08122153246164,1.081203429454615,1880,-178845,-180845.2,-0.005760345832022769,-111.0385867486301,0.027746177963982408
2023-05-22T20:15:00-04:00,1.0815299999999999,1.08206,1.08152,1.08174,1.0805868,1.0812913333333332,1.0812588888888863,1.0812259999999985,1.081276000000002,1.081279400000001,1.0815345000000016,1.0803802500000017,1.081325225969312,1.0812143435636918,1390,-177455,-180093.4,-0.0016162345696927054,-110.76869132270565,0.03144072498612974
2023-05-22T20:30:00-04:00,1.08174,1.08182,1.08157,1.08161,1.0806457280000001,1.0813615555555554,1.0812799999999974,1.0812315555555538,1.0812880000000018,1.0812664000000012,1.0815327000000015,1.0804003500000017,1.0813821807754496,1.0812482748509538,-1064,-178519,-179377.4,0.0001937717361175525,-110.89655938712035,0.017569491964261105
2023-05-22T20:45:00-04:00,1.08161,1.08163,1.0810899999999999,1.08115,1.0807022988800001,1.0813355555555555,1.0812622222222195,1.0812419999999983,1.0812900000000019,1.0812344000000012,1.0815225000000015,1.0804179000000016,1.0813357446203598,1.0812818198807632,-1267,-179786,-179066,-0.001334395564964152,-111.43540425726752,-0.0147968667634571
2023-05-22T21:00:00-04:00,1.08115,1.08117,1.0808,1.081,1.0807566069248,1.081283111111111,1.0812333333333308,1.0812511111111092,1.081277500000002,1.081212000000001,1.0815140000000014,1.0804348500000018,1.0812685956962877,1.0813066559046107,-1719,-181505,-179222,-0.003716948226875125,-111.67390030314475,-0.024046020383619755
2023-05-22T21:15:00-04:00,1.081,1.08119,1.0806499999999999,1.08081,1.08206,1.0811984444444445,1.081206666666664,1.0812482222222202,1.0812565000000018,1.081189600000001,1.0815036000000016,1.0804511000000019,1.0811768765570302,1.0812977247236888,-1993,-183498,-180152.6,-0.00594106673185572,-112.02419632534625,-0.022200638268351877
2023-05-22T21:30:00-04:00,1.08081,1.08105,1.0806,1.08061,1.0820318,1.081079111111111,1.081165555555553,1.0812295555555536,1.0812200000000018,1.0811758000000011,1.0814872000000015,1.0804666500000017,1.0810635012456242,1.0812453797789512,-2298,-185796,-181820.8,-0.007280097455438952,-112.4494329534307,-0.03422820033672977
2023-05-22T21:45:00-04:00,1.08061,1.08082,1.08042,1.08045,1.081974528,1.080936,1.0811055555555529,1.0811946666666647,1.0811805000000019,1.081166800000001,1.0814682000000015,1.0804814000000018,1.0809408009964994,1.0811571038231613,-2170,-187966,-183710.2,-0.008262551833541201,-112.77073295990884,-0.049954208642076704
2023-05-22T22:00:00-04:00,1.08045,1.08063,1.08026,1.08051,1.08188125632,1.080816888888889,1.081045555555553,1.0811513333333314,1.0811360000000019,1.081145600000001,1.0814462000000014,1.0804968500000018,1.0808546407971995,1.081060883058529,2201,-185765,-184906,-0.009487264866359072,-112.64850610998485,-0.049951436103786585
2023-05-22T22:15:00-04:00,1.08051,1.08077,1.08036,1.0806499999999999,1.0817515558144,1.0807377777777778,1.080947777777775,1.0810942222222202,1.081100000000002,1.081134000000001,1.0814241000000016,1.0805111500000018,1.0808137126377595,1.0809699064468234,1259,-184506,-185506.2,-0.00988399519535904,-112.48537943832076,-0.08136621268018382
2023-05-22T22:30:00-04:00,1.0806499999999999,1.08073,1.08053,1.08071,1.081632231349248,1.080690222222222,1.0808333333333306,1.0810195555555535,1.081073000000002,1.081126000000001,1.0814093000000014,1.0805265000000017,1.0807929701102077,1.0808931251574592,1344,-183162,-185439,-0.014562138176369617,-112.41075768289558,-0.0952169652596617
2023-05-22T22:45:00-04:00,1.08071,1.08106,1.08064,1.08101,1.081522452841308,1.0807255555555555,1.080766666666664,1.0809397777777758,1.081062000000002,1.081134000000001,1.0813940000000015,1.0805446500000015,1.080836376088166,1.0808477001259675,1406,-181756,-184631,-0.020257707641418266,-112.02045871277413,-0.05547285990328621
2023-05-22T23:00:00-04:00,1.08101,1.08104,1.08051,1.08054,1.0814214566140035,1.0806802222222223,1.0806988888888862,1.0808584444444422,1.081019000000002,1.081120000000001,1.0813795000000015,1.0805606500000018,1.080777100870533,1.0808149601007742,-1898,-183654,-183768.6,-0.027116816390528965,-112.84566847031563,-0.05642140313555005
2023-05-22T23:15:00-04:00,1.08054,1.08074,1.08051,1.08055,1.081328540084883,1.0806504444444445,1.0806488888888863,1.080779111111109,1.0809755000000019,1.081134200000001,1.0813607000000014,1.0805809500000016,1.0807316806964262,1.0807903680806195,2490,-181164,-182848.4,-0.028923925143069094,-112.8226244367772,-0.041628122109163876
2023-05-22T23:30:00-04:00,1.08055,1.08095,1.08047,1.0809,1.0812430568780924,1.0807006666666665,1.0806588888888864,1.0807213333333312,1.0809550000000019,1.081156000000001,1.0813504000000014,1.0806026500000017,1.080765344557141,1.0807806944644958,2465,-178699,-181687,-0.027558973604355535,-112.02418845510104,0.008327088017313262
2023-05-22T23:45:00-04:00,1.0809,1.08093,1.08062,1.0808,1.081164412327845,1.0807288888888889,1.0806799999999974,1.0806906666666647,1.080932000000002,1.081168000000001,1.0813357000000015,1.0806249500000016,1.0807722756457128,1.0807765555715967,-1319,-180018,-181058.2,-0.025405398261605,-112.14621639478092,0.017582661644803623
2023-05-23T00:00:00-04:00,1.0808,1.08083,1.08056,1.08077,1.0810920593416173,1.080746888888889,1.0807155555555528,1.0806804444444424,1.0809180000000018,1.081185200000001,1.0813224000000015,1.0806467500000019,1.0807718205165702,1.0807636444572775,-1036,-181054,-180917.8,-0.021767085576176615,-112.17497287146483,0.029617289092516822
2023-05-23T00:15:00-04:00,1.08077,1.08086,1.08062,1.08074,1.0810254945942879,1.0807517777777778,1.0807411111111085,1.0806888888888868,1.080906000000002,1.0811898000000009,1.0813073000000013,1.080668550000002,1.080765456413256,1.0807613155658222,-980,-182034,-180593.8,-0.01771876418001582,-112.20217569907845,0.021286244458630872
2023-05-23T00:30:00-04:00,1.08074,1.08107,1.08069,1.08097,1.08026,1.0807975555555556,1.0807766666666643,1.0807144444444425,1.080905000000002,1.0811940000000009,1.0812926000000014,1.080690000000002,1.0808063651306048,1.080776252452658,1034,-181000,-180561,-0.013419040146485053,-111.98212277238012,0.029611807708332764
2023-05-23T00:45:00-04:00,1.08097,1.08104,1.0809,1.08102,1.0802762,1.0808462222222222,1.0808111111111087,1.080744888888887,1.080903500000002,1.081183400000001,1.0812820000000014,1.080709050000002,1.0808490921044838,1.0807930019621266,1260,-179740,-180769.2,-0.010128145936862811,-111.92384178400845,0.028684846073417702
2023-05-23T01:00:00-04:00,1.08102,1.08108,1.08074,1.08077,1.0802920759999999,1.080838,1.0807844444444419,1.080765777777776,1.080865500000002,1.0811704000000009,1.0812679000000012,1.080728250000002,1.080833273683587,1.0808052015697014,-1094,-180834,-180932.4,-0.008339633214681822,-112.17684357860992,-0.02220145974597996
2023-05-23T01:15:00-04:00,1.08077,1.08083,1.0803099999999999,1.08038,1.08108,1.0807571111111112,1.0807666666666642,1.0807759999999982,1.080797500000002,1.0811588000000008,1.0812488000000013,1.080745450000002,1.0807426189468696,1.0807993612557611,-958,-181792,-181080,-0.009102247849845872,-112.5225415532022,-0.014807411109274993
2023-05-23T01:30:00-04:00,1.08038,1.08038,1.08001,1.08008,1.08108,1.0806197777777777,1.0807144444444419,1.0807706666666648,1.080721000000002,1.0811274000000006,1.0812277000000012,1.080761200000002,1.0806100951574957,1.080768289004609,-1817,-183609,-181395,-0.00604511009188216,-113.0270862504383,-0.04349636759057614
2023-05-23T01:45:00-04:00,1.08008,1.08074,1.08007,1.08072,1.0810372000000001,1.0806208888888889,1.080694444444442,1.0807542222222204,1.080699500000002,1.0811188000000007,1.0812165000000014,1.0807806500000021,1.0806320761259967,1.0807334312036874,1909,-181700,-181535,-0.0005507787129321979,-111.89591078195453,-0.016652789342221204
2023-05-23T02:00:00-04:00,1.08072,1.08106,1.08032,1.08083,1.08001,1.080648,1.0806977777777753,1.0807315555555537,1.080691000000002,1.0811078000000007,1.0812070000000014,1.080801150000002,1.0806716609007974,1.0806979449629501,2597,-179103,-181407.6,0.00021150200800023215,-111.63157774471996,0.002775721687636426
2023-05-23T02:15:00-04:00,1.08083,1.08118,1.0804799999999999,1.08068,1.080031,1.0806444444444445,1.0806877777777752,1.0807122222222205,1.080684500000002,1.0810854000000005,1.0811995000000012,1.0808228000000022,1.0806733287206378,1.0806659559703604,-2858,-181961,-181633,0.0005111370596997043,-112.02821736427127,-0.008327396208251845
2023-05-23T02:30:00-04:00,1.08068,1.08117,1.08061,1.08114,1.08007696,1.080734888888889,1.0807322222222198,1.0807053333333314,1.080711000000002,1.0810688000000006,1.0811962000000013,1.080847900000002,1.0807666629765103,1.0806707647762885,2273,-179688,-181212.2,0.002480741208510546,-111.06069691418449,0.03701167718414752
2023-05-23T02:45:00-04:00,1.08114,1.08129,1.08083,1.08091,1.0801210816,1.0807704444444444,1.080725555555553,1.0807075555555536,1.0807340000000019,1.0810518000000007,1.0811952000000014,1.0808707500000019,1.0807953303812081,1.080707811821031,-2455,-182143,-180919,0.0027318636201425247,-111.58296970031753,-0.0055505703210957736
2023-05-23T03:00:00-04:00,1.08091,1.08096,1.07964,1.07975,1.08129,1.0805753333333332,1.080584444444442,1.080685555555554,1.0806960000000019,1.0810136000000006,1.0811808000000014,1.080887250000002,1.0805862643049664,1.080698649456825,-4835,-186978,-181974.6,-0.005472708501576867,-116.77174582413934,-0.1174816377125404
2023-05-23T03:15:00-04:00,1.07975,1.07997,1.0786,1.07896,1.08129,1.0802504444444443,1.080383333333331,1.080622666666665,1.0806115000000018,1.0809546000000005,1.0811494000000013,1.0809004000000018,1.080261011443973,1.08061651956546,-4927,-191905,-184535,-0.01770599412673965,-120.3765895379623,-0.1674731904105489
2023-05-23T03:30:00-04:00,1.07896,1.08026,1.0785,1.07957,1.0811824,1.0800877777777778,1.0802933333333309,1.080543777777776,1.080554500000002,1.0809138000000005,1.0811262000000013,1.0809158000000019,1.0801228091551784,1.080506415652368,6081,-185824,-185307.6,-0.02405274151889897,-116.9386400310297,-0.07497362039282267
2023-05-23T03:45:00-04:00,1.07957,1.08037,1.07914,1.08034,1.081021456,1.0800971111111113,1.0803222222222195,1.080461777777776,1.080521000000002,1.0808890000000007,1.0811190000000013,1.0809331500000017,1.0801662473241427,1.0803863325218948,4738,-181086,-185587.2,-0.022792745983778197,-113.55927602498957,0.024072290941425545
2023-05-23T04:00:00-04:00,1.08034,1.08047,1.07891,1.07968,1.08087016864,1.0799686666666666,1.080206666666664,1.0803579999999982,1.0804780000000018,1.0808552000000007,1.0811130000000013,1.0809410500000018,1.080068997859314,1.0802410660175157,-5184,-186270,-186412.6,-0.020634549869694853,-116.72627900553324,-0.0962321415352663
2023-05-23T04:15:00-04:00,1.07968,1.08027,1.0795299999999999,1.08012,1.0807279585215999,1.0799513333333335,1.080127777777775,1.0802666666666647,1.080456500000002,1.080835400000001,1.0811087000000013,1.0809465500000017,1.0800791982874514,1.0801396528140128,3495,-182775,-185572,-0.02433705543658822,-115.30196809859787,-0.06569025656208548
2023-05-23T04:30:00-04:00,1.08012,1.0808,1.0798,1.08039,1.0785,1.0800037777777778,1.0800955555555527,1.0802091111111092,1.0804310000000021,1.0808182000000008,1.0811059000000014,1.0809570500000019,1.080141358629961,1.0801157222512106,3922,-178853,-182961.6,-0.027704420366706776,-114.32157703093874,-0.026834955768601572
2023-05-23T04:45:00-04:00,1.08039,1.08074,1.0802,1.08033,1.078546,1.080050666666667,1.0800055555555526,1.0801515555555534,1.080407500000002,1.0808002000000008,1.0811023000000013,1.080968000000002,1.080179086903969,1.0801269778009686,-3224,-182077,-182212.2,-0.02843234261603304,-114.50062348638524,-0.07492091681003177
2023-05-23T05:00:00-04:00,1.08033,1.08037,1.0798,1.0798,1.07859108,1.0800095555555556,1.0798822222222193,1.0800635555555533,1.0803590000000018,1.0807694000000008,1.0810972000000012,1.0809762000000018,1.0801032695231751,1.080114382240775,-2607,-184684,-182931.8,-0.03642902950675074,-115.77959380101113,-0.10269125089044827
2023-05-23T05:15:00-04:00,1.0798,1.0798699999999999,1.07895,1.07902,1.0786352584,1.0798371111111111,1.0798011111111083,1.0799824444444421,1.080273000000002,1.0807250000000008,1.0810838000000011,1.0809820500000018,1.07988661561854,1.0800779057926202,-3141,-187825,-183242.8,-0.046213116343785755,-118.04851397141307,-0.06760824264875179
2023-05-23T05:30:00-04:00,1.07902,1.07925,1.0780399999999999,1.07811,1.0808,1.0794988888888888,1.079706666666664,1.07989822222222,1.080130000000002,1.0806592000000008,1.0810528000000013,1.0809844500000017,1.079531292494832,1.0799683246340963,-2857,-190682,-184824.2,-0.049806974827947256,-120.45798738247176,-0.07877956550752739
2023-05-23T05:45:00-04:00,1.07811,1.07853,1.07802,1.07813,1.0807448,1.0791835555555556,1.0795466666666638,1.0797884444444423,1.0799855000000018,1.0805944000000007,1.0810238000000012,1.0809863500000017,1.0792510339958656,1.079790259707277,2561,-188121,-186677.8,-0.04497650648801431,-120.41047831567863,-0.13338644089775428
2023-05-23T06:00:00-04:00,1.07813,1.07814,1.07728,1.07739,1.080635808,1.0787522222222223,1.079218888888886,1.079631111111109,1.079816500000002,1.0805172000000007,1.0809823000000014,1.0809847500000018,1.0788788271966925,1.079530207765822,-3068,-191189,-188500.2,-0.04916413474374718,-122.51627260764702,-0.27306218412721994
2023-05-23T06:15:00-04:00,1.07739,1.07742,1.07695,1.07715,1.08043445952,1.0783384444444444,1.0789377777777749,1.07944222222222,1.079655000000002,1.0804356000000008,1.080935700000001,1.080979950000002,1.078533061757354,1.0792161662126576,-3287,-194476,-190458.6,-0.06275172580466844,-123.2484865691652,-0.23432868998220965
2023-05-23T06:30:00-04:00,1.07715,1.07784,1.0771,1.07758,1.0801557027584,1.078066888888889,1.0786555555555526,1.079213111111109,1.079530000000002,1.0803592000000009,1.0808910000000012,1.0809725500000018,1.0783424494058833,1.0789073329701262,2917,-191559,-191205.4,-0.06986115987688749,-122.08401551128115,-0.23515905640113938
2023-05-23T06:45:00-04:00,1.07758,1.07795,1.07754,1.07777,1.079899246537728,1.0778897777777776,1.0783644444444416,1.0789446666666644,1.0793825000000021,1.0802862000000006,1.080849400000001,1.0809673500000019,1.0782279595247066,1.0786466663761012,2404,-189155,-190900,-0.08144829116507317,-121.6601397897572,-0.24250502133489452
2023-05-23T07:00:00-04:00,1.07777,1.07806,1.07753,1.078,1.0796633068147097,1.077816888888889,1.0781055555555525,1.0786564444444422,1.0792410000000021,1.0802200000000008,1.0808093000000012,1.080962050000002,1.0781823676197653,1.078432933100881,2253,-186902,-190656.2,-0.0916011674051867,-121.17934147471745,-0.21567484009515087
2023-05-23T07:15:00-04:00,1.078,1.07845,1.07783,1.07813,1.079446242269533,1.0778217777777779,1.077919999999997,1.0783966666666642,1.079113500000002,1.0801574000000007,1.0807623000000013,1.0809583500000017,1.0781718940958123,1.078291546480705,2260,-184642,-189346.8,-0.10008405790055994,-120.90679973074721,-0.15465827005001484
2023-05-23T07:30:00-04:00,1.07813,1.07839,1.07782,1.07793,1.0792465428879703,1.077823777777778,1.077798888888886,1.0781688888888865,1.078953000000002,1.0800950000000007,1.0807184000000012,1.0809494500000019,1.0781235152766497,1.0782096371845642,-2233,-186875,-187826.6,-0.1052903328300998,-121.3210354908132,-0.10101759003540577
2023-05-23T07:45:00-04:00,1.07793,1.07814,1.0772599999999999,1.07728,1.0790628194569327,1.0777200000000002,1.077706666666664,1.0779791111111088,1.078771500000002,1.0800210000000008,1.0806693000000012,1.080934600000002,1.0779548122213198,1.0781321097476515,-3264,-190139,-187542.6,-0.10439903355957811,-123.28925235090628,-0.0769865783639783
2023-05-23T08:00:00-04:00,1.07728,1.07808,1.07728,1.07797,1.0788937939003782,1.0777726666666667,1.077688888888886,1.0778439999999976,1.078682500000002,1.0799606000000008,1.0806326000000013,1.0809263000000018,1.0779578497770559,1.0780780877981213,3581,-186558,-187023.2,-0.09273221679732836,-120.99561467082285,-0.014840510884581447
2023-05-23T08:15:00-04:00,1.07797,1.07827,1.0776,1.07775,1.078738290388348,1.0777848888888888,1.077728888888886,1.0777686666666644,1.0786220000000022,1.0798946000000007,1.0805911000000015,1.080916150000002,1.0779162798216446,1.0780248702384971,-3597,-190155,-187673.8,-0.08743388929591031,-121.72971673303273,0.03341408403641355
2023-05-23T08:30:00-04:00,1.07775,1.07781,1.07643,1.07748,1.07859522715728,1.077735111111111,1.0777655555555528,1.0777377777777755,1.0785175000000022,1.0798136000000007,1.0805506000000014,1.080906400000002,1.0778290238573156,1.0779562961907978,-5165,-195320,-189809.4,-0.08007092298765896,-123.02366245328322,0.030636401615368465
2023-05-23T08:45:00-04:00,1.07748,1.07769,1.07628,1.07639,1.078378704441552,1.07746,1.0776333333333306,1.0777046666666643,1.0783200000000022,1.0797066000000008,1.0804930000000015,1.080891150000002,1.0775412190858524,1.0778398369526383,-3890,-199210,-192276.4,-0.07308778217072351,-126.95886310665975,-0.11043263609198616
2023-05-23T09:00:00-04:00,1.07639,1.07708,1.07628,1.07684,1.0781268599085658,1.0773013333333334,1.0775299999999972,1.077669333333331,1.078178000000002,1.0796112000000007,1.0804388000000014,1.0808780000000018,1.077400975268682,1.0777290695621107,4863,-194347,-193118,-0.06450490300846178,-124.92581746335175,-0.08628928249996524
2023-05-23T09:15:00-04:00,1.07684,1.07803,1.07675,1.0776,1.07628,1.0773153333333334,1.0774855555555527,1.0776286666666643,1.078052000000002,1.0795402000000007,1.0803873000000015,1.080867950000002,1.0774407802149455,1.0776256556496886,5129,-189218,-193650,-0.0569007948354716,-121.30592964343482,-0.037105751391482186
2023-05-23T09:30:00-04:00,1.0776,1.07819,1.07737,1.07771,1.07628,1.077360222222222,1.077438888888886,1.0775706666666642,1.0779180000000022,1.0794744000000007,1.0803432000000015,1.080855450000002,1.0774946241719563,1.077541324519751,6659,-182559,-192130.8,-0.04895146595977072,-120.62618762413233,-0.03895634107204947
2023-05-23T09:45:00-04:00,1.07771,1.07849,1.07653,1.07818,1.0763563999999999,1.0775084444444443,1.077466666666664,1.0775108888888865,1.0778105000000022,1.0794218000000009,1.0803057000000014,1.080842100000002,1.077631699337565,1.0775018596158006,11023,-171536,-187374,-0.038729417128099464,-115.8189481997977,0.02319260063268129
2023-05-23T10:00:00-04:00,1.07818,1.07933,1.07795,1.07906,1.0764844159999998,1.077827111111111,1.0776644444444416,1.0775171111111086,1.0777735000000022,1.0793908000000008,1.0802833000000014,1.0808334500000019,1.077917359470052,1.0775770876926407,8519,-163017,-180135.4,-0.022637238256780146,-108.86582348963805,0.16523095202731813
2023-05-23T10:15:00-04:00,1.07906,1.07954,1.07875,1.07885,1.07653,1.078064222222222,1.0777622222222194,1.0775635555555532,1.077765000000002,1.0793588000000007,1.0802628000000012,1.0808210500000017,1.0781038875760416,1.0777176701541127,-6134,-169151,-175096.2,-0.003874646996098731,-110.05958472626891,0.08163492490514503
2023-05-23T10:30:00-04:00,1.07885,1.07908,1.07805,1.07811,1.0768309999999999,1.0781337777777777,1.0778022222222194,1.0776268888888865,1.077765000000002,1.0793108000000007,1.0802282000000014,1.0808062000000018,1.0781051100608332,1.07785053612329,-4927,-174078,-172068.2,0.0014447668293600046,-113.43909068168524,0.03340292275573333
2023-05-23T10:45:00-04:00,1.07811,1.0783099999999999,1.07771,1.07785,1.0771019,1.0781433333333335,1.0778433333333306,1.0777077777777753,1.0777510000000021,1.0792548000000006,1.0801944000000014,1.0807926000000017,1.0780540880486666,1.077962428898632,-5107,-179185,-171393.4,0.003521383457616199,-114.67070897666407,0.03433938448973359
2023-05-23T11:00:00-04:00,1.07785,1.07808,1.07761,1.07764,1.07734571,1.0781026666666667,1.0779822222222195,1.0778108888888864,1.077763500000002,1.0791934000000005,1.0801597000000014,1.0807822000000018,1.0779712704389333,1.0780303431189058,-3911,-183096,-173705.4,0.007171052806129194,-115.43269812172151,0.11612891238305571
2023-05-23T11:15:00-04:00,1.07764,1.07767,1.07725,1.07737,1.07954,1.0779802222222221,1.0780411111111083,1.0778862222222199,1.077774500000002,1.0791206000000004,1.0801273000000013,1.0807717500000016,1.0778510163511466,1.0780170744951247,-3389,-186485,-178399,0.01635248914856463,-116.28180357437729,0.04921808253778829
2023-05-23T11:30:00-04:00,1.07737,1.07768,1.07715,1.07767,1.0794941999999998,1.077906,1.078048888888886,1.077943555555553,1.077779000000002,1.0790632000000004,1.0800916000000014,1.0807630500000018,1.0778148130809173,1.0779592595960998,3023,-183462,-181261.2,0.021755689439890178,-115.44003148122461,0.0064959168522656366
2023-05-23T11:45:00-04:00,1.07767,1.07791,1.07707,1.07707,1.079400432,1.0777102222222223,1.077977777777775,1.0779786666666642,1.077744000000002,1.0789936000000007,1.0800639000000012,1.0807508500000018,1.0776658504647338,1.07787140767688,-2464,-185926,-183630.8,0.01909188716316367,-116.81188000628315,-0.05938517783076838
2023-05-23T12:00:00-04:00,1.07707,1.07722,1.07602,1.07615,1.0792606060799999,1.0773446666666666,1.0777522222222193,1.0779604444444417,1.077651500000002,1.0788986000000005,1.0800273000000014,1.0807370000000018,1.077362680371787,1.0777331261415042,-2638,-188564,-185506.6,0.011775867028756996,-119.06517830630087,-0.1882802500510097
2023-05-23T12:15:00-04:00,1.07615,1.07637,1.07602,1.07624,1.0790013575936,1.0770422222222222,1.077438888888886,1.077851777777775,1.0775570000000019,1.0788074000000005,1.079987700000001,1.0807215000000019,1.0771381442974297,1.0775665009132036,2540,-186024,-186092.2,0.0015510884798069335,-118.85275438770181,-0.26133857246119985
2023-05-23T12:30:00-04:00,1.07624,1.07677,1.07622,1.07672,1.0787628489861119,1.0768984444444443,1.0772022222222195,1.0776839999999974,1.0774965000000019,1.0787264000000005,1.0799558000000014,1.0807105500000018,1.0770545154379438,1.077407200730563,2709,-183315,-185458.2,-0.01393415020230706,-117.64454803967581,-0.1974324512212251
2023-05-23T12:45:00-04:00,1.07672,1.07687,1.07657,1.07667,1.078543421067223,1.076792,1.0770422222222191,1.0774826666666641,1.077466000000002,1.0786450000000005,1.0799174000000014,1.0807009000000016,1.0769776123503552,1.0772397605844506,-1687,-185002,-185766.2,-0.02859908249564928,-117.72288781231848,-0.13356707571582546
2023-05-23T13:00:00-04:00,1.07667,1.07727,1.07641,1.07722,1.078341547381845,1.0768275555555555,1.0769722222222193,1.0772815555555528,1.0774285000000021,1.0785700000000005,1.0798820000000013,1.0806886500000017,1.0770260898802841,1.0771118084675604,2315,-182687,-185118.4,-0.036594194251371615,-116.54030633424244,-0.0584496915155085
2023-05-23T13:15:00-04:00,1.07722,1.07748,1.07706,1.0772599999999999,1.0781558235912974,1.076885111111111,1.0769299999999968,1.0771171111111086,1.077404000000002,1.0784948000000005,1.0798391000000014,1.0806684500000017,1.0770728719042273,1.0770538467740485,1937,-180750,-183555.6,-0.03893337835545026,-116.46838045095059,-0.03526223970899809
2023-05-23T13:30:00-04:00,1.0772599999999999,1.07779,1.0771,1.07768,1.0779849577039935,1.0770351111111112,1.0769644444444415,1.0770222222222197,1.077414000000002,1.0784330000000006,1.0798017000000015,1.0806487000000018,1.077194297523382,1.077065077419239,1875,-178875,-182125.8,-0.03825285868833912,-115.73735915618408,0.028773773169851816
2023-05-23T13:45:00-04:00,1.07768,1.0779,1.07765,1.07779,1.07602,1.0772002222222221,1.0769777777777747,1.0769773333333308,1.077484000000002,1.0783812000000006,1.0797700000000012,1.0806282500000017,1.0773134380187055,1.0771168619353912,1649,-177226,-180908,-0.03572427734894043,-115.56904388634509,0.011135134131981035
2023-05-23T14:00:00-04:00,1.07779,1.07799,1.07759,1.07797,1.0760576,1.0773986666666666,1.0770777777777747,1.0769844444444419,1.077540500000002,1.0783390000000006,1.0797332000000015,1.0806091000000015,1.0774447504149645,1.077210289548313,2109,-175117,-178931,-0.03992018614376499,-115.21682313833281,0.08356002859611009
2023-05-23T14:15:00-04:00,1.07797,1.07798,1.07758,1.07773,1.076134896,1.0775291111111114,1.0772533333333303,1.077040666666664,1.0775470000000023,1.0782792000000005,1.0796990000000013,1.0805908500000017,1.0775018003319716,1.0773054316386506,-2182,-177299,-177853.4,-0.03772669381214867,-115.70262515508657,0.14681968127121098
2023-05-23T14:30:00-04:00,1.07773,1.07807,1.07753,1.0778699999999999,1.0762091001599998,1.0776524444444444,1.0774344444444415,1.077141555555553,1.0775550000000023,1.0782200000000006,1.0796639000000012,1.0805714500000017,1.0775754402655773,1.0774059453109206,2282,-175017,-176706.8,-0.022957459981171834,-115.40618727175813,0.15145320746300064
2023-05-23T14:45:00-04:00,1.0778699999999999,1.07797,1.07757,1.07762,1.0763207541503998,1.0776895555555555,1.0775344444444412,1.0772555555555527,1.0775270000000021,1.0781588000000006,1.0796221000000015,1.0805491500000017,1.0775843522124617,1.0774839562487366,-2068,-177085,-176348.8,-0.009753092530012449,-115.88583695121828,0.08358719072740574
2023-05-23T15:00:00-04:00,1.07762,1.07764,1.07715,1.07744,1.0764257089013758,1.0776706666666667,1.077619999999997,1.0773839999999972,1.0774460000000021,1.0780848000000007,1.0795768000000014,1.0805272000000017,1.0775554817699693,1.0775323649989894,-2042,-179127,-176729,0.00019886883425562072,-116.22692193479332,0.07151680644950982
2023-05-23T15:15:00-04:00,1.07744,1.07747,1.07706,1.07712,1.0765243663672932,1.0775706666666667,1.0776088888888857,1.0774902222222196,1.0773595000000022,1.0780090000000007,1.0795304000000012,1.0805021500000016,1.0774683854159754,1.0775370919991916,-1691,-180818,-177869.2,0.01294968098725112,-116.72914943702064,-0.0092831547873219
2023-05-23T15:30:00-04:00,1.07712,1.07715,1.0769,1.07691,1.0766171043852557,1.077430888888889,1.0775699999999968,1.0775535555555529,1.0772995000000023,1.0779522000000008,1.0794829000000012,1.0804725500000019,1.0773567083327804,1.0775080735993534,-1220,-182038,-178817,0.018648255621419123,-116.96700594325955,-0.03248983532293508
2023-05-23T15:45:00-04:00,1.07691,1.07697,1.07663,1.07674,1.07807,1.077264888888889,1.0774655555555523,1.077559777777775,1.0772440000000023,1.0779078000000006,1.0794312000000013,1.0804464500000017,1.0772333666662244,1.0774396588794828,-1628,-183666,-180546.8,0.01987823750733756,-117.22400049247908,-0.08722440798752328
2023-05-23T16:00:00-04:00,1.07674,1.07703,1.07667,1.07698,1.0780412000000001,1.0771677777777777,1.0773755555555524,1.0775279999999974,1.0772110000000021,1.0778560000000008,1.0793849000000013,1.0804243000000016,1.0771826933329796,1.0773593271035862,890,-182776,-181685,0.017226700191949034,-117.02562391131741,-0.07515378691581638
2023-05-23T16:15:00-04:00,1.07698,1.07707,1.07696,1.077,1.0780129760000001,1.0770926666666667,1.0772677777777746,1.077457555555553,1.077192500000002,1.0777892000000007,1.0793391000000012,1.0804024500000018,1.0771461546663836,1.077277461682869,433,-182343,-182328.2,0.01272256757167783,-117.01758290777049,-0.08998395131591207
2023-05-23T16:30:00-04:00,1.077,1.0770899999999999,1.07692,1.07704,1.0779853164800002,1.077047111111111,1.0771911111111079,1.0773739999999974,1.077161000000002,1.0777364000000007,1.0792958000000012,1.0803825500000017,1.0771249237331069,1.0772087693462953,555,-181788,-182522.2,0.005547969156136316,-116.9969700944,-0.064023456709944
2023-05-23T16:45:00-04:00,1.07704,1.07714,1.07687,1.07687,1.0779582101504002,1.0769828888888888,1.0770799999999967,1.0772759999999972,1.077151000000002,1.0776714000000007,1.0792534000000011,1.0803627500000017,1.0770739389864854,1.0771522154770363,-691,-182479,-182610.4,0.0011007913763449461,-117.10603753850607,-0.09277556662676296
2023-05-23T17:00:00-04:00,1.07687,1.07716,1.07661,1.07694,1.0779316459473922,1.076954888888889,1.0770044444444413,1.077183777777775,1.0771905000000022,1.0776024000000006,1.0792103000000013,1.0803437500000017,1.0770471511891884,1.077114972381629,1667,-180812,-182039.6,-0.006958456159758399,-116.99767719788926,-0.06310202112061895
2023-05-23T17:15:00-04:00,1.07694,1.077,1.07684,1.07696,1.0778787801094964,1.076946,1.076951111111108,1.0770988888888862,1.0772265000000023,1.0775350000000008,1.0791676000000012,1.0803275500000018,1.0770297209513506,1.0770843779053032,16832,-163980,-178280.4,-0.01666609934126944,-116.68508782429512,-0.044550044550047886
2023-05-23T17:30:00-04:00,1.07696,1.0773,1.07696,1.07729,1.0778280289051165,1.0770137777777777,1.0769699999999967,1.0770393333333306,1.077255000000002,1.0774848000000008,1.0791271000000011,1.0803146500000018,1.0770817767610805,1.0770715023242428,363,-163617,-174535.2,-0.022699323042795354,-116.5738580664582,0.015782828282828607
2023-05-23T17:45:00-04:00,1.07729,1.0773,1.07725,1.07729,1.077779307748912,1.0770777777777778,1.077012222222219,1.0770035555555526,1.0772860000000022,1.0774502000000006,1.0790876000000014,1.0802981500000017,1.0771234214088645,1.0770712018593942,0,-163617,-170901,-0.023640296184264727,-116.5738580664582,0.03528614276030931
2023-05-23T18:00:00-04:00,1.07729,1.07733,1.07707,1.07711,1.0777325354389555,1.0770973333333334,1.07705333333333,1.0769982222222194,1.077280500000002,1.0774302000000007,1.0790447000000014,1.0802823500000018,1.0771207371270917,1.0770805614875154,-442,-164059,-167217,-0.023728242664415918,-116.64771004689061,0.0343629845645171
2023-05-23T18:15:00-04:00,1.07711,1.07719,1.0770899999999999,1.07717,1.0776876340213972,1.0771206666666666,1.0770744444444411,1.0770122222222194,1.0772760000000021,1.0774110000000008,1.079002700000001,1.0802649000000017,1.0771305897016734,1.0770972491900124,476,-163583,-163771.2,-0.01951572706785359,-116.62119464920609,0.01764192464111798
2023-05-23T18:30:00-04:00,1.07717,1.0773,1.07717,1.07724,1.0776445286605414,1.0771537777777778,1.0771011111111077,1.0770422222222193,1.0772540000000022,1.0774080000000008,1.0789626000000012,1.080248100000002,1.0771524717613388,1.0771217993520101,219,-163364,-163648,-0.017013839160033784,-116.60696291234004,0.022284122562675764
2023-05-23T18:45:00-04:00,1.07724,1.07731,1.0772,1.07724,1.0776031475141197,1.0771815555555557,1.07712333333333,1.0770728888888859,1.077226500000002,1.0774098000000008,1.078922700000001,1.0802316000000018,1.077169977409071,1.0771394394816083,0,-163364,-163597.4,-0.012841300096378577,-116.60696291234004,0.0185694124637876
2023-05-23T19:00:00-04:00,1.07724,1.07737,1.07718,1.07728,1.0775634216135548,1.077212888888889,1.0771688888888855,1.0771042222222191,1.0771920000000021,1.0774038000000008,1.0788815000000012,1.0802152500000017,1.0771919819272568,1.0771531515852868,854,-162510,-163376,-0.0083591896491272,-116.5752522443366,0.03807330504146475
2023-05-23T19:15:00-04:00,1.07728,1.07729,1.07702,1.07706,1.0775252847490127,1.077191111111111,1.077182222222219,1.077129999999997,1.077158500000002,1.0773896000000007,1.0788379000000012,1.0801974500000018,1.0771655855418054,1.0771621212682294,-273,-162783,-163120.8,-0.0025728419292281603,-116.63100376668922,0.011142682043558413
2023-05-23T19:30:00-04:00,1.07706,1.07707,1.07687,1.07693,1.077488673359052,1.0771406666666665,1.0771788888888856,1.077150888888886,1.0771115000000022,1.0773682000000009,1.0787941000000012,1.080179050000002,1.0771184684334443,1.0771596970145836,-468,-163251,-163054.4,0.0008709068484940191,-116.68749087047172,-0.002785618778782359
2023-05-23T19:45:00-04:00,1.07693,1.07699,1.0769,1.07692,1.07745352642469,1.0770888888888888,1.0771377777777744,1.0771582222222194,1.077076500000002,1.0773440000000007,1.0787507000000012,1.080160750000002,1.0770787747467554,1.077144957611667,-362,-163613,-163104.2,0.004699557675830765,-116.69085227743405,-0.034345440874785936
2023-05-23T20:00:00-04:00,1.07692,1.07704,1.07675,1.07693,1.0774197853677026,1.0770473333333332,1.0770977777777746,1.0771531111111081,1.0770510000000022,1.0773240000000008,1.0787095000000013,1.0801388000000018,1.0770490197974043,1.0771207660893336,1219,-162394,-162910.2,0.004407903986543618,-116.67953295937903,-0.033417185716022424
2023-05-23T20:15:00-04:00,1.07693,1.07751,1.07693,1.07741,1.07661,1.0771097777777776,1.077131111111108,1.0771455555555527,1.077065500000002,1.0773266000000008,1.0786738000000011,1.0801171000000018,1.0771212158379235,1.077106612871467,987,-161407,-162689.6,0.005654680718471139,-116.23961578741796,0.02785230849216579
2023-05-23T20:30:00-04:00,1.07741,1.07751,1.07717,1.0773,1.0766280000000001,1.0771435555555553,1.0771455555555525,1.0771382222222194,1.0770850000000018,1.0773132000000007,1.0786369000000011,1.0800947500000018,1.0771569726703387,1.0771048902971736,-1178,-162585,-162650,0.006622864977256307,-116.35988569395313,0.01206866139977566
2023-05-23T20:45:00-04:00,1.0773,1.07742,1.07703,1.0772599999999999,1.0766456400000002,1.0771664444444442,1.0771477777777745,1.077131999999997,1.077111000000002,1.0773034000000008,1.0785990000000012,1.0800724500000016,1.077177578136271,1.0771167122377387,-1298,-163883,-162776.4,0.005910970265778534,-116.40808025442844,0.0018565964873109965
2023-05-23T21:00:00-04:00,1.0772599999999999,1.0774,1.07708,1.07719,1.0766629272000001,1.0771748888888888,1.077142222222219,1.077132888888886,1.0771215000000018,1.0772976000000007,1.0785556000000012,1.0800468500000018,1.0771800625090167,1.0771369697901911,-1919,-165802,-163214.2,0.0034572077699257715,-116.53277624239755,-0.004641491218287798
2023-05-23T21:15:00-04:00,1.07719,1.07735,1.07677,1.07702,1.0766798686560002,1.0771504444444446,1.0771133333333303,1.077135999999997,1.077122500000002,1.0773102000000008,1.0785084000000011,1.0800214500000018,1.0771480500072133,1.0771567758321532,-2065,-167867,-164308.8,0.0012378727158904143,-116.85867046718612,-0.024134858161288332
2023-05-23T21:30:00-04:00,1.07702,1.07729,1.07688,1.07721,1.0766964712828802,1.0771697777777778,1.077129999999997,1.0771357777777748,1.077131000000002,1.0773176000000009,1.0784644000000012,1.0799985500000018,1.0771604400057706,1.0771646206657226,1819,-166048,-165237,-0.0003404118362498395,-116.53777577627987,0.013926800735343855
2023-05-23T21:45:00-04:00,1.07721,1.07745,1.0770899999999999,1.07737,1.0767127418572227,1.0772177777777778,1.0771788888888858,1.0771424444444413,1.077156000000002,1.0773130000000009,1.0784266000000011,1.0799745500000018,1.0772023520046166,1.0771736965325782,1199,-164849,-165689.8,0.0010786919005686317,-116.35968608160573,0.04085688020576973
2023-05-23T22:00:00-04:00,1.07737,1.07739,1.07686,1.07729,1.0767286870200783,1.07724,1.0772199999999972,1.0771568888888858,1.077173500000002,1.0773046000000008,1.0783895000000012,1.0799517500000018,1.0772198816036933,1.0771821572260627,-4002,-168851,-166683.4,0.002564056089324229,-116.65685418541355,0.03435724102068691
2023-05-23T22:15:00-04:00,1.07729,1.07763,1.07716,1.07761,1.0767443132796768,1.0773180000000002,1.0772955555555526,1.0771875555555526,1.077206000000002,1.0772932000000008,1.0783575000000012,1.0799305500000018,1.0772979052829545,1.0772057257808503,1563,-167288,-166980.6,0.006007670721448368,-116.1925780851993,0.06314245122710055
2023-05-23T22:30:00-04:00,1.07761,1.07765,1.0772,1.0776,1.0767797407484898,1.0773788888888889,1.0773166666666638,1.0772282222222194,1.0772215000000023,1.0772640000000009,1.0783274000000012,1.079907300000002,1.0773583242263636,1.0772477806246803,-1608,-168896,-167186.4,0.009398047540316878,-116.20749999572361,0.017634883656167333
2023-05-23T22:45:00-04:00,1.0776,1.07766,1.07741,1.07747,1.0768319563035804,1.0774095555555556,1.0773355555555524,1.0772693333333305,1.077230500000002,1.077236400000001,1.078297600000001,1.0798829000000019,1.0773806593810908,1.0772918244997443,-1381,-170277,-168032.2,0.00915926602114684,-116.37410170322171,0.015780191218788035
2023-05-23T23:00:00-04:00,1.07747,1.07796,1.07725,1.07795,1.076898199799294,1.0775324444444443,1.077412222222219,1.0773159999999973,1.0772725000000023,1.0772332000000007,1.078272000000001,1.079859100000002,1.0774945275048726,1.0773502595997955,1599,-168678,-168798,0.012275356988930989,-115.66176632497447,0.0640513896366782
2023-05-23T23:15:00-04:00,1.07795,1.07797,1.07771,1.07781,1.0770043798193645,1.0776119999999998,1.077481111111108,1.0773682222222194,1.0773045000000023,1.0772324000000006,1.078243600000001,1.079833850000002,1.077557622003898,1.0774178076798364,-1330,-170008,-169029.4,0.014286181567260527,-115.83450160954243,0.057557162617536635
2023-05-23T23:30:00-04:00,1.07781,1.07797,1.07772,1.07774,1.0771202542410407,1.0776637777777778,1.077561111111108,1.0774213333333305,1.0773295000000025,1.077234400000001,1.078213900000001,1.079811600000002,1.0775940976031184,1.0774770461438692,-1210,-171218,-169815.4,0.01687159070782117,-115.91308688895161,0.06685112625576423
2023-05-23T23:45:00-04:00,1.07774,1.0779,1.07773,1.07788,1.0772222237321158,1.0777275555555554,1.0776355555555526,1.0774851111111083,1.0773615000000023,1.0772446000000009,1.078182600000001,1.079788300000002,1.0776512780824947,1.0775356369150955,1243,-169975,-170031.2,0.022024825333059158,-115.75161937359537,0.06219771446606961
2023-05-24T00:00:00-04:00,1.07788,1.07788,1.07755,1.07763,1.077311956884262,1.0777264444444443,1.0776644444444414,1.077550888888886,1.0773790000000023,1.0772438000000009,1.0781535000000009,1.0797665000000018,1.0776470224659958,1.0775889095320763,-897,-170872,-170150.2,0.02419904476771359,-115.9596666515854,0.024132842013435404
2023-05-24T00:15:00-04:00,1.07763,1.07803,1.07762,1.078,1.0773909220581506,1.0777935555555556,1.0777433333333302,1.0776171111111084,1.0774260000000022,1.0772624000000008,1.0781280000000009,1.079744350000002,1.0777176179727965,1.0776335276256614,1192,-169680,-170350.6,0.02686339974501227,-115.55039816425673,0.06590611627324011
2023-05-24T00:30:00-04:00,1.078,1.07811,1.07786,1.07809,1.0774803929700094,1.0778628888888888,1.0777966666666634,1.0776802222222193,1.0774840000000023,1.0773012000000008,1.0780999000000009,1.0797251500000018,1.0777920943782373,1.0776804221005292,1102,-168578,-170064.6,0.029734900632599443,-115.45839445368168,0.04454301649019923
2023-05-24T00:45:00-04:00,1.07809,1.07823,1.07795,1.078,1.077581130094808,1.0779035555555554,1.0778411111111081,1.0777362222222195,1.0775380000000023,1.077336400000001,1.078071900000001,1.0797038000000019,1.07783367550259,1.0777283376804234,-779,-169357,-169692.4,0.02862423368205385,-115.52342613007228,0.03711952487009818
2023-05-24T01:00:00-04:00,1.078,1.07825,1.07793,1.07825,1.0776979266777424,1.0779853333333334,1.0779277777777747,1.0777946666666638,1.0776040000000022,1.077367000000001,1.078046700000001,1.0796845500000019,1.0779169404020719,1.077781470144339,1275,-168082,-169313.8,0.0287772200375665,-115.2277396736717,0.07239180673243831
2023-05-24T01:15:00-04:00,1.07825,1.07829,1.0779,1.07797,1.077808341342194,1.0779937777777777,1.077929999999997,1.0778477777777749,1.0776320000000024,1.077393000000001,1.078019000000001,1.079663150000002,1.0779275523216576,1.0778375761154713,-1149,-169231,-168985.6,0.028820086566432642,-115.52611203629615,0.0018553736258760634
2023-05-24T01:30:00-04:00,1.07797,1.07819,1.0778699999999999,1.07815,1.07829,1.0780377777777779,1.0779677777777747,1.077892666666664,1.0776745000000023,1.077411600000001,1.0779908000000011,1.079641700000002,1.077972041857326,1.0778884608923773,1304,-167927,-168635,0.02740514140262988,-115.30836942750389,0.03154544864122684
2023-05-24T01:45:00-04:00,1.07815,1.07862,1.07809,1.07835,1.0778699999999999,1.0781142222222222,1.0780355555555525,1.0779404444444416,1.0777290000000024,1.077433400000001,1.0779641000000009,1.079623050000002,1.0780476334858609,1.077939568713902,2191,-165736,-168066.6,0.02777502845561817,-114.90193247531732,0.056599922059123675
2023-05-24T02:00:00-04:00,1.07835,1.07891,1.07816,1.07851,1.0778699999999999,1.0782091111111112,1.0781055555555525,1.0779933333333305,1.0777950000000025,1.077450000000001,1.0779415000000008,1.0796047000000017,1.0781401067886887,1.078000854971122,5317,-160419,-166279,0.029395014114413816,-114.11302349400249,0.05844806471964695
2023-05-24T02:15:00-04:00,1.07851,1.07893,1.07827,1.07867,1.0779116,1.078322,1.078221111111108,1.0780519999999971,1.0778775000000025,1.077467600000001,1.0779244000000008,1.0795866000000018,1.078246085430951,1.0780666839768978,2629,-157790,-164220.6,0.030183917786054795,-113.7230039299745,0.09650807791170715
2023-05-24T02:30:00-04:00,1.07867,1.07888,1.07781,1.07833,1.07893,1.0783437777777778,1.0782577777777747,1.0781175555555527,1.0779335000000025,1.0774748000000007,1.0779069000000008,1.0795673000000017,1.0782628683447608,1.0781337471815182,-3629,-161419,-162658.2,0.030889013371809437,-114.86687554965431,0.03061224489795375
2023-05-24T02:45:00-04:00,1.07833,1.07847,1.07762,1.07776,1.07893,1.0782442222222224,1.078221111111108,1.0781682222222193,1.0779530000000026,1.0774754000000009,1.0778773000000008,1.0795469000000018,1.0781622946758087,1.0781717977452148,-2960,-164379,-161948.6,0.02623205160898292,-116.43151717142119,-0.030609689358025903
2023-05-24T03:00:00-04:00,1.07776,1.07813,1.07744,1.07803,1.07888,1.078206,1.0782244444444415,1.0782059999999971,1.0779900000000024,1.077478600000001,1.077849300000001,1.0795281500000018,1.078135835740647,1.078189438196172,4585,-159794,-160760.2,0.022759109055206946,-115.2828848228464,0.002782931354357559
2023-05-24T03:15:00-04:00,1.07803,1.07821,1.07717,1.07752,1.0787936,1.078065111111111,1.0781433333333303,1.0782135555555528,1.0779855000000025,1.077476600000001,1.0778177000000009,1.0795086000000018,1.0780126685925175,1.0781639505569376,-4410,-164204,-161517.2,0.017290032565840358,-117.36919039875806,-0.06770229538603269
2023-05-24T03:30:00-04:00,1.07752,1.07858,1.07703,1.07842,1.078663712,1.0781204444444443,1.0781933333333302,1.078207999999997,1.0780265000000024,1.0774962000000008,1.077790500000001,1.079493350000002,1.078094134874014,1.0781335604455502,5047,-159157,-161790.6,0.015288365249379961,-113.15367699761516,0.04174513205375283
2023-05-24T03:45:00-04:00,1.07842,1.07858,1.07786,1.07839,1.07703,1.0781597777777778,1.0782199999999968,1.0782004444444415,1.0780725000000024,1.077521600000001,1.077765300000001,1.0794802500000018,1.0781533078992112,1.0781116483564404,-4777,-163934,-162293.6,0.015694211561451097,-113.2865658535339,0.022260353383111626
2023-05-24T04:00:00-04:00,1.07839,1.07949,1.07782,1.07884,1.07703,1.0782837777777776,1.0782744444444414,1.0782111111111083,1.0781170000000024,1.0775602000000009,1.077756200000001,1.0794685000000017,1.0782906463193689,1.0781373186851524,6877,-157057,-160829.2,0.016042197339448325,-110.41687121615742,0.04543979227524472
2023-05-24T04:15:00-04:00,1.07884,1.07884,1.07818,1.0783099999999999,1.0771283999999999,1.078290888888889,1.078252222222219,1.0782166666666637,1.0781420000000026,1.0775916000000008,1.077749700000001,1.0794495500000019,1.0782945170554952,1.078169054948122,-3955,-161012,-161072.8,0.014080867819713398,-112.35983773575306,-0.01854410251181723
2023-05-24T04:30:00-04:00,1.0783099999999999,1.0785,1.07748,1.07772,1.077222864,1.0781844444444446,1.0781466666666633,1.0782173333333305,1.0781410000000025,1.0776064000000007,1.077731200000001,1.079428700000002,1.0781796136443962,1.0782024439584976,-4102,-165114,-161254.8,0.007150883193789355,-114.60425724405722,-0.08807142128732665
2023-05-24T04:45:00-04:00,1.07772,1.0782,1.07754,1.07775,1.07731354944,1.078105111111111,1.0780822222222188,1.078195111111108,1.0781345000000024,1.0776214000000008,1.077705300000001,1.079412150000002,1.078093690915517,1.078202355166798,3455,-161659,-161755.2,-0.0014266425270176512,-114.50808198517744,-0.0537868741479904
2023-05-24T05:00:00-04:00,1.07775,1.07809,1.07749,1.07777,1.0774006074623999,1.0780426666666665,1.07808333333333,1.0781677777777745,1.0781415000000023,1.077636000000001,1.077686200000001,1.079399600000002,1.0780289527324136,1.0781774841334386,3297,-158362,-160640.8,-0.0061350343587644315,-114.44689896499679,0.0009278503562800129
2023-05-24T05:15:00-04:00,1.07777,1.0781,1.07748,1.07802,1.07949,1.07803,1.0780822222222188,1.07812933333333,1.0781425000000024,1.0776590000000008,1.077665200000001,1.079386950000002,1.078027162185931,1.078124787306751,3156,-155206,-160270.6,-0.005445908612022779,-113.71483182636771,-0.0009276179698213883
2023-05-24T05:30:00-04:00,1.07802,1.07818,1.07754,1.07767,1.0794498000000001,1.0779475555555555,1.0780988888888856,1.0780986666666634,1.0781215000000024,1.077673600000001,1.077638000000001,1.0793719500000019,1.0779557297487448,1.078057029845401,-2914,-158120,-159692.2,-0.0073275702147510375,-114.66091816984948,0.013920855297337631
2023-05-24T05:45:00-04:00,1.07767,1.07792,1.07729,1.07736,1.079410404,1.077799777777778,1.077981111111108,1.0780655555555523,1.0780895000000026,1.077681600000001,1.077608300000001,1.079355300000002,1.0778365837989958,1.077988423876321,-2441,-160561,-158781.6,-0.005587507657899234,-115.36309044893262,-0.09829194562413891
2023-05-24T06:00:00-04:00,1.07736,1.07737,1.07565,1.07567,1.07932558784,1.0773375555555555,1.0776788888888855,1.0779848888888854,1.0779605000000025,1.0776492000000006,1.077567000000001,1.079332100000002,1.0774032670391966,1.077850339101057,-4819,-165380,-159525.8,-0.02080622119258469,-122.92241138158366,-0.2522278581960196
2023-05-24T06:15:00-04:00,1.07567,1.07571,1.0748,1.07523,1.0791050525696,1.0768477777777776,1.0772777777777744,1.0778237777777746,1.0778235000000025,1.0776080000000008,1.077529100000001,1.079306450000002,1.0769686136313572,1.0776382712808457,-5842,-171222,-162097.8,-0.03678465206111593,-125.31206620137037,-0.33461866449150135
2023-05-24T06:30:00-04:00,1.07523,1.0754,1.0749,1.07534,1.078760648364032,1.0764602222222222,1.0769477777777743,1.0775968888888856,1.0776830000000026,1.0775726000000008,1.077501400000001,1.079277100000002,1.0766428909050858,1.0773614170246766,2897,-168325,-164721.6,-0.05764452776856257,-125.01569240227607,-0.2754309985069152
2023-05-24T06:45:00-04:00,1.07534,1.07557,1.07494,1.07515,1.0784437964949094,1.0761006666666666,1.0766622222222189,1.077309555555552,1.0775230000000025,1.0775322000000007,1.0774716000000009,1.079247700000002,1.0763443127240686,1.0770391336197414,-2995,-171320,-167361.6,-0.07372018236920523,-125.54487387046264,-0.2384663920127641
2023-05-24T07:00:00-04:00,1.07515,1.07657,1.0751,1.0763,1.0781522927753167,1.0760282222222222,1.0765011111111076,1.0770135555555522,1.0774125000000023,1.0775134000000008,1.077460700000001,1.079221500000002,1.0763354501792548,1.076738906895793,2875,-168445,-168938.4,-0.07784587806641335,-122.46972156613305,-0.13453954998839726
2023-05-24T07:15:00-04:00,1.0763,1.077,1.07612,1.07688,1.0778841093532914,1.076104,1.076402222222219,1.0767582222222187,1.0773230000000025,1.0775062000000009,1.077458000000001,1.0791968500000022,1.076444360143404,1.0765471255166346,2651,-165794,-169021.2,-0.07872219960719874,-121.04114217377025,-0.08257791551071522
2023-05-24T07:30:00-04:00,1.07688,1.07768,1.07673,1.07759,1.0748,1.0763415555555556,1.076354444444441,1.0765735555555522,1.0772860000000024,1.0775124000000007,1.077458100000001,1.079174550000002,1.076673488114723,1.0764881004133078,3465,-162329,-167242.6,-0.07562306483578322,-118.75662579311506,-0.039887942709776296
2023-05-24T07:45:00-04:00,1.07759,1.07807,1.07683,1.07806,1.0748576,1.0766826666666667,1.0763977777777745,1.0764635555555522,1.0773010000000025,1.0775324000000008,1.077461000000001,1.0791552000000022,1.0769507904917786,1.0765496803306465,3325,-159004,-165378.4,-0.07405924208944964,-117.30639889791382,0.03618918592891261
2023-05-24T08:00:00-04:00,1.07806,1.07898,1.07784,1.0786,1.0749860960000002,1.077123111111111,1.0765355555555522,1.0764382222222189,1.0773295000000025,1.0775658000000008,1.0774670000000008,1.0791381500000021,1.0772806323934228,1.0767369442645172,4675,-154329,-161980.2,-0.06913707279937871,-114.96469249938319,0.11509616098610564
2023-05-24T08:15:00-04:00,1.0786,1.08013,1.0783099999999999,1.07911,1.0752257302400001,1.077638,1.0769177777777745,1.0765215555555523,1.0774090000000025,1.077609600000001,1.0774768000000008,1.0791195500000021,1.0776465059147382,1.0769991554116138,6040,-148289,-157949,-0.05766451424701609,-112.1087681530082,0.3198006823654197
2023-05-24T08:30:00-04:00,1.07911,1.07912,1.07856,1.0789,1.0756180718208002,1.0780344444444445,1.0773255555555523,1.076706222222219,1.0774330000000023,1.0776490000000007,1.0774865000000007,1.0791024500000022,1.0778972047317905,1.0772897243292912,-4167,-152456,-155281.4,-0.033782529606038336,-112.91968640971992,0.34132232173582044
2023-05-24T08:45:00-04:00,1.0789,1.07947,1.07858,1.07893,1.075979026075136,1.0783553333333333,1.0777244444444412,1.076980222222219,1.0774600000000025,1.0776794000000007,1.0775030000000008,1.0790861500000022,1.0781037637854325,1.077575779463433,4455,-148001,-152415.8,-0.0016970432997256704,-112.7958102395467,0.3338478992690667
2023-05-24T09:00:00-04:00,1.07893,1.0794,1.07866,1.07907,1.076311103989125,1.0786244444444444,1.0781599999999967,1.0773326666666634,1.0774715000000024,1.0777148000000007,1.0775140000000007,1.0790733000000023,1.078297011028346,1.0778450235707464,3934,-144067,-149428.4,0.029913908575504074,-112.2853415344406,0.36460028833185354
2023-05-24T09:15:00-04:00,1.07907,1.07912,1.07849,1.07858,1.076616615669995,1.0787084444444444,1.07841333333333,1.077708222222219,1.0774850000000025,1.0777412000000008,1.0775223000000007,1.0790567000000022,1.0783536088226768,1.0780596188565972,-3414,-147481,-148058.8,0.0628954998694812,-113.83562094170759,0.21183684846233017
2023-05-24T09:30:00-04:00,1.07858,1.07873,1.07744,1.07766,1.0768976864163955,1.0785577777777777,1.0784999999999967,1.0780246666666633,1.0774820000000023,1.0777506000000008,1.0775241000000009,1.0790373500000021,1.0782148870581414,1.078173295085278,-5278,-152759,-148952.8,0.07839182299666114,-118.33761430334991,0.07243146868731919
2023-05-24T09:45:00-04:00,1.07766,1.0781,1.07691,1.07694,1.08013,1.0782457777777779,1.0784277777777744,1.0782451111111078,1.0774415000000024,1.0777490000000007,1.0775296000000008,1.0790113000000021,1.0779599096465131,1.0781858360682226,-5963,-158722,-150206,0.08239866564019564,-122.32157956140934,-0.06031978767435104
2023-05-24T10:00:00-04:00,1.07694,1.07772,1.07676,1.07688,1.0800656,1.0779362222222224,1.0782966666666634,1.078359555555552,1.0773970000000024,1.0777424000000009,1.0775300000000008,1.0789844000000022,1.0777439277172105,1.0781138688545782,-5845,-164567,-153519.2,0.07965716876956278,-122.64722444413233,-0.10945587444112191
2023-05-24T10:15:00-04:00,1.07688,1.07717,1.07626,1.07642,1.079933376,1.0775608888888888,1.078054444444441,1.0783384444444413,1.0773170000000023,1.0777234000000007,1.0775182000000008,1.078952750000002,1.0774791421737684,1.0779502950836626,-5280,-169847,-158675.2,0.07040641149634104,-124.90262894602732,-0.20211385128871415
2023-05-24T10:30:00-04:00,1.07642,1.07717,1.07617,1.0762,1.07971297344,1.07719,1.0777311111111076,1.0782019999999968,1.0772435000000025,1.0777016000000008,1.0775031000000006,1.078923150000002,1.0772233137390148,1.0777242360669301,-4587,-174434,-164065.8,0.05617848393686627,-125.84012546225657,-0.26966666975562903
2023-05-24T10:45:00-04:00,1.0762,1.07638,1.0758,1.07625,1.0794295355648,1.0768937777777778,1.077436666666663,1.07798933333333,1.0771880000000025,1.0776744000000007,1.0774838000000007,1.0788947500000021,1.077028650991212,1.077486988853544,5181,-169253,-167364.6,0.035908920513282684,-125.59941741542568,-0.24562053943832063
2023-05-24T11:00:00-04:00,1.07625,1.07641,1.0756999999999999,1.07575,1.07906658200832,1.0765564444444444,1.0770833333333298,1.077720444444441,1.0771920000000024,1.0776374000000006,1.0774507000000006,1.078867000000002,1.0767729207929695,1.0772495910828355,-4333,-173586,-170337.4,0.013784560319913297,-127.61242554550675,-0.294736451855075
2023-05-24T11:15:00-04:00,1.07575,1.0764799999999999,1.07558,1.0761,1.0786625921673216,1.0763597777777778,1.07675333333333,1.0774117777777743,1.0772355000000025,1.0776100000000006,1.0774232000000008,1.078843000000002,1.0766383366343757,1.0770284728662687,3844,-169742,-171372.4,-0.014389958593983943,-126.36176321689855,-0.2752370096471885
2023-05-24T11:30:00-04:00,1.0761,1.0761,1.07551,1.07572,1.0782310292638966,1.0761531111111111,1.0764355555555523,1.0770879999999965,1.0772545000000027,1.0775654000000008,1.0773993000000006,1.0788137500000021,1.0764546693075006,1.076823578293015,-3374,-173116,-172026.2,-0.047656034832149516,-127.55321382557818,-0.26516345565466487
2023-05-24T11:45:00-04:00,1.07572,1.07598,1.07547,1.07582,1.077795664581673,1.0760299999999998,1.0762311111111076,1.0767879999999965,1.0772880000000025,1.0775256000000006,1.0773790000000008,1.078786700000002,1.0763277354460004,1.076644462634412,4934,-168182,-170775.8,-0.07539926554674084,-127.09454428331817,-0.17074030770373436
2023-05-24T12:00:00-04:00,1.07582,1.07612,1.07494,1.07518,1.077377044956972,1.0758197777777778,1.0760355555555519,1.0765077777777745,1.0772320000000024,1.0774744000000007,1.0773544000000006,1.078757050000002,1.0760981883568004,1.0764583701075296,-5272,-173454,-171616,-0.0985547019707551,-130.23083102273543,-0.16342600330566084
2023-05-24T12:15:00-04:00,1.07518,1.0755,1.07496,1.0752,1.0768896359655775,1.0756526666666666,1.0758488888888853,1.0762608888888854,1.0771480000000024,1.0774208000000007,1.0773327000000008,1.0787300000000022,1.0759185506854403,1.076287496086024,3451,-170003,-170899.4,-0.10985046755410847,-130.1666371203194,-0.15600624024962167
2023-05-24T12:30:00-04:00,1.0752,1.07609,1.07516,1.07601,1.076499708772462,1.0756848888888888,1.0758033333333297,1.0760708888888852,1.0770690000000023,1.0773884000000007,1.0773161000000007,1.0787038500000021,1.0759368405483523,1.0761471968688192,2556,-167447,-170440.4,-0.1140856546517656,-128.24107908460516,-0.038089221679272166
2023-05-24T12:45:00-04:00,1.07601,1.07606,1.0755,1.0756,1.0761877670179696,1.0756442222222222,1.075736666666663,1.0759311111111074,1.0769460000000022,1.0773404000000009,1.0773014000000007,1.078682650000002,1.0758694724386817,1.0760301574950557,-2779,-170226,-169862.4,-0.11291074228295575,-129.29998188290634,-0.055751719011350676
2023-05-24T13:00:00-04:00,1.0756,1.07581,1.07538,1.07555,1.07609,1.0756068888888888,1.0756588888888852,1.075816666666663,1.0767935000000022,1.0772896000000007,1.0772954000000008,1.0786613500000022,1.0758055779509454,1.0759257259960449,-3627,-173853,-170996.6,-0.10786014441191327,-129.46858545300634,-0.06504065040649691
2023-05-24T13:15:00-04:00,1.07555,1.07641,1.07555,1.07628,1.07494,1.0757311111111112,1.0757177777777742,1.0757531111111074,1.0766520000000024,1.0772552000000006,1.0772958000000008,1.078641750000002,1.0759004623607564,1.0758861807968358,2765,-171088,-170523.4,-0.09733262869737486,-127.59191770162359,0.04926795259120794
2023-05-24T13:30:00-04:00,1.07628,1.07658,1.07583,1.07601,1.0749694,1.0757895555555554,1.075707777777774,1.075724888888885,1.0765075000000022,1.0772104000000007,1.0772887000000007,1.078622250000002,1.0759223698886051,1.0758869446374688,-2609,-173697,-171262.2,-0.0812196885760175,-128.246422105682,-0.00836353498746822
2023-05-24T13:45:00-04:00,1.07601,1.0761,1.07551,1.07561,1.0750338240000001,1.07577,1.0756955555555519,1.0757033333333295,1.0763415000000023,1.0771632000000007,1.0772781000000007,1.0785977500000021,1.075859895910884,1.0758715557099752,-2282,-175979,-172968.6,-0.07122963350930236,-129.09474135922045,-0.010225709292385983
2023-05-24T14:00:00-04:00,1.07561,1.07626,1.07518,1.07611,1.0750956710400001,1.0758528888888887,1.0757277777777743,1.0757015555555518,1.0761935000000025,1.0771224000000006,1.0772670000000006,1.0785745000000022,1.0759099167287072,1.0758796445679804,4701,-171278,-173179,-0.05513884476971323,-126.90946974590359,0.026956182260963864
2023-05-24T14:15:00-04:00,1.07611,1.0765,1.07594,1.07623,1.0751550441984001,1.0759533333333333,1.0758444444444408,1.075738666666663,1.0760760000000025,1.0770800000000005,1.0772567000000008,1.078547900000002,1.0759739333829657,1.0759133156543843,2795,-168483,-172105,-0.03876973995690147,-126.59779157173892,0.09765806655629712
2023-05-24T14:30:00-04:00,1.07623,1.07659,1.0761,1.07658,1.07518,1.0761004444444444,1.0759977777777743,1.075794666666663,1.0760220000000025,1.0770414000000006,1.0772457000000006,1.078523700000002,1.0760951467063726,1.0759522525235075,2513,-165970,-171081.4,-0.016912926307934388,-125.78054061237134,0.12834821428572907
2023-05-24T14:45:00-04:00,1.07658,1.07658,1.07497,1.07506,1.07659,1.075912888888889,1.0758922222222185,1.075831555555552,1.0759280000000024,1.0769692000000004,1.0772184000000007,1.0784942000000022,1.075888117365098,1.0759454020188062,-2916,-168886,-170119.2,-0.0067093005244174275,-129.89757789710683,-0.0882891422942172
2023-05-24T15:00:00-04:00,1.07506,1.07551,1.07496,1.07538,1.07659,1.0758104444444443,1.0758677777777743,1.0758659999999964,1.0758530000000026,1.0769102000000006,1.0771925000000007,1.078462850000002,1.0757864938920785,1.075930721615045,2800,-166086,-168140.6,-0.005660809934004043,-129.06413604269844,-0.020453700260309314
2023-05-24T15:15:00-04:00,1.07538,1.07562,1.07531,1.07544,1.07658,1.075724888888889,1.075855555555552,1.0758915555555517,1.0758040000000024,1.0768638000000004,1.0771696000000006,1.078434300000002,1.0757171951136628,1.0758921772920362,2482,-163604,-166605.8,-0.0007745933385023612,-128.92565476166303,-0.0102273255543726
2023-05-24T15:30:00-04:00,1.07544,1.07572,1.07536,1.07549,1.0765152,1.0756517777777779,1.0757677777777743,1.0758762222222185,1.0757685000000023,1.0768130000000005,1.077145800000001,1.078404850000002,1.0756717560909304,1.0758317418336292,1701,-161903,-165289.8,0.0027842243810411974,-128.8465708518213,-0.0734009737242954
2023-05-24T15:45:00-04:00,1.07549,1.07549,1.07493,1.07495,1.076452992,1.0754882222222222,1.0756499999999967,1.075806666666663,1.0757035000000026,1.0767616000000004,1.0771191000000009,1.078370600000002,1.0755274048727443,1.0757181934669036,-2409,-164312,-164958.2,-0.004045980756355778,-130.05612184718152,-0.09851209561247934
2023-05-24T16:00:00-04:00,1.07495,1.07531,1.07494,1.07529,1.0763616124800002,1.075416222222222,1.075614444444441,1.0757511111111075,1.0756805000000025,1.0766990000000003,1.0770976000000008,1.078337200000002,1.0754799238981956,1.0756365547735232,1452,-162860,-163753,-0.006489781029642906,-129.59686327701544,-0.02975056014725374
2023-05-24T16:15:00-04:00,1.07529,1.07538,1.07505,1.07507,1.0762757157312002,1.0753073333333334,1.0754988888888855,1.07567733333333,1.0756290000000024,1.0766326000000004,1.077077100000001,1.0783037500000021,1.0753979391185564,1.0755588438188188,-1043,-163903,-163316.4,-0.008499832659550042,-129.8102568731617,-0.0966443950897148
2023-05-24T16:30:00-04:00,1.07507,1.07513,1.07493,1.07496,1.0761949727873281,1.0751995555555554,1.0753577777777743,1.0755777777777744,1.0755910000000024,1.0765550000000004,1.0770576000000007,1.078270250000002,1.0753103512948452,1.0754774750550553,-729,-164632,-163522,-0.014144966649761788,-129.88484736494368,-0.11800451576336883
2023-05-24T16:45:00-04:00,1.07496,1.0751,1.07487,1.07494,1.0761190744200884,1.075116,1.0751755555555522,1.07545933333333,1.0755470000000025,1.0764876000000005,1.0770396000000009,1.078235400000002,1.0752362810358762,1.0753903800440445,-931,-165563,-164254,-0.02268585667002606,-129.90216893969986,-0.15233424362333367
2023-05-24T17:00:00-04:00,1.07494,1.0753,1.07492,1.07522,1.0760191484664814,1.075124888888889,1.0751933333333301,1.0753679999999965,1.0755490000000025,1.0764376000000004,1.0770220000000008,1.078203450000002,1.075233024828701,1.0753315040352358,82,-165481,-164487.8,-0.032674877004323435,-129.88080960801622,0.01488289025730285
2023-05-24T17:15:00-04:00,1.07522,1.07528,1.07499,1.07519,1.075927216589163,1.0751242222222221,1.0751722222222189,1.0752795555555523,1.0755485000000025,1.0763864000000003,1.077003900000001,1.078171500000002,1.0752244198629608,1.0752804032281889,-123,-165604,-165036.6,-0.03151043315444028,-129.88424146382246,-0.017668173110892194
2023-05-24T17:30:00-04:00,1.07519,1.07531,1.075,1.07515,1.07584263926203,1.075119777777778,1.0751399999999967,1.0752077777777747,1.0755055000000027,1.0763340000000003,1.0769850000000007,1.078140400000002,1.0752095358903686,1.0752427225825514,-500,-166104,-165476.8,-0.03342760952301154,-129.90284282730244,-0.026965707059426976
2023-05-24T17:45:00-04:00,1.07515,1.07516,1.07497,1.07498,1.0757648281210674,1.0750877777777779,1.0750833333333303,1.0751528888888857,1.0754745000000026,1.0762732000000004,1.0769661000000008,1.078109750000002,1.075163628712295,1.0752133780660413,-121,-166225,-165795.4,-0.033145761207946746,-129.92197504141208,-0.04742024565546964
2023-05-24T18:00:00-04:00,1.07498,1.0752599999999999,1.07484,1.07484,1.075693241871382,1.0750391111111113,1.075071111111108,1.0751319999999969,1.0754390000000027,1.0762166000000004,1.0769451000000008,1.0780777000000021,1.075098902969836,1.0751859024528332,-537,-166762,-166035.2,-0.03582572518199048,-129.99191122627136,-0.01023303409461412
2023-05-24T18:15:00-04:00,1.07484,1.07492,1.0742099999999999,1.07455,1.075607917684244,1.074934888888889,1.0749888888888857,1.0750911111111079,1.0753525000000028,1.0761604000000005,1.076921000000001,1.0780443000000022,1.0749891223758687,1.0751371219622667,-1088,-167850,-166509,-0.03511882437175614,-130.2854618942779,-0.06881864427272502
2023-05-24T18:30:00-04:00,1.07455,1.07546,1.07454,1.07521,1.0742099999999999,1.074979111111111,1.075004444444441,1.0750575555555524,1.0753125000000028,1.0761512000000004,1.076900200000001,1.0780136500000022,1.075033297900695,1.0750988975698135,1783,-166067,-166601.6,-0.031126202603293896,-129.19032439485935,0.013022407843212907
2023-05-24T18:45:00-04:00,1.07521,1.07566,1.0752,1.0755,1.0742099999999999,1.0750782222222222,1.075064444444441,1.075042444444441,1.0753070000000027,1.0761566000000005,1.076882300000001,1.077984950000002,1.075126638320556,1.075082318055851,1017,-165050,-166390.8,-0.02486964030690683,-128.91602449065468,0.050234427327527066
2023-05-24T19:00:00-04:00,1.0755,1.07558,1.07527,1.07542,1.074268,1.0751493333333333,1.0751177777777743,1.07504933333333,1.0752725000000027,1.0761582000000005,1.0768654000000009,1.0779550500000021,1.0751853106564448,1.0750866544446809,-753,-165803,-166306.4,-0.019750628388817682,-128.97203564825568,0.04465365508772917
2023-05-24T19:15:00-04:00,1.07542,1.07553,1.07532,1.07537,1.07432368,1.0751997777777778,1.075134444444441,1.0750619999999966,1.075229500000003,1.0761626000000006,1.076847400000001,1.077925050000002,1.075222248525156,1.075111323555745,-614,-166417,-166237.4,-0.012475189120678796,-129.00058263454946,0.013950633358742625
2023-05-24T19:30:00-04:00,1.07537,1.07556,1.07531,1.07556,1.0743771328,1.0752848888888888,1.0751755555555522,1.07509933333333,1.075178500000003,1.0761478000000004,1.076830600000001,1.077896600000002,1.0752897988201247,1.0751714588445962,608,-165809,-165829.2,-0.00634628202204646,-128.89315914309992,0.03441252243789297
2023-05-24T19:45:00-04:00,1.07556,1.07567,1.07552,1.07556,1.074428447488,1.0753617777777777,1.0752211111111079,1.0751426666666632,1.0752035000000029,1.0761214000000003,1.076813800000001,1.077868250000002,1.0753438390560996,1.0752335670756772,0,-165809,-165777.6,0.0016121081724771891,-128.89315914309992,0.03813421383063028
2023-05-24T20:00:00-04:00,1.07556,1.07558,1.07486,1.07521,1.0745029406387199,1.0753595555555555,1.0752466666666634,1.0751791111111078,1.075195000000003,1.0760738000000003,1.0767931000000008,1.077837300000002,1.0753170712448796,1.075271653660542,-2457,-168266,-166420.8,0.0015058053223939365,-129.69269612848444,0.021395746897612276
2023-05-24T20:15:00-04:00,1.07521,1.07525,1.07493,1.07494,1.0745729642003967,1.075298222222222,1.0752577777777745,1.075207111111108,1.0751700000000028,1.0760114000000005,1.076771900000001,1.077804900000002,1.0752416569959038,1.0752829229284335,-2112,-170378,-167335.8,0.003082532140721252,-130.22304833875032,0.009303710319674462
2023-05-24T20:30:00-04:00,1.07494,1.07504,1.07469,1.07474,1.0746387863483728,1.0751946666666667,1.0752788888888858,1.0752359999999967,1.0751325000000027,1.0759342000000005,1.076750000000001,1.077772050000002,1.075141325596723,1.0752667383427472,-1316,-171694,-168391.2,0.005252868482505242,-130.467899214148,0.017681820296880976
2023-05-24T20:45:00-04:00,1.07474,1.07504,1.07452,1.07504,1.07567,1.0751468888888889,1.0752599999999968,1.0752528888888857,1.075137000000003,1.0758528000000005,1.0767312000000009,1.077740950000002,1.0751210604773784,1.0752329906741978,1934,-169760,-169181.4,0.011803687622607972,-129.92804771518087,-0.015810864854307854
2023-05-24T21:00:00-04:00,1.07504,1.07534,1.07466,1.07476,1.0756469999999998,1.0750468888888889,1.0751777777777745,1.0752442222222192,1.0751105000000027,1.0757700000000006,1.076709500000001,1.0777095000000019,1.0750488483819027,1.0751739925393584,-1862,-171622,-170344,0.008459749750866346,-130.41301571637163,-0.06880520688051725
2023-05-24T21:15:00-04:00,1.07476,1.07478,1.07422,1.07441,1.0756244599999998,1.0748933333333335,1.0750655555555524,1.0752079999999968,1.0750775000000028,1.0756796000000004,1.076679500000001,1.077676650000002,1.0749210787055221,1.075094794031487,-2547,-174169,-171524.6,0.0022191098579271156,-131.24245670784845,-0.09391679529857687
2023-05-24T21:30:00-04:00,1.07441,1.07457,1.07405,1.07414,1.0755682815999998,1.0747082222222224,1.0749288888888857,1.0751422222222191,1.0750365000000026,1.0755810000000006,1.0766479000000009,1.077642400000002,1.0747648629644178,1.0749994352251897,-2662,-176831,-172815.2,-0.005567936129529171,-131.91141920819746,-0.11437923691379176
2023-05-24T21:45:00-04:00,1.07414,1.07453,1.0741,1.07437,1.0754771847039999,1.0745964444444445,1.0747966666666633,1.0750457777777747,1.0750080000000026,1.0754968000000005,1.076619000000001,1.077609000000002,1.0746858903715342,1.0749083481801518,1985,-174846,-173445.6,-0.012256867079208516,-131.48638150361526,-0.11064003867752839
2023-05-24T22:00:00-04:00,1.07437,1.07446,1.0740399999999999,1.07424,1.07539155362176,1.0744851111111111,1.0746499999999968,1.0749237777777747,1.0749590000000027,1.0754284000000005,1.076589500000001,1.077572550000002,1.0745967122972273,1.0748034785441216,-2029,-176875,-174868.6,-0.021435785668717282,-131.73189282653001,-0.12272676559187658
2023-05-24T22:15:00-04:00,1.07424,1.07433,1.074,1.07428,1.0752834293320193,1.0744111111111112,1.0745466666666637,1.0747975555555525,1.0749135000000025,1.0753752000000005,1.076562100000001,1.077535250000002,1.074533369837782,1.0747003828352972,1263,-175612,-175666.6,-0.029180285166728707,-131.68486422956866,-0.08649473126180908
2023-05-24T22:30:00-04:00,1.07428,1.07459,1.07422,1.07431,1.0751550863988173,1.0743637777777777,1.0744766666666636,1.0746797777777748,1.0748715000000026,1.0753238000000005,1.0765331000000011,1.077498750000002,1.0744886958702256,1.074613906268238,1433,-174179,-175668.6,-0.03365587806089242,-131.64484672947532,-0.05860792230263163
2023-05-24T22:45:00-04:00,1.07431,1.07439,1.07414,1.07415,1.0750395777589357,1.0742984444444443,1.0744111111111083,1.0745762222222193,1.0748300000000026,1.0752784000000004,1.076500900000001,1.077463750000002,1.0744209566961804,1.0745451250145905,-809,-174988,-175300,-0.036576969800077096,-131.76533336741048,-0.05489699834379389
2023-05-24T23:00:00-04:00,1.07415,1.07422,1.07401,1.0740399999999999,1.0749356199830422,1.0742242222222222,1.074299999999997,1.0744768888888858,1.0747900000000026,1.0752352000000005,1.0764684000000009,1.077428950000002,1.0743447653569442,1.0744769000116725,-1256,-176244,-175579.6,-0.03892667642566204,-131.893955999259,-0.0930197946123039
2023-05-24T23:15:00-04:00,1.0740399999999999,1.07424,1.07359,1.07369,1.074842057984738,1.074102222222222,1.0741811111111081,1.0743831111111082,1.0747470000000026,1.0751840000000006,1.076429200000001,1.077393350000002,1.0742138122855553,1.0744003200093384,-1569,-177813,-175767.2,-0.04639449096988939,-132.40524980582092,-0.09955711042464405
2023-05-24T23:30:00-04:00,1.07369,1.07383,1.07361,1.07382,1.0746918110265695,1.07403,1.0741155555555526,1.074296888888886,1.0746775000000024,1.0751454000000005,1.076391400000001,1.0773594000000017,1.0741350498284443,1.0743206560074707,1152,-176661,-175977,-0.051908035709529954,-132.26576820498644,-0.0549138596997506
2023-05-24T23:45:00-04:00,1.07382,1.07402,1.07373,1.07374,1.0745595937033812,1.0739548888888888,1.0740711111111083,1.0742157777777748,1.0745895000000025,1.0750982000000007,1.076354100000001,1.077325850000002,1.0740560398627554,1.0742341248059766,-914,-177575,-176656.2,-0.05163225181222012,-132.33386155396494,-0.037239093600478335
2023-05-25T00:00:00-04:00,1.07374,1.0739,1.07367,1.0738,1.0744432424589754,1.0739006666666666,1.074007777777775,1.0741351111111084,1.0745085000000025,1.0750598000000007,1.076312600000001,1.077292300000002,1.0740048318902045,1.0741508998447815,831,-176744,-177007.4,-0.04726665688772468,-132.28742573151243,-0.05305434812959776
2023-05-25T00:15:00-04:00,1.0738,1.07397,1.07379,1.07384,1.0743408533638983,1.073867111111111,1.0739633333333305,1.074067777777775,1.0744320000000027,1.0750202000000006,1.076272900000001,1.077258250000002,1.0739718655121635,1.0740763198758254,749,-175995,-176957.6,-0.04520029906031201,-132.25952481886588,-0.037235627047976054
2023-05-25T00:30:00-04:00,1.07384,1.07388,1.07363,1.07364,1.0742507509602306,1.0738024444444443,1.0738922222222194,1.0740099999999972,1.0743360000000026,1.0749894000000006,1.076231900000001,1.077222900000002,1.0739054924097309,1.0740146559006605,-828,-176823,-176759.6,-0.043120642062744984,-132.41373773699146,-0.05957478497225807
2023-05-25T00:45:00-04:00,1.07364,1.07365,1.07329,1.07342,1.074171460845003,1.073708,1.0737933333333305,1.0739455555555528,1.0742290000000025,1.0749538000000007,1.076187300000001,1.0771849500000021,1.0738083939277847,1.0739493247205287,-1146,-177969,-177021.2,-0.041644245115468756,-132.64856505341027,-0.08284387188056123
2023-05-25T01:00:00-04:00,1.07342,1.07378,1.07336,1.07356,1.0740480563267025,1.0736613333333336,1.0737277777777752,1.0738768888888863,1.0741465000000026,1.0749048000000008,1.076146600000001,1.077150050000002,1.0737587151422279,1.0738898597764233,1538,-176431,-176792.4,-0.03976391670586669,-132.4479725546679,-0.054927151701333
2023-05-25T01:15:00-04:00,1.07356,1.0737,1.07337,1.07355,1.0739419284409641,1.0736257777777778,1.0736733333333306,1.0738099999999975,1.0740770000000024,1.0748638000000006,1.0761021000000008,1.077115050000002,1.0737169721137823,1.0738322878211388,-915,-177346,-176912.8,-0.037993516718871224,-132.45649559949078,-0.04562213697812739
2023-05-25T01:30:00-04:00,1.07355,1.07377,1.07352,1.07372,1.0738506584592291,1.073635111111111,1.0736766666666637,1.073752666666664,1.0740260000000024,1.0748272000000008,1.076058400000001,1.077079150000002,1.0737175776910257,1.073781430256911,1273,-176073,-176928.4,-0.03556598327834921,-132.25491206821604,0.0027941025808170413
2023-05-25T01:45:00-04:00,1.07372,1.07399,1.07362,1.07394,1.07329,1.0736877777777778,1.0736899999999971,1.0737122222222193,1.0739710000000025,1.0747804000000007,1.0760178000000011,1.077044850000002,1.0737620621528206,1.073752744205529,1503,-174570,-176477.8,-0.029692575215681655,-131.94695468640344,0.011175057272159018
2023-05-25T02:00:00-04:00,1.07394,1.07398,1.0728,1.07302,1.07399,1.073553777777778,1.0736099999999973,1.0736755555555528,1.0738840000000025,1.0747206000000007,1.075965500000001,1.0770061000000022,1.0736136497222564,1.0737137953644234,-3718,-178288,-176541.6,-0.028187637346504153,-135.13201157971153,-0.06705533928137462
2023-05-25T02:15:00-04:00,1.07302,1.07367,1.073,1.07342,1.07399,1.0735157777777777,1.0735677777777748,1.0736435555555528,1.0738345000000025,1.0746768000000007,1.075920000000001,1.076969500000002,1.073574919777805,1.0736770362915387,2429,-175859,-176427.2,-0.025227150781935985,-134.22652985523305,-0.035388340473090606
2023-05-25T02:30:00-04:00,1.07342,1.07397,1.0734,1.07386,1.0728,1.0735742222222224,1.0735699999999972,1.073622888888886,1.0738205000000023,1.0746318000000006,1.075877100000001,1.076933950000002,1.0736319358222441,1.0736600290332312,2820,-173039,-175565.8,-0.022230056473043616,-133.0705983465971,0.0018624748566016377
2023-05-25T02:45:00-04:00,1.07386,1.07439,1.07296,1.07322,1.0728233999999999,1.0735042222222222,1.0735233333333305,1.0735922222222194,1.0737630000000022,1.0745716000000007,1.0758258000000012,1.076894950000002,1.0735495486577953,1.0736264232265849,-2899,-175938,-175538.8,-0.023925004534359876,-134.7983468426766,-0.03911925785178132
2023-05-25T03:00:00-04:00,1.07322,1.07332,1.0719,1.07191,1.07439,1.0731815555555557,1.0733555555555527,1.0735253333333303,1.0736465000000024,1.0744782000000008,1.075759800000001,1.0768506500000021,1.0732216389262361,1.073518338581268,-5427,-181365,-176897.8,-0.029130041597167745,-141.42268295270136,-0.1406718712153791
2023-05-25T03:15:00-04:00,1.07191,1.07252,1.07154,1.07242,1.07439,1.0729944444444446,1.0732288888888861,1.073449111111108,1.0735535000000023,1.0744254000000009,1.0756973000000012,1.076810850000002,1.0730613111409888,1.0734078708650145,4757,-176608,-176561.8,-0.030374334397052876,-139.15936793558234,-0.10618875516972882
2023-05-25T03:30:00-04:00,1.07242,1.07249,1.07192,1.07213,1.074276,1.0727746666666667,1.0730711111111084,1.0733497777777745,1.0734445000000026,1.0743604000000007,1.0756353000000012,1.076771100000002,1.072875048912791,1.0732678966920117,-3713,-180321,-177454.2,-0.034161077397994156,-140.1634241822018,-0.13227143589026844
2023-05-25T03:45:00-04:00,1.07213,1.07228,1.07138,1.07209,1.07416656,1.0725784444444444,1.0728899999999972,1.0732137777777748,1.0733415000000026,1.0742934000000006,1.0755786000000012,1.076727950000002,1.0727180391302327,1.0730851173536096,-3494,-183815,-179609.4,-0.03791760606671777,-140.29378150827245,-0.1518086652013579
2023-05-25T04:00:00-04:00,1.07209,1.07286,1.07196,1.07281,1.0739993664,1.0725624444444444,1.072764444444442,1.073061999999997,1.0732800000000027,1.0742398000000006,1.0755264000000013,1.0766878500000021,1.072736431304186,1.0729224938828879,4235,-179580,-180337.8,-0.040453174939707015,-137.44961730564,-0.10522003091419013
2023-05-25T04:15:00-04:00,1.07281,1.07306,1.07236,1.07283,1.073842204416,1.0725755555555554,1.0727433333333307,1.0729395555555528,1.0732370000000024,1.0741974000000007,1.0754795000000013,1.0766486000000022,1.0727551450433488,1.0728291951063105,3360,-176220,-179308.8,-0.04542907380850246,-137.38697806849672,-0.017707032487757405
2023-05-25T04:30:00-04:00,1.07283,1.07371,1.07253,1.07358,1.07138,1.0727428888888888,1.0727611111111084,1.072845999999997,1.0732250000000025,1.0741632000000008,1.0754311000000012,1.076610800000002,1.072920116034679,1.0728009560850484,3359,-172861,-178559.4,-0.03972345764892162,-135.038749551397,0.014905628738046428
2023-05-25T04:45:00-04:00,1.07358,1.07358,1.0722,1.07228,1.0714266,1.0726466666666665,1.0725855555555528,1.0727488888888859,1.0731520000000025,1.0741074000000006,1.0753700000000013,1.076567650000002,1.0727920928277432,1.0727843648680389,-3122,-175983,-177691.8,-0.04351553327485659,-138.81918510347532,-0.14713277335966857
2023-05-25T05:00:00-04:00,1.07228,1.07272,1.0722099999999999,1.07258,1.071472268,1.0726455555555554,1.0725144444444417,1.0726737777777748,1.0730910000000025,1.0740598000000006,1.0753074000000011,1.0765318000000021,1.0727496742621947,1.0727906918944314,3069,-172914,-175511.6,-0.050298150217227826,-137.96054743420927,-0.05963362591080802
2023-05-25T05:15:00-04:00,1.07258,1.07338,1.07245,1.07325,1.07151702264,1.0727926666666667,1.0726633333333306,1.0726535555555525,1.0730615000000026,1.0740260000000006,1.0752568000000011,1.076503250000002,1.0728497394097558,1.0728133535155453,3093,-169821,-173559.8,-0.04757917326187384,-136.02846777581564,0.1250104952841301
2023-05-25T05:30:00-04:00,1.07325,1.07382,1.07314,1.07334,1.0715608821872,1.0729279999999999,1.072765555555553,1.072657999999997,1.0730465000000025,1.0739884000000004,1.0752130000000013,1.0764721000000022,1.0729477915278047,1.0728518828124365,2740,-167081,-171732,-0.03203522410228606,-135.7986983837823,0.08578728483243804
2023-05-25T05:45:00-04:00,1.07334,1.07355,1.07305,1.07315,1.071651246899712,1.0730048888888888,1.0728788888888863,1.0726815555555524,1.0730330000000026,1.0739476000000006,1.0751670000000013,1.0764361500000021,1.0729882332222438,1.0728655062499493,-2539,-169620,-171083.8,-0.023058407531985042,-136.24814590274158,0.09513771650826121
2023-05-25T06:00:00-04:00,1.07315,1.07325,1.07252,1.07259,1.0717379970237235,1.072947111111111,1.0729344444444417,1.0727513333333303,1.0729845000000027,1.0738964000000004,1.0751152000000013,1.0764007000000022,1.072908586577795,1.0728888049999596,-2356,-171976,-170282.4,-0.015088813198174412,-137.47757328940727,0.04663787555148774
2023-05-25T06:15:00-04:00,1.07259,1.0731,1.07257,1.07294,1.0718212771427746,1.0729482222222222,1.0729488888888863,1.072838222222219,1.0729540000000024,1.0738556000000006,1.0750644000000014,1.0763648000000021,1.072914869262236,1.072921843999968,2105,-169871,-169673.8,-0.00441581830429857,-136.79068454347438,0.012117709566462232
2023-05-25T06:30:00-04:00,1.07294,1.07296,1.0724,1.07258,1.0719012260570637,1.0728744444444442,1.0729211111111085,1.0728897777777746,1.0728970000000024,1.0738104000000004,1.0750135000000012,1.076325750000002,1.0728478954097886,1.0729214751999745,-1880,-171751,-170059.8,-0.0022546052975017505,-137.42147470881434,-0.02330285320133306
2023-05-25T06:45:00-04:00,1.07258,1.07258,1.0722099999999999,1.07224,1.0719779770147813,1.0727382222222224,1.0727722222222198,1.0728911111111077,1.0728120000000025,1.0737642000000005,1.0749623000000013,1.0762853000000023,1.0727263163278309,1.07287718015998,-1851,-173602,-171364,-0.0011850770831452434,-138.00822814445553,-0.12481603606623604
2023-05-25T07:00:00-04:00,1.07224,1.07261,1.0722,1.0724,1.07205165793419,1.0726637777777779,1.0727855555555532,1.0728724444444413,1.0727810000000024,1.0737080000000006,1.0749296000000013,1.0762483000000023,1.0726610530622647,1.0728117441279839,2373,-171229,-171685.8,-0.00534874719455733,-137.65412831605903,0.01119110680047376
2023-05-25T07:15:00-04:00,1.0724,1.0729,1.0724,1.07286,1.0721223916168225,1.0726786666666668,1.072816666666664,1.0728488888888856,1.0727530000000025,1.0736552000000004,1.0749059000000014,1.0762175000000023,1.0727008424498117,1.0727701953023874,1987,-169242,-171139,0.0007679168768843416,-136.80181574612263,0.026105278860302814
2023-05-25T07:30:00-04:00,1.07286,1.07295,1.07254,1.07259,1.0721902959521497,1.0726333333333333,1.072743333333331,1.0728077777777745,1.0726895000000025,1.0735986000000006,1.0748784000000013,1.0761899000000024,1.0726786739598493,1.0727229562419098,-2135,-171377,-171440.2,0.00454552516585274,-137.3391179104311,-0.06149545772188259
2023-05-25T07:45:00-04:00,1.07259,1.07328,1.07254,1.07328,1.0722554841140637,1.0727406666666668,1.0727366666666642,1.0727708888888856,1.0726925000000025,1.0735568000000006,1.0748597000000013,1.0761656500000023,1.0727989391678794,1.072713164993528,2582,-168795,-170849,0.0073999858837915196,-135.6781104425261,-0.005590027391129464
2023-05-25T08:00:00-04:00,1.07328,1.07403,1.07301,1.07364,1.0723180647495012,1.0729213333333334,1.0727911111111088,1.0727746666666633,1.0727790000000026,1.0735184000000006,1.0748331000000013,1.0761469000000023,1.0729671513343035,1.0727613319948226,4096,-164699,-169068.4,0.008332042318201215,-134.30422851050497,0.045659972976739446
2023-05-25T08:15:00-04:00,1.07364,1.07373,1.0729,1.07318,1.0724207808645312,1.072999111111111,1.0728566666666641,1.0727888888888857,1.0728170000000026,1.0734708000000006,1.0747961000000013,1.0761270500000024,1.0730097210674427,1.0728310655958584,-4533,-169232,-168669,0.002973976375218614,-136.24638789353799,0.0550070390363597
2023-05-25T08:30:00-04:00,1.07318,1.07337,1.07146,1.07178,1.07403,1.0727837777777778,1.0727277777777753,1.0727711111111078,1.0727995000000026,1.0734022000000005,1.0747380000000013,1.0760980500000024,1.0727637768539542,1.0728436524766871,-12283,-181515,-171123.6,-0.0017356086525257574,-152.26998132614094,-0.10811415363394504
2023-05-25T08:45:00-04:00,1.07178,1.07211,1.07148,1.07183,1.0739786,1.0726042222222223,1.072644444444442,1.07275133333333,1.0727865000000025,1.0733400000000006,1.0746757000000011,1.0760683500000026,1.0725770214831634,1.0728233219813499,7687,-173828,-171613.8,-0.010751151243085951,-151.9113722832396,-0.06992485409014045
2023-05-25T09:00:00-04:00,1.07183,1.07253,1.0715,1.07199,1.073928228,1.0724733333333332,1.072616666666664,1.07272733333333,1.0727455000000026,1.0732850000000007,1.0746096000000014,1.0760383000000027,1.0724596171865306,1.07275545758508,6384,-167444,-171343.6,-0.015807192205766166,-150.95838533568298,-0.023315675595023826
2023-05-25T09:15:00-04:00,1.07199,1.07249,1.0718699999999999,1.07203,1.07387886344,1.0723559999999999,1.0725755555555532,1.0726842222222188,1.0727055000000025,1.0732248000000006,1.0745388000000013,1.0760078000000026,1.0723736937492245,1.072636766068064,5471,-161973,-170798.4,-0.014302874691251485,-150.75424164031247,-0.03450205147332912
2023-05-25T09:30:00-04:00,1.07203,1.07216,1.07071,1.07098,1.0738304861712,1.072036888888889,1.0723666666666645,1.072586222222219,1.0725755000000026,1.0731492000000005,1.0744596000000013,1.0759730500000027,1.0720949549993797,1.0724538128544514,-6200,-168173,-170586.6,-0.019329556507742093,-156.8268328924229,-0.17523255597187723
2023-05-25T09:45:00-04:00,1.07098,1.07192,1.07094,1.07133,1.073705666724352,1.0718295555555557,1.0722266666666644,1.072485999999997,1.0725280000000026,1.0730876000000007,1.074383600000001,1.0759433000000027,1.0719419639995038,1.0722894502835614,6245,-161928,-166669.2,-0.02360714723350376,-154.78594510740444,-0.11747265963695717
2023-05-25T10:00:00-04:00,1.07133,1.07301,1.07132,1.07264,1.073585840055378,1.0719122222222222,1.072155555555553,1.072388222222219,1.0725310000000026,1.0730576000000005,1.0743193000000013,1.0759166500000026,1.072081571199603,1.0721903602268494,6753,-155175,-162938.6,-0.024738935852706572,-146.52851742405667,-0.059630292188429294
2023-05-25T10:15:00-04:00,1.07264,1.07266,1.07208,1.07241,1.0734708064531628,1.0719631111111112,1.0720188888888866,1.0722686666666637,1.0724890000000027,1.0730184000000005,1.074257600000001,1.0758899500000028,1.0721472569596824,1.0721278881814797,-5189,-160364,-161522.6,-0.032096036811973955,-147.64116472417578,-0.11456354085166745
2023-05-25T10:30:00-04:00,1.07241,1.0732599999999999,1.07233,1.07304,1.0733603741950364,1.0721673333333333,1.072003333333331,1.0721542222222191,1.0724740000000026,1.0729944000000007,1.0742114000000011,1.0758677500000027,1.0723258055677458,1.072118310545184,6261,-154103,-159948.6,-0.03675827449659569,-143.9630658627334,-0.013045341881141
2023-05-25T10:45:00-04:00,1.07304,1.07318,1.07253,1.07283,1.0732599999999999,1.0723326666666666,1.0721199999999977,1.072104888888886,1.0724580000000026,1.0729654000000004,1.0741703000000014,1.0758499500000025,1.0724266444541966,1.0721846484361472,-5982,-160085,-158331,-0.03775811628544157,-145.13377711301322,0.09796786653977453
2023-05-25T11:00:00-04:00,1.07283,1.0731,1.07262,1.07279,1.0732599999999999,1.0724666666666667,1.0722266666666644,1.072104888888886,1.0724680000000026,1.0729350000000004,1.0741294000000012,1.0758297000000026,1.0724993155633573,1.072296118748918,-4230,-164315,-158808.4,-0.02674279980182846,-145.2914908234801,0.08956644243955196
2023-05-25T11:15:00-04:00,1.07279,1.07293,1.07215,1.07215,1.07318,1.0724513333333334,1.0722444444444423,1.072122666666664,1.0724285000000024,1.0728950000000004,1.0740867000000012,1.0758024500000025,1.0724294524506859,1.0723656949991345,-3921,-168236,-161420.6,-0.02180582030232585,-147.63066251598275,0.014925512364848363
2023-05-25T11:30:00-04:00,1.07215,1.0723799999999999,1.0718,1.07214,1.0731,1.0724304444444441,1.0722566666666644,1.0721702222222194,1.0724065000000027,1.0728570000000006,1.0740461000000012,1.0757746000000026,1.0723715619605487,1.0724105559993078,-3688,-171924,-163732.6,-0.016855596470867786,-147.6650606878798,0.010260906877611121
2023-05-25T11:45:00-04:00,1.07214,1.07247,1.07192,1.07242,1.0730043999999999,1.0724631111111111,1.0724166666666646,1.072252888888886,1.0724155000000026,1.0728316000000007,1.074007800000001,1.0757458000000026,1.072381249568439,1.0724216447994463,3294,-168630,-166638,-0.012508575500939138,-146.80479990104274,0.1344562923677273
2023-05-25T12:00:00-04:00,1.07242,1.07243,1.0715999999999999,1.0717,1.0729126239999998,1.0723197777777778,1.0724577777777755,1.0723204444444416,1.0723805000000026,1.0727892000000006,1.073967300000001,1.0757090000000025,1.0722449996547512,1.0723853158395573,-2837,-171467,-168914.4,-0.0033969789532732634,-148.70950141723932,0.03453651069233603
2023-05-25T12:15:00-04:00,1.0717,1.07191,1.0715,1.07179,1.0728245190399999,1.0721862222222223,1.072363333333331,1.0723477777777748,1.0723270000000027,1.0727502000000007,1.073924200000001,1.0756737000000025,1.072153999723801,1.072316252671646,2072,-169395,-169930.4,0.0036013392897920405,-148.53549749823227,-0.07924373508353384
2023-05-25T12:30:00-04:00,1.07179,1.07208,1.0714299999999999,1.07148,1.0727399382784,1.0720095555555555,1.0722599999999975,1.072350888888886,1.0722715000000025,1.0727038000000007,1.073881800000001,1.0756405500000026,1.0720191997790407,1.072234202137317,-2562,-171957,-170674.6,-0.001088017507638891,-149.2765195268014,-0.0867205639634186
2023-05-25T12:45:00-04:00,1.07148,1.07153,1.07116,1.0712599999999999,1.072658740747264,1.0718095555555556,1.0720622222222198,1.072311999999997,1.0721705000000026,1.0726522000000005,1.073836200000001,1.0756076000000026,1.0718673598232324,1.0721333617098536,-2016,-173973,-171084.4,-0.005906729630225713,-149.6904516580593,-0.16588384403192005
2023-05-25T13:00:00-04:00,1.0712599999999999,1.0721,1.07114,1.07198,1.0725807911173735,1.071793111111111,1.0719677777777754,1.072222222222219,1.0720875000000025,1.0726190000000004,1.0738042000000012,1.0755793000000025,1.0718898878585859,1.072035089367883,2501,-171472,-171652.8,-0.010019813114399843,-148.00951519072163,-0.07922970088457794
2023-05-25T13:15:00-04:00,1.07198,1.07217,1.0718699999999999,1.07214,1.0725059594726785,1.0718275555555554,1.0718955555555534,1.0721097777777746,1.0720355000000026,1.0725934000000006,1.073773600000001,1.0755531500000024,1.0719399102868687,1.0719740714943065,1853,-169619,-171283.2,-0.009793953865711956,-147.73294286661084,-0.06058967738325464
2023-05-25T13:30:00-04:00,1.07214,1.07259,1.07213,1.07259,1.07071,1.0719664444444443,1.0719444444444421,1.072025999999997,1.0720760000000027,1.0725740000000006,1.0737394000000011,1.0755277500000024,1.072069928229495,1.0719572571954452,1615,-168004,-171005,-0.009039101331094774,-147.05509295894976,0.04103903371729664
2023-05-25T13:45:00-04:00,1.07259,1.07278,1.07246,1.07276,1.0707476,1.0721295555555554,1.072013333333331,1.0719766666666637,1.0721225000000028,1.0725582000000005,1.0737110000000012,1.0755062000000024,1.072207942583596,1.071995005756356,1287,-166717,-169957,-0.00770177860439354,-146.85111007639443,0.057828268696237695
2023-05-25T14:00:00-04:00,1.07276,1.07292,1.07241,1.07244,1.070828896,1.072214888888889,1.072015555555553,1.0719673333333302,1.0721450000000028,1.0725326000000006,1.073679900000001,1.0754876500000023,1.0722543540668767,1.0720724046050851,-2553,-169270,-169016.4,-0.007612739835613032,-147.612659724032,0.001864940974630371
2023-05-25T14:15:00-04:00,1.07244,1.07262,1.07215,1.07252,1.0709543622400002,1.0723157777777779,1.072106666666664,1.071995111111108,1.0721695000000027,1.0725042000000005,1.073642300000001,1.0754690500000026,1.0723074832535013,1.072155923684068,1572,-167698,-168261.6,-0.009033808829566076,-147.49539442247686,0.07651394979936743
2023-05-25T14:30:00-04:00,1.07252,1.07262,1.07191,1.0720399999999999,1.0710723005056002,1.0723024444444442,1.0721344444444418,1.0720428888888858,1.0722225000000027,1.0724846000000006,1.0736026000000012,1.0754456500000025,1.0722539866028011,1.0722187389472546,-1617,-169315,-168200.8,-0.005907060180380332,-148.21907323499323,0.023325464876502063
2023-05-25T14:45:00-04:00,1.0720399999999999,1.07235,1.07191,1.07209,1.0711831624752641,1.0722935555555555,1.0722022222222196,1.0720944444444411,1.0722605000000027,1.0724580000000004,1.073567400000001,1.0754227500000024,1.0722211892822409,1.0722489911578037,2091,-167224,-168044.8,-0.008038535227750597,-148.12154888888654,0.05693060066450138
2023-05-25T15:00:00-04:00,1.07209,1.07237,1.07201,1.07203,1.0712873727267482,1.072259111111111,1.0722877777777753,1.0721493333333298,1.0722300000000027,1.0724214000000005,1.0735266000000012,1.0753968000000023,1.0721829514257928,1.0722439929262433,-1919,-169143,-168530,-0.006017611394502942,-148.22894658870644,0.07187797546815522
2023-05-25T15:15:00-04:00,1.07203,1.0721,1.07173,1.07194,1.0713853303631433,1.0721895555555556,1.0722833333333308,1.0722028888888855,1.0722065000000027,1.0723958000000005,1.073483700000001,1.0753702000000025,1.0721343611406342,1.0722199943409945,-1731,-170874,-168850.8,0.003433031895803892,-148.37426901438505,-0.0037314128994981256
2023-05-25T15:30:00-04:00,1.07194,1.07205,1.07151,1.07173,1.0714774105413547,1.0720788888888888,1.0722377777777752,1.0722291111111075,1.0721410000000027,1.0723922000000004,1.0734352000000011,1.0753404500000026,1.0720534889125073,1.0721691954727957,-1856,-172730,-169857.2,0.004121539217374446,-148.73787145481984,-0.038241274460426945
2023-05-25T15:45:00-04:00,1.07173,1.07208,1.07167,1.07207,1.07151,1.0720453333333333,1.0721799999999975,1.0722382222222187,1.0721030000000027,1.0723852000000003,1.0734053000000012,1.0753118500000025,1.0720567911300058,1.0721297563782366,1948,-170782,-170150.6,0.007777075526594121,-148.1198799830872,-0.048480780167618004
2023-05-25T16:00:00-04:00,1.07207,1.07243,1.07207,1.07225,1.07151,1.0720593333333335,1.0721233333333309,1.072222444444441,1.0720760000000027,1.0723876000000003,1.0733740000000012,1.0752832500000025,1.0720954329040047,1.0721046051025893,1199,-169583,-170622.4,0.007182098851951661,-147.91856850156097,-0.047540922480332086
2023-05-25T16:15:00-04:00,1.07225,1.07232,1.07215,1.0723,1.0715946,1.0720946666666666,1.0721077777777752,1.0721864444444411,1.0720835000000029,1.0723918000000006,1.073342600000001,1.0752561000000025,1.0721363463232036,1.0720952840820714,527,-169056,-170605,0.005067998234122799,-147.89399400867214,-0.013054343366531366
2023-05-25T16:30:00-04:00,1.0723,1.0725,1.07227,1.07244,1.071674124,1.0721611111111111,1.0720988888888863,1.072149555555552,1.0720985000000027,1.0723844000000005,1.0733121000000012,1.0752289500000025,1.072197077058563,1.0721078272656572,536,-168520,-170134.2,0.003779851835281751,-147.82401359274374,-0.007459068362348298
2023-05-25T16:45:00-04:00,1.07244,1.07258,1.0724,1.07251,1.07174887656,1.0722433333333334,1.0721511111111086,1.0721322222222187,1.0721030000000027,1.0723780000000003,1.073287700000001,1.0752034000000024,1.0722596616468503,1.0721490618125258,633,-167887,-169165.6,0.002043129577180223,-147.78269659598865,0.04384164769973066
2023-05-25T17:00:00-04:00,1.07251,1.07256,1.07178,1.0725,1.07292,1.0723131111111113,1.0721966666666642,1.072135555555552,1.0721430000000027,1.0723564000000005,1.073259800000001,1.0751787000000026,1.0723077293174803,1.0721992494500208,-46,-167933,-168595.8,0.005978353563330869,-147.78312549641848,0.03824305795222616
2023-05-25T17:15:00-04:00,1.0725,1.07257,1.07199,1.07246,1.0728972,1.072365777777778,1.072244444444442,1.0721597777777743,1.072176500000003,1.0723600000000004,1.073233700000001,1.0751554000000025,1.0723381834539842,1.0722477995600166,-63,-167996,-168278.4,0.006053655910858226,-147.78547514676814,0.040110817794271655
2023-05-25T17:30:00-04:00,1.07246,1.07251,1.07194,1.07251,1.072874856,1.072418888888889,1.0723077777777754,1.0721997777777743,1.0722280000000028,1.0723586000000005,1.073209200000001,1.0751334000000026,1.0723725467631875,1.0722950396480133,106,-167890,-168045.2,0.007332550484147881,-147.78053323751277,0.053174617982366695
2023-05-25T17:45:00-04:00,1.07251,1.0728,1.07241,1.07279,1.07285295888,1.0725153333333333,1.072425555555553,1.0722651111111077,1.0723045000000029,1.0723494000000005,1.0731877000000012,1.0751136500000027,1.07245603741055,1.0723468317184106,126,-167764,-167894,0.00944160835992117,-147.74763843932908,0.09890550791709095
2023-05-25T18:00:00-04:00,1.07279,1.0728199999999999,1.07244,1.0725,1.0728314997024,1.0725302222222224,1.0724733333333307,1.072329555555552,1.0723305000000027,1.0723326000000004,1.073160500000001,1.0750912500000025,1.07246482992844,1.0723878653747287,-704,-168468,-168010.2,0.011115260769125045,-147.93794595524545,0.040109321219689985
2023-05-25T18:15:00-04:00,1.0725,1.07258,1.0724,1.07248,1.0728199999999999,1.0725315555555555,1.0724988888888862,1.0723899999999964,1.072347500000003,1.0723192000000004,1.073133400000001,1.0750686500000026,1.072467863942752,1.072419892299783,-1583,-170051,-168433.8,0.012718098289190554,-147.96746576876512,0.02145022149686869
2023-05-25T18:30:00-04:00,1.07248,1.07261,1.07245,1.07261,1.0728199999999999,1.0725537777777778,1.0725333333333307,1.0724477777777741,1.0723485000000028,1.0723196000000004,1.073108000000001,1.0750465000000027,1.0724962911542018,1.0724515138398265,993,-169058,-168646.2,0.013987839904663414,-147.84709988781634,0.028909820013059074
2023-05-25T18:45:00-04:00,1.07261,1.0727,1.07254,1.07262,1.0727992,1.072571111111111,1.0725533333333308,1.0724968888888853,1.0723415000000027,1.0723132000000006,1.073084400000001,1.0750252500000026,1.0725210329233614,1.0724812110718616,764,-168294,-168727,0.016838672462653314,-147.83997707523778,0.016784155756951153
2023-05-25T19:00:00-04:00,1.07262,1.07273,1.07244,1.07269,1.072778816,1.0725984444444443,1.0725733333333307,1.0725264444444407,1.072354000000003,1.0723154000000006,1.073062900000001,1.0750040000000027,1.072554826338689,1.0725009688574894,553,-167741,-168722.4,0.019480877034819852,-147.8038878730972,0.01678306029779181
2023-05-25T19:15:00-04:00,1.07269,1.07271,1.07255,1.0726,1.07275883968,1.0726037777777777,1.0725844444444417,1.072548666666663,1.0723580000000026,1.0723226000000006,1.0730434000000009,1.0749822000000027,1.0725638610709511,1.0725207750859913,-279,-168020,-168632.8,0.01960951487778862,-147.82729631355994,0.009324009324008297
2023-05-25T19:30:00-04:00,1.0726,1.0726,1.07236,1.07239,1.0727392628864,1.072564888888889,1.0725766666666638,1.0725642222222183,1.0723755000000028,1.0723224000000005,1.073015200000001,1.0749577000000026,1.072529088856761,1.0725330200687933,-419,-168439,-168310.4,0.019161128885892175,-147.9093306227153,-0.006527049959906616
2023-05-25T19:45:00-04:00,1.07239,1.07245,1.07224,1.07234,1.072720077628672,1.0725175555555555,1.0725577777777753,1.072569111111107,1.0723880000000028,1.0723120000000004,1.0729836000000008,1.0749329500000027,1.0724912710854086,1.0725320160550347,-803,-169242,-168347.2,0.016709702773439337,-147.94677036012416,-0.0158506680590394
2023-05-25T20:00:00-04:00,1.07234,1.07253,1.07218,1.07224,1.0727012760760986,1.072454,1.072496666666664,1.072557777777774,1.0723985000000027,1.0723050000000003,1.072951800000001,1.0749086000000028,1.072441016868327,1.0725160128440276,-1250,-170492,-168786.8,0.013525754884653992,-148.06333786669856,-0.051268188555060025
2023-05-25T20:15:00-04:00,1.07224,1.07244,1.07188,1.0724,1.0726828505545767,1.0724346666666666,1.072485555555553,1.0725402222222182,1.0724215000000028,1.0722874000000002,1.0729221000000009,1.0748847500000027,1.0724328134946615,1.0724916102752222,993,-169499,-169138.4,0.008245868074214966,-147.91516208515716,-0.009324009324008297
2023-05-25T20:30:00-04:00,1.0724,1.07259,1.07218,1.0722099999999999,1.0726647935434852,1.0723795555555555,1.0724555555555528,1.0725144444444406,1.0724455000000028,1.0722588000000004,1.0728886000000009,1.0748596000000026,1.0723882507957292,1.0724564882201777,-1306,-170805,-169695.4,0.004342682978950802,-148.14654962711927,-0.02517529464420917
2023-05-25T20:45:00-04:00,1.0722099999999999,1.07256,1.07191,1.07254,1.0726470976726155,1.0723964444444445,1.0724477777777752,1.0724886666666626,1.0724690000000026,1.0722460000000003,1.072858400000001,1.0748361000000026,1.0724186006365835,1.0724343905761422,2445,-168360,-169679.6,0.001305422164323813,-147.3940384585978,-0.006526137179404862
2023-05-25T21:00:00-04:00,1.07254,1.07278,1.07243,1.07271,1.07178,1.0724488888888888,1.0724577777777755,1.0724686666666627,1.0724920000000027,1.0722646000000002,1.072833400000001,1.0748132500000027,1.0724768805092668,1.0724315124609138,2235,-166125,-169056.2,-0.0006038515962345492,-147.03978593654733,0.008390669575445688
2023-05-25T21:15:00-04:00,1.07271,1.07322,1.07255,1.07275,1.0717999999999999,1.0725073333333333,1.0724644444444422,1.0724622222222187,1.0725145000000027,1.0722830000000003,1.072811500000001,1.0747917000000027,1.0725315044074135,1.072449609968731,2188,-163937,-167745.2,-0.0016117151711569234,-146.95819818216816,0.005593414686458439
2023-05-25T21:30:00-04:00,1.07275,1.07292,1.07253,1.07266,1.0718568,1.0725464444444446,1.072471111111109,1.0724593333333297,1.0725255000000025,1.0722964000000004,1.072790700000001,1.0747703500000028,1.0725572035259308,1.072474487974985,-1487,-165424,-166930.2,-0.0034897737639547387,-147.08295231873328,0.005593884020133226
2023-05-25T21:45:00-04:00,1.07266,1.0732599999999999,1.07262,1.07322,1.0719113279999999,1.0726962222222223,1.0725633333333309,1.0724808888888853,1.0725610000000025,1.0723202000000003,1.0727725000000008,1.0747518500000028,1.0726897628207446,1.0725347903799882,1684,-163740,-165517.2,-0.0011720971613861876,-146.2037921002109,0.07739721556524291
2023-05-25T22:00:00-04:00,1.07322,1.07373,1.07322,1.07342,1.07199224832,1.0728675555555556,1.0726833333333312,1.0725279999999966,1.0726070000000028,1.0723690000000003,1.0727591000000007,1.0747343000000027,1.0728358102565956,1.0726182323039906,1966,-161774,-164200,0.004390747199642964,-145.8374180110214,0.10071432568028515
2023-05-25T22:15:00-04:00,1.07342,1.07365,1.07332,1.07359,1.0721312684544,1.073048888888889,1.0728333333333309,1.0726031111111078,1.0726635000000027,1.0724142000000003,1.0727509000000008,1.0747152000000029,1.0729866482052766,1.0727201858431925,1110,-160664,-163107.8,0.011204964278732474,-145.661624752092,0.1259046482130831
2023-05-25T22:30:00-04:00,1.07359,1.07373,1.07337,1.0735,1.072259166978048,1.0731822222222223,1.072955555555553,1.07270133333333,1.0727130000000025,1.0724314000000004,1.0727445000000007,1.0746962000000027,1.0730893185642212,1.0728317486745542,-1598,-162262,-162772.8,0.018333742476252576,-145.7955865065795,0.10257366654232365
2023-05-25T22:45:00-04:00,1.0735,1.07362,1.07322,1.07341,1.072376833619804,1.0732731111111111,1.0730888888888863,1.0728248888888854,1.0727440000000026,1.0724514000000003,1.0727349000000006,1.0746769500000029,1.073153454851377,1.0729509989396433,-1445,-163707,-162429.4,0.023753011296877076,-145.91673229139542,0.11191837419909254
2023-05-25T23:00:00-04:00,1.07341,1.07368,1.07339,1.07357,1.0724850869302198,1.0733693333333332,1.0732033333333308,1.0729528888888855,1.0727975000000025,1.0724620000000005,1.0727282000000007,1.074658850000003,1.0732367638811016,1.073060399151715,1326,-162381,-162157.6,0.03296720369142838,-145.71908181301353,0.09603371436029093
2023-05-25T23:15:00-04:00,1.07357,1.0738699999999999,1.07352,1.07381,1.0725846799758023,1.0734906666666666,1.073325555555553,1.0730813333333298,1.0728640000000025,1.0724816000000004,1.0727235000000008,1.0746428000000028,1.0733514111048812,1.073163519321372,1188,-161193,-162041.4,0.03898843130162398,-145.4535006212887,0.10254402401393468
2023-05-25T23:30:00-04:00,1.07381,1.07382,1.07353,1.07361,1.0727132119782221,1.0735475555555554,1.0734211111111085,1.0731988888888853,1.0729140000000024,1.0724980000000004,1.0727165000000007,1.074624800000003,1.073403128883905,1.0732468154570978,-2183,-163376,-162583.8,0.04235962272250114,-145.8600902414263,0.0801677930552189
2023-05-25T23:45:00-04:00,1.07361,1.07377,1.07342,1.07374,1.0728288907804,1.0736113333333333,1.0735411111111084,1.0733159999999966,1.0729700000000024,1.0725298000000005,1.0727124000000008,1.0746066500000029,1.0734705031071239,1.0733230523656783,2017,-161359,-162403.2,0.04656928229258255,-145.61585816460143,0.10068428020061995
2023-05-26T00:00:00-04:00,1.07374,1.07398,1.07367,1.07389,1.07293300170236,1.073681111111111,1.0736155555555529,1.0734213333333298,1.0730300000000024,1.0725648000000003,1.0727109000000008,1.0745896500000027,1.073554402485699,1.0734032418925428,1137,-160222,-161706.2,0.05239359188127801,-145.45702082967853,0.06242895212537489
2023-05-26T00:15:00-04:00,1.07389,1.07396,1.07381,1.07384,1.0730586414980767,1.073726,1.0736622222222196,1.0735131111111076,1.0730920000000024,1.0725932000000005,1.0727124000000006,1.074570800000003,1.0736115219885594,1.0734781935140343,-881,-161103,-161450.6,0.05306544116481009,-145.49803992846898,0.03912727543737446
2023-05-26T00:30:00-04:00,1.07384,1.07402,1.07375,1.07401,1.0731692045183074,1.0737955555555554,1.0737088888888864,1.0735897777777743,1.0731730000000024,1.0726394000000006,1.0727143000000006,1.0745528500000028,1.0736912175908475,1.0735461548112277,794,-160309,-161273.8,0.05230333002762341,-145.37234150039777,0.039121079741788294
2023-05-26T00:45:00-04:00,1.07401,1.07407,1.07396,1.07397,1.0732883158857445,1.0738477777777777,1.0737611111111083,1.0736577777777743,1.0732545000000022,1.0726830000000005,1.0727166000000006,1.0745353500000028,1.073746974072678,1.073614923848982,-1862,-162171,-161032.8,0.04882987989325659,-145.44168908561548,0.04378202142526246
2023-05-26T01:00:00-04:00,1.07397,1.0740399999999999,1.0737,1.07371,1.0734133853440253,1.0738375555555555,1.0737944444444418,1.0737084444444411,1.0733280000000023,1.0727276000000003,1.0727157000000007,1.074514150000003,1.0737395792581423,1.073668739079186,-1936,-164107,-161582.4,0.04470513070805082,-145.91038001739224,0.02794831425084236
2023-05-26T01:15:00-04:00,1.07371,1.07427,1.07363,1.07399,1.0735184436889813,1.0738766666666666,1.0738411111111086,1.0737535555555522,1.0734075000000023,1.0727822000000002,1.0727172000000007,1.074495050000003,1.0737896634065138,1.0737157912633488,2069,-162038,-161945.6,0.042341469041446374,-145.37083023206836,0.03912180854532886
2023-05-26T01:30:00-04:00,1.07399,1.07413,1.07375,1.07409,1.07363,1.0739264444444443,1.0738722222222197,1.0737955555555523,1.073501500000002,1.0728244000000005,1.0727217000000007,1.074476800000003,1.073849730725211,1.0737634330106793,1688,-160350,-161795,0.039685497093584085,-145.2136593086892,0.02607537646325309
2023-05-26T01:45:00-04:00,1.07409,1.07418,1.07364,1.07372,1.07427,1.073896,1.0738844444444418,1.0738306666666635,1.0735605000000021,1.0728560000000005,1.0727247000000006,1.0744560000000027,1.0738237845801688,1.0737899464085434,-1727,-162077,-162148.6,0.032146382035055154,-145.80857221170473,0.010245806205237889
2023-05-26T02:00:00-04:00,1.07372,1.07382,1.07323,1.07344,1.0742574,1.0738071111111112,1.0738511111111084,1.0738486666666636,1.0735970000000021,1.0728730000000004,1.0727235000000006,1.074435050000003,1.073747027664135,1.0737899571268348,-2578,-164655,-162645.4,0.02656949653257826,-146.4808517631708,-0.027939724700576207
2023-05-26T02:15:00-04:00,1.07344,1.07378,1.07297,1.07335,1.0742163040000001,1.073706888888889,1.0737911111111085,1.0738479999999968,1.073627000000002,1.0728848000000004,1.0727215000000008,1.074411800000003,1.073667622131308,1.073775565701468,-3019,-167674,-163358.8,0.020097324097540885,-146.7339725710406,-0.050284479788431306
2023-05-26T02:30:00-04:00,1.07335,1.07368,1.07323,1.07366,1.0741415257600002,1.0736806666666667,1.0737711111111083,1.0738339999999968,1.0736770000000022,1.0729092000000005,1.0727209000000006,1.074389650000003,1.0736660977050463,1.0737508525611745,2390,-165284,-164008,0.013918088192364777,-146.04370378639433,-0.016762273709290672
2023-05-26T02:45:00-04:00,1.07366,1.07367,1.07286,1.07294,1.0740712342144,1.0735144444444444,1.0736522222222196,1.0737899999999967,1.073663000000002,1.0729176000000005,1.0727109000000008,1.074364350000003,1.073520878164037,1.0736850820489399,-2624,-167908,-165519.6,0.004293353108917165,-147.80336699448642,-0.09962663289912613
2023-05-26T03:00:00-04:00,1.07294,1.07373,1.07252,1.07337,1.0739743354772482,1.073458,1.073585555555553,1.0737302222222191,1.0736605000000021,1.0729442000000005,1.0727144000000006,1.074339950000003,1.0734907025312297,1.073618465639152,3721,-164187,-165941.6,-0.0023329428831283063,-146.31210932863397,-0.05586748233192323
2023-05-26T03:15:00-04:00,1.07337,1.07436,1.07329,1.07366,1.07252,1.073472888888889,1.0735799999999973,1.0736759999999967,1.073664000000002,1.0729756000000004,1.0727168000000007,1.074318400000003,1.0735245620249838,1.0735739725113216,3721,-160466,-165103.8,-0.006284686078234279,-145.3067803181339,-0.004656750891756943
2023-05-26T03:30:00-04:00,1.07366,1.07402,1.07308,1.07313,1.07252,1.073382888888889,1.0734844444444418,1.0736146666666635,1.0736455000000018,1.0729976000000003,1.0727095000000006,1.074293300000003,1.0734456496199871,1.0735295780090575,-3839,-164305,-164430,-0.00964676859848176,-147.20185883461076,-0.08007523347517974
2023-05-26T03:45:00-04:00,1.07313,1.07445,1.07302,1.0740399999999999,1.0725567999999999,1.073494,1.0734788888888864,1.0735562222222192,1.073677000000002,1.0730396000000004,1.0727177000000006,1.074271750000003,1.0735645196959898,1.0735092624072462,4460,-159845,-163342.2,-0.011575845069796448,-143.4198380170026,-0.0046551033898561125
2023-05-26T04:00:00-04:00,1.0740399999999999,1.07411,1.07344,1.07348,1.072632528,1.0734942222222223,1.0734522222222198,1.0735162222222192,1.073672500000002,1.0730746000000004,1.0727334000000006,1.074246600000003,1.0735476157567918,1.0735146099257973,-3519,-163364,-162433.4,-0.017567731788798654,-145.2546300173002,-0.02235219610326882
2023-05-26T04:15:00-04:00,1.07348,1.0735999999999999,1.073,1.07309,1.07270522688,1.0734217777777777,1.0734133333333309,1.073481777777775,1.0736365000000019,1.0730950000000004,1.0727401000000005,1.074218700000003,1.0734560926054335,1.073507687940638,-2973,-166337,-162863.4,-0.021307038685164332,-146.33473397824935,-0.03260545535845976
2023-05-26T04:30:00-04:00,1.07309,1.07342,1.07287,1.07341,1.0727750178048,1.0734211111111112,1.0734199999999976,1.073449777777775,1.0736265000000018,1.0731182000000006,1.0727529000000007,1.074194100000003,1.0734468740843468,1.0734921503525103,2800,-163537,-163477.6,-0.019812704081347145,-145.49976207468146,0.005589975310937623
2023-05-26T04:45:00-04:00,1.07341,1.07361,1.07306,1.07317,1.0728420170926078,1.073371111111111,1.0733655555555532,1.0734259999999973,1.0735980000000018,1.0731356000000005,1.0727637000000005,1.074171150000003,1.0733914992674773,1.0734813202820086,-2675,-166212,-163859,-0.019538093738345825,-146.0978559996496,-0.04563828400053103
2023-05-26T05:00:00-04:00,1.07317,1.07323,1.07255,1.07269,1.07445,1.073236,1.0733377777777755,1.073397777777775,1.0735380000000019,1.0731406000000006,1.0727625000000005,1.074144450000003,1.073251199413982,1.073418656225607,-2764,-168976,-165685.2,-0.02391698252121443,-147.33411866073786,-0.023300464145253556
2023-05-26T05:15:00-04:00,1.07269,1.07367,1.07269,1.07366,1.074412,1.0733004444444445,1.0733699999999977,1.0733813333333306,1.073529000000002,1.0731636000000004,1.0727708000000005,1.074125150000003,1.0733329595311856,1.0733757249804856,2893,-166083,-166229,-0.01619025905287111,-144.71806928953052,0.027017710575116084
2023-05-26T05:30:00-04:00,1.07366,1.07367,1.07315,1.07336,1.07437476,1.0732984444444444,1.0733366666666644,1.0733659999999974,1.0734965000000019,1.0731808000000005,1.0727686000000005,1.074099850000003,1.0733383676249484,1.0733521799843886,-2408,-168491,-166659.8,-0.014154579900258826,-145.39090799079528,-0.027941806530928502
2023-05-26T05:45:00-04:00,1.07336,1.07352,1.07309,1.07351,1.0743382648,1.073333111111111,1.0733788888888867,1.0733577777777752,1.0734735000000017,1.0732018000000005,1.0727809000000006,1.0740754500000032,1.0733726940999586,1.0733373439875111,2183,-166308,-167214,-0.013334255996292168,-145.08583793042436,0.035410434896056116
2023-05-26T06:00:00-04:00,1.07351,1.07351,1.07269,1.07269,1.074302499504,1.0731953333333333,1.0732288888888866,1.0733304444444418,1.0734225000000017,1.0732054000000004,1.0727820000000008,1.074044700000003,1.073236155279967,1.0733062751900089,-2585,-168893,-167750.2,-0.01175575011430462,-147.06038870312338,-0.1256936426948682
2023-05-26T06:15:00-04:00,1.07269,1.0733,1.07263,1.07328,1.07426744951392,1.0732055555555555,1.0732066666666644,1.0733042222222198,1.0733870000000019,1.0732152000000006,1.0727823000000005,1.0740195500000032,1.0732449242239737,1.0733050201520073,2148,-166745,-167304,-0.01692860308400688,-145.87894765305282,-0.01863099452248556
2023-05-26T06:30:00-04:00,1.07328,1.07426,1.07323,1.07417,1.07255,1.0733982222222223,1.0733266666666645,1.073295555555553,1.073391000000002,1.0732486000000006,1.0727906000000005,1.0740018000000031,1.0734299393791789,1.073324416121606,2468,-164277,-166942.8,-0.011298953815245979,-143.83239875621308,0.10064393480509275
2023-05-26T06:45:00-04:00,1.07417,1.07467,1.07416,1.07441,1.0725841999999999,1.0736148888888888,1.0734377777777757,1.073315777777775,1.0734255000000021,1.0732872000000007,1.0728032000000005,1.073985100000003,1.073625951503343,1.073381932897285,2913,-161364,-165517.4,-0.0004214312424871483,-143.18155205597006,0.09316104750282855
2023-05-26T07:00:00-04:00,1.07441,1.07475,1.07407,1.0747,1.072667632,1.0738673333333333,1.0736077777777755,1.0733615555555531,1.073488500000002,1.0733290000000006,1.0728243000000006,1.0739697500000032,1.0738407612026744,1.073475546317828,2357,-159007,-164057.2,0.007248302260529398,-142.545361030198,0.14256827902382954
2023-05-26T07:15:00-04:00,1.0747,1.07483,1.0743,1.07444,1.07279257408,1.0740337777777778,1.07380222222222,1.0734762222222198,1.0735430000000021,1.0733654000000008,1.0728393000000005,1.0739518500000031,1.0739606089621394,1.0736204370542626,-2251,-161258,-162530.2,0.014642340538990203,-143.08994091295583,0.1631412616879192
2023-05-26T07:30:00-04:00,1.07444,1.07586,1.07439,1.07523,1.0729555681536,1.0743193333333334,1.0739766666666644,1.0736302222222196,1.073621500000002,1.0734162000000007,1.0728658000000006,1.0739396500000031,1.0742144871697115,1.0738143496434103,2670,-158588,-160898.8,0.029960849087471878,-141.12677870752827,0.14622878751186122
2023-05-26T07:45:00-04:00,1.07523,1.07527,1.07468,1.0752599999999999,1.07324601133824,1.074576,1.0741877777777755,1.0738024444444418,1.073737500000002,1.0734694000000007,1.0728960000000007,1.0739291500000032,1.0744235897357692,1.0740130797147285,2579,-156009,-159245.2,0.03776440069928133,-141.05482200989155,0.17701423567114394
2023-05-26T08:00:00-04:00,1.0752599999999999,1.07542,1.07497,1.07523,1.073507410204416,1.0747844444444443,1.0743788888888866,1.073990666666664,1.073830500000002,1.0735262000000008,1.0729243000000006,1.0739269500000033,1.0745848717886153,1.074204863771783,-3016,-159025,-158777.4,0.04501999558326934,-141.13896909989762,0.1602220752484787
2023-05-26T08:15:00-04:00,1.07523,1.07572,1.07492,1.0755,1.0737426691839744,1.0750086666666667,1.0746911111111086,1.0742073333333306,1.073922500000002,1.0735894000000006,1.0729507000000007,1.073928300000003,1.0747678974308923,1.0743902910174266,2972,-156053,-158186.6,0.0541013678987321,-140.39267295860694,0.2619582544817216
2023-05-26T08:30:00-04:00,1.0755,1.07569,1.07302,1.07305,1.07586,1.0746804444444444,1.0746655555555533,1.0743799999999974,1.073918500000002,1.0736056000000007,1.0729553000000005,1.0739168500000031,1.074424317944714,1.0744830328139414,-11666,-167719,-159478.8,0.060160078043703706,-166.96794027613194,-0.02142963625521322
2023-05-26T08:45:00-04:00,1.07305,1.07424,1.0729,1.07418,1.0758032,1.0745833333333334,1.0746666666666644,1.0745179999999974,1.0739255000000019,1.0736412000000006,1.0729643000000006,1.073912000000003,1.074375454355771,1.0745152262511533,6956,-160763,-159913.8,0.06388191135827807,-159.64276437566227,0.0009309513391589289
2023-05-26T09:00:00-04:00,1.07418,1.07505,1.07375,1.07377,1.07569,1.074404,1.074595555555553,1.074599555555553,1.073940000000002,1.0736724000000004,1.0729656000000005,1.0738993500000031,1.074254363484617,1.074481381000923,-6882,-167645,-162241,0.061355215525984996,-162.26953083938358,-0.059567576623467386
2023-05-26T09:15:00-04:00,1.07377,1.07394,1.07248,1.07315,1.0755784,1.074114888888889,1.074423333333331,1.0746084444444417,1.0739430000000019,1.0736846000000007,1.0729653000000006,1.073880700000003,1.0740334907876936,1.0743711048007385,-4631,-172276,-164891.2,0.051086491412185166,-164.94349267478526,-0.14422629571042528
2023-05-26T09:30:00-04:00,1.07315,1.07349,1.07252,1.07311,1.0753924959999999,1.0738522222222222,1.0742755555555532,1.0745253333333307,1.0739280000000018,1.0736926000000004,1.0729786000000006,1.073858300000003,1.073848792630155,1.074187283840591,-6590,-178866,-169453.8,0.03619196017035795,-165.18912469267676,-0.12378541379695965
2023-05-26T09:45:00-04:00,1.07311,1.07316,1.07203,1.07227,1.0752177462399999,1.0734511111111111,1.0739466666666644,1.074381555555553,1.0738830000000017,1.0736830000000004,1.0729830000000005,1.0738293500000031,1.073533034104124,1.074009027072473,-5203,-184069,-172723.8,0.021041354132108416,-169.26188517389465,-0.27528993796674683
2023-05-26T10:00:00-04:00,1.07227,1.07407,1.07226,1.07341,1.0749627265408,1.073343777777778,1.0737411111111088,1.0741964444444416,1.0739190000000018,1.0736980000000005,1.0729972000000005,1.073803400000003,1.0735084272832993,1.0738356216579785,8676,-175393,-175649.8,0.0030286811225698888,-160.0378651043233,-0.17205141082156014
2023-05-26T10:15:00-04:00,1.07341,1.07394,1.07283,1.07302,1.074728108417536,1.0731995555555556,1.0734955555555534,1.0739764444444417,1.0738870000000018,1.0736940000000004,1.0730071000000008,1.073772950000003,1.0734107418266394,1.073666897326383,-4862,-180255,-178171.8,-0.019293702386420985,-161.80436625486172,-0.20553741990084198
2023-05-26T10:30:00-04:00,1.07302,1.07321,1.07124,1.07128,1.074512259744133,1.0727564444444444,1.0730266666666646,1.0736971111111084,1.073783000000002,1.0736512000000005,1.0730101000000005,1.073734850000003,1.0729845934613116,1.0734571178611065,-5397,-185652,-180847,-0.04552747746894595,-170.55609502040235,-0.39237563923755375
2023-05-26T10:45:00-04:00,1.07128,1.07196,1.07019,1.07053,1.0741850337697196,1.0722571111111112,1.0727466666666645,1.073391333333331,1.0736340000000018,1.0735900000000005,1.0730021000000007,1.0736928500000031,1.0724936747690492,1.0731860942888853,-9948,-195600,-184193.8,-0.07927281726963586,-177.52066077352038,-0.2348446018358956
2023-05-26T11:00:00-04:00,1.07053,1.07096,1.07027,1.07047,1.0737056297173533,1.071801777777778,1.0723344444444423,1.0730688888888864,1.073523000000002,1.0735294000000004,1.0729804000000007,1.0736498500000031,1.0720889398152393,1.0728972754311086,-6566,-202166,-187813.2,-0.08983216631203814,-177.88866540673914,-0.3453797315161221
2023-05-26T11:15:00-04:00,1.07047,1.07072,1.07015,1.07029,1.073283754151271,1.071392888888889,1.0719477777777755,1.0727102222222198,1.073373500000002,1.0734670000000006,1.0729592000000008,1.073608400000003,1.0717291518521914,1.072541420344887,-4845,-207011,-194136.8,-0.11543537814833686,-178.70335428171958,-0.32409175149239855
2023-05-26T11:30:00-04:00,1.07029,1.07076,1.07025,1.07046,1.072845028570093,1.0710953333333335,1.0716488888888867,1.0723408888888866,1.073188000000002,1.0734048000000005,1.0729334000000008,1.073572400000003,1.0714753214817532,1.0721543362759098,3474,-203537,-198793.2,-0.1337789229089559,-178.151559908232,-0.2506639332805368
2023-05-26T11:45:00-04:00,1.07046,1.07138,1.07046,1.07121,1.07246772457028,1.0710075555555554,1.0714377777777755,1.0720231111111087,1.073028000000002,1.0733528000000006,1.072917200000001,1.0735437500000031,1.0714222571854026,1.0718418690207279,3257,-200280,-201718.8,-0.1387399228841705,-175.86959701377532,-0.17705547427570453
2023-05-26T12:00:00-04:00,1.07121,1.07191,1.07119,1.0718699999999999,1.0721432431304407,1.071094,1.0713933333333312,1.071752444444442,1.0728865000000019,1.0733180000000004,1.0729080000000009,1.0735187000000033,1.0715118057483222,1.0716454952165824,3151,-197129,-202024.6,-0.1390395975932226,-173.92818496571786,-0.03730403722944575
2023-05-26T12:15:00-04:00,1.0718699999999999,1.072,1.07151,1.07175,1.07015,1.0711653333333333,1.0712088888888867,1.0715273333333308,1.072752000000002,1.0732782000000005,1.072904000000001,1.0734953500000033,1.0715594445986578,1.0715395961732663,-2281,-199410,-201473.4,-0.13081083096448737,-174.18355175460061,-0.1546473388546776
2023-05-26T12:30:00-04:00,1.07175,1.07194,1.0714,1.07146,1.070187,1.0712155555555556,1.0710355555555533,1.0713448888888866,1.072563500000002,1.0732296000000006,1.0728972000000008,1.0734716500000032,1.0715395556789262,1.0715016769386132,-1579,-200989,-200269,-0.13577786162954134,-174.61080624492004,-0.14538405621516892
2023-05-26T12:45:00-04:00,1.07146,1.07218,1.07146,1.07196,1.07022326,1.0714004444444447,1.071111111111109,1.0712373333333312,1.072398500000002,1.0731920000000006,1.072892600000001,1.0734502000000032,1.071623644543141,1.0715313415508907,1920,-199069,-199375.4,-0.1311623599278519,-173.71483252681588,0.0634754685983136
2023-05-26T13:00:00-04:00,1.07196,1.07254,1.0718699999999999,1.07246,1.0703015295999998,1.0716702222222223,1.0713255555555532,1.0712148888888866,1.0722600000000022,1.0731610000000005,1.072900200000001,1.0734337500000033,1.071790915634513,1.0716050732407127,2341,-196728,-198665,-0.10774217010943807,-172.62290745498495,0.18028453196080327
2023-05-26T13:15:00-04:00,1.07246,1.0727,1.07213,1.07216,1.0704358378239998,1.0718371111111111,1.071513333333331,1.0712388888888864,1.0720930000000022,1.0731248000000004,1.072903900000001,1.0734140500000031,1.0718647325076103,1.0716756585925704,-2218,-198946,-199028.4,-0.07892133003148076,-173.2433501754593,0.15787457845618927
2023-05-26T13:30:00-04:00,1.07216,1.07267,1.07213,1.07256,1.0706169707980797,1.0720464444444444,1.0717655555555534,1.0713502222222198,1.072068500000002,1.0731018000000005,1.072914700000001,1.073398250000003,1.0720037860060883,1.0717645268740565,1586,-197360,-198618.4,-0.046379164997247986,-172.6516474445237,0.212092049818273
2023-05-26T13:45:00-04:00,1.07256,1.07275,1.07233,1.07266,1.0707836131342334,1.0722253333333334,1.072009999999998,1.0715451111111087,1.0719925000000021,1.0730752000000003,1.072928700000001,1.073382450000003,1.0721350288048705,1.0718836214992453,1618,-195742,-197569,-0.022541499678099756,-172.5007934130476,0.2055191226201801
2023-05-26T14:00:00-04:00,1.07266,1.07297,1.07251,1.07296,1.07098025182081,1.0724153333333333,1.0722044444444423,1.0717637777777755,1.0719520000000022,1.0730526000000005,1.072938500000001,1.073371350000003,1.0723000230438964,1.0720188971993967,1788,-193954,-196546,0.006196472141954411,-172.0007281547179,0.16336666013199264
2023-05-26T14:15:00-04:00,1.07296,1.073,1.07277,1.07289,1.0712190216023127,1.0725524444444443,1.0723177777777757,1.07196222222222,1.0719390000000022,1.0730360000000005,1.0729460000000008,1.0733598000000029,1.072418018435117,1.0721443177595174,-1236,-195190,-196238.4,0.025777443337923863,-172.08136489793296,0.09516079375297573
2023-05-26T14:30:00-04:00,1.07289,1.07327,1.07289,1.07297,1.071468358577989,1.0726828888888889,1.072453333333331,1.0721502222222201,1.0719320000000023,1.0730266000000004,1.0729498000000008,1.0733446000000029,1.0725284147480936,1.072277054207614,1189,-194001,-195249.4,0.03683853987372257,-171.99270716042017,0.11383251691159309
2023-05-26T14:45:00-04:00,1.07297,1.07315,1.07287,1.07292,1.0717566212055107,1.0727762222222221,1.0726155555555534,1.0723202222222201,1.0719645000000022,1.0730180000000005,1.0729514000000009,1.073331200000003,1.0726067317984749,1.0723976433660916,-1496,-195497,-194876.8,0.04859725403312354,-172.06242019992717,0.13626266962835912
2023-05-26T15:00:00-04:00,1.07292,1.07312,1.07292,1.07301,1.071998761812629,1.072855111111111,1.0727322222222202,1.0724646666666646,1.071944500000002,1.0730050000000004,1.0729571000000009,1.073318500000003,1.07268738543878,1.0725081146928734,1094,-194403,-194609,0.0597673271945744,-171.9706519413432,0.09795141609761515
2023-05-26T15:15:00-04:00,1.07301,1.07311,1.07275,1.07276,1.0722021599226084,1.0728606666666667,1.0727655555555533,1.0725768888888867,1.0719315000000023,1.0730014000000003,1.0729595000000007,1.0733009000000029,1.0727019083510239,1.0725884917542987,-815,-195218,-194861.8,0.070119249366567,-172.16053833569185,0.02797307125673377
2023-05-26T15:30:00-04:00,1.07276,1.07288,1.0726499999999999,1.0728,1.072373014334991,1.0728675555555556,1.0728366666666647,1.0726806666666646,1.0720075000000022,1.0729900000000003,1.0729671000000007,1.073284850000003,1.072721526680819,1.0726491934034392,998,-194220,-194667.8,0.07426893804625813,-172.12332591166407,0.0596925831965354
2023-05-26T15:45:00-04:00,1.0728,1.07297,1.07266,1.07295,1.0725165320413925,1.0728902222222223,1.072879999999998,1.0727659999999979,1.072128500000002,1.0729758000000005,1.0729757000000009,1.073271550000003,1.0727672213446553,1.0726969547227516,1736,-192484,-194364.4,0.07421456840694186,-171.8805966051762,0.03636160214814206
2023-05-26T16:00:00-04:00,1.07295,1.07302,1.07276,1.07278,1.0726370869147697,1.0728702222222222,1.0728933333333313,1.0728215555555536,1.0722440000000022,1.0729688000000004,1.0729832000000006,1.073254900000003,1.0727697770757243,1.0727295637782015,-650,-193134,-193891.8,0.06626590303958163,-171.9835836968394,0.011187142244524828
2023-05-26T16:15:00-04:00,1.07278,1.07295,1.07277,1.07285,1.07266,1.0728615555555554,1.0728811111111092,1.0728513333333312,1.072372000000002,1.0729450000000005,1.0729923000000006,1.073238000000003,1.0727858216605795,1.0727492510225614,453,-192681,-193547.4,0.057461387093728625,-171.95402498023392,-0.010252013122561182
2023-05-26T16:30:00-04:00,1.07285,1.07286,1.07256,1.07262,1.07327,1.0728093333333333,1.072851111111109,1.0728684444444423,1.0724800000000023,1.0729278000000004,1.0730012000000009,1.073218200000003,1.0727526573284636,1.0727594008180494,-673,-193354,-193174.6,0.04393860407131911,-172.09830423642083,-0.025165674020635152
2023-05-26T16:45:00-04:00,1.07262,1.07284,1.07212,1.07224,1.0732557999999999,1.0726871111111111,1.0727699999999978,1.0728551111111089,1.0725315000000024,1.0729108000000003,1.0730029000000008,1.073204100000003,1.072650125862771,1.0727451206544398,-1204,-194558,-193242.2,0.029970908238528566,-172.52484858577083,-0.06803545299494836
2023-05-28T17:00:00-04:00,1.07172,1.07241,1.07157,1.07232,1.0732103679999998,1.0725971111111112,1.0727033333333311,1.0728197777777755,1.0725540000000022,1.0728890000000004,1.0730036000000007,1.0731888000000032,1.0725841006902168,1.072708496523552,135,-194423,-193630,0.018980639747590778,-172.5147762139138,-0.05592215635836371
2023-05-28T17:15:00-04:00,1.07232,1.07242,1.0722,1.0724,1.0731119459199998,1.0725364444444443,1.0726355555555533,1.07276822222222,1.072586500000002,1.0728736000000003,1.0730046000000006,1.0731736000000032,1.0725472805521734,1.0726639972188419,46,-194377,-193878.6,0.011778819258929374,-172.5113444025142,-0.056849423584123114
2023-05-28T17:30:00-04:00,1.0724,1.07254,1.0724,1.0724,1.0730194291647999,1.0724893333333334,1.0725955555555535,1.072711111111109,1.0726335000000022,1.0728678000000003,1.0730042000000006,1.073158150000003,1.0725178244417388,1.0726103977750738,0,-194377,-194217.8,0.003205451220649345,-172.5113444025142,-0.03355829822140236
2023-05-28T17:45:00-04:00,1.0724,1.07244,1.07217,1.07217,1.0729324634149118,1.072404222222222,1.0725255555555535,1.0726459999999978,1.0726440000000022,1.0728380000000002,1.0730008000000006,1.0731442500000028,1.072448259553391,1.0725495182200593,-100,-194477,-194442.4,-0.005447319492499524,-172.53279162370032,-0.058724832214756564
2023-05-28T18:00:00-04:00,1.07217,1.0729,1.07213,1.07275,1.07157,1.0724491111111112,1.0725033333333314,1.0725926666666645,1.0726585000000022,1.0728258000000002,1.0730033000000005,1.073131550000003,1.0725086076427128,1.0725212145760477,1236,-193241,-194179,-0.009420380251202114,-171.8641663124157,-0.01864019758609236
2023-05-28T18:15:00-04:00,1.07275,1.0728,1.07234,1.07241,1.0715966,1.0724304444444446,1.0724622222222202,1.0725444444444423,1.072671000000002,1.0728038000000002,1.0730028000000007,1.073118250000003,1.0724888861141704,1.0725021716608385,-1161,-194402,-194174.8,-0.014232707881359007,-172.23213648253923,-0.03448983016088866
2023-05-28T18:30:00-04:00,1.07241,1.07241,1.07192,1.07194,1.0716226679999998,1.0723260000000001,1.072361111111109,1.0724895555555534,1.072640000000002,1.0727888,1.0729971000000007,1.073103150000003,1.0723791088913364,1.072468537328671,-538,-194940,-194287.4,-0.021087343332051,-172.46792316860157,-0.08482080439951423
2023-05-28T18:45:00-04:00,1.07194,1.072,1.07179,1.07193,1.07164821464,1.072239777777778,1.0722844444444426,1.0724273333333312,1.072603500000002,1.0727618000000003,1.0729885000000006,1.073088100000003,1.0722892871130691,1.072422829862937,-419,-195359,-194483.8,-0.026868246589329226,-172.47183196946722,-0.0643284667449663
2023-05-28T19:00:00-04:00,1.07193,1.0723,1.07184,1.0722099999999999,1.0716732503472,1.0722248888888888,1.072281111111109,1.0723784444444422,1.072566000000002,1.0727226000000003,1.0729856000000004,1.0730730500000027,1.0722734296904552,1.07238786389035,585,-194774,-194543.2,-0.028693480990176455,-172.31902348383858,-0.002797881071420254
2023-05-28T19:15:00-04:00,1.0722099999999999,1.0723799999999999,1.07216,1.07228,1.071697785340256,1.0722246666666666,1.0722766666666648,1.0723331111111087,1.072535500000002,1.0726800000000003,1.0729836000000004,1.0730585000000028,1.072274743752364,1.0723410911122802,300,-194474,-194789.8,-0.025302349535508997,-172.29943776835373,-0.0037302297821583115
2023-05-28T19:30:00-04:00,1.07228,1.07231,1.07215,1.07227,1.071721829633451,1.0722233333333333,1.0722622222222205,1.072293111111109,1.072500500000002,1.0726314000000003,1.0729802000000006,1.0730441000000028,1.0722737950018912,1.0722980728898244,-308,-194782,-194865.8,-0.023016492488897408,-172.30231015243245,-0.01212234240954527
2023-05-28T19:45:00-04:00,1.07227,1.07239,1.07215,1.07216,1.0717453930407819,1.0722028888888888,1.0722355555555536,1.072267999999998,1.0724625000000019,1.0725858000000004,1.0729756000000004,1.073030000000003,1.072251036001513,1.07227245831186,-514,-195296,-194937,-0.02165865900123474,-172.35503940905627,-0.022379709063783847
2023-05-28T20:00:00-04:00,1.07216,1.07216,1.0717,1.0719,1.0729,1.0721357777777778,1.0722055555555536,1.0722522222222204,1.072407000000002,1.0725192000000003,1.0729677000000004,1.073015300000003,1.0721808288012105,1.072250766649488,-913,-196209,-195107,-0.021792848056035888,-172.57644293091863,-0.02518257365902725
2023-05-28T20:15:00-04:00,1.0719,1.072,1.0718,1.07192,1.072876,1.0720786666666666,1.0721133333333315,1.0722186666666649,1.072365000000002,1.0724524000000004,1.0729609000000007,1.0730021500000029,1.0721286630409683,1.0722218133195907,817,-195392,-195230.6,-0.01928502854779346,-172.56119897159414,-0.07737124213471064
2023-05-28T20:30:00-04:00,1.07192,1.07211,1.0718699999999999,1.07202,1.0728524799999999,1.07206,1.072069999999998,1.0721773333333313,1.0723260000000019,1.0723882000000005,1.0729572000000005,1.0729862000000028,1.0721069304327746,1.0721882506556726,603,-194789,-195293.6,-0.02280708298464525,-172.50494477351967,-0.03636668811369835
2023-05-28T20:45:00-04:00,1.07202,1.07216,1.07171,1.07198,1.0728294304,1.072042,1.0720744444444428,1.072139777777776,1.072277500000002,1.0723178000000007,1.0729536000000006,1.0729686000000027,1.0720815443462197,1.0721498005245382,-1438,-196227,-195582.6,-0.023176499322672888,-172.55860048889818,0.003731552139115996
2023-05-28T21:00:00-04:00,1.07198,1.07259,1.07183,1.07252,1.0728068417919998,1.0721311111111111,1.0721399999999983,1.072120666666665,1.0722645000000022,1.0723072000000005,1.0729564000000007,1.072954100000003,1.0721692354769758,1.072133440419631,1246,-194981,-195519.6,-0.015858375073800234,-171.93093952507425,0.055040907521934114
2023-05-28T21:15:00-04:00,1.07252,1.0731,1.0723799999999999,1.07305,1.0717,1.0723131111111108,1.0722333333333318,1.0721262222222205,1.072274500000002,1.0722846000000006,1.0729629000000005,1.0729425000000028,1.0723453883815808,1.072166352335705,1514,-193467,-194971.2,-0.006612387946786096,-171.1827763206583,0.07834286193937512
2023-05-28T21:30:00-04:00,1.07305,1.07321,1.07279,1.0728199999999999,1.071728,1.0724304444444444,1.0722933333333318,1.0721622222222207,1.072284500000002,1.0722656000000006,1.0729690000000007,1.0729288000000028,1.0724403107052647,1.072228681868564,-1459,-194926,-194878,-0.0007904678458178677,-171.49550172953977,0.05035998060208015
2023-05-28T21:45:00-04:00,1.0728199999999999,1.07318,1.07274,1.07315,1.0717872800000001,1.0726017777777779,1.0723911111111093,1.072226444444443,1.072330000000002,1.0722656000000006,1.0729751000000005,1.0729167500000028,1.0725822485642118,1.0723237454948515,1243,-193683,-194656.8,0.004969172479674133,-171.1131542714385,0.08206888190474339
2023-05-28T22:00:00-04:00,1.07315,1.07348,1.07311,1.07332,1.0718441888,1.0727875555555557,1.0725199999999981,1.0723155555555541,1.072380000000002,1.0722698000000004,1.0729812000000005,1.072907300000003,1.0727297988513695,1.0724533963958816,1340,-192343,-193880,0.009964511419320721,-170.90088198890578,0.10819280704372947
2023-05-28T22:15:00-04:00,1.07332,1.07341,1.07324,1.07338,1.071942337472,1.0729595555555556,1.0726844444444426,1.0724244444444428,1.072429000000002,1.0722920000000002,1.0729875000000006,1.0728995000000028,1.0728598390810957,1.0725915171167055,781,-191562,-193196.2,0.016633379186980324,-170.85722306146573,0.1380725813975115
2023-05-28T22:30:00-04:00,1.07338,1.07355,1.07325,1.07331,1.07203459722368,1.0730846666666667,1.0728388888888871,1.0725455555555539,1.0724745000000022,1.0722900000000004,1.0729940000000007,1.0728923500000027,1.0729498712648766,1.072712413693365,-942,-192504,-193003.6,0.02573940286548589,-170.91865517311305,0.1296738562579299
2023-05-28T22:45:00-04:00,1.07331,1.07331,1.07304,1.07312,1.0721558294457856,1.073140888888889,1.0729611111111095,1.0726791111111094,1.072522000000002,1.0722920000000002,1.0729930000000008,1.0728827500000029,1.0729838970119012,1.0728211309546922,-811,-193315,-192681.4,0.03373054899061897,-171.06222040589756,0.10261002593236142
2023-05-28T23:00:00-04:00,1.07312,1.07336,1.07308,1.07329,1.0722673630901227,1.0732066666666666,1.073106666666665,1.0728222222222206,1.072549000000002,1.0723322000000004,1.0729917000000009,1.0728754000000027,1.073045117609521,1.072913704763754,807,-192508,-192446.4,0.040597183503897676,-170.9343782260854,0.12220377245845486
2023-05-28T23:15:00-04:00,1.07329,1.07334,1.07309,1.07311,1.072369974042913,1.0732073333333334,1.0731722222222206,1.0729526666666651,1.072584000000002,1.0723838000000003,1.0729869000000007,1.0728689000000027,1.0730580940876169,1.0729793638110035,-650,-193158,-192609.4,0.04953363265741721,-171.04338883831514,0.0550106291724248
2023-05-28T23:30:00-04:00,1.07311,1.0732,1.07293,1.07296,1.0724643761194799,1.073164888888889,1.0731622222222208,1.0730482222222206,1.072635000000002,1.0724336000000003,1.0729815000000007,1.0728630000000028,1.0730384752700934,1.073015091048803,-639,-193797,-193056.4,0.05119282705530341,-171.1327086657327,-0.008387307208438145
2023-05-28T23:45:00-04:00,1.07296,1.07319,1.07291,1.07303,1.0725512260299215,1.0731384444444445,1.073185555555554,1.073117555555554,1.072690000000002,1.0724884000000003,1.0729777000000007,1.0728563000000026,1.0730367802160747,1.0730324728390428,556,-193241,-193203.8,0.04616498555218415,-171.09643517930263,0.019574579146552404
2023-05-29T00:00:00-04:00,1.07303,1.07324,1.07297,1.07317,1.0726311279475278,1.0731353333333333,1.0731877777777763,1.0731628888888873,1.072738000000002,1.0725426000000002,1.0729737000000008,1.0728509500000027,1.0730634241728598,1.0730483782712343,581,-192660,-193072.8,0.04392068706989309,-171.02063114772847,0.0018636723663895056
2023-05-29T00:15:00-04:00,1.07317,1.07324,1.07309,1.07314,1.0727046377117255,1.0731257777777776,1.0731677777777762,1.0731751111111096,1.072781000000002,1.0725812000000003,1.0729670000000007,1.0728452500000027,1.073078739338288,1.0730551026169877,-453,-193113,-193193.8,0.0396974418389005,-171.0332945654535,-0.01677039466329417
2023-05-29T00:30:00-04:00,1.07314,1.07336,1.07303,1.07335,1.0727722666947874,1.0731622222222221,1.0731644444444428,1.073173555555554,1.0728350000000018,1.0726108000000003,1.0729644000000007,1.0728404500000028,1.0731329914706302,1.0730700820935903,619,-192494,-193061,0.03522575599339044,-170.91216405126147,-0.0027949095380922404
2023-05-29T00:45:00-04:00,1.07335,1.07361,1.07328,1.0735999999999999,1.0728344853592044,1.0732493333333333,1.0731966666666652,1.0731804444444428,1.0729070000000018,1.0726478000000004,1.0729630000000008,1.0728377000000027,1.0732263931765043,1.0731076656748726,787,-191707,-192643,0.03137108693636589,-170.72885944419025,0.0270192209147312
2023-05-29T01:00:00-04:00,1.0735999999999999,1.07374,1.07346,1.07366,1.072912036823284,1.0733419999999998,1.0732566666666652,1.0731946666666652,1.072995000000002,1.0726918000000003,1.0729607000000008,1.072835800000003,1.0733131145412034,1.0731629325398984,815,-190892,-192173.2,0.027973797033619293,-170.6833117541752,0.05032056060831826
2023-05-29T01:15:00-04:00,1.07366,1.07372,1.07352,1.07368,1.07301139240449,1.0734266666666668,1.0732999999999986,1.0732171111111095,1.0730830000000018,1.0727262000000004,1.0729591000000007,1.0728357500000028,1.0733864916329627,1.073227546031919,652,-190240,-191689.2,0.02529114326275068,-170.67116638226983,0.03633687074321855
2023-05-29T01:30:00-04:00,1.07368,1.07384,1.07348,1.07366,1.0730988253159512,1.0734986666666666,1.0733611111111094,1.0732557777777763,1.0731650000000017,1.0727502000000002,1.072955600000001,1.072834950000003,1.0734411933063701,1.0733000368255354,-1003,-191243,-191315.2,0.021015898598400896,-170.68984978887133,0.05125290044823461
2023-05-29T01:45:00-04:00,1.07366,1.07385,1.07339,1.07363,1.0732025897717181,1.0735524444444444,1.0734355555555541,1.0733099999999984,1.073247500000002,1.0727796000000003,1.0729522000000007,1.0728344000000027,1.073478954645096,1.0733692294604285,-1129,-192372,-191290.8,0.018715947558175388,-170.72139608844472,0.0624440799284382
2023-05-29T02:00:00-04:00,1.07363,1.07412,1.07362,1.07391,1.0733061754082431,1.0736473333333332,1.073533333333332,1.0733773333333319,1.0733170000000019,1.0728066000000005,1.0729542000000007,1.072834950000003,1.0735651637160768,1.073436983568343,1695,-190677,-191084.8,0.01900273571964653,-170.2793443574017,0.08201075459213554
2023-05-29T02:15:00-04:00,1.07391,1.07433,1.07384,1.07425,1.07339,1.0737906666666666,1.0736533333333318,1.073456666666665,1.0733770000000018,1.0728384000000002,1.0729568000000007,1.0728370000000027,1.0737021309728614,1.0735147868546746,1246,-189431,-190792.6,0.022692396250592866,-169.88486064833856,0.1006364322521101
2023-05-29T02:30:00-04:00,1.07425,1.07434,1.07389,1.07395,1.0735780000000001,1.07385,1.073743333333332,1.0735453333333316,1.073433500000002,1.0728582000000002,1.0729554000000008,1.0728385500000028,1.0737517047782892,1.07358782948374,-1261,-190692,-190883,0.025965453038041163,-170.23701331298827,0.07547943418379498
2023-05-29T02:45:00-04:00,1.07395,1.07412,1.07357,1.07364,1.07434,1.0738293333333333,1.0737755555555542,1.0736282222222207,1.0734580000000018,1.0728732000000003,1.0729546000000008,1.0728396500000028,1.0737293638226313,1.0736454635869923,-1286,-191978,-191030,0.02698481211563908,-170.60822240093466,0.02701821400287897
2023-05-29T03:00:00-04:00,1.07364,1.07366,1.07309,1.07349,1.07434,1.0737722222222221,1.0737633333333318,1.0736937777777762,1.0734665000000019,1.0728836000000002,1.0729551000000008,1.0728393000000027,1.073681491058105,1.073685970869594,-2148,-194126,-191380.8,0.02678034747476962,-170.90832299331174,-0.010245901639328658
2023-05-29T03:15:00-04:00,1.07349,1.0738699999999999,1.07312,1.07351,1.07429,1.0737215555555555,1.0737466666666653,1.0737364444444428,1.073473000000002,1.0728954000000004,1.0729567000000007,1.0728391000000028,1.073647192846484,1.0737023766956753,1528,-192598,-191765,0.02509887840227823,-170.87985509887412,-0.013970903265474592
2023-05-29T03:30:00-04:00,1.07351,1.07356,1.07281,1.07302,1.074242,1.0735762222222223,1.073673333333332,1.073740444444443,1.0734585000000019,1.0728956000000003,1.072950300000001,1.0728356000000028,1.073521754277187,1.0736663013565404,-1929,-194527,-192784.2,0.020734187188034107,-171.76034060902285,-0.06147082929735889
2023-05-29T03:45:00-04:00,1.07302,1.07307,1.07245,1.07281,1.0741560799999998,1.0734035555555554,1.0735788888888873,1.073707555555554,1.073443000000002,1.0728966000000002,1.0729490000000008,1.072829950000003,1.0733794034217496,1.0735918410852325,-1534,-196061,-193858,0.014847852761952808,-172.06055868510722,-0.0791684518376411
2023-05-29T04:00:00-04:00,1.07281,1.07292,1.07151,1.0722,1.0740195935999999,1.073127777777778,1.0734199999999983,1.073636444444443,1.0733885000000019,1.0728846000000005,1.0729373000000009,1.0728258500000027,1.0731435227373998,1.0734746728681863,-2353,-198414,-195145.2,0.005328054670144093,-173.3984749983407,-0.1331929994504664
2023-05-29T04:15:00-04:00,1.0722,1.07275,1.07215,1.0727,1.07376863424,1.0729837777777778,1.073285555555554,1.0735408888888873,1.0733680000000017,1.0728796000000005,1.0729277000000008,1.0728222500000029,1.0730548181899198,1.0733493382945491,1266,-197148,-195749.6,-0.0007187072850330334,-172.8081000682904,-0.11267238409177058
2023-05-29T04:30:00-04:00,1.0727,1.07286,1.07255,1.07269,1.073542770816,1.0728646666666666,1.0731122222222205,1.0734139999999983,1.073354500000002,1.0728778000000003,1.0729233000000007,1.072816400000003,1.0729818545519358,1.0732162706356396,-1206,-198354,-196900.8,-0.010221805186621129,-172.81934272700212,-0.1452175936700029
2023-05-29T04:45:00-04:00,1.07269,1.0728199999999999,1.07228,1.07241,1.0733394937343999,1.0727242222222222,1.0729411111111096,1.0732675555555538,1.0733235000000019,1.0728690000000003,1.072907000000001,1.0728123500000029,1.0728674836415486,1.073085416508512,-1396,-199750,-197945.4,-0.024925131435796038,-173.183735049108,-0.14339587504072582
2023-05-29T05:00:00-04:00,1.07241,1.07241,1.07152,1.07159,1.0731565443609599,1.072454,1.0727133333333319,1.0730944444444428,1.0732445000000017,1.0728484000000005,1.0728881000000008,1.0728107500000028,1.072611986913239,1.0729319332068097,-1266,-201016,-198936.4,-0.040527001880249505,-174.1517603379435,-0.19093923475279287
2023-05-29T05:15:00-04:00,1.07159,1.07191,1.07134,1.07153,1.0729918899248638,1.0722173333333334,1.0724955555555542,1.0729095555555541,1.0731640000000018,1.0728342000000004,1.0728725000000008,1.0728063000000028,1.0723955895305912,1.072782346565448,-1705,-202721,-199797.8,-0.0529143493064627,-174.2472259544572,-0.1825820454778304
2023-05-29T05:30:00-04:00,1.07153,1.0719,1.07152,1.07161,1.0727936631338801,1.0720402222222223,1.0722844444444428,1.0727093333333317,1.0730770000000018,1.0728200000000003,1.0728545000000007,1.0728037000000028,1.072238471624473,1.072619077252359,1373,-201348,-200637.8,-0.06364796988122468,-174.14471832517964,-0.17698950172797764
2023-05-29T05:45:00-04:00,1.07161,1.07188,1.07132,1.07161,1.0726192235578145,1.0719053333333333,1.072127777777776,1.072512444444443,1.0729775000000017,1.0728042000000002,1.072838900000001,1.0728013000000027,1.0721127772995784,1.0724452618018874,0,-201348,-201236.6,-0.07363817309149938,-174.14471832517964,-0.1314048200406454
2023-05-29T06:00:00-04:00,1.07161,1.0718,1.07146,1.07147,1.0724373322597205,1.0717737777777778,1.0719788888888873,1.0723199999999984,1.072868000000002,1.0727856000000002,1.0728267000000007,1.0727946000000028,1.0719842218396627,1.0722686094415101,-1167,-202515,-201789.6,-0.07863825073151254,-174.29718050825,-0.12490562168511841
2023-05-29T06:15:00-04:00,1.07147,1.07161,1.07141,1.07144,1.0722809057433595,1.071666,1.071894444444443,1.0721562222222205,1.0727560000000016,1.0727710000000001,1.0728045000000008,1.0727876500000029,1.0718753774717302,1.0721212875532085,-1099,-203614,-202309.2,-0.08156226696480272,-174.32795131844532,-0.07088229807872541
2023-05-29T06:30:00-04:00,1.07144,1.07179,1.0712,1.07122,1.0721463789392893,1.071531111111111,1.0717299999999985,1.0720031111111095,1.0726340000000016,1.0727404,1.0727831000000005,1.0727758500000026,1.0717443019773842,1.0719910300425668,-1245,-204859,-202736.8,-0.07978659649092085,-174.5835885916476,-0.13796960939684216
2023-05-29T06:45:00-04:00,1.07122,1.07153,1.0712,1.07151,1.071994958309003,1.071487111111111,1.0715988888888874,1.0718659999999984,1.0725280000000015,1.0727224000000002,1.0727631000000006,1.0727720000000027,1.0716974415819074,1.0718828240340539,1076,-203783,-203223.8,-0.0813436576408137,-174.29229455307487,-0.11000382216669857
2023-05-29T07:00:00-04:00,1.07151,1.07183,1.07144,1.07183,1.0718677649795625,1.0715333333333334,1.071534444444443,1.0717473333333316,1.0724240000000014,1.0727202,1.0727545000000007,1.0727682500000026,1.0717239532655258,1.0718050592272435,1180,-202603,-203474.8,-0.08137679882094173,-173.9398946687993,-0.05408379257933299
2023-05-29T07:15:00-04:00,1.07183,1.0719,1.07163,1.07183,1.0712,1.0715924444444445,1.0715611111111096,1.0716637777777762,1.0723030000000013,1.0727182,1.0727400000000007,1.0727611500000027,1.0717451626124206,1.071757247381795,0,-202603,-203492.4,-0.07755665885578242,-173.9398946687993,0.022396625575081697
2023-05-29T07:30:00-04:00,1.07183,1.07189,1.07165,1.07181,1.0712139999999999,1.0716422222222222,1.0715922222222207,1.0716033333333317,1.0721960000000015,1.0727102,1.0727164000000007,1.0727535000000028,1.0717581300899364,1.0717337979054362,-1239,-203842,-203538,-0.06467752056463316,-173.96301400675415,0.02613085961194142
2023-05-29T07:45:00-04:00,1.07181,1.0718699999999999,1.07103,1.07105,1.0719,1.0715337777777778,1.0715299999999983,1.0715633333333314,1.0720665000000014,1.0726856,1.0726828000000006,1.0727430000000029,1.0716165040719492,1.0717082383243492,-1197,-205039,-203574,-0.056282553341023146,-174.8117838446917,-0.05225781767619693
2023-05-29T08:00:00-04:00,1.07105,1.07147,1.07101,1.0713,1.07189,1.0714877777777778,1.071495555555554,1.0715426666666648,1.0719570000000016,1.0726662,1.0726488000000005,1.0727365500000028,1.0715532032575594,1.0716793906594797,1126,-203913,-203600,-0.04878594815427499,-174.54895764610166,-0.028928434785046097
2023-05-29T08:15:00-04:00,1.0713,1.07137,1.07112,1.07124,1.0718699999999999,1.0714366666666666,1.0714699999999986,1.071529777777776,1.0718435000000013,1.0726478,1.0726168000000005,1.0727280500000027,1.0714905626060476,1.0716327125275842,-1189,-205102,-204099.8,-0.042247176635669285,-174.61554963714053,-0.021465836654311597
2023-05-29T08:30:00-04:00,1.07124,1.07135,1.071,1.07111,1.0718355999999998,1.0713646666666667,1.071433333333332,1.0715042222222202,1.0717480000000015,1.072632,1.0725756000000006,1.0727207000000027,1.0714144500848382,1.0715665700220676,-1154,-206256,-204830.4,-0.034947605249194824,-174.7555929514305,-0.030799671470165522
2023-05-29T08:45:00-04:00,1.07111,1.07151,1.0709899999999999,1.07148,1.0717854639999997,1.0713739999999998,1.0714622222222205,1.0714782222222201,1.0716815000000015,1.0726232,1.0725378000000005,1.0727169000000027,1.0714275600678704,1.0715004560176546,1177,-205079,-205077.8,-0.02773428405363035,-174.349014728839,0.024271391497538035
2023-05-29T09:00:00-04:00,1.07148,1.07157,1.07127,1.07147,1.0717218268799997,1.0713755555555555,1.071457777777776,1.0714637777777756,1.0716450000000015,1.0726122,1.0725002000000006,1.0727122500000028,1.0714360480542964,1.071464364814124,-1371,-206450,-205360,-0.019448924910186235,-174.36181011466056,-0.0037330496215658283
2023-05-29T09:15:00-04:00,1.07147,1.07147,1.07086,1.07124,1.0716632807295998,1.071332,1.0713922222222207,1.071443111111109,1.0715720000000015,1.0725974,1.0724576000000006,1.0727041500000027,1.0713968384434371,1.0714330918512993,-1561,-208011,-206179.6,-0.017703409239206703,-174.69689182483435,-0.05504604274932502
2023-05-29T09:30:00-04:00,1.07124,1.07128,1.07083,1.07086,1.0715829526566398,1.0712255555555554,1.071284444444443,1.0714059999999979,1.0714805000000016,1.0725642,1.0724357000000004,1.0726955000000027,1.0712894707547498,1.0713928734810398,-1194,-209205,-207000.2,-0.018580322900181606,-175.12043836902617,-0.09049942621499094
2023-05-29T09:45:00-04:00,1.07086,1.07116,1.0708,1.07095,1.071492598337843,1.0711586666666666,1.0711888888888874,1.071357111111109,1.0714075000000016,1.0725221999999999,1.0724034000000007,1.0726838500000029,1.0712215766037998,1.0713542987848323,1177,-208028,-207354.6,-0.019061747796371896,-175.0215178752173,-0.08023810190237644
2023-05-29T10:00:00-04:00,1.07095,1.0711,1.07083,1.07086,1.0713956345705449,1.0710928888888889,1.0711677777777764,1.0712982222222203,1.0713710000000014,1.0724829999999999,1.0723743000000006,1.072669950000003,1.0711492612830398,1.0712986390278663,-771,-208799,-208098.6,-0.021040925800603023,-175.08631081606433,-0.01773960132581434
2023-05-29T10:15:00-04:00,1.07086,1.07098,1.0706,1.07083,1.0713122457306685,1.0710253333333333,1.071115555555554,1.0712297777777757,1.0713360000000016,1.0724365999999999,1.0723511000000006,1.072658200000003,1.071085409026432,1.0712285112222932,-915,-209714,-208751.4,-0.01971708910679084,-175.1119444189629,-0.04387193129841972
2023-05-29T10:30:00-04:00,1.07083,1.07089,1.07059,1.0706,1.0711982864137615,1.0709222222222223,1.071044444444443,1.07116022222222,1.0712855000000014,1.0723821999999998,1.0723260000000006,1.0726523000000028,1.0709883272211456,1.071146808977835,-764,-210478,-209244.8,-0.022118190077591967,-175.27604142782516,-0.05974384825062301
2023-05-29T10:45:00-04:00,1.0706,1.07098,1.0706,1.07086,1.0710887948592844,1.0708853333333332,1.071016666666665,1.0711066666666647,1.0712480000000015,1.0723318,1.0723119000000005,1.0726474500000027,1.0709626617769163,1.0710814471822683,1368,-209110,-209225.8,-0.02233229332279021,-174.94381650722,-0.02334027317456503
2023-05-29T11:00:00-04:00,1.07086,1.07114,1.07083,1.07102,1.07059,1.070886,1.0709655555555537,1.0710619999999982,1.0712255000000015,1.0722859999999996,1.0722880000000006,1.0726426000000027,1.0709741294215331,1.0710319577458152,1138,-207972,-209214.6,-0.020550338326951748,-174.7737849438035,-0.042931272632238116
2023-05-29T11:15:00-04:00,1.07102,1.07109,1.07081,1.0708199999999999,1.0706,1.070856888888889,1.0708933333333315,1.071007111111109,1.0711945000000016,1.0722399999999999,1.0722660000000006,1.0726365500000028,1.0709433035372264,1.0709907661966525,-638,-208610,-209176.8,-0.02382272231599931,-174.8929237087193,-0.06066432097959248
2023-05-29T11:30:00-04:00,1.0708199999999999,1.0712599999999999,1.0708199999999999,1.0712599999999999,1.0706108,1.0709302222222223,1.0708955555555537,1.0709631111111089,1.0711965000000017,1.0721993999999997,1.0722658000000005,1.0726379500000027,1.071006642829781,1.0709750129573223,592,-208018,-208837.6,-0.024983163037212618,-174.64967087444276,0.0018669952578235485
2023-05-29T11:45:00-04:00,1.0712599999999999,1.07152,1.07124,1.07138,1.0706367680000002,1.071027111111111,1.0709533333333314,1.0709448888888864,1.0711900000000016,1.0721647999999997,1.0722743000000006,1.0726382000000028,1.071081314263825,1.0709936103658582,508,-207510,-208244,-0.024387305620463928,-174.59276592139676,0.04855910203015109
2023-05-29T12:00:00-04:00,1.07138,1.07141,1.0712,1.07133,1.0706897619200002,1.0711024444444444,1.070995555555554,1.070940666666664,1.0711650000000017,1.0721321999999995,1.0722829000000005,1.0726316500000028,1.07113105141106,1.071027288292687,-422,-207932,-208008.4,-0.019199711226250016,-174.61246014753505,0.03548251552358419
2023-05-29T12:15:00-04:00,1.07133,1.07136,1.07111,1.07123,1.0707395762048002,1.0711493333333333,1.071036666666665,1.0709548888888862,1.0711350000000017,1.0720961999999996,1.0722923000000004,1.072625750000003,1.071150841128848,1.07106263063415,-568,-208500,-208114,-0.013918939404246341,-174.6654783585438,0.034551668752216116
2023-05-29T12:30:00-04:00,1.07123,1.07135,1.0712,1.07131,1.0707864016325122,1.071204,1.0710899999999983,1.0709942222222195,1.0711100000000018,1.0720589999999997,1.0723008000000005,1.0726171000000029,1.0711826729030784,1.0711105045073201,324,-208176,-208027.2,-0.007406416196897499,-174.64128187412865,0.04482504225694424
2023-05-29T12:45:00-04:00,1.07131,1.07136,1.0712599999999999,1.0712599999999999,1.0708304175345613,1.071238,1.0711633333333317,1.0710477777777754,1.0711205000000017,1.0720213999999997,1.0723013000000003,1.0726092500000028,1.0711981383224627,1.0711488036058565,-579,-208755,-208174.6,-0.0009469419110109415,-174.668304864673,0.06164767420137147
2023-05-29T13:00:00-04:00,1.0712599999999999,1.0715,1.0712599999999999,1.07136,1.0708717924824875,1.0712773333333332,1.0712188888888872,1.0711008888888864,1.071123500000002,1.0719815999999995,1.0722962000000005,1.0726021000000028,1.0712305106579703,1.0711786428846857,227,-208528,-208378.2,0.004770209707076279,-174.64711486411287,0.04669144425976944
2023-05-29T13:15:00-04:00,1.07136,1.07138,1.07123,1.07124,1.0709106849335384,1.0712815555555555,1.0712433333333318,1.071150444444442,1.0711235000000017,1.0719343999999995,1.0722911000000004,1.072597550000003,1.0712324085263762,1.071198914307749,-184,-208712,-208534.2,0.008584622101168572,-174.6677241831093,0.02054116636476321
2023-05-29T13:30:00-04:00,1.07124,1.07132,1.07121,1.07131,1.070947243837526,1.071294888888889,1.0712977777777763,1.071202666666664,1.0711335000000017,1.0718873999999996,1.0722896000000004,1.072593400000003,1.071247926821101,1.0712183314461996,185,-208527,-208539.6,0.010980813362755547,-174.65563538881483,0.0457593246297325
2023-05-29T13:45:00-04:00,1.07131,1.07132,1.07113,1.07117,1.0709816092072746,1.0712693333333332,1.0712877777777763,1.0712422222222198,1.0711180000000016,1.0718371999999996,1.0722817000000004,1.072587150000003,1.0712323414568807,1.07122826515696,-238,-208765,-208657.4,0.01398160563082127,-174.68673749744818,-0.00840132180795731
2023-05-29T14:00:00-04:00,1.07117,1.07119,1.07111,1.07115,1.0710139126548381,1.0712417777777776,1.0712622222222208,1.0712619999999977,1.0711020000000018,1.0717869999999996,1.0722686000000003,1.0725844000000029,1.0712158731655046,1.0712318121255684,-153,-208918,-208690,0.01442193770572833,-174.68959418686254,-0.02146763986633617
2023-05-29T14:15:00-04:00,1.07115,1.07118,1.0711,1.07112,1.0710442778955478,1.0712133333333334,1.0712388888888875,1.0712659999999978,1.0710960000000018,1.0717367999999996,1.0722582000000005,1.0725810500000028,1.0711966985324037,1.071225049700455,-140,-209058,-208796,0.013550786105786621,-174.6935152063276,-0.019601803365892997
2023-05-29T14:30:00-04:00,1.07112,1.07117,1.07107,1.07107,1.07152,1.0711795555555557,1.0712211111111098,1.0712615555555534,1.0711065000000015,1.0716799999999997,1.0722433000000005,1.0725790000000028,1.071171358825923,1.0712128397603644,-177,-209235,-208900.6,0.011879256604078686,-174.70177758589293,-0.01493610149080384
2023-05-29T14:45:00-04:00,1.07107,1.07112,1.07103,1.07105,1.071511,1.0711453333333332,1.0711922222222208,1.0712404444444423,1.0711115000000018,1.0716159999999995,1.0722272000000004,1.072577950000003,1.0711470870607385,1.0711926718082918,-290,-209525,-209100.2,0.009353946396331247,-174.70719273149496,-0.024269352475000415
2023-05-29T15:00:00-04:00,1.07105,1.07108,1.07101,1.07104,1.07149176,1.0711148888888888,1.0711677777777764,1.0712164444444423,1.0711205000000017,1.0715577999999994,1.0722080000000005,1.072573250000003,1.0711256696485907,1.0711713374466338,-269,-209794,-209306,0.006433035303586632,-174.7097042855774,-0.020536564419458114
2023-05-29T15:15:00-04:00,1.07104,1.07105,1.07094,1.07097,1.0714628544,1.0710753333333334,1.0711244444444428,1.0711888888888867,1.0711275000000016,1.0715043999999994,1.0721888000000004,1.0725674000000032,1.0710945357188726,1.0711470699573076,-239,-210033,-209529,0.003236507808216522,-174.7253246172177,-0.03640232974911444
2023-05-29T15:30:00-04:00,1.07097,1.07108,1.07097,1.07106,1.071421026048,1.0710624444444443,1.071104444444443,1.071161999999998,1.0711505000000017,1.0714557999999996,1.0721697000000006,1.0725597500000028,1.071087628575098,1.0711252559658464,208,-209825,-209682.4,-0.0005868333271885854,-174.70784513599975,-0.016802957320494846
2023-05-29T15:45:00-04:00,1.07106,1.07107,1.07091,1.07091,1.07138254396416,1.0710235555555556,1.0710599999999983,1.0711297777777757,1.0711530000000018,1.0714037999999995,1.0721496000000004,1.0725505000000028,1.0710521028600786,1.0711014047726775,-338,-210163,-209868,-0.005045807933771106,-174.7551814196813,-0.037337465346160864
2023-05-29T16:00:00-04:00,1.07091,1.071,1.07079,1.07087,1.071335289567744,1.0709855555555556,1.0710266666666652,1.0710966666666646,1.0711455000000016,1.0713607999999994,1.0721282000000005,1.072542650000003,1.0710156822880628,1.0710751238181424,-435,-210598,-210082.6,-0.009198036981396554,-174.77142928364748,-0.028006758964493682
2023-05-29T16:15:00-04:00,1.07087,1.07095,1.07054,1.07057,1.0712698548196147,1.0708942222222222,1.0709622222222206,1.0710555555555534,1.0711330000000017,1.0713159999999995,1.0721063000000006,1.072532900000003,1.0709265458304502,1.0710352990545142,-325,-210923,-210308.4,-0.012799264497834181,-174.86247674972645,-0.05414741166036736
2023-05-29T16:30:00-04:00,1.07057,1.07101,1.07057,1.0709,1.0711676751448687,1.070881777777778,1.0709377777777762,1.0710182222222202,1.0711150000000016,1.0712899999999994,1.0720873000000006,1.072527200000003,1.0709212366643601,1.071000639243612,218,-210705,-210442.8,-0.015488877705310888,-174.79527890185105,-0.020539248636950946
2023-05-29T16:45:00-04:00,1.0709,1.07097,1.07058,1.0706499999999999,1.071079800624587,1.0708242222222222,1.0708911111111095,1.0709755555555536,1.0710785000000018,1.0712489999999995,1.0720643000000005,1.072520000000003,1.0708669893314882,1.0709565113948898,-239,-210944,-210666.6,-0.017165378485137776,-174.85107309365236,-0.03921312332528098
2023-05-29T17:00:00-04:00,1.0706499999999999,1.07115,1.07059,1.07101,1.07054,1.070848,1.070886666666665,1.0709408888888867,1.0710625000000018,1.0712153999999996,1.0720466000000006,1.072514900000003,1.0708955914651905,1.0709252091159123,110,-210834,-210800.8,-0.016080858665260572,-174.81408621652164,-0.0037346529106988473
2023-05-29T17:15:00-04:00,1.07101,1.07131,1.07094,1.07105,1.0705522,1.0708806666666666,1.0708877777777763,1.070913111111109,1.0710535000000019,1.0711881999999995,1.0720286000000003,1.072510450000003,1.0709264731721524,1.0709073672927303,145,-210689,-210819,-0.014836188384351513,-174.8086707675529,0.0009336719450315125
2023-05-29T17:30:00-04:00,1.07105,1.07106,1.07094,1.07095,1.070582512,1.070893111111111,1.0708855555555539,1.0708977777777755,1.0710355000000018,1.0711753999999996,1.0720119000000006,1.0725065500000028,1.070931178537722,1.0709082938341845,-81,-210770,-210788.4,-0.014431785139663318,-174.81623343969707,-0.0018674659420813823
2023-05-29T17:45:00-04:00,1.07095,1.07096,1.07093,1.07094,1.0706116115200002,1.070904,1.0708722222222207,1.0708846666666645,1.0710195000000018,1.0711635999999995,1.0719989000000005,1.072500900000003,1.0709329428301777,1.070910635067348,-94,-210864,-210820.2,-0.013067071557547596,-174.8171111650811,-0.011203854125809756
2023-05-29T18:00:00-04:00,1.07094,1.07122,1.07069,1.07102,1.0706395470592,1.0709335555555557,1.0708844444444428,1.070883333333331,1.0710025000000019,1.0711517999999995,1.0719859000000005,1.072494750000003,1.070950354264142,1.0709273080538788,409,-210455,-210722.4,-0.012373612859181937,-174.7865585664294,0.010271638139531285
2023-05-29T18:15:00-04:00,1.07102,1.07111,1.0708,1.07084,1.070666365176832,1.0709246666666665,1.0708811111111094,1.0708822222222198,1.0709825000000017,1.0711363999999994,1.0719703000000005,1.0724874500000032,1.0709282834113136,1.0709338464431035,-461,-210916,-210738.8,-0.010715449677499734,-174.86403611119982,-0.0028014604947355416
2023-05-29T18:30:00-04:00,1.07084,1.07104,1.07084,1.07098,1.07069,1.0709444444444445,1.070926666666665,1.0708899999999977,1.0709660000000019,1.0711265999999995,1.0719561000000004,1.0724801500000032,1.0709386267290508,1.0709362771544833,318,-210598,-210720.6,-0.008532442176935296,-174.82246127275522,0.03829735561430093
2023-05-29T18:45:00-04:00,1.07098,1.07114,1.07097,1.0709899999999999,1.0707148,1.0709571111111111,1.0709366666666649,1.0709002222222197,1.070957000000002,1.0711175999999996,1.0719443000000004,1.0724725500000032,1.0709489013832407,1.0709398217235868,242,-210356,-210637.8,-0.003188039648931736,-174.82020166006407,0.008404146045375243
2023-05-29T19:00:00-04:00,1.0709899999999999,1.0709899999999999,1.07081,1.07083,1.0707386079999999,1.0709357777777777,1.070956666666665,1.0709171111111089,1.070941000000002,1.0711097999999994,1.0719251000000005,1.072464200000003,1.0709251211065927,1.0709382573788697,-295,-210651,-210595.2,-0.002329927518673099,-174.8642730332795,0.016812216877604168
2023-05-29T19:15:00-04:00,1.07083,1.07088,1.07076,1.07087,1.07131,1.0709184444444444,1.0709411111111096,1.070928444444442,1.070928500000002,1.0710969999999995,1.0719097000000004,1.072456250000003,1.0709140968852742,1.070931005903096,395,-210256,-210555.4,0.0009693330589697109,-174.84951812353657,-0.013071773372800346
2023-05-29T19:30:00-04:00,1.07087,1.07087,1.0706,1.07077,1.071299,1.0708842222222223,1.0709099999999983,1.0709342222222198,1.0709135000000019,1.0710757999999998,1.0718980000000005,1.072447550000003,1.0708852775082194,1.0709224047224772,-629,-210885,-210549.2,0.0002845792719199152,-174.90825541190958,-0.026142570374871197
2023-05-29T19:45:00-04:00,1.07077,1.07077,1.07066,1.07068,1.07127104,1.0708382222222221,1.070879999999998,1.0709248888888863,1.070895000000002,1.0710527999999997,1.0718855000000005,1.072437000000003,1.0708442220065755,1.0709035237779823,-507,-211392,-210708,-0.0014362609190967646,-174.95086960543384,-0.025211261029925994
2023-05-29T20:00:00-04:00,1.07068,1.07194,1.0704,1.07171,1.0704,1.0710042222222222,1.0709655555555537,1.0709306666666643,1.0709285000000022,1.0710507999999996,1.0718805000000005,1.072433050000003,1.0710173776052603,1.0709172190223861,2459,-208933,-210423.4,0.0027257031136914476,-172.5852981928739,0.07189945281714544
2023-05-29T20:15:00-04:00,1.07171,1.0718,1.07145,1.07153,1.0704,1.071117111111111,1.0710222222222203,1.0709437777777753,1.070956500000002,1.0710603999999997,1.0718730000000005,1.072428300000003,1.0711199020842082,1.070956175217909,-1567,-210500,-210393.2,0.006055997972550181,-172.84848506245592,0.04761815839106743
2023-05-29T20:30:00-04:00,1.07153,1.07194,1.07152,1.07192,1.0704,1.0712966666666668,1.0711422222222202,1.0709839999999973,1.070999500000002,1.0710727999999998,1.0718695000000005,1.072424850000003,1.0712799216673665,1.0710293401743276,1249,-209251,-210192.2,0.0102351824393644,-172.39389209725675,0.10085540323484087
2023-05-29T20:45:00-04:00,1.07192,1.07197,1.07067,1.07137,1.0704308,1.0713422222222224,1.0711855555555536,1.0710391111111086,1.071022500000002,1.0710753999999998,1.0718616000000005,1.072418600000003,1.0712979373338931,1.0711118721394626,-2646,-211897,-210394.6,0.013805301235788613,-173.75154938511417,0.03641524584958546
2023-05-29T21:00:00-04:00,1.07137,1.07189,1.07136,1.07183,1.070492368,1.071471111111111,1.071278888888887,1.0711188888888863,1.071070500000002,1.0710897999999998,1.0718609000000006,1.072414300000003,1.0714043498671144,1.0712238977115702,1855,-210042,-210124.6,0.017650500527413564,-172.95509251213824,0.07843210487494505
2023-05-29T21:15:00-04:00,1.07183,1.07208,1.07166,1.0720399999999999,1.07055147328,1.0716233333333334,1.0714133333333313,1.0712084444444419,1.0711440000000019,1.0711009999999996,1.0718621000000004,1.072411500000003,1.0715314798936915,1.0713267181692563,1564,-208478,-210033.6,0.022250921935177213,-172.64866332094212,0.11299646068936557
2023-05-29T21:30:00-04:00,1.0720399999999999,1.07262,1.07193,1.07218,1.0706431848832,1.0717766666666668,1.0715588888888867,1.0713157777777753,1.071208000000002,1.0711152,1.0718637000000006,1.0724104500000031,1.0716611839149532,1.0714349745354055,2060,-206418,-209217.2,0.027694969473437633,-172.3796435082485,0.12233044160354874
2023-05-29T21:45:00-04:00,1.07218,1.07234,1.072,1.0723,1.070801330092544,1.071924888888889,1.071728888888887,1.0714331111111084,1.071290500000002,1.0711363999999997,1.0718669000000005,1.0724102500000032,1.0717889471319626,1.0715367796283246,1671,-204747,-208316.4,0.034818811493128515,-172.19262267219466,0.14288782838518369
2023-05-29T22:00:00-04:00,1.0723,1.07249,1.07205,1.07212,1.0709468236851405,1.072003111111111,1.071888888888887,1.071573777777775,1.071346000000002,1.0711615999999997,1.0718629000000006,1.072409650000003,1.0718551577055702,1.07164822370266,-1141,-205888,-207114.6,0.040883761306158714,-172.38415489265543,0.13449396645121658
2023-05-29T22:15:00-04:00,1.07212,1.07231,1.07207,1.0722099999999999,1.0710806777903292,1.0720673333333333,1.0719444444444424,1.071706888888886,1.071404000000002,1.0711867999999998,1.0718545000000006,1.072408700000003,1.0719261261644562,1.0717525789621285,1013,-204875,-206081.2,0.049828593372411585,-172.29911776994535,0.04665441210774789
2023-05-29T22:30:00-04:00,1.0722099999999999,1.07232,1.07193,1.07198,1.0712038235671029,1.0720744444444443,1.0719944444444423,1.0718231111111083,1.071455500000002,1.0712091999999998,1.0718461000000006,1.0724075500000032,1.071936900931565,1.0718336631697032,-1561,-206436,-205672.8,0.04821320476494203,-172.63396821901776,0.041996024376344046
2023-05-29T22:45:00-04:00,1.07198,1.07223,1.07196,1.07213,1.0713171176817347,1.0721015555555555,1.0720177777777757,1.071914888888886,1.071515000000002,1.0712351999999998,1.0718359000000006,1.072405500000003,1.071975520745252,1.0718965305357628,941,-205495,-205488.2,0.04856621235109715,-172.50229598632677,0.019591014254799193
2023-05-29T23:00:00-04:00,1.07213,1.07216,1.07136,1.07142,1.07262,1.071982,1.0720233333333313,1.071973777777775,1.071535000000002,1.0712515999999999,1.0718169000000006,1.0723990500000031,1.0718644165962015,1.0719116244286107,-1479,-206974,-205933.6,0.04176569613359918,-173.4817387777793,0.004666921791734463
2023-05-29T23:15:00-04:00,1.07142,1.07148,1.07072,1.0708199999999999,1.0725947999999998,1.0717413333333332,1.071911111111109,1.0719782222222192,1.071534000000002,1.0712507999999998,1.0717913000000008,1.0723894000000032,1.071655533276961,1.0718716995428887,-1854,-208828,-206521.6,0.037521909631137745,-174.519987083766,-0.09423136131664325
2023-05-29T23:30:00-04:00,1.0708199999999999,1.07084,1.07012,1.07058,1.0725198079999998,1.0714751111111112,1.0717488888888869,1.0719391111111078,1.0715140000000019,1.0712419999999998,1.0717640000000008,1.0723790000000033,1.071440426621569,1.0717745596343113,-1506,-210334,-207613.4,0.02701182067153964,-174.85752280405484,-0.13618894817355648
2023-05-29T23:45:00-04:00,1.07058,1.07078,1.07053,1.0706499999999999,1.0723758195199997,1.0712553333333332,1.071578888888887,1.071855999999997,1.0714970000000021,1.0712386,1.0717393000000006,1.0723661500000032,1.0712823412972552,1.0716436477074496,1383,-208951,-208116.4,0.01550602575110469,-174.76709518538112,-0.1426999197895905
2023-05-30T00:00:00-04:00,1.0706499999999999,1.07076,1.07035,1.07066,1.0722404703487998,1.0710715555555554,1.0713966666666646,1.0717317777777748,1.071488500000002,1.0712266,1.0717130000000008,1.0723523500000032,1.0711578730378042,1.0714801181659601,1209,-207742,-208565.8,0.0027865923577075555,-174.7558029797116,-0.1529422736174658
2023-05-30T00:15:00-04:00,1.07066,1.07077,1.07034,1.07054,1.0721132421278718,1.0709002222222224,1.0712211111111092,1.0715713333333303,1.071472000000002,1.0712098,1.0716873000000007,1.0723371000000033,1.0710342984302434,1.0713140945327684,-1227,-208969,-208964.8,-0.012350940942411237,-174.89332562929212,-0.14737156288474376
2023-05-30T00:30:00-04:00,1.07054,1.07068,1.07047,1.07059,1.0719936476001994,1.070774,1.0710411111111091,1.0713973333333304,1.071463000000002,1.071195,1.0716636000000006,1.0723225500000033,1.0709454387441948,1.0711720756262153,1172,-207797,-208758.6,-0.02538663281764103,-174.8385868993055,-0.1510898051687594
2023-05-30T00:45:00-04:00,1.07059,1.07085,1.07059,1.07078,1.0718812287441875,1.0707217777777778,1.0709077777777756,1.071229111111108,1.071468000000002,1.071186,1.0716411000000006,1.072309400000003,1.0709123509953558,1.0710664605009725,829,-206968,-208085.4,-0.03877770883944456,-174.69146241654357,-0.11194238698481948
2023-05-30T01:00:00-04:00,1.07078,1.0708199999999999,1.07024,1.07034,1.0717755550195363,1.0706082222222222,1.0707088888888867,1.0710551111111082,1.0713995000000023,1.0711666,1.0716128000000007,1.0722932500000033,1.0707978807962846,1.0709695684007783,-1111,-208079,-207911,-0.05257403432024478,-175.14798943423162,-0.16695736524488244
2023-05-30T01:15:00-04:00,1.07034,1.07045,1.06835,1.06912,1.0716762217183642,1.0702904444444445,1.0704533333333313,1.0708664444444413,1.071279000000002,1.0711237999999998,1.0715726000000005,1.0722698000000033,1.0704623046370276,1.070830454720623,-3396,-211475,-208657.6,-0.06916443934334694,-179.01883421252637,-0.21466838401373586
2023-05-30T01:30:00-04:00,1.06912,1.06946,1.06864,1.06877,1.071410123980895,1.0699537777777777,1.0702255555555535,1.0706673333333303,1.0711215000000023,1.0710719999999998,1.0715268000000007,1.0722456000000031,1.070123843709622,1.0706483637764987,-2753,-214228,-209709.4,-0.0816427236170554,-179.92008945047925,-0.19144207243046316
2023-05-30T01:45:00-04:00,1.06877,1.06878,1.0681,1.0686,1.0711653140624235,1.0696286666666668,1.0700055555555537,1.070460222222219,1.0709830000000022,1.0710191999999998,1.0714768000000006,1.0722199000000032,1.0698190749676977,1.0704230910211994,-3122,-217350,-211620,-0.08762159847704099,-180.416678987985,-0.184946477610276
2023-05-30T02:00:00-04:00,1.0686,1.06905,1.06848,1.06864,1.0708587826561813,1.0693555555555558,1.0697822222222202,1.070235111111108,1.0708235000000024,1.0709657999999997,1.0714266000000008,1.072193650000003,1.0695832599741582,1.07015727281696,3140,-214210,-213068.4,-0.09360867651159417,-180.29914202373257,-0.18773642179982677
2023-05-30T02:15:00-04:00,1.06864,1.06894,1.0685,1.06879,1.0705829043905633,1.0691571111111111,1.0695744444444424,1.0700082222222194,1.0706610000000025,1.0709182,1.0713777000000007,1.0721684000000031,1.0694246079793266,1.0698826182535686,2826,-211384,-213729.4,-0.09747274436654643,-179.9024696176841,-0.17465862178469713
2023-05-30T02:30:00-04:00,1.06879,1.06965,1.06875,1.06938,1.0703346139515069,1.0691182222222222,1.0694455555555538,1.0698066666666637,1.0705210000000025,1.0708828,1.0713349000000008,1.072145250000003,1.0694156863834612,1.069673294602855,3741,-207643,-212963,-0.0976088174853319,-177.83733989154487,-0.10835653034917424
2023-05-30T02:45:00-04:00,1.06938,1.06984,1.06936,1.06942,1.0701111525563562,1.0691131111111112,1.0693155555555538,1.0696246666666638,1.0703770000000026,1.0708487999999998,1.0712928000000006,1.0721225000000032,1.0694165491067689,1.0695318356822845,2620,-205023,-211122,-0.09580584203427377,-177.7393391808526,-0.10928553414471398
2023-05-30T03:00:00-04:00,1.06942,1.06942,1.06831,1.06848,1.0699100373007207,1.068946,1.0690599999999983,1.0694355555555526,1.0701950000000024,1.0707969999999998,1.0712385000000006,1.0720963500000031,1.069229239285415,1.0694138685458279,-5938,-210961,-209844.2,-0.09854057791351685,-182.9587291305446,-0.21479669026316972
2023-05-30T03:15:00-04:00,1.06848,1.0689899999999999,1.06724,1.06773,1.06984,1.0686800000000003,1.0687699999999982,1.069233111111108,1.0699710000000024,1.0707305999999996,1.0711733000000008,1.072065050000003,1.068929391428332,1.0692830948366627,-4078,-215039,-210010,-0.10752669032001758,-185.82120666872981,-0.24384774931330241
2023-05-30T03:30:00-04:00,1.06773,1.06831,1.06728,1.06831,1.0695279999999998,1.0685879999999999,1.0686799999999983,1.0690542222222192,1.0697875000000026,1.0706759999999997,1.0711169000000007,1.072036150000003,1.0688055131426657,1.0691592758693305,3709,-211330,-209999.2,-0.10916100558425626,-183.80644638288967,-0.07576324453756149
2023-05-30T03:45:00-04:00,1.06831,1.06909,1.06803,1.06903,1.0692534399999998,1.0686579999999999,1.0687088888888872,1.068906888888886,1.0696325000000024,1.0706371999999995,1.0710708000000007,1.0720127000000033,1.0688504105141325,1.0690462206954647,4902,-206428,-209756.2,-0.09688499063849597,-180.5026862383631,0.024327030137440885
2023-05-30T04:00:00-04:00,1.06903,1.06936,1.06873,1.06902,1.06724,1.0687202222222223,1.068755555555554,1.068794888888886,1.0695125000000023,1.0705963999999997,1.0710261000000008,1.0719906000000032,1.068884328411306,1.0689397765563722,-4782,-211210,-210993.6,-0.08071528074250738,-180.54741837871396,0.039303761931507294
2023-05-30T04:15:00-04:00,1.06902,1.07017,1.06901,1.06973,1.0672824,1.068915111111111,1.0688766666666651,1.0687582222222194,1.0694580000000022,1.0705727999999997,1.0709883000000007,1.0719725000000033,1.069053462729045,1.0689046212450983,4104,-207106,-210222.6,-0.06263140038394449,-177.82170697948854,0.10199880221590389
2023-05-30T04:30:00-04:00,1.06973,1.07043,1.06957,1.0704,1.0673979040000001,1.0692197777777779,1.0690555555555539,1.0688153333333303,1.0694490000000025,1.0705633999999997,1.0709621000000007,1.0719562000000034,1.069322770183236,1.068983296996079,2809,-204297,-208074.2,-0.04430629985606163,-176.06235648917803,0.150637636953949
2023-05-30T04:45:00-04:00,1.0704,1.07081,1.07012,1.07046,1.06757982976,1.0695006666666669,1.069175555555554,1.0689144444444416,1.0694395000000025,1.0705611999999995,1.0709386000000007,1.0719438000000034,1.0695502161465889,1.0691322375968635,3881,-200416,-205891.4,-0.02815742511814199,-175.84481164612887,0.10099309880491218
2023-05-30T05:00:00-04:00,1.07046,1.07052,1.0697,1.06999,1.0678382433792002,1.0696635555555556,1.0692388888888873,1.0690204444444416,1.0694060000000025,1.0705429999999996,1.0709165000000007,1.0719269000000033,1.069638172917271,1.0692897900774914,-4161,-204577,-205521.2,-0.01951575285903555,-177.67175520310425,0.05329991958257368
2023-05-30T05:15:00-04:00,1.06999,1.07173,1.06999,1.07157,1.0680759839088643,1.0701297777777776,1.0695822222222207,1.069185777777775,1.0694575000000026,1.0705613999999994,1.0709052000000008,1.0719164500000031,1.0700245383338167,1.0695178320619934,3650,-200927,-203464.6,-0.0034639836968106135,-172.2819852052541,0.2891958670260384
2023-05-30T05:30:00-04:00,1.07157,1.07207,1.07142,1.07203,1.068441385517978,1.0706193333333334,1.0700599999999985,1.0694224444444416,1.0695295000000025,1.0705817999999996,1.0708986000000007,1.0719109500000032,1.0704256306670534,1.0697922656495948,4338,-196589,-201361.2,0.023093176761210067,-170.41978301594258,0.40272353497606794
2023-05-30T05:45:00-04:00,1.07203,1.07247,1.07185,1.07194,1.0688768192558207,1.0709953333333333,1.0704633333333318,1.0697039999999969,1.0695875000000024,1.0705995999999995,1.0708939000000008,1.0719004500000033,1.0707285045336428,1.0700734125196765,-4040,-200629,-200627.6,0.05644065917797688,-170.75895262873382,0.3397890125525175
2023-05-30T06:00:00-04:00,1.07194,1.07317,1.07193,1.0729899999999999,1.0693798645600059,1.0715006666666667,1.0709033333333315,1.0700495555555525,1.0697200000000024,1.0706403999999994,1.0709079000000008,1.0718980000000033,1.0711808036269141,1.0703995300157414,4144,-196485,-199841.4,0.09034602670696901,-166.69977021180753,0.37042926765385104
2023-05-30T06:15:00-04:00,1.0729899999999999,1.07328,1.0726,1.07263,1.069986286230405,1.0718459999999999,1.0713044444444426,1.0704626666666637,1.0698955000000026,1.0706741999999994,1.0709189000000006,1.0718957000000033,1.0714706429015313,1.0707660240125936,-2995,-199480,-198822,0.11379341194651466,-167.70462580226015,0.33769246599688413
2023-05-30T06:30:00-04:00,1.07263,1.07359,1.07255,1.07342,1.070579154708932,1.0722691111111111,1.0717144444444426,1.0708891111111078,1.0701280000000024,1.0707221999999994,1.0709370000000007,1.0718957500000033,1.071860514321225,1.071133219210075,3233,-196247,-197886,0.13575520452082165,-165.32349717449455,0.34494685574864414
2023-05-30T06:45:00-04:00,1.07342,1.07347,1.07285,1.07315,1.0711813237671457,1.072556222222222,1.0720199999999982,1.071281111111108,1.0703555000000025,1.0707683999999995,1.0709524000000006,1.0718956500000032,1.07211841145698,1.0714717753680605,-3023,-199270,-198422.2,0.1481955408752266,-166.08387987651238,0.2569133034379699
2023-05-30T07:00:00-04:00,1.07315,1.0738,1.07313,1.07374,1.0716630590137166,1.0729002222222221,1.0723844444444426,1.0716653333333301,1.0706105000000024,1.0708235999999995,1.0709751000000007,1.0719009000000035,1.072442729165584,1.071814620294449,2764,-196506,-197597.6,0.15649764132603916,-164.56427870239912,0.3064103282700848
2023-05-30T07:15:00-04:00,1.07374,1.07379,1.07304,1.07328,1.0720904472109734,1.0730793333333333,1.072749999999998,1.0720346666666636,1.0708350000000024,1.0708693999999996,1.0709935000000006,1.0718990000000033,1.0726101833324673,1.0721004962355594,-3001,-199507,-198202,0.1621668017910493,-165.84993444773758,0.30747950915429256
2023-05-30T07:30:00-04:00,1.07328,1.07417,1.07311,1.07368,1.0724323577687787,1.0732653333333333,1.0729844444444425,1.0723706666666635,1.0710500000000025,1.0709263999999994,1.0710181000000005,1.0719006000000033,1.0728241466659738,1.072371196988448,3510,-195997,-197505.4,0.17484364426055715,-164.54179491285402,0.19690734156425213
2023-05-30T07:45:00-04:00,1.07368,1.07446,1.07346,1.0744,1.0727798862150228,1.0735484444444445,1.0732477777777758,1.07267733333333,1.0712990000000024,1.0709969999999993,1.0710470000000007,1.0719050500000034,1.073139317332779,1.0726269575907588,3163,-192834,-196822.8,0.1789076877941769,-162.42071600666208,0.22107590272660121
2023-05-30T08:00:00-04:00,1.0744,1.07466,1.07409,1.07427,1.07311,1.073752888888889,1.0735066666666648,1.0729746666666635,1.0715885000000023,1.0710669999999995,1.0710714000000008,1.0719129500000033,1.0733654538662232,1.0728763660726073,-3717,-196551,-196279,0.17822024199752823,-162.8704647036091,0.2173629121033048
2023-05-30T08:15:00-04:00,1.07427,1.07439,1.07334,1.07359,1.07466,1.0737695555555555,1.0735733333333315,1.0732124444444413,1.0718815000000024,1.0711251999999996,1.0710890000000008,1.0719145000000032,1.0734103630929785,1.0730698928580862,-3710,-200261,-197030,0.1708704059835171,-165.21885011882134,0.05591850809421859
2023-05-30T08:30:00-04:00,1.07359,1.07379,1.07325,1.07338,1.07466,1.073730888888889,1.073656666666665,1.0733937777777747,1.0721350000000025,1.0711585999999995,1.0711047000000007,1.0719105500000032,1.0734042904743828,1.0732287142864696,-3241,-203502,-197829,0.14936690979235906,-165.85280721603735,0.06992159458527436
2023-05-30T08:45:00-04:00,1.07338,1.07339,1.07215,1.0722099999999999,1.0746035999999999,1.0734415555555556,1.0735222222222207,1.0735013333333303,1.0722940000000025,1.0711721999999995,1.0711163000000008,1.0718995500000033,1.0731654323795061,1.0732969714291758,-4857,-208359,-200301.4,0.12810177788875302,-171.14700871038283,-0.11272381733153429
2023-05-30T09:00:00-04:00,1.0722099999999999,1.07352,1.07185,1.0732,1.0744563839999999,1.073377111111111,1.0735277777777759,1.0735573333333304,1.0725030000000024,1.0711977999999995,1.0711353000000008,1.071892050000003,1.0731723459036049,1.073303577143341,5056,-203303,-202395.2,0.10750883251026244,-166.47866948579042,0.0046591809159841095
2023-05-30T09:15:00-04:00,1.0732,1.07386,1.07318,1.07334,1.0742478732799998,1.0733395555555556,1.0734833333333316,1.0735526666666637,1.0726835000000023,1.0712371999999997,1.0711563000000006,1.071886550000003,1.0732058767228838,1.0732716617146731,3035,-200268,-203138.6,0.09007965049703939,-166.0827507381198,-0.03725296626743495
2023-05-30T09:30:00-04:00,1.07334,1.07357,1.0726499999999999,1.07284,1.0740560434175999,1.073210888888889,1.0734344444444428,1.0735248888888858,1.0728055000000023,1.0712573999999995,1.0711736000000007,1.0718746000000032,1.073132701378307,1.073216129371739,-5059,-205327,-204151.8,0.06787114382144441,-168.43941311909856,-0.040995825879546435
2023-05-30T09:45:00-04:00,1.07284,1.07339,1.07261,1.07301,1.073879559944192,1.073126,1.0733599999999983,1.0734655555555523,1.0729330000000021,1.0712767999999997,1.0711889000000006,1.0718633500000032,1.0731081611026456,1.0731569034973916,4297,-201030,-203657.4,0.053761531742253114,-167.7585194164029,-0.06240220549884029
2023-05-30T10:00:00-04:00,1.07301,1.07351,1.07228,1.0728199999999999,1.0737171951486566,1.073018,1.0731844444444427,1.073397999999997,1.0730745000000024,1.0712895999999994,1.0712024000000007,1.0718513000000032,1.0730505288821164,1.0731339227979135,-6949,-207979,-203581.4,0.035266214203624684,-168.98899257136037,-0.1470588235294245
2023-05-30T10:15:00-04:00,1.0728199999999999,1.0729899999999999,1.0720399999999999,1.07281,1.0735678195367642,1.0729431111111112,1.0730222222222205,1.0732968888888856,1.0731365000000022,1.0712997999999994,1.0712181000000005,1.0718378500000032,1.0730024231056932,1.0730999382383313,-5015,-212994,-205519.6,0.007930133174952317,-169.03573853060723,-0.13590624330941167
2023-05-30T10:30:00-04:00,1.07281,1.07407,1.0727,1.0731,1.07185,1.0729586666666668,1.0729677777777762,1.0731937777777747,1.073190000000002,1.0713193999999995,1.0712405000000005,1.0718381000000032,1.0730219384845545,1.0730631505906654,5216,-207778,-207021.6,-0.009762231965525375,-167.625759130714,-0.04564125969877714
2023-05-30T10:45:00-04:00,1.0731,1.07313,1.07256,1.07275,1.0718944,1.072915111111111,1.0728977777777762,1.0730864444444415,1.0732305000000022,1.0713301999999993,1.0712585000000003,1.0718309500000032,1.0729675507876437,1.073030120472533,-4903,-212681,-208492.4,-0.02078401529941039,-169.22491112027626,-0.05869310029997842
2023-05-30T11:00:00-04:00,1.07275,1.07284,1.0722,1.0723799999999999,1.0719379119999999,1.0728115555555553,1.0729166666666652,1.0729977777777746,1.0732000000000022,1.0713381999999994,1.0712737000000006,1.0718240000000032,1.072850040630115,1.072978496378027,-3720,-216401,-211566.6,-0.03205396993988961,-170.50796868261673,0.015855103011537246
2023-05-30T11:15:00-04:00,1.0723799999999999,1.07256,1.07197,1.07224,1.07407,1.0726762222222224,1.0728099999999985,1.0729228888888858,1.0731805000000023,1.0713403999999995,1.0712878000000006,1.0718194500000033,1.072728032504092,1.072913997102422,-4027,-220428,-214056.4,-0.0284475138708122,-171.0336965029782,-0.0894521058516446
2023-05-30T11:30:00-04:00,1.07224,1.0726499999999999,1.07218,1.07228,1.074028,1.0725702222222222,1.0726922222222206,1.0728568888888859,1.0731235000000023,1.0713575999999996,1.0713046000000004,1.0718153000000035,1.0726384260032735,1.0728411976819379,3092,-217336,-214924.8,-0.035467869251942105,-170.91834919267504,-0.09875715057671017
2023-05-30T11:45:00-04:00,1.07228,1.07234,1.07196,1.07214,1.0739868399999999,1.0724597777777778,1.0726144444444428,1.072786222222219,1.0730730000000022,1.0713839999999994,1.0713174000000003,1.0718146500000034,1.0725387408026188,1.0727445581455508,-2094,-219430,-217255.2,-0.04097253069814371,-171.19174793180997,-0.06524738078370707
2023-05-30T12:00:00-04:00,1.07214,1.07234,1.0715999999999999,1.07229,1.0739057663999998,1.072394888888889,1.072534444444443,1.0727135555555525,1.0730005000000022,1.0714181999999994,1.0713301000000004,1.0718090500000033,1.072488992642095,1.072648846516441,2602,-216828,-218084.6,-0.042283241803763534,-170.82770965322726,-0.06710095898454385
2023-05-30T12:15:00-04:00,1.07229,1.0727,1.07227,1.0725,1.0737674204159997,1.072388,1.0724988888888873,1.0726299999999969,1.0729615000000021,1.0714551999999997,1.0713469000000004,1.0718064500000033,1.072491194113676,1.0725770772131533,1845,-214983,-217801,-0.0415355413132222,-170.46638016213802,-0.029827930128062115
2023-05-30T12:30:00-04:00,1.0725,1.0727,1.07226,1.0723,1.0736373751910397,1.0723482222222223,1.0724422222222207,1.0725564444444413,1.0728925000000022,1.0714879999999996,1.0713573000000005,1.0718115500000034,1.072452955290941,1.072522061770523,-1863,-216846,-217084.6,-0.04203442908651828,-170.81379274955057,-0.047538706760750775
2023-05-30T12:45:00-04:00,1.0723,1.07267,1.07205,1.07207,1.0735151326795773,1.0722737777777778,1.0723277777777762,1.0724835555555523,1.0727760000000022,1.0715185999999997,1.0713642000000005,1.0718192500000034,1.0723763642327528,1.0724696494164188,-1934,-218780,-217373.4,-0.04178887452755752,-171.22862068949266,-0.09598359891900703
2023-05-30T13:00:00-04:00,1.07207,1.07216,1.07141,1.07165,1.0734002247188026,1.0721382222222222,1.072205555555554,1.0724017777777743,1.072645000000002,1.0715397999999996,1.0713674000000004,1.0718251500000033,1.0722310913862023,1.0724081195331354,-2013,-220793,-217646,-0.04310350567762257,-172.01724456666503,-0.10254020041949204
2023-05-30T13:15:00-04:00,1.07165,1.07193,1.07151,1.07164,1.0732410067412983,1.0720251111111112,1.0721233333333318,1.0723195555555525,1.072547500000002,1.0715569999999994,1.0713715000000006,1.0718319000000034,1.0721128731089618,1.0723328956265088,-1665,-222458,-218772,-0.04178109741622484,-172.03278135572873,-0.06900538988044937
2023-05-30T13:30:00-04:00,1.07164,1.07194,1.0714299999999999,1.07179,1.0730945262019944,1.0719584444444445,1.0720733333333319,1.0722344444444412,1.072468000000002,1.0715859999999995,1.0713763000000005,1.0718385500000034,1.0720482984871693,1.0722443165012074,2064,-220394,-219854.2,-0.03929362058059272,-171.74387836591853,-0.041968216071034604
2023-05-30T13:45:00-04:00,1.07179,1.0719,1.07164,1.07168,1.0729597641058348,1.0718797777777778,1.0720066666666652,1.07214733333333,1.072441500000002,1.0716371999999996,1.0713805000000005,1.0718409000000033,1.0719746387897355,1.0721486532009663,-1576,-221970,-220879,-0.03696987350477043,-171.9056264695583,-0.05595553400230667
2023-05-30T14:00:00-04:00,1.07168,1.07173,1.07142,1.07168,1.072835782977368,1.0718144444444444,1.071955555555554,1.0720728888888857,1.072365500000002,1.0716953999999996,1.0713837000000004,1.0718399500000033,1.0719157110317885,1.0720565225607737,0,-221970,-221517,-0.04021223320411869,-171.9056264695583,-0.04290484451658617
2023-05-30T14:15:00-04:00,1.07168,1.0719,1.07161,1.07175,1.0727217203391786,1.0717733333333335,1.071895555555554,1.0720108888888855,1.072286000000002,1.0717583999999996,1.0713888000000005,1.0718399500000033,1.0718825688254308,1.0719868180486192,1552,-220418,-221442,-0.03741275168660651,-171.8042529252167,-0.05035951095319223
2023-05-30T14:30:00-04:00,1.07175,1.07192,1.07168,1.07179,1.0726167827120443,1.0717522222222222,1.071816666666665,1.0719495555555523,1.072233500000002,1.0718213999999997,1.0713936000000004,1.0718416000000035,1.0718640550603447,1.0719370544388958,1375,-219043,-220759,-0.03519483282099425,-171.7529349872647,-0.06620046620046512
2023-05-30T14:45:00-04:00,1.07179,1.07209,1.07175,1.07194,1.0725202400950808,1.0717768888888888,1.071776666666665,1.0718902222222189,1.072180000000002,1.0718843999999996,1.0714013000000004,1.0718415000000037,1.0718792440482756,1.0719032435511173,1909,-217134,-220107,-0.0364220013578862,-171.4857651125693,-0.033572694208723115
2023-05-30T15:00:00-04:00,1.07194,1.07254,1.07178,1.07251,1.07141,1.0719235555555555,1.0718255555555538,1.0718539999999965,1.072164500000002,1.0719469999999998,1.0714149000000004,1.0718417500000035,1.0720053952386206,1.0719093948408944,2032,-215102,-218733.4,-0.03224358026298046,-170.40525687516762,0.04104209613178206
2023-05-30T15:15:00-04:00,1.07251,1.0729,1.07246,1.0727,1.0714326,1.0720984444444446,1.0719422222222204,1.07185133333333,1.072159000000002,1.0720125999999999,1.0714307000000005,1.0718444500000035,1.0721443161908966,1.0719551158727159,1815,-213287,-216996.8,-0.02583497327879034,-170.08372141162897,0.09797975085149026
2023-05-30T15:30:00-04:00,1.0727,1.07301,1.07269,1.07284,1.071491296,1.072278,1.072075555555554,1.0718873333333299,1.0721460000000023,1.0720997999999997,1.0714484000000004,1.0718458500000034,1.0722834529527172,1.0720352926981733,1438,-211849,-215283,-0.014869412977754149,-169.8960454537656,0.11197790302714437
2023-05-30T15:45:00-04:00,1.07284,1.07303,1.07278,1.073,1.07158241824,1.072462888888889,1.0722099999999983,1.0719659999999966,1.0721585000000022,1.0722051999999997,1.0714679000000005,1.0718475500000035,1.0724267623621737,1.072147834158539,1644,-210205,-213515.4,-0.0017409903746188077,-169.6508644388893,0.11289525000232632
2023-05-30T16:00:00-04:00,1.073,1.07304,1.07273,1.07301,1.0716982247808,1.072622888888889,1.072357777777776,1.0720822222222188,1.0721900000000022,1.0722991999999998,1.0714876000000004,1.0718478000000036,1.072543409889739,1.0722806673268317,1224,-208981,-211884.8,0.008482788821409685,-169.63945716955092,0.12410421021200857
2023-05-30T16:15:00-04:00,1.07301,1.07336,1.07296,1.0732,1.07183240230272,1.0727913333333334,1.072526666666665,1.072222444444441,1.0722380000000022,1.0723825999999996,1.0715099000000003,1.0718493500000037,1.0726747279117912,1.072414533861466,984,-207997,-210463.8,0.01901674290556011,-169.46521834605448,0.14183338309942947
2023-05-30T16:30:00-04:00,1.0732,1.07346,1.07317,1.07339,1.0720157140263935,1.072964,1.0727088888888874,1.0723757777777745,1.0722935000000022,1.0724699999999998,1.0715332000000004,1.0718514500000036,1.072817782329433,1.0725492270891732,586,-207411,-209288.6,0.029855916227785603,-169.36147253912188,0.15302076043854312
2023-05-30T16:45:00-04:00,1.07339,1.07348,1.07334,1.07342,1.0722179140626984,1.0731062222222223,1.0728899999999983,1.0725386666666634,1.072357500000002,1.0725437999999996,1.0715583000000004,1.0718539500000035,1.0729382258635463,1.0726801816713387,829,-206582,-208235.2,0.0403653934029487,-169.3383029549074,0.15208203099487963
2023-05-30T17:00:00-04:00,1.07342,1.07342,1.07246,1.07294,1.0724198478126667,1.0731162222222221,1.0730011111111095,1.0726968888888855,1.0723900000000022,1.0725945999999997,1.0715790000000005,1.0718536000000034,1.072938580690837,1.0727825453370714,-204,-206786,-207551.4,0.04753533400645441,-169.42952540278426,0.09328880347781704
2023-05-30T17:15:00-04:00,1.07294,1.07322,1.07285,1.0732,1.07246,1.0731559999999998,1.073077777777776,1.0728408888888858,1.0724250000000022,1.0726493999999998,1.0716053000000005,1.0718558000000034,1.0729908645526696,1.0728720362696575,174,-206612,-207077.6,0.055241774344166134,-169.38736088286703,0.06433506447491001
2023-05-30T17:30:00-04:00,1.0732,1.0734299999999999,1.0732,1.07337,1.07246,1.0732144444444445,1.0731522222222205,1.072965999999997,1.072478500000002,1.072717,1.0716300000000005,1.0718586500000036,1.0730666916421356,1.0729504290157266,522,-206090,-206696.2,0.059395600809594946,-169.3046735925204,0.062459215064784974
2023-05-30T17:45:00-04:00,1.07337,1.0734299999999999,1.07323,1.0732599999999999,1.0726232,1.073236,1.0731988888888873,1.0730639999999967,1.0725380000000022,1.0727507999999997,1.0716561000000004,1.0718602000000035,1.0731053533137085,1.0730079432125816,-253,-206343,-206482.6,0.06035209607342479,-169.3306012782206,0.03914842847021596
2023-05-30T18:00:00-04:00,1.0732599999999999,1.0734,1.07322,1.07328,1.072760288,1.0732522222222223,1.0732299999999981,1.0731319999999966,1.0726195000000023,1.0727757999999996,1.0716788000000006,1.0718627000000034,1.0731402826509668,1.0730483545700658,309,-206034,-206373,0.05907909948683923,-169.32484312083093,0.026095060577824604
2023-05-30T18:15:00-04:00,1.07328,1.07334,1.07308,1.0731,1.07287544192,1.0732262222222222,1.0732399999999982,1.0731797777777743,1.0726925000000023,1.0727989999999998,1.0716993000000006,1.0718639500000036,1.0731322261207734,1.0730870836560529,-324,-206358,-206287.4,0.053570421775754204,-169.37918122458765,0.00838761987306022
2023-05-30T18:30:00-04:00,1.0731,1.07332,1.0731,1.07331,1.0729721712128,1.0732402222222224,1.0732522222222203,1.0732146666666633,1.0727685000000022,1.0728053999999998,1.0717229000000004,1.0718674000000035,1.0731677808966187,1.073122466924843,211,-206147,-206194.4,0.048949801040379055,-169.33788963946046,0.010249720462174292
2023-05-30T18:45:00-04:00,1.07331,1.07334,1.07314,1.0732,1.073053423818752,1.0732297777777777,1.0732311111111095,1.0732304444444412,1.0728445000000022,1.0728167999999998,1.0717455000000005,1.0718722000000036,1.0731742247172948,1.0731439735398747,-310,-206457,-206267.8,0.04268801792589858,-169.36966051646712,-0.017700928832962343
2023-05-30T19:00:00-04:00,1.0732,1.07333,1.07313,1.0732,1.0731,1.0732235555555554,1.0732066666666649,1.0732319999999966,1.0729205000000024,1.0728123999999999,1.0717673000000005,1.0718766000000035,1.0731793797738358,1.0731587788319001,0,-206457,-206290.6,0.03416763980990236,-169.36966051646712,-0.02049523951483194
2023-05-30T19:15:00-04:00,1.0732,1.07355,1.0732,1.07348,1.07313,1.0732782222222224,1.073266666666665,1.07323933333333,1.0730070000000025,1.0728189999999997,1.0717937000000004,1.0718820000000036,1.0732395038190687,1.0731786230655205,398,-206059,-206295.6,0.026735440302838864,-169.26582153025763,0.05032900255372946
2023-05-30T19:30:00-04:00,1.07348,1.07357,1.07327,1.07328,1.07313,1.073280888888889,1.073275555555554,1.0732464444444412,1.0730815000000025,1.0728098,1.0718167000000003,1.0718864000000035,1.073247603055255,1.0732016984524169,-675,-206734,-206370.8,0.023112337142149303,-169.3915807432844,0.007454342154312338
2023-05-30T19:45:00-04:00,1.07328,1.07332,1.07303,1.07316,1.07357,1.0732577777777776,1.0732522222222205,1.0732464444444412,1.0731425000000023,1.0728073999999999,1.0718384000000003,1.0718913500000036,1.0732300824442038,1.073214158761934,-641,-207375,-206616.4,0.016658686413572522,-169.46324890070846,-0.019564549037148746
2023-05-30T20:00:00-04:00,1.07316,1.07331,1.07278,1.07284,1.07357,1.0731753333333334,1.073205555555554,1.0732413333333302,1.0731590000000024,1.0727905999999998,1.0718585000000005,1.0718918000000033,1.073152065955363,1.0732097270095475,-1168,-208543,-207033.6,0.0077255233811294064,-169.81152874714317,-0.039133108473237144
2023-05-30T20:15:00-04:00,1.07284,1.07321,1.07271,1.07305,1.0735384,1.073144222222222,1.0731799999999982,1.0732359999999967,1.0731765000000024,1.0727635999999998,1.0718803000000003,1.0718950000000034,1.0731316527642905,1.0732001816076386,1211,-207332,-207208.6,0.003372347549066269,-169.5744850127559,-0.02142963625521322
2023-05-30T20:30:00-04:00,1.07305,1.0732,1.07286,1.07308,1.0734886959999999,1.0731242222222221,1.0731777777777762,1.0732182222222189,1.0731885000000023,1.0727398,1.0719034000000003,1.0719007000000034,1.0731213222114324,1.0731765452861113,1062,-206270,-207250.8,-0.00017748898326309115,-169.5447939452381,-0.0018637592023025794
2023-05-30T20:45:00-04:00,1.07308,1.07356,1.07294,1.07351,1.07271,1.0731906666666668,1.0731999999999984,1.0732031111111078,1.0732140000000023,1.0727381999999999,1.0719317000000004,1.0719086000000033,1.073199057769146,1.0731668362288898,1984,-204286,-206761.2,0.0006700009941561066,-168.74977400264308,0.01863394545843959
2023-05-30T21:00:00-04:00,1.07351,1.07354,1.07325,1.07345,1.072727,1.0732406666666665,1.0732277777777763,1.073198222222219,1.0732360000000025,1.0727395999999998,1.0719491000000003,1.0719148000000032,1.0732492462153167,1.0731706689831122,-1546,-205832,-206452.6,-0.00002218502016873889,-168.83618214043398,0.02329481923221054
2023-05-30T21:15:00-04:00,1.07345,1.07346,1.07295,1.07304,1.07274366,1.073203111111111,1.0732099999999987,1.0731991111111079,1.0732280000000025,1.0727562,1.0719642000000003,1.0719186000000034,1.0732073969722533,1.07318173518649,-1470,-207302,-206204.4,-0.0016461263228877796,-169.39764285122632,-0.014908684308603986
2023-05-30T21:30:00-04:00,1.07304,1.07339,1.07164,1.07167,1.07356,1.0728951111111111,1.0730088888888873,1.0731648888888856,1.0731420000000025,1.0727255999999998,1.0719617000000001,1.0719156000000032,1.0728999175778027,1.0731353881491927,-3654,-210956,-206929.2,-0.009114212980384798,-174.06287434306293,-0.1686105004285212
2023-05-30T21:45:00-04:00,1.07167,1.07178,1.07117,1.07133,1.0735216,1.0725593333333332,1.0727922222222206,1.0730877777777745,1.0730375000000025,1.0726854,1.0719613000000003,1.0719114500000033,1.0725859340622421,1.0730283105193545,-2881,-213837,-208442.6,-0.020009612068910467,-174.97690571466055,-0.18168604651163892
2023-05-30T22:00:00-04:00,1.07133,1.07147,1.07093,1.07109,1.073427536,1.0722188888888888,1.0725622222222206,1.072960222222219,1.0729450000000025,1.0726504,1.0719539000000002,1.0719074000000033,1.0722867472497937,1.0728458484154841,-2612,-216449,-210875.2,-0.030081875248307337,-175.5620475477087,-0.19288829251926967
2023-05-30T22:15:00-04:00,1.07109,1.07117,1.07074,1.0708199999999999,1.07327768384,1.0718704444444445,1.0723377777777763,1.072782222222219,1.0728260000000025,1.0726065999999999,1.0719417000000002,1.0719019000000032,1.0719933977998348,1.0725946787323877,-1974,-218423,-213393.4,-0.04248610280086214,-176.05965279096594,-0.18828529883301637
2023-05-30T22:30:00-04:00,1.0708199999999999,1.07083,1.07041,1.07052,1.0730746691328,1.0715068888888888,1.072056666666665,1.0725515555555523,1.0726835000000023,1.0725605999999999,1.0719251,1.0718944000000032,1.0716987182398678,1.0722929429859105,-1606,-220029,-215938.8,-0.052221685582986906,-176.50958835436592,-0.23577652485905998
2023-05-30T22:45:00-04:00,1.07052,1.07054,1.07026,1.07047,1.07280820221952,1.0711895555555555,1.071766666666665,1.072303111111108,1.0725440000000026,1.0725137999999999,1.0719068,1.0718868500000032,1.0714529745918944,1.0720035543887287,-1865,-221894,-218126.4,-0.06340752632485833,-176.59669555460485,-0.24322510903194552
2023-05-30T23:00:00-04:00,1.07047,1.07051,1.06989,1.0699,1.0725024179531777,1.0708162222222222,1.071365555555554,1.0720177777777746,1.0723750000000023,1.0724497999999998,1.0718846,1.071873750000003,1.0711423796735156,1.0717148435109833,-2290,-224184,-220195.8,-0.07815004631254081,-177.81606648513062,-0.33628005328314514
2023-05-30T23:15:00-04:00,1.0699,1.0699,1.06949,1.06986,1.072136679439733,1.070515111111111,1.070966666666665,1.0716986666666635,1.0722130000000025,1.0723919999999998,1.0718611,1.0718578000000032,1.0708859037388125,1.071434674808787,-1177,-225361,-221978.2,-0.09701403716929781,-177.86007059766453,-0.3344356979831368
2023-05-30T23:30:00-04:00,1.06986,1.07003,1.06942,1.06998,1.0717132107293756,1.0703177777777777,1.0706266666666648,1.0713564444444412,1.0720465000000026,1.0723439999999997,1.0718411,1.0718436000000033,1.07070472299105,1.0711769398470303,1290,-224071,-223107.8,-0.11553576758506105,-177.71537876882724,-0.2851711026616028
2023-05-30T23:45:00-04:00,1.06998,1.0700399999999999,1.06968,1.06979,1.071300432798088,1.0701504444444445,1.0704177777777761,1.0710286666666635,1.0718760000000025,1.0722949999999998,1.0718177000000002,1.071826800000003,1.07052177839284,1.0709415518776246,-840,-224911,-224084.2,-0.1302357276886176,-177.8645404354004,-0.17542713708509913
2023-05-31T00:00:00-04:00,1.06979,1.06993,1.06951,1.06989,1.070961954894432,1.070044888888889,1.070257777777776,1.0707268888888857,1.0717105000000025,1.0722471999999998,1.0718024000000002,1.0718096500000032,1.070395422714272,1.0707300415021002,1002,-223909,-224487.2,-0.13215647646686304,-177.77087719308182,-0.13441236593765563
2023-05-31T00:15:00-04:00,1.06989,1.07006,1.06983,1.06987,1.0706844030134344,1.0699673333333333,1.0701222222222204,1.0704782222222191,1.0715300000000025,1.0722017999999998,1.0717929000000002,1.0717921000000032,1.0702903381714177,1.0705596332016805,-924,-224833,-224617,-0.13100291147182844,-177.7881499968279,-0.11390265990719722
2023-05-31T00:30:00-04:00,1.06987,1.07005,1.06983,1.06983,1.0704568104710162,1.0699088888888888,1.0700122222222204,1.07028733333333,1.0713575000000026,1.0721525999999997,1.0717854000000002,1.0717747000000033,1.0701982705371342,1.0704221065613448,-756,-225589,-224662.6,-0.12656202570327027,-177.81641511315047,-0.09245251302738317
2023-05-31T00:45:00-04:00,1.06983,1.06997,1.06952,1.0698,1.0702701845862332,1.0698664444444446,1.0699322222222205,1.0701484444444411,1.0711895000000025,1.0720985999999997,1.0717769000000001,1.0717581000000032,1.0701186164297074,1.0703048852490764,-1102,-226691,-225186.6,-0.1206341304041059,-177.8473172190925,-0.06725703396478645
2023-05-31T01:00:00-04:00,1.0698,1.0698,1.0694299999999999,1.06953,1.0701171513607113,1.0697860000000001,1.069827777777776,1.070030444444441,1.0710240000000026,1.0720431999999998,1.0717656,1.0717393000000033,1.070000893143766,1.0702007081992615,-1363,-228054,-225815.2,-0.11375821799517156,-178.1913160973875,-0.08781189570935578
2023-05-31T01:15:00-04:00,1.06953,1.06988,1.0691,1.0694299999999999,1.0699916641157832,1.0697064444444446,1.0697755555555537,1.0699339999999968,1.0708430000000024,1.0719903999999998,1.0717545000000002,1.0717209000000032,1.0698867145150126,1.0700989665594096,-1805,-229859,-227005.2,-0.10832413291093068,-178.3600818169095,-0.04392933919059655
2023-05-31T01:30:00-04:00,1.0694299999999999,1.06945,1.06849,1.06914,1.06988,1.0695793333333332,1.0696955555555538,1.0698486666666633,1.0706460000000024,1.0719401999999996,1.0717400000000001,1.0717018000000034,1.06973737161201,1.0699883732475284,-4603,-234462,-228931,-0.0980521213196878,-179.6082888056788,-0.06729852504066457
2023-05-31T01:45:00-04:00,1.06914,1.06988,1.06903,1.06973,1.06849,1.0695862222222223,1.069667777777776,1.0697797777777744,1.0704570000000024,1.0719019999999997,1.0717295000000002,1.0716853000000033,1.069735897289608,1.069895898598023,2983,-231479,-230109,-0.08438062239080601,-177.96213395224495,-0.023364922708822733
2023-05-31T02:00:00-04:00,1.06973,1.06979,1.06885,1.06906,1.06849,1.0694646666666667,1.0695866666666651,1.0697106666666634,1.0702375000000024,1.0718473999999996,1.0717167000000003,1.0716647500000034,1.0696007178316864,1.0697923188784189,-3705,-235184,-231807.6,-0.07319536261779104,-180.28267277980015,-0.06823769150955977
2023-05-31T02:15:00-04:00,1.06906,1.06972,1.06849,1.06857,1.06988,1.0692613333333334,1.0694399999999984,1.069633111111108,1.0700140000000027,1.0717851999999994,1.0717112000000002,1.0716419000000033,1.0693945742653492,1.0696710551027355,-3484,-238668,-233930.4,-0.06289680385430683,-181.879552281418,-0.12337716961556681
2023-05-31T02:30:00-04:00,1.06857,1.06909,1.06834,1.06862,1.0698522,1.0690973333333331,1.0693011111111095,1.0695382222222192,1.0698615000000025,1.0717239999999995,1.0717097000000002,1.071618250000003,1.0692396594122793,1.069541644082189,2718,-235950,-235148.6,-0.055107281620151195,-181.75237296700746,-0.11683662501053355
2023-05-31T02:45:00-04:00,1.06862,1.06885,1.06791,1.06848,1.069791712,1.0689331111111111,1.0691511111111094,1.0694293333333302,1.0697190000000025,1.0716585999999995,1.0717085000000002,1.0715926500000033,1.0690877275298234,1.0694117152657516,-4513,-240463,-236348.8,-0.05390882371377642,-182.34362149314316,-0.126188272903168
2023-05-31T03:00:00-04:00,1.06848,1.06848,1.0674,1.06773,1.06967880928,1.068648888888889,1.0689211111111094,1.069279999999997,1.0695510000000026,1.0715773999999996,1.0716994000000002,1.0715630000000032,1.0688161820238586,1.0692277722126018,-5265,-245728,-239198.6,-0.05752353630155948,-186.03929197831852,-0.1934941110487957
2023-05-31T03:15:00-04:00,1.06773,1.06808,1.06719,1.06783,1.0694965045376,1.0684306666666665,1.0687322222222204,1.069109111111108,1.0694015000000026,1.0714951999999995,1.0716898000000001,1.071533750000003,1.0686189456190869,1.069031417770082,4873,-240855,-240332.8,-0.06143680553519693,-185.58290319089105,-0.15894832309519458
2023-05-31T03:30:00-04:00,1.06783,1.0680399999999999,1.06723,1.06727,1.06926585408384,1.0681382222222222,1.0684922222222206,1.0689195555555524,1.0692390000000027,1.0713903999999994,1.0716687000000003,1.0715018000000032,1.0683491564952694,1.0688223342160659,-4059,-244914,-241582,-0.0667726550077096,-187.7115566282364,-0.20197675397173634
2023-05-31T03:45:00-04:00,1.06727,1.06774,1.06697,1.06741,1.069058268675456,1.0679217777777779,1.0682999999999983,1.06871933333333,1.0690860000000026,1.0712845999999994,1.0716486000000003,1.0714707000000032,1.0681613251962154,1.0686066673728531,4176,-240738,-242539.6,-0.07182372855359727,-187.16376647204336,-0.1618122977346287
2023-05-31T04:00:00-04:00,1.06741,1.06768,1.06658,1.06666,1.0688076764344012,1.0675937777777778,1.0679588888888871,1.0684808888888857,1.0689240000000026,1.0711609999999994,1.0716304,1.071434450000003,1.0678610601569722,1.068361333898283,-4643,-245381,-243523.2,-0.07806353955137728,-190.42610240668904,-0.28698830546026827
2023-05-31T04:15:00-04:00,1.06666,1.06726,1.06662,1.06704,1.068495801733585,1.06741,1.0677344444444428,1.0682435555555525,1.0687830000000027,1.0710417999999995,1.0716235000000003,1.0713984000000032,1.0676968481255777,1.0681374671186268,3431,-241950,-242767.6,-0.0904991285563843,-189.2038010173052,-0.1889510411015201
2023-05-31T04:30:00-04:00,1.06704,1.06713,1.0662,1.06648,1.0682275894908833,1.0671591111111112,1.0675022222222206,1.0679975555555525,1.0686080000000027,1.0709111999999994,1.0716052000000003,1.0713610500000033,1.0674534785004621,1.0679043736949017,-3300,-245250,-243646.6,-0.09959388899607635,-190.93569485446187,-0.19558849677605822
2023-05-31T04:45:00-04:00,1.06648,1.06653,1.06584,1.0659399999999999,1.067903175172342,1.0668466666666667,1.0672044444444426,1.067739999999997,1.0684155000000026,1.0707659999999994,1.0715743000000002,1.0713225500000032,1.0671507828003697,1.0676646989559218,-4922,-250172,-244698.2,-0.10622111497830403,-193.42789348922392,-0.2507907394583684
2023-05-31T05:00:00-04:00,1.0659399999999999,1.06702,1.0659399999999999,1.0663,1.0675318036413204,1.0666657777777777,1.0669622222222204,1.0674724444444414,1.0682360000000026,1.0706241999999992,1.0715471000000003,1.0712866000000032,1.0669806262402957,1.0674285591647377,3967,-246205,-245791.6,-0.11239776399029075,-192.0881182673535,-0.2040281521413663
2023-05-31T05:15:00-04:00,1.0663,1.06736,1.06601,1.06722,1.06584,1.0667173333333333,1.0669055555555538,1.0672617777777746,1.0681035000000025,1.0705001999999992,1.0715220000000003,1.0712551500000032,1.0670285009922365,1.0672620473317906,2723,-243482,-245411.8,-0.11230415202586194,-189.73872316278624,-0.04776488438088378
2023-05-31T05:30:00-04:00,1.06722,1.06763,1.06698,1.06746,1.0658703999999999,1.0668282222222223,1.0668644444444428,1.0670877777777747,1.0679850000000024,1.0703905999999994,1.0714926000000002,1.0712273500000031,1.0671148007937892,1.067145637865433,3059,-240423,-245106.4,-0.1040993725679747,-189.0508050203226,-0.034649710159855164
2023-05-31T05:45:00-04:00,1.06746,1.0675999999999999,1.0669899999999999,1.06759,1.065940784,1.0669733333333333,1.0668999999999984,1.0669673333333303,1.0678745000000025,1.0702783999999994,1.0714639000000004,1.0712012500000032,1.0672098406350314,1.0670969102923469,2413,-238010,-243658.4,-0.09636920020183212,-188.75693920802058,0.02998304084253263
2023-05-31T06:00:00-04:00,1.06759,1.06762,1.067,1.06706,1.06600835264,1.0670053333333334,1.0668611111111095,1.0668986666666638,1.0677510000000026,1.0701521999999994,1.0714346000000003,1.0711755500000033,1.067179872508025,1.0671027282338779,-2146,-240156,-241655.2,-0.08612881863826861,-189.82231074578348,-0.03278964971286314
2023-05-31T06:15:00-04:00,1.06706,1.06726,1.06676,1.06721,1.0660732185344,1.0670751111111112,1.0669222222222206,1.0668906666666638,1.0676400000000026,1.0700311999999994,1.0713910000000002,1.0711481000000034,1.06718589800642,1.0671437825871029,2125,-238031,-240020.4,-0.07766399684574377,-189.52359277303574,0.05156282226764391
2023-05-31T06:30:00-04:00,1.06721,1.06786,1.06721,1.06771,1.066135489793024,1.0672326666666667,1.066996666666665,1.066908888888886,1.0675685000000026,1.0699197999999994,1.0713478000000003,1.0711232000000033,1.067290718405136,1.0671962260696826,2236,-235795,-238483,-0.06016366264616791,-188.47600138989665,0.06279052331683427
2023-05-31T06:45:00-04:00,1.06771,1.06788,1.06731,1.06762,1.0662389604054425,1.0673573333333335,1.0671233333333316,1.0669606666666638,1.0674630000000027,1.0698101999999994,1.0713046000000004,1.0710992500000034,1.0673565747241087,1.0672445808557467,-2405,-238200,-238038.4,-0.04795488110726959,-188.67872497588894,0.10689370639861213
2023-05-31T07:00:00-04:00,1.06762,1.06806,1.06746,1.06774,1.0663702435730071,1.0674806666666665,1.0673233333333316,1.0670453333333305,1.0673970000000028,1.0696987999999994,1.0712521000000002,1.0710800000000034,1.067433259779287,1.0672892646845977,2263,-235937,-237623.8,-0.027278404781871473,-188.42436481028716,0.16886503930803085
2023-05-31T07:15:00-04:00,1.06774,1.06827,1.06772,1.06822,1.0665392192157064,1.06766,1.067536666666665,1.0671804444444415,1.0673795000000026,1.0695991999999992,1.0712080000000002,1.0710634500000034,1.0675906078234296,1.0673714117476787,2064,-233873,-236367.2,-0.0021725398103577807,-187.49649847578618,0.18006189627683783
2023-05-31T07:30:00-04:00,1.06822,1.06872,1.06815,1.06817,1.0667469129098217,1.0677866666666667,1.0676422222222206,1.0673244444444416,1.0673570000000028,1.069498599999999,1.0711555000000001,1.0710462500000033,1.0677064862587438,1.0674755293981435,-2645,-236518,-236064.6,0.01713080439855323,-187.62030256108667,0.08901632278255714
2023-05-31T07:45:00-04:00,1.06817,1.0684,1.06788,1.06797,1.0670231451024466,1.0678522222222222,1.0676988888888872,1.067464888888886,1.0673315000000028,1.0693883999999994,1.0711037,1.0710280500000033,1.067759189006995,1.0675692235185152,-2974,-239492,-236804,0.027057641028968366,-188.17714276442504,0.04777696588162652
2023-05-31T08:00:00-04:00,1.06797,1.0687,1.0679,1.06868,1.067260704788104,1.0680484444444445,1.0678199999999984,1.0676042222222193,1.067379000000003,1.0692963999999991,1.0710531,1.0710141000000035,1.067943351205596,1.0676865788148127,2408,-237084,-236580.8,0.037594840312492404,-186.57627382615902,0.10209912044886477
2023-05-31T08:15:00-04:00,1.06868,1.06873,1.06798,1.06825,1.0674650061177695,1.0681344444444443,1.0679522222222204,1.067729999999997,1.0674000000000028,1.0691981999999993,1.0710028,1.0709981500000034,1.0680046809644768,1.0678008630518507,-2463,-239547,-237302.8,0.04145730941058746,-187.56730013899391,0.11152137649242072
2023-05-31T08:30:00-04:00,1.06825,1.06859,1.06795,1.06851,1.0676674051389263,1.068246,1.068096666666665,1.067841999999997,1.0674620000000028,1.0691115999999994,1.0709511,1.0709846000000034,1.0681057447715814,1.067903890441481,2851,-236696,-237867.4,0.05200631141980378,-186.87339889864717,0.12181295152782291
2023-05-31T08:45:00-04:00,1.06851,1.06869,1.06801,1.06808,1.067837420316698,1.0682426666666667,1.0681377777777759,1.0679411111111083,1.0674955000000028,1.0690121999999993,1.0708879,1.0709674500000035,1.0681005958172651,1.0679827123531853,-2938,-239634,-238490.6,0.056541103040183775,-188.05573692075313,0.034653604443152304
2023-05-31T09:00:00-04:00,1.06808,1.06868,1.06783,1.06837,1.06873,1.0682891111111112,1.0682211111111093,1.0680455555555528,1.0675810000000028,1.0689179999999994,1.0708289,1.0709501500000034,1.068154476653812,1.0680617698825485,3182,-236452,-237882.6,0.05843891681276166,-187.19177541974162,0.0702497143178311
2023-05-31T09:15:00-04:00,1.06837,1.06874,1.06817,1.06858,1.06783,1.068360888888889,1.0683144444444426,1.0681444444444415,1.0676580000000029,1.0688193999999993,1.0707788,1.0709339000000033,1.0682395813230496,1.0681210159060393,2978,-233474,-237160.6,0.05886209757295987,-186.60641641490236,0.07867083746981232
2023-05-31T09:30:00-04:00,1.06858,1.07052,1.06854,1.06988,1.06783,1.0686740000000001,1.068498888888887,1.0682537777777747,1.0678280000000027,1.0687479999999994,1.0707438,1.0709242500000034,1.0685676650584397,1.0682336127248317,5764,-227710,-234793.2,0.06623098384540839,-179.59411972209585,0.15539870064218933
2023-05-31T09:45:00-04:00,1.06988,1.0702099999999999,1.06891,1.06917,1.0679376,1.0688082222222222,1.0686099999999983,1.0683564444444413,1.0679895000000026,1.0686705999999995,1.0707134,1.0709148500000034,1.0686881320467518,1.0683500901798657,-6902,-234612,-234376.4,0.06312392060390856,-184.17446518139963,0.09361805705083365
2023-05-31T10:00:00-04:00,1.06917,1.0692,1.0663,1.0663,1.07052,1.0683462222222222,1.0684244444444424,1.0684137777777747,1.0679895000000028,1.0685631999999994,1.0706444,1.0708898500000033,1.0682105056374014,1.0683720721438932,-15683,-250295,-236508.6,0.04400677960376449,-226.2727376731445,-0.15637143365450903
2023-05-31T10:15:00-04:00,1.0663,1.06658,1.06579,1.06641,1.0704356,1.0679433333333335,1.0681722222222203,1.0684039999999968,1.0679490000000027,1.0684647999999994,1.0705751000000001,1.0708657000000033,1.067850404509921,1.068311257715115,7250,-243045,-237827.2,0.02890815207234187,-225.5248243279317,-0.2124115731556681
2023-05-31T10:30:00-04:00,1.06641,1.06847,1.0664,1.06766,1.070249776,1.067840888888889,1.0681066666666648,1.0683624444444413,1.0679590000000025,1.0683961999999996,1.0705233,1.0708484500000033,1.0678123236079369,1.0682258061720922,7573,-235472,-238226.8,0.01739449155132024,-216.64807898608402,-0.055230517201017404
2023-05-31T10:45:00-04:00,1.06766,1.06766,1.06573,1.06611,1.07007138496,1.0674415555555554,1.0678399999999981,1.0682306666666637,1.0678850000000026,1.0683019999999994,1.0704543,1.0708216000000033,1.0674718588863494,1.0680066449376742,-11263,-246735,-242031.8,0.003375653113268669,-232.99939869460718,-0.22461184265942102
2023-05-31T11:00:00-04:00,1.06611,1.0664,1.06548,1.06575,1.0698109018624,1.0670235555555554,1.0675811111111093,1.068024888888886,1.0678195000000028,1.0682065999999995,1.0703836,1.0707930000000034,1.0671274871090795,1.0676945159501396,-7392,-254127,-245934.8,-0.014266314951324962,-235.49550134817892,-0.21814845329937302
2023-05-31T11:15:00-04:00,1.06575,1.06597,1.06509,1.06555,1.069464429713408,1.0666173333333335,1.0672677777777761,1.0677935555555524,1.0677365000000028,1.0681081999999995,1.070311,1.0707645500000034,1.0668119896872637,1.0674148127601122,-5204,-259331,-247742,-0.031228341526006252,-236.47209060457104,-0.26395349925587996
2023-05-31T11:30:00-04:00,1.06555,1.06672,1.06553,1.06652,1.0690269867420672,1.0664677777777778,1.067038888888887,1.0675668888888858,1.0676770000000029,1.0680405999999996,1.0702452,1.0707428500000034,1.066753591749811,1.06719545020809,4120,-255211,-250175.2,-0.04547917711973159,-232.72153924611797,-0.19277920230588003
2023-05-31T11:45:00-04:00,1.06652,1.06667,1.06519,1.06525,1.0686332880678604,1.06611,1.0665244444444426,1.0672504444444415,1.0675585000000027,1.0679483999999995,1.0701702,1.0707143500000034,1.0664528733998488,1.0669235601664726,-3555,-258766,-254834,-0.06570381363117248,-236.95479319353535,-0.4327588140725981
2023-05-31T12:00:00-04:00,1.06525,1.06542,1.06399,1.06432,1.0682789592610744,1.065669111111111,1.0659855555555537,1.0668795555555526,1.0673875000000028,1.0678351999999993,1.0700896,1.0706816500000034,1.066026298719879,1.0666344481331784,-4514,-263280,-258143,-0.10308050370505834,-240.89567092176858,-0.4536229037477689
2023-05-31T12:15:00-04:00,1.06432,1.0647199999999999,1.06406,1.06452,1.0677642841497454,1.0653759999999999,1.0657877777777758,1.066520888888886,1.0672025000000027,1.0677297999999993,1.0700123999999998,1.0706501000000035,1.0657250389759032,1.0663539585065431,3980,-259300,-259177.6,-0.1322980670854278,-240.14777555195508,-0.1669323830066693
2023-05-31T12:30:00-04:00,1.06452,1.06468,1.06361,1.06362,1.067311370051776,1.0649424444444444,1.065477777777776,1.0661628888888859,1.0669750000000027,1.0676043999999993,1.0699257999999998,1.0706152000000033,1.0653040311807225,1.0660523668052349,-4022,-263322,-259975.8,-0.1369129409704907,-243.54818136866083,-0.261625453624785
2023-05-31T12:45:00-04:00,1.06362,1.0639399999999999,1.0635,1.06379,1.0667931782445275,1.0646048888888888,1.0650477777777758,1.0657646666666636,1.0667660000000025,1.0674827999999994,1.0698422999999997,1.0705798500000034,1.065001224944578,1.0657018934441882,2651,-260671,-261067.8,-0.14194790140179997,-243.12446801238696,-0.36247494520727946
2023-05-31T13:00:00-04:00,1.06379,1.0643799999999999,1.06354,1.06403,1.066266269725403,1.0644013333333333,1.0648166666666645,1.065423111111108,1.0665335000000025,1.0673667999999994,1.0697596999999996,1.0705449000000034,1.0648069799556623,1.065372714755351,2664,-258007,-260916,-0.1584153111583857,-242.52344713420607,-0.1951018187616531
2023-05-31T13:15:00-04:00,1.06403,1.06491,1.06398,1.06482,1.0658236665693386,1.0644019999999998,1.0647133333333314,1.0651686666666635,1.0663620000000027,1.0672671999999994,1.0696828999999997,1.0705149000000034,1.06480958396453,1.0651293718042811,3120,-254887,-259237.4,-0.15330318738263898,-240.20697109499645,-0.08726249120336621
2023-05-31T13:30:00-04:00,1.06482,1.06681,1.06479,1.06665,1.0635,1.0647893333333334,1.0648355555555535,1.0649782222222193,1.0662690000000026,1.0672095999999995,1.0696263999999998,1.0704918500000034,1.065177667171624,1.0650198974434253,4288,-250599,-257497.2,-0.13772953247497402,-232.8376128936103,0.10323307212238758
2023-05-31T13:45:00-04:00,1.06665,1.0669899999999999,1.0662099999999999,1.0663,1.0635662,1.0650822222222223,1.0648111111111092,1.064844888888886,1.0661800000000026,1.0671469999999994,1.0695686999999998,1.0704664500000034,1.0654021337372992,1.0650395179547405,-3658,-254257,-255684.2,-0.12083952610952436,-234.03791289829812,-0.020627836327484432
2023-05-31T14:00:00-04:00,1.0663,1.0672,1.06628,1.06714,1.063703152,1.065548,1.0650211111111092,1.0648395555555525,1.0661185000000026,1.0671069999999994,1.0695236,1.0704455000000033,1.0657497069898394,1.065189214363793,2915,-251342,-253818.4,-0.11083153124888617,-231.7415610273426,0.17742314010795093
2023-05-31T14:15:00-04:00,1.06714,1.06756,1.06695,1.06751,1.06391296288,1.0660457777777779,1.0653755555555535,1.0649513333333305,1.0660650000000027,1.0670625999999996,1.0694822999999998,1.0704269000000033,1.0661017655918714,1.0654481714910349,2789,-248553,-251927.6,-0.08579769074222805,-230.77455576092964,0.29972188815394113
2023-05-31T14:30:00-04:00,1.06751,1.06799,1.06726,1.06793,1.0642047258496,1.0665566666666666,1.0657544444444425,1.0651595555555526,1.0659675000000026,1.0670399999999995,1.0694436999999999,1.0704100000000034,1.0664674124734972,1.0657797371928281,2412,-246141,-250178.4,-0.04903697000726038,-229.82558104406496,0.320332168489097
2023-05-31T14:45:00-04:00,1.06793,1.06796,1.06714,1.0674,1.06458325326464,1.0668857777777778,1.0661744444444423,1.0654273333333304,1.0658790000000027,1.0670165999999994,1.0694008999999998,1.0703907000000035,1.0666539299787978,1.066074989754263,-2847,-248988,-249856.2,-0.010948440483566862,-231.238510730468,0.35539008292434277
2023-05-31T15:00:00-04:00,1.0674,1.06765,1.06703,1.06757,1.064923927938176,1.0671648888888887,1.0665944444444424,1.0657839999999972,1.0659425000000025,1.0669955999999994,1.0693598,1.0703717500000034,1.0668371439830382,1.0663619918034106,2639,-246349,-248274.6,0.03325418860289359,-230.81820906286447,0.3553332894650161
2023-05-31T15:15:00-04:00,1.06757,1.06761,1.06717,1.06732,1.0652305351443583,1.06731,1.0669599999999981,1.0661717777777748,1.0659880000000026,1.0669723999999996,1.0693154999999999,1.0703521500000033,1.0669337151864307,1.0665987934427288,-2017,-248366,-247679.4,0.0618104838837652,-231.2905434296973,0.30920180821969445
2023-05-31T15:30:00-04:00,1.06732,1.06845,1.06721,1.06834,1.0655064816299225,1.067586,1.0673511111111091,1.0665668888888862,1.0660220000000027,1.0669845999999996,1.069281,1.0703373000000034,1.0672149721491446,1.0668214347541833,2422,-245944,-247157.6,0.09361223149819664,-228.9759236343219,0.3305723033000852
2023-05-31T15:45:00-04:00,1.06834,1.06891,1.06816,1.06862,1.0658597038343318,1.0678397777777777,1.0675699999999981,1.0669299999999973,1.0661475000000027,1.0670003999999995,1.0692478,1.0703245500000034,1.0674959777193156,1.0670271478033473,2887,-243057,-246540.8,0.12496281666153523,-228.2192731298013,0.18469038578725966
2023-05-31T16:00:00-04:00,1.06862,1.06913,1.06858,1.06876,1.0662867452975253,1.0680777777777777,1.0678433333333315,1.067263777777775,1.0662980000000026,1.0670301999999996,1.0692103,1.0703126000000034,1.0677487821754525,1.0672461182426782,2244,-240813,-244905.8,0.1329018641275972,-227.9252864928302,0.23070430460469912
2023-05-31T16:15:00-04:00,1.06876,1.06922,1.06872,1.06901,1.0667416660499212,1.0683111111111112,1.0680511111111093,1.0675551111111083,1.0664710000000026,1.0670621999999996,1.0691733999999997,1.0703020500000036,1.068001025740362,1.0674788945941431,1122,-239691,-243574.2,0.14373763394208164,-227.6628328081862,0.17523473958431304
2023-05-31T16:30:00-04:00,1.06901,1.0691,1.06877,1.06884,1.0671877661609352,1.068468888888889,1.0681988888888871,1.067802888888886,1.0665870000000024,1.0671057999999995,1.0691334,1.0702909000000034,1.0681688205922897,1.067725915675315,-652,-240343,-241969.6,0.14496661794282606,-227.76651752582217,0.12458899682439073
2023-05-31T16:45:00-04:00,1.06884,1.06895,1.06878,1.06887,1.067553568251967,1.0686031111111112,1.0683033333333316,1.0679933333333307,1.0667680000000026,1.0671423999999998,1.0690921,1.0702800000000035,1.0683090564738318,1.0679447325402525,1336,-239007,-240582.2,0.14721027686317598,-227.7290189292128,0.08802075042371137
2023-05-31T17:00:00-04:00,1.06887,1.06894,1.06816,1.06847,1.0678535259666129,1.0686364444444445,1.0684222222222204,1.0681637777777753,1.0669755000000025,1.0671821999999995,1.0690467,1.0702671500000036,1.0683412451790655,1.0681137860322023,-431,-239438,-239858.4,0.13787821100250483,-227.89031076077322,0.10024358253701766
2023-05-31T17:15:00-04:00,1.06847,1.06849,1.06813,1.06819,1.0680994912926225,1.0685900000000002,1.0684911111111093,1.0682933333333307,1.0671590000000024,1.0672271999999996,1.0689966,1.0702532500000035,1.0683109961432524,1.0682262288257622,-64,-239502,-239596.2,0.12798725438148725,-227.90708240621015,0.05807581704244827
2023-05-31T17:30:00-04:00,1.06819,1.06866,1.06819,1.06852,1.06922,1.0685957777777777,1.0686244444444426,1.0684079999999974,1.0674040000000027,1.0672715999999998,1.0689479,1.0702405500000034,1.0683527969146018,1.0682965830606101,498,-239004,-239458.8,0.11901819139127051,-227.75323337186236,0.11243113592923096
2023-05-31T17:45:00-04:00,1.06852,1.06881,1.06848,1.06862,1.0691994,1.0685948888888888,1.0686555555555537,1.0684993333333306,1.0676455000000025,1.0672995999999997,1.0688999000000001,1.0702291000000033,1.0684062375316814,1.0683440664484884,442,-238562,-239102.6,0.10886526562805031,-227.71186774463968,0.026208884811935892
2023-05-31T18:00:00-04:00,1.06862,1.06888,1.06857,1.06875,1.069179212,1.0686137777777778,1.0686699999999982,1.068572666666664,1.0678815000000026,1.0673253999999996,1.068858,1.0702185000000035,1.0684749900253452,1.0683772531587912,346,-238216,-238944.4,0.090559753381494,-227.66977607500962,0.01216522243643068
2023-05-31T18:15:00-04:00,1.06875,1.06905,1.06875,1.06891,1.06915942776,1.0686617777777778,1.068686666666665,1.0686255555555528,1.0680860000000025,1.0673517999999997,1.0688151000000001,1.0702102000000036,1.0685619920202762,1.0684214025270333,769,-237447,-238546.2,0.07149564756773724,-227.55465092881084,0.014034956398077633
2023-05-31T18:30:00-04:00,1.06891,1.0691599999999999,1.06889,1.06908,1.06819,1.0687404444444442,1.0686944444444426,1.0686662222222194,1.0682075000000026,1.0673921999999998,1.0687722000000002,1.0702011000000033,1.068665593616221,1.068492322021627,602,-236845,-238014.8,0.05548620646627716,-227.45890853702855,0.006548114610715942
2023-05-31T18:45:00-04:00,1.06908,1.06945,1.06908,1.06929,1.0682094,1.0688595555555556,1.0687444444444425,1.0686902222222194,1.0683570000000029,1.0674337999999997,1.0687325,1.0701943000000034,1.0687904748929768,1.0685798576173018,735,-236110,-237436,0.04633261773513399,-227.3145320637992,0.04210171775008995
2023-05-31T19:00:00-04:00,1.06929,1.06948,1.06924,1.06944,1.068259024,1.0689986666666667,1.0688077777777758,1.068720666666664,1.0684720000000028,1.0674683999999997,1.0686941,1.0701864500000036,1.0689203799143814,1.0686826860938419,763,-235347,-236793,0.03794695983094119,-227.20749842465554,0.05332734570153147
2023-05-31T19:15:00-04:00,1.06944,1.06972,1.06942,1.06959,1.0683322825600001,1.0691551111111113,1.0689322222222204,1.0687731111111085,1.0685760000000026,1.0675077999999996,1.068659,1.0701791500000035,1.069054303931505,1.068798548875074,839,-234508,-236051.4,0.03376260025518528,-227.08982001352442,0.10482278398083332
2023-05-31T19:30:00-04:00,1.06959,1.06959,1.06937,1.06957,1.0684432999552,1.0692826666666668,1.0690855555555536,1.0688528888888862,1.0686580000000026,1.0675443999999998,1.0686216,1.0701722500000035,1.069157443145204,1.0689176391000594,-895,-235403,-235642.6,0.034873528870656784,-227.10655539811114,0.1291904998174423
2023-05-31T19:45:00-04:00,1.06957,1.06959,1.06927,1.06932,1.068545435958784,1.0693295555555555,1.0691744444444427,1.068948888888886,1.0687540000000026,1.0675663999999996,1.0685828000000002,1.0701641500000036,1.0691899545161632,1.069022511280048,-831,-236234,-235520.4,0.03925145527606686,-227.30079233444994,0.07486991352526241
2023-05-31T20:00:00-04:00,1.06932,1.06946,1.0689899999999999,1.06935,1.0686394010820812,1.0693646666666667,1.0692555555555536,1.0690511111111083,1.0688430000000024,1.0675899999999998,1.0685443000000001,1.0701558000000035,1.0692219636129305,1.0691088090240384,1862,-234372,-235172.8,0.0383257672395421,-227.24855352847985,0.06831240291217827
2023-05-31T20:15:00-04:00,1.06935,1.06951,1.06909,1.06932,1.0687258489955147,1.0693775555555556,1.069318888888887,1.0691533333333305,1.0689430000000026,1.0676169999999998,1.0685027000000002,1.0701482000000035,1.0692415708903444,1.0691730472192311,-1190,-235562,-235215.8,0.037075350906233435,-227.28193829492673,0.053333333333329534
2023-05-31T20:30:00-04:00,1.06932,1.06933,1.06881,1.06887,1.0688053810758735,1.0692877777777778,1.0693144444444425,1.069229777777775,1.0689695000000026,1.0676207999999996,1.0684586000000003,1.0701376500000037,1.0691672567122756,1.0691956377753853,-1329,-236891,-235692.4,0.03129046901418488,-227.84121895927424,-0.003742129833198305
2023-05-31T20:45:00-04:00,1.06887,1.06907,1.06852,1.06865,1.06972,1.0691548888888889,1.0692666666666648,1.0692659999999974,1.0689710000000026,1.0676287999999996,1.0684135000000001,1.0701259500000035,1.0690638053698205,1.0691769102203086,-2185,-239076,-236427,0.027476786392243893,-228.29094624135695,-0.04022149885882539
2023-05-31T21:00:00-04:00,1.06865,1.06879,1.0684,1.06863,1.069696,1.0690275555555555,1.0691933333333314,1.069269777777775,1.0689645000000028,1.0676311999999997,1.0683714000000004,1.0701149500000036,1.0689770442958564,1.069134328176247,-1779,-240855,-237351.2,0.023222507077650573,-228.32424058468754,-0.061723199506224215
2023-05-31T21:15:00-04:00,1.06863,1.06897,1.06832,1.06874,1.06964416,1.0689368888888888,1.0691155555555536,1.069241777777775,1.0689510000000026,1.0676443999999996,1.0683283000000003,1.0701043000000037,1.068929635436685,1.069075862540998,2390,-238465,-238169.8,0.018166404802760414,-228.07822465775294,-0.06545481747455892
2023-05-31T21:30:00-04:00,1.06874,1.06883,1.06801,1.06811,1.0695647104,1.0687357777777777,1.068951111111109,1.0691682222222194,1.0689145000000027,1.0676391999999995,1.0682786000000002,1.0700910000000037,1.068765708349348,1.0689806900327987,-2492,-240957,-239248.8,0.009733983810151333,-229.54720682366826,-0.1383707775876876
2023-05-31T21:45:00-04:00,1.06811,1.06934,1.06803,1.06914,1.0694403335679998,1.0687735555555555,1.0689033333333313,1.0690859999999973,1.0689280000000028,1.0676503999999996,1.0682349000000002,1.0700833000000036,1.0688405666794785,1.0689153520262393,3827,-237130,-239296.6,0.004187561783447484,-225.85675359319544,-0.0402030722626785
2023-05-31T22:00:00-04:00,1.06914,1.06933,1.06881,1.0693,1.06801,1.0688528888888889,1.068901111111109,1.0690128888888861,1.0689695000000026,1.0676387999999997,1.0681934000000002,1.0700712500000038,1.0689324533435827,1.0688890816209917,1971,-235159,-238513.2,-0.00025392175448354037,-225.56178754571815,-0.0018703475105797164
2023-05-31T22:15:00-04:00,1.0693,1.06939,1.0688199999999999,1.06887,1.06803,1.0688466666666665,1.0688477777777756,1.0689437777777748,1.0690035000000024,1.0676327999999997,1.0681517000000003,1.0700579500000038,1.0689199626748662,1.0688776652967937,-1970,-237129,-237768,-0.006245472922876096,-226.35398805072128,-0.04488708093702118
2023-05-31T22:30:00-04:00,1.06887,1.06918,1.06887,1.06906,1.0680844,1.068889111111111,1.068818888888887,1.0688844444444414,1.0690305000000024,1.0676879999999995,1.0681256000000003,1.0700436500000037,1.068947970139893,1.0688813322374353,1762,-235367,-237148.4,-0.012833459470196472,-226.0407787736344,-0.024314517637390957
2023-05-31T22:45:00-04:00,1.06906,1.06918,1.06884,1.06904,1.068136624,1.068933333333333,1.0688377777777758,1.068861777777775,1.0690515000000027,1.0677405999999996,1.0681027,1.0700320000000039,1.0689663761119144,1.0689214657899488,-1566,-236933,-236343.6,-0.017768651181430697,-226.07007553901693,0.01590464696361611
2023-05-31T23:00:00-04:00,1.06904,1.06935,1.06891,1.06919,1.06818675904,1.0690037777777779,1.0688977777777757,1.0688606666666636,1.0690735000000027,1.0677711999999997,1.0680837000000003,1.070018800000004,1.0690111008895316,1.068955572631959,1601,-235332,-235984,-0.01731386151206737,-225.84543473979505,0.05053104384035792
2023-05-31T23:15:00-04:00,1.06919,1.06921,1.0689,1.069,1.0682348886784,1.0690242222222222,1.068938888888887,1.0688682222222194,1.0690780000000026,1.0678289999999997,1.0680655000000001,1.070003600000004,1.0690088807116251,1.0689708581055677,-1531,-236863,-236324.8,-0.015153357591010783,-226.11750050920946,0.03462377062219678
2023-05-31T23:30:00-04:00,1.069,1.0691,1.06883,1.06893,1.068281093131264,1.0690224444444445,1.0689599999999981,1.068890666666664,1.0690705000000027,1.0678925999999997,1.0680496000000002,1.069987350000004,1.0689931045693002,1.0689854864844546,-1168,-238031,-236505.2,-0.012436254175108295,-226.19398320331612,0.017777944121106393
2023-05-31T23:45:00-04:00,1.06893,1.06896,1.06853,1.0687,1.0683254494060135,1.0689704444444446,1.0690255555555537,1.0689319999999973,1.0690410000000026,1.0679555999999997,1.0680319000000003,1.0699693500000038,1.0689344836554402,1.0689827891875638,-1168,-239199,-237271.6,-0.011117985613251762,-226.44529994061412,0.055237756410865035
2023-06-01T00:00:00-04:00,1.0687,1.06871,1.06835,1.06842,1.06939,1.0688493333333333,1.0689455555555536,1.068953555555553,1.0689900000000025,1.0679935999999997,1.0680171000000003,1.069950850000004,1.068831586924352,1.0689558313500513,-933,-240132,-237911.4,-0.004343131437668975,-226.68974646442814,-0.06734384645603513
2023-06-01T00:15:00-04:00,1.06842,1.06914,1.06842,1.06907,1.0693692000000001,1.0688742222222223,1.0689199999999979,1.0689579999999972,1.0689640000000025,1.0680699999999996,1.0680092000000003,1.069935150000004,1.0688792695394818,1.0689294650800416,1331,-238801,-238605.2,-0.003349834534916737,-225.87999936122898,-0.021509398672023988
2023-06-01T00:30:00-04:00,1.06907,1.06915,1.06868,1.06873,1.0693488160000002,1.068836222222222,1.0689044444444424,1.0689511111111085,1.0689220000000024,1.0681581999999996,1.0679967000000004,1.069918900000004,1.0688494156315853,1.0688975720640337,-1036,-239837,-239200,-0.00485120952796427,-226.20948199566826,-0.013097944558274533
2023-06-01T00:45:00-04:00,1.06873,1.06891,1.0681,1.06815,1.0693288396800003,1.0686853333333333,1.068803333333331,1.068919777777775,1.0688635000000024,1.0682307999999996,1.0679803000000003,1.069899000000004,1.0687095325052682,1.0688408576512274,-1275,-241112,-239816.2,-0.005261378231442904,-226.90142476886638,-0.08512150861504186
2023-06-01T01:00:00-04:00,1.06815,1.06845,1.06785,1.06805,1.0692796860928002,1.0685346666666666,1.0686933333333313,1.0688533333333305,1.0687985000000024,1.0683193999999996,1.0679619000000002,1.069882150000004,1.0685776260042146,1.068769486120982,-2141,-243253,-240627,-0.009053112185350673,-227.10186478197312,-0.09260645064731407
2023-06-01T01:15:00-04:00,1.06805,1.06826,1.06799,1.06817,1.069193904927232,1.0684299999999998,1.068579999999998,1.0687802222222196,1.0687410000000024,1.0684069999999997,1.0679449000000003,1.069868900000004,1.0684961008033718,1.068702388896786,1652,-241601,-240920.8,-0.01193630052194228,-226.91625549401826,-0.09539932098130555
2023-06-01T01:30:00-04:00,1.06817,1.06827,1.06776,1.06794,1.0691132706315982,1.068302,1.0684622222222202,1.068688666666664,1.0686945000000023,1.0684851999999996,1.0679260000000004,1.0698557000000042,1.0683848806426974,1.0686035111174292,-2065,-243666,-241893.8,-0.01748448051825306,-227.36089445598157,-0.09915809167446782
2023-06-01T01:45:00-04:00,1.06794,1.06803,1.06757,1.06771,1.0690050089810703,1.0681515555555556,1.0683266666666646,1.0685731111111085,1.0686475000000022,1.0685429999999996,1.0679051000000002,1.069841000000004,1.068249904514158,1.0684836088939436,-1810,-245476,-243021.6,-0.02438774418922137,-227.7507103632422,-0.11413282441319815
2023-06-01T02:00:00-04:00,1.06771,1.06809,1.06733,1.06768,1.0688615080829633,1.068022222222222,1.0682133333333312,1.0684551111111085,1.0686000000000022,1.0685635999999996,1.0678866000000002,1.069826100000004,1.0681359236113264,1.0683688871151553,-3324,-248800,-244559.2,-0.03176381411733907,-227.84410651013596,-0.09544306166370552
2023-06-01T02:15:00-04:00,1.06768,1.0683,1.06759,1.06796,1.0686777271130077,1.0679715555555556,1.06816222222222,1.0683488888888863,1.0685610000000023,1.0685967999999997,1.0678719000000003,1.069813200000004,1.068100738889061,1.0682735096921245,2467,-246333,-245175.2,-0.0357041634653782,-227.19713363436782,-0.043054229610069536
2023-06-01T02:30:00-04:00,1.06796,1.06816,1.0674299999999999,1.06791,1.0685159998594467,1.067921111111111,1.0680333333333312,1.0682395555555528,1.0685510000000022,1.0686121999999998,1.0678596000000002,1.0697998000000042,1.068062591111249,1.0681868077537,-2488,-248821,-246619.2,-0.0367795008093653,-227.3136173978049,-0.1085055234923859
2023-06-01T02:45:00-04:00,1.06791,1.06853,1.06772,1.0684,1.06733,1.0679944444444442,1.0679966666666647,1.0681464444444415,1.0685140000000024,1.0686299999999997,1.0678463000000002,1.0697879000000041,1.068130072888999,1.0681358462029604,3145,-245676,-247021.2,-0.04434160954234372,-225.87056508066178,-0.030877770812079895
2023-06-01T03:00:00-04:00,1.0684,1.06867,1.06798,1.06847,1.067354,1.068089111111111,1.06803222222222,1.0680875555555527,1.0684725000000024,1.0686407999999998,1.0678404000000001,1.069778550000004,1.0681980583111992,1.0681254769623685,5473,-240203,-245966.6,-0.043790318087979827,-225.51198215291927,0.02995833918458063
2023-06-01T03:15:00-04:00,1.06847,1.06854,1.0672,1.06723,1.06867,1.0679286666666665,1.067941111111109,1.068033111111108,1.0683905000000025,1.0686373999999998,1.0678270000000003,1.069769100000004,1.0680044466489593,1.0680991815698953,-3799,-244002,-245007,-0.04317929390605001,-229.92086588386212,-0.07677543186180824
2023-06-01T03:30:00-04:00,1.06723,1.06751,1.06616,1.06629,1.06867,1.0675984444444444,1.06773222222222,1.0679471111111083,1.0682520000000024,1.0686118,1.0678037000000002,1.0697567000000041,1.0676615573191675,1.0680113452559166,-4199,-248201,-245380.6,-0.04815882963860996,-233.61928140816312,-0.17600194725559637
2023-06-01T03:45:00-04:00,1.06629,1.06703,1.06627,1.06701,1.0685696,1.067454,1.067628888888887,1.0678662222222193,1.0681505000000022,1.0686056,1.0677890000000003,1.069748750000004,1.0675312458553339,1.0679050762047335,3729,-244472,-244510.8,-0.04988398296170904,-231.10131725207032,-0.08708354401931527
2023-06-01T04:00:00-04:00,1.06701,1.06722,1.06644,1.06695,1.0684732160000001,1.0673182222222222,1.0675444444444426,1.0677757777777752,1.0680385000000023,1.0685778,1.0677812000000002,1.0697403000000039,1.0674149966842672,1.067762060963787,-4279,-248751,-245125.8,-0.04983958954881408,-231.34193355369803,-0.07118037669403414
2023-06-01T04:15:00-04:00,1.06695,1.06764,1.06686,1.06746,1.0683806873600001,1.0673013333333334,1.0675199999999982,1.0676733333333308,1.0679615000000022,1.0685546,1.0677775000000003,1.069733650000004,1.0674239973474138,1.06760724877103,3242,-245509,-246187,-0.04447074066907322,-229.79226393469054,-0.020605424846385337
2023-06-01T04:30:00-04:00,1.06746,1.06807,1.0671599999999999,1.0680399999999999,1.0682918598656002,1.0674053333333335,1.0675288888888872,1.0675908888888863,1.0679170000000022,1.0685402,1.0677852000000003,1.0697269500000042,1.067547197877931,1.0675157990168243,2625,-242884,-245963.4,-0.03682124485040712,-228.36598098263661,0.007490917262805532
2023-06-01T04:45:00-04:00,1.0680399999999999,1.06869,1.06801,1.06866,1.06616,1.0676315555555556,1.0676122222222206,1.0675668888888865,1.0679150000000022,1.0685332,1.0677977000000003,1.0697231500000042,1.0677697583023447,1.0675374392134596,2766,-240118,-244346.8,-0.029063182770585286,-226.76031078301844,0.07023063741326784
2023-06-01T05:00:00-04:00,1.06866,1.06908,1.06825,1.06908,1.0662106,1.067925111111111,1.067687777777776,1.0675786666666642,1.0679480000000023,1.068538,1.0678219000000002,1.069726150000004,1.0680318066418757,1.067637551370768,2832,-237286,-242909.6,-0.019801688828372355,-225.64729073922504,0.0636465743167366
2023-06-01T05:15:00-04:00,1.06908,1.06945,1.0688,1.06907,1.066325376,1.0682015555555555,1.0677544444444427,1.0676206666666643,1.0679480000000021,1.0685419999999999,1.0678422000000003,1.069732850000004,1.0682394453135005,1.0678024410966147,-2307,-239593,-241078,-0.016425874229518675,-225.6688700410548,0.05615506284686832
2023-06-01T05:30:00-04:00,1.06907,1.06947,1.06886,1.06946,1.06651285344,1.0685426666666666,1.0680022222222203,1.0677171111111086,1.0679845000000021,1.0685618,1.0678720000000002,1.0697386000000042,1.0684835562508004,1.068014352877292,2140,-237453,-239466.8,-0.008894964513581932,-224.88819150737575,0.20895214714730437
2023-06-01T05:45:00-04:00,1.06946,1.07097,1.06944,1.07086,1.0667494251648,1.0691142222222223,1.0685099999999983,1.0679133333333308,1.0681200000000022,1.0686151999999998,1.0679212,1.069747750000004,1.0689588450006402,1.0682966823018336,3313,-234140,-237718,0.015594802624310568,-220.5512364085413,0.42858884543604114
2023-06-01T06:00:00-04:00,1.07086,1.07097,1.07025,1.07034,1.06717148264832,1.0694802222222222,1.0688799999999983,1.0681668888888862,1.0682345000000022,1.0686516,1.0679616,1.069754350000004,1.0692350760005123,1.0685897458414673,-3041,-237181,-237130.6,0.043744099026883754,-222.02791870127757,0.31208704698175793
2023-06-01T06:15:00-04:00,1.07034,1.07123,1.07005,1.07042,1.0675513343834881,1.0697882222222221,1.069265555555554,1.068482444444442,1.0683470000000024,1.0686875999999998,1.0679936,1.069757800000004,1.0694720608004098,1.0688777966731742,3324,-233857,-236444.8,0.06509439891332931,-221.77947428174778,0.32522611181403643
2023-06-01T06:30:00-04:00,1.07042,1.07147,1.07042,1.07117,1.0679927742574695,1.0701691111111111,1.069677777777776,1.0688671111111085,1.0685085000000023,1.0687359999999997,1.0680307000000002,1.069761650000004,1.0698116486403277,1.0691922373385396,2999,-230858,-234697.8,0.09121089075704505,-219.67819627872086,0.34755400670750003
2023-06-01T06:45:00-04:00,1.07117,1.07138,1.07064,1.07088,1.0684795858614238,1.0704095555555555,1.0699933333333318,1.0692653333333308,1.068667000000002,1.0687753999999996,1.0680636000000001,1.0697637500000041,1.0700253189122622,1.0695005898708319,-2698,-233556,-233918.4,0.11010180004964863,-220.40863122368734,0.2659076439084843
2023-06-01T07:00:00-04:00,1.07088,1.07156,1.07087,1.07128,1.0688982438408245,1.0706668888888888,1.0702844444444426,1.0696202222222198,1.068847000000002,1.0688193999999998,1.0681058,1.069770200000004,1.0702762551298097,1.069764071896666,2915,-230641,-233218.6,0.12449308564832645,-219.31980707905873,0.24516684445942272
2023-06-01T07:15:00-04:00,1.07128,1.07135,1.07084,1.07087,1.0693241248262926,1.070784,1.0704833333333317,1.0699408888888864,1.0689925000000022,1.0688509999999998,1.0681424000000002,1.0697667000000042,1.0703950041038477,1.0699960575173328,-2205,-232846,-232351.6,0.13093927648192727,-220.1637040994456,0.16743368129606373
2023-06-01T07:30:00-04:00,1.07087,1.07144,1.07084,1.07139,1.0696818648540858,1.0709653333333333,1.0707411111111094,1.0702359999999973,1.0691665000000021,1.06889,1.0681792,1.0697635000000043,1.070594003283078,1.0702204460138665,2159,-230687,-231717.6,0.13724854395588174,-219.11532287670133,0.2170110469847718
2023-06-01T07:45:00-04:00,1.07139,1.07139,1.07048,1.07062,1.0699823664774322,1.0709411111111111,1.0708699999999984,1.0704744444444418,1.0692775000000023,1.0689105999999997,1.0682092,1.0697569000000042,1.0705992026264624,1.0703779568110934,-3075,-233762,-232298.4,0.13965916909961384,-221.3253024359659,0.10846595478090136
2023-06-01T08:00:00-04:00,1.07062,1.07073,1.06948,1.06955,1.07156,1.070677111111111,1.070724444444443,1.0706206666666642,1.0693315000000023,1.0689102,1.0682273,1.0697397000000044,1.07038936210117,1.0704507654488749,-3449,-237211,-233029.4,0.1353723652980406,-224.7723051073149,-0.12233158396054783
2023-06-01T08:15:00-04:00,1.06955,1.07012,1.0683799999999999,1.06925,1.0715184,1.0703822222222221,1.0706033333333318,1.070684444444442,1.0694325000000025,1.0689087999999998,1.0682376,1.0697228000000043,1.070161489680936,1.0704278123591002,-8297,-245508,-236002.8,0.11683799521568024,-227.09954553553212,-0.10183679952165063
2023-06-01T08:30:00-04:00,1.06925,1.07092,1.06903,1.07019,1.071392864,1.0702995555555554,1.070577777777776,1.0707033333333311,1.0696275000000024,1.0689255999999998,1.0682578,1.0697066500000043,1.0701671917447488,1.0703822498872806,9529,-235979,-236629.4,0.10224036504130264,-218.72240267838978,-0.021486892995268445
2023-06-01T08:45:00-04:00,1.07019,1.07114,1.07008,1.07079,1.0712723494399998,1.0703420000000001,1.070535555555554,1.0706622222222197,1.0698165000000024,1.0689549999999999,1.068286,1.0696948500000043,1.070291753395799,1.0703217999098247,5642,-230337,-236559.4,0.0856462128963634,-215.55922604620332,-0.03547522802170029
2023-06-01T09:00:00-04:00,1.07079,1.07132,1.07028,1.07049,1.0683799999999999,1.0703328888888888,1.0704922222222204,1.0705866666666644,1.0699935000000025,1.0689873999999997,1.0683041,1.0696786000000043,1.070331402716639,1.07026823992786,-5133,-235470,-236901,0.06378739848380284,-216.99732315207825,-0.03641864634694013
2023-06-01T09:15:00-04:00,1.07049,1.0712599999999999,1.07029,1.07123,1.0684387999999998,1.0704804444444445,1.0704866666666648,1.0705391111111087,1.0701820000000024,1.0690389999999999,1.0683339,1.0696683500000044,1.0705111221733112,1.0702925919422883,3997,-231473,-235753.4,0.047999430379640856,-214.23430808421227,-0.004667313867532812
2023-06-01T09:30:00-04:00,1.07123,1.07278,1.07116,1.07222,1.068496424,1.070827111111111,1.0706366666666647,1.0705457777777752,1.0703910000000025,1.0691107999999998,1.068371,1.0696610500000043,1.070852897738649,1.0704308735538308,8163,-223310,-231313.8,0.03559374368785775,-206.6902979276629,0.12606572226320303
2023-06-01T09:45:00-04:00,1.07222,1.07313,1.0719,1.07271,1.06866776704,1.0712417777777778,1.0707833333333316,1.070586888888886,1.0705935000000024,1.0691902,1.0684173000000001,1.0696526000000042,1.0712243181909191,1.0706422988430648,6354,-216956,-227509.2,0.03200102488705409,-203.7865468318051,0.12320443535967181
2023-06-01T10:00:00-04:00,1.07271,1.07417,1.07213,1.07239,1.0689355010176,1.071563111111111,1.070979999999998,1.0706757777777751,1.0707590000000025,1.0692758,1.0684575,1.0696432000000042,1.0714574545527353,1.0708754390744522,-13186,-230142,-227470.2,0.024746200230924394,-207.7200610155093,0.1653247650893921
2023-06-01T10:15:00-04:00,1.07239,1.07297,1.0721,1.07258,1.0693542609361921,1.0718831111111111,1.071316666666665,1.070840666666664,1.0709345000000023,1.0693446,1.0684975,1.0696381500000043,1.0716819636421884,1.071145551259562,7006,-223136,-225003.4,0.02748161666630713,-206.47877752722522,0.2832967135711363
2023-06-01T10:30:00-04:00,1.07258,1.07315,1.07217,1.07303,1.0697395200612967,1.0722257777777777,1.0717366666666648,1.0710906666666637,1.0711130000000026,1.0694192,1.0685290000000003,1.0696364000000043,1.0719515709137506,1.07143364100765,6870,-216266,-221962,0.042362255977041754,-203.59647504163075,0.3535188216039181
2023-06-01T10:45:00-04:00,1.07303,1.07365,1.07278,1.07315,1.0700939584563929,1.0725084444444444,1.0720655555555536,1.0713764444444416,1.0712275000000024,1.0695048,1.0685688000000002,1.0696411000000043,1.0721912567310006,1.0717013128061204,6127,-210139,-219327.8,0.06235938798199127,-202.91127518701276,0.2765864005457044
2023-06-01T11:00:00-04:00,1.07315,1.07402,1.07278,1.07384,1.0704200417798815,1.0728633333333333,1.0724044444444423,1.0717006666666637,1.0714025000000025,1.0696004,1.0686442000000003,1.0696443000000044,1.0725210053848004,1.0719606502448964,4381,-205758,-217088.2,0.08317484051096859,-200.09443690718294,0.2848364291784568
2023-06-01T11:15:00-04:00,1.07384,1.07407,1.07325,1.07368,1.0707200384374909,1.0731184444444444,1.0727588888888868,1.0720564444444416,1.0715655000000024,1.0696932,1.0687169,1.069646000000004,1.0727528043078403,1.0722197201959176,-3541,-209299,-212919.6,0.09529045100107766,-200.6220387845574,0.2979943764070684
2023-06-01T11:30:00-04:00,1.07368,1.07479,1.07359,1.07445,1.0709960353624917,1.0734566666666665,1.0731166666666647,1.0724164444444415,1.0717295000000024,1.0697983999999998,1.0687848000000002,1.0696540500000042,1.0730922434462722,1.0725017761567344,4031,-205268,-209346,0.11431740141210824,-197.7311681340845,0.30058904250254387
2023-06-01T11:45:00-04:00,1.07445,1.07537,1.0743,1.07506,1.0713754318262425,1.0738453333333333,1.0734322222222201,1.0727555555555526,1.0719385000000023,1.0699195999999997,1.0688743000000003,1.0696643000000041,1.0734857947570178,1.0728086209253875,3122,-202146,-206522,0.13274751051234465,-195.95870780554432,0.2648710152767113
2023-06-01T12:00:00-04:00,1.07506,1.0752599999999999,1.07475,1.0750899999999999,1.0718547800070934,1.0741768888888887,1.0736966666666645,1.0730817777777748,1.0721290000000026,1.0700427999999997,1.0689677000000004,1.0696756500000042,1.0738066358056142,1.0731316967403104,2976,-199170,-204328.2,0.1407932713450359,-195.87566127790873,0.22186797923015789
2023-06-01T12:15:00-04:00,1.0750899999999999,1.07537,1.07498,1.07537,1.0722766064062421,1.0745115555555556,1.0740277777777756,1.0734064444444413,1.0723540000000025,1.0701761999999997,1.0690659000000005,1.0696884500000041,1.0741193086444913,1.0734513573922484,2428,-196742,-202525,0.14741128743974224,-195.2433049170458,0.2778839787763764
2023-06-01T12:30:00-04:00,1.07537,1.07602,1.07532,1.07601,1.072647813637493,1.0749079999999998,1.074408888888887,1.0737364444444415,1.0725850000000026,1.0703279999999997,1.0691608000000004,1.069703000000004,1.074497446915593,1.073800285913799,2319,-194423,-199549.8,0.15830865125541171,-193.86316598811908,0.31978966603888026
2023-06-01T12:45:00-04:00,1.07601,1.0764,1.07581,1.07599,1.073119919728244,1.0752242222222224,1.0747377777777758,1.0740606666666639,1.0728535000000026,1.0704664,1.0692682000000004,1.0697192000000042,1.0747959575324744,1.0741410287310393,-2766,-197189,-197934,0.16964455743150808,-193.91457814971585,0.2758543563553744
2023-06-01T13:00:00-04:00,1.07599,1.07616,1.0756,1.07577,1.0736447325717249,1.0754306666666666,1.0750288888888868,1.0743799999999972,1.0731645000000025,1.0706072,1.0693827000000002,1.069736150000004,1.0749907660259794,1.0744420229848317,-2017,-199206,-197346,0.1722863163278394,-194.32697975196143,0.24414107999812185
2023-06-01T13:15:00-04:00,1.07577,1.07612,1.07556,1.07605,1.074085575360249,1.0756348888888887,1.0752744444444426,1.0746955555555526,1.0735045000000025,1.0707651999999999,1.0694980000000003,1.069755200000004,1.0752026128207834,1.0747212183878656,1993,-197213,-196954.6,0.17041758986750533,-193.80824433453938,0.20580347165313692
2023-06-01T13:30:00-04:00,1.07605,1.07612,1.07572,1.0758699999999999,1.0744558833026092,1.0757539999999999,1.075517777777776,1.0749935555555528,1.0737885000000025,1.0709216,1.0696205000000005,1.069773150000004,1.0753360902566267,1.0749645747102927,-1389,-198602,-197326.6,0.15991335032989584,-194.04059413241131,0.2039713881230827
2023-06-01T13:45:00-04:00,1.0758699999999999,1.07643,1.0758699999999999,1.07641,1.0747669419741916,1.0759324444444445,1.0757355555555537,1.075258888888886,1.0740695000000025,1.0710864,1.0697467000000005,1.069794500000004,1.0755508722053013,1.0751752597682345,1358,-197244,-197890.8,0.1577098089853755,-193.35898761861293,0.18241891200150626
2023-06-01T14:00:00-04:00,1.07641,1.07658,1.07625,1.07649,1.0750662924188372,1.076083333333333,1.0758944444444425,1.0754902222222193,1.0743695000000026,1.0712574,1.0698713000000004,1.069815500000004,1.0757386977642411,1.0753638078145877,1639,-195605,-197574,0.15139277272528262,-193.23717529802897,0.13301583167451514
2023-06-01T14:15:00-04:00,1.07649,1.07676,1.07633,1.07674,1.0753690339350699,1.0762524444444446,1.0760777777777757,1.0756999999999972,1.0746450000000025,1.071438,1.0699905000000003,1.069836700000004,1.075938958211393,1.0755534462516705,1766,-193839,-196500.6,0.13928744427568537,-192.82704608177974,0.15347552297948558
2023-06-01T14:30:00-04:00,1.07674,1.07685,1.07655,1.07668,1.075647227148056,1.0763728888888888,1.0762233333333313,1.075889777777775,1.0748680000000024,1.071618,1.0700908000000005,1.069858600000004,1.0760871665691143,1.0757303570013366,-1359,-195198,-196097.6,0.12990051210542933,-192.90277466992538,0.12181853687569343
2023-06-01T14:45:00-04:00,1.07668,1.0767,1.07613,1.07617,1.0758877817184447,1.0763622222222222,1.0762411111111092,1.0760344444444416,1.0750410000000024,1.0717822,1.0701895000000006,1.069879100000004,1.0761037332552914,1.0758838856010695,-1980,-197178,-195812.8,0.11982175583546606,-193.84065779211585,0.014869750281146088
2023-06-01T15:00:00-04:00,1.07617,1.07629,1.07599,1.07605,1.07685,1.076324,1.076247777777776,1.076136888888886,1.0752240000000024,1.0719450000000001,1.0702786000000004,1.069901100000004,1.076092986604233,1.0759923084808558,-1499,-198677,-196099.4,0.10538218982544319,-194.0078061051149,0.005576260002411638
2023-06-01T15:15:00-04:00,1.07605,1.07622,1.07598,1.07602,1.0768328,1.0762784444444444,1.0762755555555537,1.0762131111111082,1.0753960000000025,1.0720974,1.0703637000000004,1.069923000000004,1.0760783892833865,1.076060246784685,-1190,-199867,-196951.8,0.0895684329401322,-194.0409830020992,0.0232391682236987
2023-06-01T15:30:00-04:00,1.07602,1.07616,1.07566,1.07574,1.076798688,1.0761713333333334,1.0762411111111092,1.0762457777777747,1.0755315000000025,1.0722428000000002,1.0704418000000004,1.0699427500000038,1.0760107114267092,1.0760745974277481,-1813,-201680,-198520,0.07528451986985735,-194.51275861965289,-0.028809070210495096
2023-06-01T15:45:00-04:00,1.07574,1.07625,1.07572,1.07624,1.07673036672,1.076171111111111,1.0762822222222204,1.0762575555555525,1.0756860000000024,1.072423,1.0705302000000005,1.069965550000004,1.0760565691413675,1.076068477942199,1387,-200293,-199539,0.06282853711048554,-193.86808611514414,0.034390772119327014
2023-06-01T16:00:00-04:00,1.07624,1.07636,1.07596,1.076,1.0766661447168,1.0761146666666668,1.076236666666665,1.0762566666666638,1.0757940000000024,1.0726172,1.0706145000000005,1.0699871500000038,1.076045255313094,1.0760567823537595,-883,-201176,-200338.6,0.05141276651522007,-194.06499386806172,-0.0380895755334883
2023-06-01T16:15:00-04:00,1.076,1.07607,1.07588,1.07597,1.076605776033792,1.0760613333333333,1.0761788888888872,1.0762428888888862,1.0759085000000022,1.0727964,1.0707010000000003,1.070008250000004,1.0760302042504752,1.0760442258830079,-678,-201854,-200974,0.037889769983624234,-194.0838972137866,-0.048305139852655755
2023-06-01T16:30:00-04:00,1.07597,1.07615,1.07596,1.07608,1.0765490294717643,1.0760415555555556,1.0761055555555539,1.076208888888886,1.0759900000000022,1.072979,1.0707784000000005,1.070029700000004,1.0760401634003802,1.0760365807064065,526,-201328,-201266.2,0.023452869646220776,-194.0301224802904,-0.061296134628610895
2023-06-01T16:45:00-04:00,1.07608,1.07625,1.07605,1.07615,1.0764956877034584,1.0760504444444443,1.076046666666665,1.0761699999999972,1.0760445000000023,1.0731528000000001,1.0708537000000002,1.070050750000004,1.0760621307203042,1.0760468645651255,473,-200855,-201101.2,0.01044434954071313,-193.99935339249024,-0.049225396589529055
2023-06-01T17:00:00-04:00,1.07615,1.07615,1.07566,1.07608,1.0764455464412508,1.076057111111111,1.076036666666665,1.0761208888888862,1.0760940000000025,1.0733136,1.0709269000000003,1.070068600000004,1.0760657045762434,1.0760486916521006,-67,-200922,-201227,0.0003540297661227338,-194.0037115210039,-0.008362990977275478
2023-06-01T17:15:00-04:00,1.07608,1.07608,1.07564,1.07601,1.0763984136547757,1.0760517777777776,1.0760322222222203,1.0760799999999973,1.0761260000000026,1.0734606,1.0709969000000004,1.070085150000004,1.0760545636609946,1.0760505533216809,-316,-201238,-201239.4,-0.005204025685382776,-194.02426761348775,-0.0037172993820026954
2023-06-01T17:30:00-04:00,1.07601,1.07617,1.07574,1.07615,1.0763377405623937,1.0760753333333333,1.076046666666665,1.0760535555555528,1.0761330000000024,1.0736020000000002,1.0710700000000004,1.0701017000000042,1.0760736509287956,1.076059242657345,235,-201003,-201069.2,-0.007726118395275533,-193.99369168947217,0.012081559822304742
2023-06-01T17:45:00-04:00,1.07615,1.07616,1.07579,1.0758699999999999,1.0762819213174022,1.07604,1.0760611111111094,1.0760446666666639,1.0761270000000025,1.073738,1.0711400000000004,1.0701160500000042,1.0760329207430364,1.076057794125876,-1278,-202281,-201259.8,-0.00850055291186682,-194.32621039039682,0.012084704482492376
2023-06-01T18:00:00-04:00,1.0758699999999999,1.07627,1.07579,1.07623,1.07564,1.0760737777777778,1.0760599999999982,1.0760473333333305,1.0761500000000024,1.0738734,1.0712176000000004,1.070132150000004,1.0760723365944291,1.076059835300701,505,-201776,-201444,-0.005009122177707254,-194.15723086684838,-0.0009291607819878012
2023-06-01T18:15:00-04:00,1.07623,1.07643,1.07623,1.07635,1.0756526,1.0761317777777777,1.0760988888888872,1.076059777777775,1.0761650000000027,1.0739832,1.0712992000000003,1.0701479000000043,1.0761278692755434,1.076072268240561,933,-200843,-201428.2,-0.006553285824402958,-194.05320105909362,0.03252788104087829
2023-06-01T18:30:00-04:00,1.07635,1.07636,1.07619,1.07634,1.075683696,1.07618,1.0761399999999983,1.0760813333333306,1.0761885000000024,1.0741032000000001,1.0713774000000003,1.070162650000004,1.0761702954204346,1.076095414592449,-302,-201145,-201409.6,-0.0046770656521810255,-194.05600683788302,0.034387575861778805
2023-06-01T18:45:00-04:00,1.07634,1.07652,1.07623,1.07651,1.07571354816,1.076254,1.0761877777777764,1.0761095555555529,1.0761935000000025,1.0742250000000002,1.0714563000000004,1.0701781000000041,1.0762382363363476,1.0761283316739594,415,-200730,-201355,-0.002491119578852385,-193.99046063501032,0.03995985428594087
2023-06-01T19:00:00-04:00,1.07651,1.07653,1.07616,1.07622,1.0757619352704,1.0762604444444444,1.076195555555554,1.0761364444444417,1.0761800000000026,1.0743260000000001,1.0715310000000002,1.0701945000000042,1.076234589069078,1.0761686653391676,-640,-201370,-201172.8,-0.00034955612992284874,-194.1628696233152,0.006504669423408865
2023-06-01T19:15:00-04:00,1.07622,1.07626,1.07601,1.07601,1.075823380448768,1.0762233333333333,1.0761877777777762,1.0761619999999974,1.0761435000000026,1.0744286000000003,1.0716020000000004,1.0702085500000043,1.0761896712552625,1.0761921322713341,-415,-201785,-201174.6,0.00047345949793647555,-194.2438474902941,-0.006505092558175461
2023-06-01T19:30:00-04:00,1.07601,1.07614,1.07595,1.07599,1.0758799100128666,1.0761837777777776,1.076185555555554,1.076179333333331,1.0761090000000024,1.0745228000000002,1.0716711000000003,1.0702216500000041,1.0761497370042101,1.0761965058170677,-369,-202154,-201436.8,0.0029559013155740746,-194.25070616261124,-0.0018587187851329431
2023-06-01T19:45:00-04:00,1.07599,1.07616,1.07594,1.0760399999999999,1.0759319172118373,1.0761546666666666,1.0761733333333319,1.0761859999999976,1.0761025000000024,1.0746262000000002,1.0717386000000004,1.070235550000004,1.076127789603368,1.0761880046536543,460,-201694,-201546.6,0.006066849513116903,-194.22933049926868,-0.01022162337964545
2023-06-01T20:00:00-04:00,1.0760399999999999,1.07643,1.07589,1.07598,1.07653,1.0761159999999999,1.076185555555554,1.076185555555553,1.0760990000000024,1.074718,1.0718040000000004,1.0702490500000041,1.0760982316826944,1.0761600037229235,-1549,-203243,-202049.2,0.00532789805149854,-194.31570275308817,0.010224283603042608
2023-06-01T20:15:00-04:00,1.07598,1.07618,1.0758,1.076,1.0765172,1.0760788888888888,1.0761599999999985,1.076178444444442,1.0760980000000024,1.0748256000000003,1.0718681000000003,1.0702635500000042,1.0760785853461554,1.0761288029783391,824,-202419,-202259,0.006757241134140786,-194.30038648326894,-0.02137089655556456
2023-06-01T20:30:00-04:00,1.076,1.07633,1.07586,1.07625,1.076488512,1.076096888888889,1.0761488888888875,1.0761706666666642,1.0761235000000027,1.0749596000000003,1.0719349000000002,1.070278250000004,1.0761128682769243,1.0761134423826713,1157,-201262,-202154.4,0.005925248061886057,-194.03156678066685,-0.009290658243135503
2023-06-01T20:45:00-04:00,1.07625,1.07637,1.07593,1.07616,1.07646097152,1.0760991111111111,1.0761288888888876,1.0761593333333308,1.0761195000000026,1.0750978000000002,1.0720033000000002,1.070293050000004,1.0761222946215394,1.0761079539061371,-1395,-202657,-202255,0.0023010244428653425,-194.14822183293157,-0.016723340208490717
2023-06-01T21:00:00-04:00,1.07616,1.07641,1.07584,1.07615,1.0764345326592,1.0761033333333332,1.0760888888888873,1.0761424444444418,1.0761270000000027,1.0752170000000003,1.0720713000000004,1.0703078000000041,1.0761278356972315,1.0761079631249097,-1312,-203969,-202710,0.0009336886367326322,-194.16041332862002,-0.033441398593616216
2023-06-01T21:15:00-04:00,1.07615,1.07639,1.07599,1.07616,1.07641,1.0761175555555555,1.0760822222222208,1.0761217777777754,1.0761365000000025,1.0753244000000002,1.0721397000000004,1.070321200000004,1.0761342685577853,1.076115170499928,1034,-202935,-202648.4,-0.0030267227758782093,-194.1508050026431,-0.005575068294581868
2023-06-01T21:30:00-04:00,1.07616,1.07633,1.07591,1.07599,1.07641,1.0760991111111111,1.0760799999999986,1.0761057777777754,1.0761320000000025,1.0754344000000002,1.0722109000000004,1.070334750000004,1.0761054148462281,1.0761205363999424,-1751,-204686,-203101.8,-0.005252509876459458,-194.42740885337162,-0.0018587187851329431
2023-06-01T21:45:00-04:00,1.07599,1.0766499999999999,1.07597,1.07614,1.0758,1.076111111111111,1.0760966666666654,1.076095333333331,1.0761315000000025,1.0755326,1.0722858000000004,1.070349650000004,1.0761123318769825,1.0761204291199542,1742,-202944,-203438.2,-0.004309967175034604,-194.18456273026624,0.01394065000604973
2023-06-01T22:00:00-04:00,1.07614,1.07653,1.07607,1.07633,1.075817,1.0761577777777778,1.0761288888888876,1.0760953333333312,1.0761440000000024,1.0756148,1.0723628000000005,1.0703671000000041,1.076155865501586,1.0761271432959634,1478,-201466,-203200,-0.001946992250771365,-193.92361155291024,0.026950670978785504
2023-06-01T22:15:00-04:00,1.07633,1.07659,1.07618,1.07649,1.07583366,1.07623,1.0761855555555544,1.0761146666666646,1.0761680000000025,1.0756904,1.0724403000000005,1.070384300000004,1.0762226924012688,1.0761461146367708,1088,-200378,-202481.8,0.00042036570065119,-193.7618767689686,0.04739865053253875
2023-06-01T22:30:00-04:00,1.07649,1.07659,1.07639,1.07651,1.0758499868,1.0762948888888888,1.076242222222221,1.0761466666666646,1.0761860000000025,1.0757728000000002,1.0725243000000004,1.070401450000004,1.076280153921015,1.076175291709417,1259,-199119,-201718.6,0.003132761383348682,-193.73848593393978,0.04739776951672959
2023-06-01T22:45:00-04:00,1.07651,1.07672,1.07638,1.07655,1.075865987064,1.0763564444444444,1.0762755555555545,1.0761857777777757,1.0762200000000024,1.0758522000000001,1.0725984000000006,1.070416650000004,1.076334123136812,1.0762210333675337,1234,-197885,-200358.4,0.006473373990847415,-193.6926340607572,0.027874564459927247
2023-06-01T23:00:00-04:00,1.07655,1.07667,1.07639,1.0766,1.07590014758144,1.0764213333333335,1.0763244444444433,1.0762313333333313,1.0762385000000023,1.0759236,1.0726714000000006,1.070432400000004,1.0763872985094496,1.076276026694027,1176,-196709,-199111.4,0.006495287819314731,-193.6380151392021,0.04088611358905701
2023-06-01T23:15:00-04:00,1.0766,1.0769,1.07659,1.07679,1.0759329416781824,1.0765144444444446,1.0763955555555544,1.0762846666666648,1.0762605000000023,1.0759964000000002,1.0727506000000004,1.070451150000004,1.0764678388075597,1.0763384213552218,1027,-195682,-197954.6,0.009871000055052502,-193.45676862239,0.05947126329972346
2023-06-01T23:30:00-04:00,1.07679,1.07679,1.07632,1.07655,1.0759909651774915,1.0765453333333332,1.0764388888888878,1.0763353333333314,1.0762710000000024,1.0760506,1.0728255000000004,1.070475550000004,1.0764842710460478,1.0763907370841777,-1357,-197039,-197286.8,0.012702550598013548,-193.759223139984,0.03623996431756341
2023-06-01T23:45:00-04:00,1.07655,1.07684,1.07655,1.07678,1.076045507266842,1.0766135555555556,1.0765266666666655,1.0763922222222202,1.0762845000000023,1.0761126,1.0729029000000003,1.070502800000004,1.0765434168368382,1.0764433896673422,1080,-195959,-196654.8,0.01651609135413737,-193.52848606321078,0.07342075669848869
2023-06-02T00:00:00-04:00,1.07678,1.07679,1.0766,1.0767,1.0760967768308314,1.076648222222222,1.076588888888888,1.076454888888887,1.0763085000000026,1.0761576000000002,1.0729780000000004,1.070530850000004,1.0765747334694706,1.076491511733874,-836,-196795,-196436.8,0.02227198097210443,-193.59059717225819,0.05203783894287861
2023-06-02T00:15:00-04:00,1.0767,1.07685,1.0766,1.07679,1.0761449702209815,1.0766884444444444,1.0766399999999987,1.0765179999999979,1.0763475000000025,1.0761922000000002,1.0730559000000006,1.070560700000004,1.0766177867755764,1.0765376093870995,849,-195946,-196284.2,0.025788657768882402,-193.51963032912644,0.04273782204341651
2023-06-02T00:30:00-04:00,1.07679,1.07686,1.07643,1.07646,1.0761902720077225,1.0766524444444445,1.0766366666666656,1.07656622222222,1.0763710000000026,1.0762196000000002,1.0731312000000006,1.070590400000004,1.0765862294204611,1.0765612875096795,-1238,-197184,-196584.6,0.025005076667800507,-193.89903578422903,-0.002786834991497784
2023-06-02T00:45:00-04:00,1.07646,1.07657,1.07617,1.0763,1.0769,1.076585111111111,1.076613333333332,1.0766011111111091,1.0763840000000027,1.0762382000000001,1.0732072000000006,1.0706195500000038,1.076528983536369,1.076570230007744,-1465,-198649,-196906.6,0.021868081891131652,-194.11678655991963,-0.019507482512939357
2023-06-02T01:00:00-04:00,1.0763,1.07673,1.07616,1.07672,1.0768853999999999,1.0766064444444445,1.0766322222222209,1.0766222222222201,1.0764210000000027,1.0762524000000002,1.0732902000000006,1.070653650000004,1.0765671868290951,1.0765749840061953,1402,-197247,-197164.2,0.020810107766794688,-193.56969002549633,0.015791184803307184
2023-06-02T01:15:00-04:00,1.07672,1.07673,1.07639,1.0764,1.0768563839999998,1.07656,1.0766099999999987,1.0766264444444424,1.0764410000000026,1.0762606000000003,1.0733635000000006,1.070686350000004,1.076533749463276,1.0765667872049565,-991,-198238,-197452.8,0.01755820218892188,-193.864214135757,-0.018577001671928106
2023-06-02T01:30:00-04:00,1.0764,1.07701,1.07639,1.0769,1.07616,1.0766179999999999,1.076622222222221,1.076622888888887,1.0764735000000025,1.0762832000000002,1.0734452000000005,1.070720950000004,1.076606999570621,1.0765646297639653,1621,-196617,-197587,0.016363115176333317,-193.111241263219,0.010215548064158704
2023-06-02T01:45:00-04:00,1.0769,1.07723,1.07687,1.07713,1.076177,1.0767195555555555,1.0766866666666657,1.0766328888888868,1.0765220000000026,1.0763048000000002,1.0735350000000006,1.0707576500000038,1.0767115996564967,1.0765897038111727,1799,-194818,-197113.8,0.015628179381432232,-192.72701802986407,0.05387580697599043
2023-06-02T02:00:00-04:00,1.07713,1.0779,1.07704,1.07745,1.07621912,1.0768722222222222,1.07676111111111,1.0766624444444424,1.0765870000000026,1.0763364000000002,1.0736290000000006,1.0707954500000039,1.0768592797251972,1.0766557630489382,2620,-192198,-195823.6,0.018281228367813734,-191.9486533013724,0.06222255242481736
2023-06-02T02:15:00-04:00,1.07745,1.07767,1.07698,1.07705,1.0763199728,1.0769299999999997,1.076799999999999,1.0766959999999979,1.0766315000000026,1.0763492000000001,1.0737178000000005,1.070831350000004,1.0768974237801578,1.0767218104391507,-2264,-194462,-195266.6,0.0168076221683788,-192.7891563409565,0.03250673353766811
2023-06-02T02:30:00-04:00,1.07705,1.0774299999999999,1.07705,1.07725,1.0764147744319998,1.0770199999999999,1.07685111111111,1.0767442222222203,1.0766945000000026,1.0763644,1.0738109000000007,1.0708684500000039,1.0769679390241262,1.0768086483513208,2183,-192279,-194074.8,0.017094296829686727,-192.38378983058098,0.042719564631927026
2023-06-02T02:45:00-04:00,1.07725,1.07725,1.07659,1.0770899999999999,1.0765038879660798,1.0770677777777777,1.07692111111111,1.076803999999998,1.0767420000000025,1.0763714000000002,1.0739047000000006,1.070904900000004,1.076992351219301,1.0768857186810568,-2382,-194661,-193683.6,0.015014829078817247,-192.73757957298096,0.058525165821294654
2023-06-02T03:00:00-04:00,1.0770899999999999,1.07749,1.07675,1.07698,1.076587654688115,1.0770795555555557,1.0769966666666657,1.0768659999999983,1.0767745000000024,1.0763774000000002,1.0739977000000005,1.0709421500000038,1.0769898809754408,1.0769413749448455,-3948,-198609,-194441.8,0.01612873267186574,-193.14077707736718,0.06317941094490513
2023-06-02T03:15:00-04:00,1.07698,1.07741,1.07698,1.07741,1.07659,1.0771622222222224,1.0770733333333324,1.0769284444444427,1.0768205000000026,1.0764022000000002,1.0740922000000006,1.070982050000004,1.0770739047803526,1.0769842999558765,3056,-195553,-195112.8,0.02166020280478166,-191.9206244282931,0.06408351289100969
2023-06-02T03:30:00-04:00,1.07741,1.07759,1.0761,1.0762099999999999,1.0779,1.0769895555555555,1.0770522222222214,1.0769788888888872,1.0768055000000025,1.0764054000000003,1.0741752000000007,1.071017400000004,1.076901123824282,1.0769850399647012,-3640,-199193,-196059,0.018162424345537227,-195.97479136567102,-0.017651430694921453
2023-06-02T03:45:00-04:00,1.0762099999999999,1.07659,1.076,1.07619,1.0778640000000002,1.0768171111111111,1.0769733333333324,1.0770033333333315,1.0767875000000025,1.0764088000000003,1.0742531000000006,1.0710497000000039,1.0767588990594257,1.0769432319717613,-3068,-202261,-198055.4,0.017627574373426092,-196.0318062605333,-0.06592998421394637
2023-06-02T04:00:00-04:00,1.07619,1.07661,1.07601,1.07627,1.07778944,1.0766764444444445,1.076877777777777,1.0769946666666648,1.0767710000000026,1.0764194000000002,1.0743311000000006,1.071085750000004,1.0766611192475406,1.076876985577409,2915,-199346,-198992.4,0.013015201649569532,-195.81511589916568,-0.07984180182520781
2023-06-02T04:15:00-04:00,1.07627,1.07678,1.07603,1.0766,1.0777178624000001,1.0766208888888888,1.0767833333333325,1.0769519999999981,1.0767615000000026,1.0764266000000002,1.0744248000000007,1.071125900000004,1.0766488953980324,1.0768087884619273,2323,-197023,-198675.2,0.00809304078115958,-195.1028503895818,-0.07888997169242354
2023-06-02T04:30:00-04:00,1.0766,1.07737,1.0766,1.07717,1.077649147904,1.0766982222222221,1.076796666666666,1.076896666666665,1.0767925000000027,1.0764500000000004,1.0745336000000008,1.071168650000004,1.0767531163184259,1.076744630769542,2113,-194910,-198546.6,0.0038120677152383275,-193.9841340603974,0.011141544032301004
2023-06-02T04:45:00-04:00,1.07717,1.07771,1.07677,1.07741,1.076,1.076820888888889,1.0768144444444436,1.0768491111111094,1.0768240000000024,1.0764788000000003,1.0746376000000006,1.071213300000004,1.0768844930547408,1.0767413046156338,2656,-192254,-197158.8,0.003352015587509277,-193.39236117403772,0.014852634021809048
2023-06-02T05:00:00-04:00,1.07741,1.07748,1.07658,1.07689,1.0760342,1.0768360000000001,1.0767922222222213,1.076812888888887,1.0768335000000027,1.0764950000000004,1.0747370000000007,1.0712591000000038,1.0768855944437925,1.0767666436925072,-2768,-195022,-195711,-0.00047759356503317396,-194.72830570768807,-0.01856855044610738
2023-06-02T05:15:00-04:00,1.07689,1.07769,1.07639,1.07643,1.076067716,1.0767635555555555,1.0767311111111102,1.0767835555555538,1.0768155000000026,1.0765006000000001,1.0748267000000007,1.0713021000000038,1.076794475555034,1.0767933149540059,-3034,-198056,-195453,-0.005412791700197045,-196.02429694170428,-0.051068729224317114
2023-06-02T05:30:00-04:00,1.07643,1.07676,1.07601,1.07633,1.07771,1.0766833333333332,1.0766111111111103,1.0767491111111096,1.0768090000000026,1.0765056000000002,1.0749096000000007,1.0713474000000038,1.0767015804440272,1.0768038519632048,-2782,-200838,-196216,-0.009415088198246033,-196.2827438448935,-0.10024039130878402
2023-06-02T05:45:00-04:00,1.07633,1.07703,1.07631,1.07672,1.07769,1.0767051111111112,1.076667777777777,1.0767233333333315,1.0768300000000026,1.0765198000000002,1.0749902000000007,1.0713939500000038,1.0767052643552217,1.076794281570564,2484,-198354,-196904.8,-0.016972612977357734,-195.38268531265922,0.04738852082772047
2023-06-02T06:00:00-04:00,1.07672,1.0772,1.07662,1.0770899999999999,1.0776564,1.0767895555555556,1.0767677777777769,1.0767139999999982,1.0768485000000025,1.0765386000000001,1.0750703000000006,1.0714461000000037,1.0767822114841774,1.0767738252564512,1731,-196623,-197778.6,-0.012293438178175521,-194.7878510010462,0.08362835558775875
2023-06-02T06:15:00-04:00,1.0770899999999999,1.07728,1.0768199999999999,1.07693,1.077623472,1.0768220000000002,1.0768411111111105,1.076723777777776,1.0768750000000025,1.0765598000000003,1.0751489000000005,1.0714955500000038,1.076811769187342,1.076759060205161,-1742,-198365,-198447.2,-0.006350076722515435,-195.04662232006308,0.061322902245708126
2023-06-02T06:30:00-04:00,1.07693,1.07749,1.07693,1.07749,1.07759120256,1.0769517777777777,1.0769399999999991,1.076765555555554,1.0769045000000026,1.0765850000000003,1.0752292000000006,1.071550600000004,1.0769474153498737,1.0767896481641288,1736,-196629,-198161.8,0.00015918645131539862,-194.1439081232256,0.08266765744009451
2023-06-02T06:45:00-04:00,1.07749,1.07749,1.07654,1.07672,1.0775595785088001,1.0769077777777778,1.0768899999999992,1.0768213333333316,1.0768840000000026,1.0765924000000004,1.0752878000000006,1.0716045000000038,1.076901932279899,1.0768297185313032,-1919,-198548,-197703.8,0.0020694403359896906,-195.51527119852125,-0.041776135614625495
2023-06-02T07:00:00-04:00,1.07672,1.07693,1.07651,1.07663,1.0775285869386242,1.0768557777777776,1.0768033333333324,1.0768484444444426,1.0768430000000024,1.0765982000000003,1.0753507000000004,1.071656150000004,1.076847545823919,1.0768581748250425,-2243,-200791,-198191.2,-0.0007340484850076269,-195.70275726732262,-0.07239583816745741
2023-06-02T07:15:00-04:00,1.07663,1.07668,1.07628,1.07667,1.0774982151998518,1.076829111111111,1.0767788888888878,1.0768506666666648,1.0768240000000024,1.0766014000000004,1.0754132000000005,1.0717034000000039,1.0768120366591352,1.0768641398600343,2054,-198737,-198614,-0.004156803470987796,-195.62644507093196,-0.020429198896812766
2023-06-02T07:30:00-04:00,1.07667,1.0768199999999999,1.07643,1.07666,1.0774684508958547,1.0768053333333334,1.0768044444444433,1.0768433333333314,1.0767945000000023,1.0766102000000004,1.0754681000000006,1.0717494000000038,1.076781629327308,1.0768581118880274,-1586,-200323,-199005.6,-0.004568140470321878,-195.64117567548126,0.02136692585676286
2023-06-02T07:45:00-04:00,1.07666,1.07668,1.07575,1.07576,1.0774392818779377,1.0765964444444445,1.07674111111111,1.0768035555555537,1.0767280000000023,1.0766052000000004,1.0755169000000004,1.0717902500000038,1.0765773034618464,1.0767840895104221,-2342,-202665,-200212.8,-0.004201374070255505,-197.5988967759213,-0.05295773601032763
2023-06-02T08:00:00-04:00,1.07576,1.07652,1.07575,1.07609,1.0773717106028202,1.076466222222222,1.0766711111111098,1.076759777777776,1.0766835000000023,1.0766072000000002,1.0755650000000005,1.0718354000000039,1.076479842769477,1.0766996716083377,2694,-199971,-200497.4,-0.0020079033550865514,-196.77248568050985,-0.05851103350916752
2023-06-02T08:15:00-04:00,1.07609,1.07647,1.07573,1.07628,1.0773068421787073,1.0763880000000001,1.07658111111111,1.0767153333333312,1.0766270000000024,1.0766120000000003,1.0756191000000006,1.071880750000004,1.0764398742155816,1.07661813728667,3082,-196889,-199717,-0.002998679784567786,-196.2283118660522,-0.07520262930674108
2023-06-02T08:30:00-04:00,1.07628,1.07673,1.07341,1.07478,1.0772122316479849,1.0760277777777778,1.0763422222222212,1.0766279999999981,1.0765555000000027,1.0765880000000003,1.0756530000000004,1.071916100000004,1.0761078993724653,1.076477309829336,-19947,-216836,-203336.8,-0.012823280247092117,-224.02823381944415,-0.19964157373272862
2023-06-02T08:45:00-04:00,1.07478,1.07506,1.07363,1.07474,1.0769080531161461,1.0757073333333333,1.0760366666666656,1.0764744444444425,1.0764830000000027,1.0765628000000005,1.0756942000000007,1.0719517000000038,1.0758343194979723,1.076287847863469,-9768,-226604,-208593,-0.026665663976144623,-224.3917686823932,-0.25522278629036277
2023-06-02T09:00:00-04:00,1.07474,1.07631,1.07457,1.07539,1.07673,1.075578,1.0758888888888878,1.0763039999999982,1.0764390000000026,1.0765456000000004,1.0757526000000006,1.0719899500000039,1.0757454555983779,1.0761214782907753,7013,-219591,-211978.2,-0.04263649051850635,-220.15032424001618,-0.12352329296380038
2023-06-02T09:15:00-04:00,1.07539,1.07681,1.07534,1.0767,1.07341,1.0757402222222223,1.0758966666666658,1.0761491111111092,1.0764440000000026,1.0765564000000005,1.0758271000000006,1.072032350000004,1.0759363644787023,1.0760127826326205,5312,-214279,-214839.8,-0.04472366877390931,-213.67944390822996,0.006501769410105096
2023-06-02T09:30:00-04:00,1.0767,1.0770899999999999,1.07564,1.07564,1.073478,1.0756888888888887,1.0757822222222213,1.0759893333333317,1.0763675000000026,1.0765462000000006,1.0758816000000007,1.072069700000004,1.0758770915829619,1.0759002261060964,-7609,-221888,-219839.6,-0.04967590552664181,-221.17042561158323,-0.09566533849741206
2023-06-02T09:45:00-04:00,1.07564,1.07571,1.07402,1.0742099999999999,1.0736224799999998,1.0753744444444444,1.0755099999999989,1.0758228888888872,1.0762075000000024,1.0765072000000004,1.0759158000000006,1.0721009000000037,1.0755436732663695,1.0757873808848772,-8217,-230105,-222493.4,-0.05944279952335495,-232.0944429408015,-0.22755558857950173
2023-06-02T10:00:00-04:00,1.0742099999999999,1.07496,1.07399,1.07403,1.0737611807999998,1.0750784444444443,1.0753177777777767,1.0756791111111095,1.0760645000000024,1.0764680000000006,1.0759512000000007,1.0721276500000037,1.0752409386130957,1.0756687047079019,-6513,-236618,-224496.2,-0.06893475492252575,-233.1857937939857,-0.16081653900498338
2023-06-02T10:15:00-04:00,1.07403,1.07422,1.07232,1.07283,1.0770899999999999,1.074580888888889,1.0749555555555546,1.0754924444444427,1.0758845000000024,1.0764018000000006,1.0759672000000007,1.0721505500000037,1.0747587508904766,1.0754713637663218,-7874,-244492,-229476.4,-0.07821061408875415,-241.9833134163433,-0.30294863812506767
2023-06-02T10:30:00-04:00,1.07283,1.0734299999999999,1.07235,1.07319,1.0769946,1.0742277777777778,1.0746122222222212,1.0752355555555537,1.0757275000000024,1.0763390000000006,1.0759769000000008,1.0721739500000038,1.0744450007123814,1.0751730910130575,5633,-238859,-234392.4,-0.09083754152098558,-240.09309781834475,-0.28710001114949785
2023-06-02T10:45:00-04:00,1.07319,1.0733,1.07211,1.07232,1.076901108,1.0737693333333334,1.0743388888888878,1.0749468888888871,1.0755075000000025,1.0762556000000005,1.0759730000000007,1.0721951500000038,1.074020000569905,1.0748016728104461,-6232,-245091,-239033,-0.10991784164849341,-245.14517620148374,-0.2288840506894554
2023-06-02T11:00:00-04:00,1.07232,1.07298,1.07215,1.07287,1.0767094636799999,1.0734755555555557,1.07413111111111,1.0746711111111091,1.0752965000000025,1.0761828000000007,1.0759778000000007,1.0722176500000038,1.073790000455924,1.0744509382483571,4387,-240704,-241152.8,-0.110649505690359,-242.8950549690156,-0.1739955710218321
2023-06-02T11:15:00-04:00,1.07287,1.07298,1.07249,1.07292,1.0765254851327999,1.0732333333333333,1.0738566666666656,1.074378888888887,1.0750960000000025,1.0761102000000007,1.0759812000000009,1.0722393500000036,1.0736160003647393,1.0741259505986858,2864,-237840,-241397.2,-0.109128675729506,-242.76158120238935,-0.22968411460028196
2023-06-02T11:30:00-04:00,1.07292,1.07296,1.07218,1.07225,1.0763488657274878,1.0729119999999999,1.0733622222222212,1.0740602222222202,1.0748340000000025,1.0760232000000007,1.0759734000000007,1.0722512000000035,1.0733428002917913,1.0738427604789487,-2738,-240578,-240614.4,-0.11763001696168955,-244.47136385160874,-0.41329989783598636
2023-06-02T11:45:00-04:00,1.07225,1.07236,1.07173,1.0723,1.0761793110983882,1.0726995555555554,1.07299111111111,1.073735999999998,1.0746130000000025,1.0759334000000005,1.0759649000000007,1.0722668500000037,1.073134240233433,1.073580608383159,2601,-237977,-240438,-0.13560205201989567,-244.35007683831867,-0.3105128109776411
2023-06-02T12:00:00-04:00,1.0723,1.07236,1.07141,1.0717,1.075912352432485,1.0724413333333334,1.0727122222222212,1.0734106666666645,1.0743665000000024,1.0758364000000007,1.0759435000000008,1.0722938500000037,1.0728473921867463,1.0733460867065272,-2766,-240743,-239568.4,-0.15005344806480353,-245.89777804134005,-0.23366008508576447
2023-06-02T12:15:00-04:00,1.0717,1.07175,1.07102,1.07133,1.0755521642378862,1.0721648888888888,1.0724122222222212,1.0730668888888868,1.0740995000000022,1.0757274000000006,1.0759200000000007,1.0723184500000036,1.072543913749397,1.0730968693652216,-2602,-243345,-240096.6,-0.15340450186296978,-246.79610779780225,-0.25138962598811454
2023-06-02T12:30:00-04:00,1.07133,1.07168,1.07122,1.0713,1.0750989478140975,1.0719424444444443,1.0722422222222212,1.072743999999998,1.0738315000000023,1.0756194000000006,1.0758885000000007,1.0723366500000036,1.0722951309995177,1.0728326954921774,-1599,-244944,-241517.4,-0.15505054916582517,-246.8408839172052,-0.14261346159224028
2023-06-02T12:45:00-04:00,1.0713,1.07131,1.07086,1.071,1.0746910530326879,1.071694,1.0719988888888878,1.0724713333333313,1.0735935000000025,1.0755036000000004,1.0758479000000007,1.0723611000000037,1.072036104799614,1.072571356393742,-2358,-247302,-242862.2,-0.14703097398691695,-247.5012031555137,-0.2040645179325316
2023-06-02T13:00:00-04:00,1.071,1.07133,1.07074,1.0712,1.0742313266687653,1.0715342222222222,1.0718744444444435,1.0722479999999979,1.0733490000000026,1.0753984000000005,1.0758090000000007,1.0723883500000035,1.0718688838396913,1.0723182851149935,2531,-244771,-244221,-0.14537061722277247,-247.0285607652243,-0.10444643390032919
2023-06-02T13:15:00-04:00,1.0712,1.07156,1.07102,1.07153,1.0737425409351382,1.0714653333333335,1.0717255555555545,1.0720506666666645,1.0731115000000027,1.0753030000000006,1.0757706000000007,1.0724182500000037,1.071801107071753,1.072109028091995,1659,-243112,-244694.8,-0.1325287252793722,-246.5174797346042,-0.12489863636786347
2023-06-02T13:30:00-04:00,1.07153,1.07157,1.07077,1.07077,1.073322185204219,1.071274222222222,1.0714866666666658,1.0718655555555536,1.0729110000000026,1.0751840000000006,1.0757182000000005,1.0724395000000035,1.0715948856574025,1.071919222473596,-1591,-244703,-244966.4,-0.1276794035413155,-247.64592224204696,-0.20038772695076018
2023-06-02T13:45:00-04:00,1.07077,1.07109,1.07072,1.0709899999999999,1.0729606792756283,1.071174888888889,1.0713466666666658,1.0716864444444423,1.0727235000000026,1.0750758000000005,1.0756682000000006,1.0724682000000036,1.071473908525922,1.0717549779788769,1288,-243415,-244660.6,-0.12886825592182807,-247.38129024824823,-0.11750990906971685
2023-06-02T14:00:00-04:00,1.0709899999999999,1.07105,1.07056,1.07061,1.0726021705915278,1.0710275555555557,1.0711588888888879,1.0715184444444426,1.0724845000000027,1.0749500000000005,1.0756166000000007,1.0724996500000037,1.0713011268207375,1.0716079823831017,-1663,-245078,-244215.8,-0.1258463898905522,-247.97134244294634,-0.15760514781310914
2023-06-02T14:15:00-04:00,1.07061,1.07114,1.07058,1.07112,1.0722345798850528,1.071019777777778,1.0710944444444435,1.0713624444444423,1.0722055000000026,1.0748298000000005,1.0755673000000008,1.0725326500000036,1.07126490145659,1.0714871859064812,1633,-243445,-243950.6,-0.11791316564526519,-247.19344012557585,-0.054119623028835016
2023-06-02T14:30:00-04:00,1.07112,1.07153,1.07101,1.07122,1.0719331555057432,1.0710448888888888,1.0710822222222214,1.0712337777777758,1.0719845000000026,1.0747052000000006,1.0755208000000007,1.0725706500000036,1.0712559211652721,1.071378148725185,1713,-241732,-243674.6,-0.09807984160107444,-247.03351406687096,-0.010267611286889423
2023-06-02T14:45:00-04:00,1.07122,1.07139,1.0709899999999999,1.07123,1.0716859875147093,1.0710744444444444,1.0710744444444438,1.0711513333333316,1.0718355000000026,1.0745888000000006,1.0754690000000007,1.0726078500000036,1.0712507369322177,1.0713093189801481,1497,-240235,-242781,-0.07944144441879612,-247.01953934645894,-0.006534117427425978
2023-06-02T15:00:00-04:00,1.07123,1.07144,1.07109,1.07114,1.07153,1.0710875555555555,1.0710899999999992,1.0710999999999982,1.0716910000000026,1.0744666000000005,1.0754155000000007,1.0726434000000036,1.0712285895457743,1.0712602551841184,-1520,-241755,-242449,-0.06730540678013465,-247.14724301420526,0.013071895424839308
2023-06-02T15:15:00-04:00,1.07114,1.07138,1.07095,1.07097,1.07056,1.0710635555555554,1.071064444444444,1.0710811111111092,1.0715980000000027,1.0743442000000005,1.0753578000000008,1.0726741500000037,1.0711768716366195,1.071235404147295,-1264,-243019,-242037.2,-0.05399739344361486,-247.34785171148107,-0.021471247199398105
2023-06-02T15:30:00-04:00,1.07097,1.07108,1.07077,1.07086,1.0705764,1.0710226666666667,1.0709899999999994,1.0710602222222203,1.0714815000000026,1.0742218000000006,1.0752996000000008,1.0726952000000036,1.0711134973092955,1.0712051233178361,-963,-243982,-242144.6,-0.04842059795153789,-247.4467620451039,-0.06252741407148381
2023-06-02T15:45:00-04:00,1.07086,1.07093,1.07064,1.07077,1.070592472,1.0709786666666667,1.0709899999999992,1.071041777777776,1.0714040000000027,1.0740890000000005,1.0752456000000006,1.0727175500000035,1.0710447978474364,1.071162898654269,-1359,-245341,-242866.4,-0.044763648646081795,-247.56097865605201,0
2023-06-02T16:00:00-04:00,1.07077,1.07086,1.07061,1.07064,1.07060822256,1.070908666666667,1.0709511111111105,1.0710171111111093,1.0712925000000026,1.0739776000000005,1.0751915000000007,1.0727350500000035,1.0709638382779492,1.071105518923415,-711,-246052,-244029.8,-0.03851330208988557,-247.6472997147294,-0.03268004369787304
2023-06-02T16:15:00-04:00,1.07064,1.07066,1.0705,1.0705,1.07138,1.0708184444444444,1.0709388888888884,1.070986888888887,1.0711715000000028,1.0738638000000007,1.0751363000000007,1.0727500000000036,1.0708710706223594,1.071034015138732,-432,-246484,-244975.6,-0.03255639248126583,-247.70378929105757,-0.010274516397199214
2023-06-02T16:30:00-04:00,1.0705,1.07064,1.0705,1.07055,1.0713624,1.0707406666666666,1.0708755555555551,1.0709491111111094,1.071086500000003,1.0737494000000007,1.0750844000000008,1.0727631000000035,1.0708068564978874,1.0709600121109855,248,-246236,-245619,-0.022583820204164252,-247.69220591880165,-0.05321532601390894
2023-06-02T16:45:00-04:00,1.07055,1.07069,1.07048,1.07066,1.071345152,1.0706975555555556,1.0708133333333327,1.070913777777776,1.0710045000000028,1.0736306000000007,1.075028600000001,1.0727794000000035,1.0707774851983098,1.0708928096887882,637,-245599,-245942.4,-0.01981114501377002,-247.62675358121814,-0.05227684322549205
2023-06-04T17:00:00-04:00,1.0711,1.0711,1.07062,1.07075,1.0713105459199999,1.070684888888889,1.0707599999999995,1.0708677777777758,1.070957000000003,1.0735022000000007,1.0749761000000009,1.0727953000000034,1.070771988158648,1.0708382477510305,66,-245533,-245980.8,-0.017309269017768813,-247.62120560146732,-0.04480830447241152
2023-06-04T17:15:00-04:00,1.07075,1.07075,1.0706,1.07075,1.0712773240831999,1.0706828888888889,1.070716666666666,1.070820888888887,1.0709280000000028,1.0733690000000005,1.0749239000000008,1.0728124500000036,1.0707675905269183,1.0707989982008244,0,-245533,-245877,-0.017567893840112456,-247.62120560146732,-0.036409806374506644
2023-06-04T17:30:00-04:00,1.07075,1.07075,1.07061,1.0706499999999999,1.0712454311198718,1.0706695555555554,1.0706811111111105,1.0707693333333315,1.0708955000000029,1.0732442000000006,1.0748696000000006,1.0728240000000036,1.0707440724215347,1.0707735985606592,-103,-245636,-245707.4,-0.01912028034758101,-247.63082502710358,-0.029879455073447247
2023-06-04T17:45:00-04:00,1.0706499999999999,1.07081,1.07062,1.07067,1.071214813875077,1.0706673333333332,1.0706599999999995,1.0707262222222205,1.0708790000000028,1.0731290000000007,1.0748148000000008,1.0728342500000037,1.0707292579372278,1.0707580788485276,211,-245425,-245545.2,-0.01912081598729766,-247.62688349625782,-0.017742748818698285
2023-06-04T18:00:00-04:00,1.07067,1.07072,1.07039,1.07064,1.071185421320074,1.0706633333333333,1.0706455555555552,1.070692666666665,1.0708510000000027,1.0730152000000006,1.0747604000000006,1.0728436500000036,1.0707114063497822,1.070744863078822,-825,-246250,-245675.4,-0.01957469288346739,-247.6499998626452,-0.01214079587586162
2023-06-04T18:15:00-04:00,1.07064,1.07077,1.07054,1.0706499999999999,1.0711376960408696,1.0706642222222222,1.070646666666666,1.0706699999999985,1.0708070000000027,1.0728938000000006,1.0747068000000006,1.0728518500000035,1.0706991250798257,1.0707302904630576,751,-245499,-245668.6,-0.018250001000356217,-247.6429853666429,0.0009340207726073627
2023-06-04T18:30:00-04:00,1.0706499999999999,1.0706499999999999,1.0704,1.07047,1.0710928342784174,1.0706288888888889,1.0706433333333327,1.0706553333333315,1.0707920000000029,1.0727614000000005,1.0746500000000005,1.0728600000000035,1.0706533000638605,1.0707074323704462,-584,-246083,-245778.6,-0.015124556346903609,-247.741168713208,-0.002802428771599672
2023-06-04T18:45:00-04:00,1.07047,1.07051,1.07009,1.07009,1.0710506642217124,1.0705182222222223,1.0705922222222217,1.0706375555555536,1.070747000000003,1.0726246000000004,1.0745922000000008,1.0728661000000035,1.0705406400510884,1.0706667458963568,-484,-246567,-245964.8,-0.015929961535753472,-247.9129810946853,-0.042968567558722616
2023-06-04T19:00:00-04:00,1.07009,1.07016,1.06997,1.06999,1.0709738110839753,1.0703977777777778,1.0705177777777775,1.0706091111111093,1.0707160000000029,1.0724746000000005,1.0745298000000008,1.0728737000000037,1.0704305120408708,1.0706069967170853,-731,-247298,-246339.4,-0.016713416496971115,-247.98129310582456,-0.06257822277846828
2023-06-04T19:15:00-04:00,1.06999,1.07008,1.0697,1.06978,1.0708734299755778,1.070250222222222,1.0704099999999996,1.0705619999999982,1.0706490000000026,1.0723358000000005,1.0744641000000006,1.0728816500000036,1.0703004096326967,1.0705247973736682,-1123,-248421,-246773.6,-0.021241677451856265,-248.2016970348333,-0.09059070744806326
2023-06-04T19:30:00-04:00,1.06978,1.06984,1.06954,1.06957,1.0707326183785084,1.0700822222222222,1.0702788888888886,1.0704884444444427,1.0705665000000029,1.0721946000000004,1.0743964000000006,1.0728869000000036,1.0701543277061574,1.0704158378989344,-1153,-249574,-247588.6,-0.025370787566193733,-248.428033290886,-0.11020312864816072
2023-06-04T19:45:00-04:00,1.06957,1.06982,1.06937,1.06968,1.0705656518055173,1.0699624444444444,1.0701711111111107,1.070393999999998,1.0704890000000027,1.0720548000000005,1.0743281000000007,1.0728922000000036,1.070059462164926,1.0702970703191474,1221,-248353,-248042.6,-0.028517402020458722,-248.302459462151,-0.09059916872926871
2023-06-04T20:00:00-04:00,1.06968,1.06971,1.06917,1.06938,1.0703743475166345,1.0698042222222222,1.0700277777777771,1.0702811111111092,1.0704010000000026,1.0719092000000006,1.0742597000000007,1.0728953500000038,1.0699235697319407,1.0701736562553181,-1602,-249955,-248720.2,-0.03215422640329302,-248.75175270872938,-0.12048530359494647
2023-06-04T20:15:00-04:00,1.06938,1.06947,1.06901,1.06917,1.0701575649636403,1.0696326666666667,1.0698644444444438,1.0701504444444425,1.0703110000000027,1.0717774000000007,1.0741913000000005,1.0728966500000034,1.0697728557855526,1.0700421250042544,-1401,-251356,-249531.8,-0.03740681108251322,-249.02687474205717,-0.1373010535754392
2023-06-04T20:30:00-04:00,1.06917,1.06937,1.06901,1.06933,1.0699280519709122,1.0695257777777778,1.069717777777777,1.070011999999998,1.0702345000000029,1.0716422000000003,1.0741247000000005,1.0728979000000036,1.069684284628442,1.0699189000034033,1382,-249974,-249842.4,-0.04235268992287308,-248.82006011014653,-0.1232895904357155
2023-06-04T20:45:00-04:00,1.06933,1.06958,1.06927,1.06936,1.0697444415767299,1.069454222222222,1.0695944444444438,1.0698751111111091,1.0701640000000028,1.0715038000000006,1.0740579000000006,1.0728982500000037,1.0696194277027535,1.0698119200027227,1870,-248104,-249548.4,-0.04773505442923475,-248.7675973530927,-0.10369277046530442
2023-06-04T21:00:00-04:00,1.06936,1.06982,1.0693,1.0697,1.06901,1.0694753333333333,1.0695511111111107,1.0697511111111093,1.0701170000000029,1.0714022000000005,1.0739951000000005,1.0728995500000036,1.0696355421622028,1.069727136002178,2210,-245894,-249056.6,-0.05017136134130533,-248.06493407786263,-0.03644553261874146
2023-06-04T21:15:00-04:00,1.0697,1.06973,1.06908,1.06932,1.0690262,1.0694291111111112,1.069476666666666,1.069640888888887,1.0700580000000026,1.0712938000000005,1.0739283000000006,1.0728982000000038,1.0695724337297623,1.0696569088017425,-1848,-247742,-248614,-0.05149597314998904,-248.72141720397283,-0.06261740763931892
2023-06-04T21:30:00-04:00,1.06932,1.06983,1.0692,1.0697,1.069042076,1.0694737777777779,1.0694677777777772,1.0695615555555535,1.0700155000000027,1.0711800000000005,1.0738628000000006,1.0728988500000036,1.06959794698381,1.069621927041394,2264,-245478,-247438.4,-0.05064781677229727,-247.91686851882704,-0.0074781730823027135
2023-06-04T21:45:00-04:00,1.0697,1.07016,1.06968,1.07013,1.06907359296,1.069606222222222,1.0695299999999994,1.0695239999999981,1.0699890000000027,1.0710486000000004,1.0738025000000007,1.0729029000000039,1.069704357587048,1.069625941633115,2460,-243018,-246047.2,-0.045508677177467545,-246.92799313320506,0.05235748945839132
2023-06-04T22:00:00-04:00,1.07013,1.07046,1.07008,1.07027,1.0691387773824,1.0697542222222223,1.0695955555555552,1.06952422222222,1.0699650000000027,1.0709412000000005,1.0737437000000007,1.0729075000000037,1.0698174860696383,1.069665553306492,2000,-241018,-244630,-0.03723178186054924,-246.66634267952182,0.05515668237230672
2023-06-04T22:15:00-04:00,1.07027,1.07032,1.06989,1.07006,1.069244475191808,1.069847111111111,1.0696711111111106,1.0695482222222201,1.0699305000000028,1.0708582000000004,1.0736827000000007,1.0729112000000036,1.0698659888557107,1.0697116426451938,-1573,-242591,-243969.4,-0.03061057368770713,-246.9749844241284,0.06358824739568852
2023-06-04T22:30:00-04:00,1.07006,1.07013,1.06985,1.07003,1.0693417171764634,1.0699188888888889,1.069766666666666,1.0696062222222202,1.069899500000003,1.0707782000000003,1.0736231000000007,1.0729170000000037,1.0698987910845685,1.069776914116155,-1069,-243660,-243153,-0.021331954225791386,-247.00495470616863,0.08043622623157055
2023-06-04T22:45:00-04:00,1.07003,1.07014,1.06993,1.07001,1.0694311798023464,1.0699675555555554,1.0698422222222215,1.0696811111111093,1.0698665000000027,1.0707218000000003,1.0735618000000005,1.0729238000000036,1.0699210328676547,1.0698415312929241,-937,-244597,-242976.8,-0.010632900124441694,-247.02246823382686,0.06359122067088868
2023-06-04T23:00:00-04:00,1.07001,1.07023,1.06997,1.07009,1.0695134854181587,1.070017111111111,1.0699233333333327,1.0697597777777759,1.0698390000000026,1.0706598000000005,1.0734994000000007,1.0729311000000037,1.0699548262941239,1.0698916250343393,1099,-243498,-243072.8,-0.0009480394275496123,-246.94030077744787,0.06826513054536333
2023-06-04T23:15:00-04:00,1.07009,1.07015,1.06992,1.06997,1.069589206584706,1.0700264444444445,1.0699533333333326,1.0698313333333314,1.0698050000000026,1.0706128000000004,1.0734342000000006,1.0729372500000036,1.069957861035299,1.0699197000274714,-740,-244238,-243716.8,0.007735876350789917,-247.02328445171818,0.02524072169767154
2023-06-04T23:30:00-04:00,1.06997,1.0704,1.06997,1.07022,1.0696588700579295,1.0700797777777777,1.0700533333333326,1.0699077777777757,1.0697925000000026,1.0705598000000005,1.0733713000000007,1.0729478000000037,1.0700102888282392,1.069948560021977,977,-243261,-243850.8,0.014510609659425043,-246.79500702337918,0.08416563797552658
2023-06-04T23:45:00-04:00,1.07022,1.07028,1.07008,1.07026,1.0697229604532952,1.070121111111111,1.0701155555555548,1.0699775555555533,1.0698010000000027,1.0705066000000005,1.0733084000000006,1.0729534000000036,1.0700602310625913,1.0699808480175816,767,-242494,-243617.6,0.02423205441458055,-246.76634002033305,0.05235112648405103
2023-06-05T00:00:00-04:00,1.07026,1.07033,1.06967,1.0697699999999999,1.07046,1.070052,1.070075555555555,1.07002422222222,1.0697900000000025,1.0704570000000004,1.0732401000000007,1.0729557500000035,1.070002184850073,1.069997078414065,-1155,-243649,-243428,0.02631111570098737,-247.295136761312,-0.03364077261642398
2023-06-05T00:15:00-04:00,1.0697699999999999,1.06994,1.06963,1.06993,1.0704442,1.070022888888889,1.070037777777777,1.070047111111109,1.0697975000000026,1.0704096000000005,1.0731715000000006,1.0729610500000035,1.0699877478800583,1.0700036627312521,803,-242846,-243297.6,0.024708745275756262,-247.1750361789437,-0.03176768478982004
2023-06-05T00:30:00-04:00,1.06993,1.06999,1.06967,1.06973,1.0704116320000001,1.0699613333333333,1.0700011111111105,1.0700566666666647,1.0698055000000026,1.0703702000000004,1.0731033000000005,1.0729644000000034,1.0699361983040467,1.0699993301850017,-789,-243635,-243177,0.019883662546765494,-247.32252246309312,-0.0308393921836104
2023-06-05T00:45:00-04:00,1.06973,1.07003,1.0697,1.06999,1.07038036672,1.0699591111111113,1.069996666666666,1.070045333333331,1.0698210000000026,1.0703434000000003,1.0730354000000006,1.0729691500000034,1.0699469586432373,1.0699866641480011,804,-242831,-243091,0.01735948829586,-247.12710866708858,-0.0037382129473042813
2023-06-05T01:00:00-04:00,1.06999,1.07,1.0695999999999999,1.06964,1.0703503520512,1.0698877777777775,1.0699555555555549,1.070013333333331,1.0698340000000024,1.0703102000000002,1.0729648000000005,1.0729714000000035,1.06988556691459,1.0699517313184006,-1212,-244043,-243400.8,0.013892066521816614,-247.52356097038123,-0.03457911608302553
2023-06-05T01:15:00-04:00,1.06964,1.06965,1.0694,1.06957,1.070305330928128,1.0698106666666667,1.069897777777777,1.0699777777777755,1.0698540000000025,1.0702816000000004,1.0728926000000008,1.0729742500000035,1.0698224535316718,1.0699157850547205,-1218,-245261,-243723.2,0.008933400100304807,-247.60327003137374,-0.04859404349167602
2023-06-05T01:30:00-04:00,1.06957,1.0700399999999999,1.06952,1.06999,1.0702329044538779,1.0698291111111111,1.0698999999999994,1.06995022222222,1.0698870000000027,1.0702574000000002,1.0728279000000007,1.0729795500000034,1.0698559628253375,1.0698894280437763,1309,-243952,-243944.4,0.004348586620468591,-247.089250378616,0.0018692112862892397
2023-06-05T01:45:00-04:00,1.06999,1.07036,1.06991,1.07013,1.0694,1.069875111111111,1.0698899999999993,1.0699279999999978,1.0699255000000025,1.0702294,1.0727662000000007,1.0729867000000035,1.06991077026027,1.069884342435021,1511,-242441,-243705.6,0.002283260496135458,-246.89154759634695,-0.008409485900088158
2023-06-05T02:00:00-04:00,1.07013,1.07013,1.06942,1.06958,1.0694192,1.0698131111111109,1.069814444444444,1.0698915555555533,1.0699195000000024,1.0702056000000004,1.0726948000000005,1.0729925000000033,1.069844616208216,1.0698638739480166,-3314,-245755,-244290.4,-0.00467774519313562,-248.59479860323412,-0.06353596322389082
2023-06-05T02:15:00-04:00,1.06958,1.06967,1.0691599999999999,1.06935,1.07036,1.0697202222222222,1.0697677777777772,1.0698539999999979,1.0699210000000026,1.0701728000000004,1.0726243000000004,1.0729939000000035,1.0697456929665727,1.0698358991584134,-1950,-247705,-245022.8,-0.011625557354536244,-249.01412207599904,-0.03926077568074118
2023-06-05T02:30:00-04:00,1.06935,1.06956,1.0691599999999999,1.06927,1.070336,1.0696206666666668,1.0696944444444438,1.069813333333331,1.0698995000000027,1.0701460000000003,1.0725480000000005,1.0729966000000035,1.0696505543732582,1.0698015193267307,-2104,-249809,-245932.4,-0.016076419070979862,-249.171526106485,-0.06168627854159664
2023-06-05T02:45:00-04:00,1.06927,1.06944,1.06891,1.06937,1.07031248,1.0695557777777778,1.069654444444444,1.06976422222222,1.0698615000000027,1.0701110000000003,1.0724704000000005,1.0730027000000035,1.0695944434986064,1.0697492154613844,2276,-247533,-246648.6,-0.019842117631828204,-248.9586706069386,-0.033653351780368684
2023-06-05T03:00:00-04:00,1.06937,1.06983,1.06832,1.06905,1.0702563807999999,1.069434888888889,1.0695499999999996,1.0696962222222202,1.0698005000000028,1.0700676000000002,1.0723864000000005,1.0730077000000036,1.069485554798885,1.0696641723691076,-5406,-252939,-248748.2,-0.021392059566468783,-250.5763707481426,-0.08785128832979194
2023-06-05T03:15:00-04:00,1.06905,1.06914,1.06841,1.06879,1.0701401979519998,1.069282888888889,1.069455555555555,1.0696244444444423,1.0697370000000028,1.0700188000000002,1.0723038000000005,1.0730108000000036,1.069346443839108,1.0695645378952858,-3760,-256699,-250937,-0.026022933656065554,-251.4908275088185,-0.07946598855689928
2023-06-05T03:30:00-04:00,1.06879,1.06994,1.06859,1.06944,1.0700309860748798,1.0692797777777778,1.0694411111111104,1.069559111111109,1.0697075000000027,1.0699848,1.0722257000000006,1.0730183000000035,1.0693651550712864,1.0694884303162286,3573,-253126,-252021.2,-0.025133345619428357,-249.3178562048204,-0.012154417195692054
2023-06-05T03:45:00-04:00,1.06944,1.06944,1.06898,1.069,1.06994,1.0691915555555556,1.0693311111111106,1.069486444444442,1.0696570000000027,1.0699454000000002,1.0721448000000007,1.0730247500000036,1.069292124057029,1.0694167442529827,-3371,-256497,-253358.8,-0.025877937867000825,-250.70478768297718,-0.09252422919840805
2023-06-05T04:00:00-04:00,1.069,1.0697,1.06852,1.06944,1.06994,1.0692133333333333,1.0692544444444438,1.0694064444444422,1.0696245000000029,1.069917,1.0720694000000006,1.0730335500000037,1.0693216992456231,1.0693621954023862,3416,-253081,-254468.4,-0.02848292582582396,-249.29876336118113,-0.06447814751479534
2023-06-05T04:15:00-04:00,1.06944,1.0695999999999999,1.06886,1.06894,1.0698428,1.0691504444444444,1.0691833333333325,1.0693331111111086,1.0695730000000028,1.0698804000000002,1.0719847000000007,1.0730384500000034,1.0692453593964986,1.0693141563219088,-2304,-255385,-254957.6,-0.034490235038308246,-250.37596264304815,-0.05983657136445838
2023-06-05T04:30:00-04:00,1.06894,1.06954,1.06864,1.06929,1.069751432,1.0691717777777778,1.0691766666666658,1.0692773333333307,1.0695265000000027,1.0698534000000002,1.0719155000000007,1.0730453500000037,1.0692542875171989,1.0692957250575268,2500,-252885,-254194.8,-0.034175172244760965,-249.55739471594262,-0.005610885117122456
2023-06-05T04:45:00-04:00,1.06929,1.0697699999999999,1.06911,1.06959,1.06832,1.0692544444444445,1.0692122222222213,1.0692315555555532,1.0694930000000027,1.0698352000000002,1.0718495000000006,1.0730513000000037,1.069321430013759,1.0692869800460214,2110,-250775,-253724.6,-0.02912718186708344,-248.96541312067853,0.029926959514444247
2023-06-05T05:00:00-04:00,1.06959,1.06966,1.069,1.06954,1.068349,1.06932,1.0692311111111101,1.069211555555553,1.0694815000000026,1.0698150000000002,1.0717822000000006,1.0730566500000036,1.0693651440110072,1.069301584036817,-2260,-253035,-253032.2,-0.02339777554147401,-249.07106107924233,0.015897210507121343
2023-06-05T05:15:00-04:00,1.06954,1.0695999999999999,1.06914,1.06933,1.06837742,1.0693397777777778,1.0692622222222212,1.0692131111111085,1.0694515000000027,1.0697884000000004,1.0717095000000008,1.0730671500000035,1.0693581152088059,1.0693088672294535,-2235,-255270,-253470,-0.02181312046489543,-249.50989459645544,0.026191478415400208
2023-06-05T05:30:00-04:00,1.06933,1.06991,1.06918,1.06969,1.0684052716,1.0694253333333334,1.0693622222222212,1.0692488888888865,1.0694495000000026,1.0697672000000003,1.0716347000000008,1.0730841500000035,1.0694244921670446,1.0693446937835627,2232,-253038,-253000.6,-0.014760413772318392,-248.75847080772763,0.08420737469475978
2023-06-05T05:45:00-04:00,1.06969,1.06983,1.0691,1.06923,1.068465460736,1.0693988888888888,1.069338888888888,1.0692813333333309,1.0694115000000026,1.0697368000000005,1.0715529000000006,1.0730952500000037,1.0693855937336356,1.0693709550268502,-1894,-254932,-253410,-0.008420079596536253,-249.57294976892223,-0.019636445242373905
2023-06-05T06:00:00-04:00,1.06923,1.06934,1.06885,1.06892,1.06852324230656,1.0693151111111112,1.069329999999999,1.0693048888888863,1.0693755000000027,1.0697022000000005,1.0714732000000007,1.0731051000000036,1.0692924749869086,1.0693651640214799,-1942,-256874,-254629.8,-0.008518445127556125,-250.1359904617569,-0.007483629560323476
2023-06-05T06:15:00-04:00,1.06892,1.06909,1.06867,1.06875,1.0685787126142976,1.069199111111111,1.0692533333333323,1.0693093333333308,1.0693345000000025,1.0696638000000003,1.0713964000000005,1.0731115500000037,1.0691839799895269,1.0693289312171836,-1621,-258495,-255721.8,-0.006893400770917541,-250.39379272946638,-0.06451974865348757
2023-06-05T06:30:00-04:00,1.06875,1.0689899999999999,1.06867,1.06898,1.0686319641097257,1.0691444444444445,1.0692577777777768,1.0693084444444418,1.0692840000000028,1.0696306000000004,1.0713229000000006,1.0731162500000035,1.0691431839916214,1.0692859449737468,1531,-256964,-256060.6,-0.008567991959119928,-250.06431436689334,0.00374202480962823
2023-06-05T06:45:00-04:00,1.06898,1.06949,1.06897,1.06928,1.06867,1.069148888888889,1.0692566666666659,1.0692873333333308,1.0692415000000026,1.0696032000000004,1.0712485000000007,1.0731193500000036,1.069170547193297,1.0692351559789972,1506,-255458,-256544.6,-0.0022266795396888054,-249.64166848016023,-0.0009351999925245267
2023-06-05T07:00:00-04:00,1.06928,1.0695,1.06924,1.06946,1.06867,1.0691895555555557,1.0692422222222213,1.0692679999999974,1.0692355000000027,1.0695830000000004,1.0711722000000008,1.0731212500000036,1.0692284377546377,1.0692037247831978,1381,-254077,-256373.6,0.002346990263486517,-249.40919429192132,-0.0121541899232382
2023-06-05T07:15:00-04:00,1.06946,1.06949,1.06876,1.06876,1.0687196,1.0690931111111113,1.0691555555555547,1.0692331111111089,1.0692060000000025,1.0695564000000004,1.0710905000000008,1.0731197000000037,1.06913475020371,1.069172179826558,-1498,-255575,-256113.8,-0.0017636472223168814,-250.38968912108766,-0.07292854872188072
2023-06-05T07:30:00-04:00,1.06876,1.06881,1.06847,1.06851,1.06991,1.068964,1.0690644444444435,1.0691953333333308,1.0691680000000026,1.0695268000000004,1.0710007000000008,1.0731149500000037,1.069009800162968,1.0691373438612461,-1239,-256814,-255777.6,-0.007656118681697864,-250.6795109707076,-0.07668353080899451
2023-06-05T07:45:00-04:00,1.06851,1.06938,1.06851,1.06897,1.0698812,1.0689451111111112,1.0689844444444434,1.0691406666666643,1.0691480000000027,1.0695106000000003,1.0709232000000009,1.0731055000000036,1.0690018401303745,1.0691090750889969,2127,-254687,-255322.2,-0.009687190594316728,-249.76382464114607,-0.06730922042835344
2023-06-05T08:00:00-04:00,1.06897,1.06917,1.06885,1.06896,1.069852976,1.0689402222222222,1.0689544444444434,1.0690802222222198,1.0691435000000027,1.0694984000000003,1.070846500000001,1.0730986000000038,1.0689934721042995,1.0690736600711974,-2777,-257464,-255723.4,-0.014689166895172929,-249.78980291930185,-0.025251816727925
2023-06-05T08:15:00-04:00,1.06896,1.0689899999999999,1.0684,1.0684,1.06982531648,1.0688293333333332,1.0688966666666657,1.0690111111111087,1.0691240000000026,1.0694728000000004,1.0707638000000008,1.0730885000000037,1.0688747776834395,1.0690029280569577,-2350,-259814,-256870.8,-0.019557913650160016,-251.02090604757583,-0.04864723272088425
2023-06-05T08:30:00-04:00,1.0684,1.06841,1.06749,1.06771,1.0697683038208,1.068592,1.06878111111111,1.0689362222222196,1.0690375000000025,1.0694394000000003,1.070674300000001,1.0730712000000038,1.0686418221467515,1.0689043424455662,-3060,-262874,-258330.6,-0.026066594536479734,-252.9971321801107,-0.09730994152048204
2023-06-05T08:45:00-04:00,1.06771,1.06799,1.06745,1.06788,1.069631605591552,1.0684117777777777,1.068658888888888,1.0688551111111084,1.0689815000000025,1.0694136000000003,1.070595500000001,1.0730562000000037,1.0684894577174011,1.0688002739564528,2910,-259964,-258960.6,-0.027257788114303672,-252.53380412286668,-0.10290183165261285
2023-06-05T09:00:00-04:00,1.06788,1.06848,1.06778,1.06797,1.0694570771442278,1.068274,1.0685133333333323,1.0687608888888862,1.0689080000000026,1.0693864000000004,1.070514300000001,1.0730396500000035,1.068385566173921,1.068677019165162,3024,-256940,-259411.2,-0.03211924660083018,-252.2789440262262,-0.12251234475534213
2023-06-05T09:15:00-04:00,1.06797,1.06859,1.06785,1.06846,1.0692965109726895,1.0682633333333333,1.068402222222221,1.0686504444444416,1.0688840000000024,1.0693684000000003,1.070436100000001,1.0730276000000034,1.0684004529391369,1.0685584153321295,2939,-254001,-258718.6,-0.035426269077365534,-250.93048854526734,-0.09350513343183586
2023-06-05T09:30:00-04:00,1.06846,1.06864,1.06815,1.06835,1.0691487900948744,1.068252888888889,1.0683566666666655,1.0685424444444416,1.0688370000000025,1.0693414000000003,1.0703718000000009,1.0730124000000034,1.0683903623513096,1.0684615322657036,-3961,-257962,-258348.2,-0.04318358302099139,-251.33828106908686,-0.03836221415472337
2023-06-05T09:45:00-04:00,1.06835,1.06913,1.06797,1.0680399999999999,1.06745,1.0681895555555554,1.0683044444444432,1.0684471111111082,1.0687595000000023,1.0693158000000005,1.070304800000001,1.0729995000000034,1.0683202898810475,1.068397225812563,-4877,-262839,-258341.2,-0.04435329729214818,-252.75342591862133,-0.04398648585415134
2023-06-05T10:00:00-04:00,1.0680399999999999,1.07224,1.0680399999999999,1.07161,1.0674836,1.0688506666666666,1.0685977777777764,1.068434888888886,1.0688630000000023,1.0693540000000004,1.070267000000001,1.0730098000000035,1.068978231904838,1.06849498065005,16052,-246787,-255705.8,-0.024346454728370413,-199.09846917542708,0.24696670626864886
2023-06-05T10:15:00-04:00,1.07161,1.07207,1.07112,1.07176,1.067673856,1.0694831111111112,1.0689088888888876,1.0685139999999973,1.0689845000000022,1.0693866000000003,1.070217600000001,1.0730223500000036,1.0695345855238705,1.06872478452004,7359,-239428,-252203.4,-0.008133985358678448,-198.06838360325,0.2619368358030362
2023-06-05T10:30:00-04:00,1.07176,1.07197,1.0711,1.07184,1.0678565017600001,1.0700693333333333,1.0692911111111099,1.0686917777777751,1.0690920000000026,1.0694180000000002,1.070179600000001,1.0730306000000034,1.0699956684190963,1.0690438276160321,6290,-233138,-248030.8,0.007625315513158631,-197.59887550442272,0.32197678771994453
2023-06-05T10:45:00-04:00,1.07184,1.07205,1.07052,1.07107,1.0680318416896002,1.070425111111111,1.069664444444443,1.0689533333333305,1.0691840000000026,1.0694382000000002,1.070148200000001,1.0730320000000035,1.070210534735277,1.0694078620928256,-5610,-238748,-244188,0.026450914380500228,-201.6290479182155,0.31469219169999624
2023-06-05T11:00:00-04:00,1.07107,1.0714,1.07074,1.07116,1.0682001680220161,1.070724222222222,1.0700288888888876,1.0692982222222194,1.0692960000000027,1.0694608000000003,1.0701195000000012,1.0730353500000036,1.0704004277882215,1.0698238896742605,3807,-234941,-238608.4,0.05011837091703295,-201.30915286000294,0.3071506161740973
2023-06-05T11:15:00-04:00,1.07116,1.07147,1.07094,1.0712599999999999,1.0683617613011356,1.0709704444444443,1.070394444444443,1.0696575555555525,1.0694215000000027,1.0694858000000003,1.0701038000000012,1.0730355000000034,1.0705723422305773,1.0701427117394082,2442,-232499,-235750.8,0.07130013652660695,-201.08117571373162,0.30806108785825376
2023-06-05T11:30:00-04:00,1.0712599999999999,1.07142,1.0703,1.07102,1.06851689084909,1.0710955555555555,1.0706788888888874,1.0700115555555527,1.0695235000000027,1.0695044000000002,1.0700821000000011,1.0730295000000034,1.0706618737844618,1.0703681693915266,-2646,-235145,-234894.2,0.0897038885637314,-201.6739729805011,0.2395971772457666
2023-06-05T11:45:00-04:00,1.07102,1.07206,1.071,1.07206,1.0686658152151265,1.0713717777777778,1.0710911111111097,1.0703715555555526,1.0696625000000026,1.0695462000000002,1.0700795000000012,1.0730262500000034,1.0709414990275694,1.0705573355132212,2441,-232704,-234807.4,0.10963591367503277,-199.3036717723072,0.34726447325315696
2023-06-05T12:00:00-04:00,1.07206,1.07206,1.07181,1.07199,1.0688087826065213,1.0715515555555555,1.0715299999999985,1.0707446666666636,1.0697890000000025,1.0695816000000002,1.0700707000000012,1.0730242500000036,1.0711511992220555,1.0707454684105768,-2696,-235400,-234137.8,0.13158550721035644,-199.47970669572572,0.3698363357177747
2023-06-05T12:15:00-04:00,1.07199,1.07212,1.07124,1.0713,1.0689460313022605,1.0715055555555555,1.071495555555554,1.0710379999999968,1.0699160000000025,1.0696024000000002,1.070054500000001,1.0730178500000036,1.0711809593776445,1.0709015747284614,-1992,-237392,-234628,0.1538562198560004,-200.76188283542868,-0.028928434785046097
2023-06-05T12:30:00-04:00,1.0713,1.07141,1.071,1.07106,1.06907779005017,1.0714184444444443,1.0714177777777765,1.0712426666666635,1.0700435000000026,1.0696282000000001,1.070042600000001,1.0730080000000037,1.0711567675021156,1.0710184597827692,-1393,-238785,-235885.2,0.13846398966072132,-201.0739522837625,-0.06531312980519378
2023-06-05T12:45:00-04:00,1.07106,1.0712599999999999,1.0709899999999999,1.07115,1.0692042784481632,1.071364888888889,1.0713411111111097,1.071375111111108,1.0701525000000027,1.0696526000000004,1.0700311000000011,1.0729980000000037,1.0711554140016926,1.0711171678262152,1353,-237432,-236342.6,0.12099935831327584,-200.9602611740206,-0.06437527989250798
2023-06-05T13:00:00-04:00,1.07115,1.07131,1.07088,1.0709899999999999,1.0693257073102367,1.0712946666666665,1.0713322222222208,1.0714233333333303,1.0702540000000025,1.0696778000000002,1.070024000000001,1.0729837500000037,1.071122331201354,1.0711533342609723,-1506,-238938,-237589.4,0.10405783739832004,-201.18521566218774,-0.00746916634767849
2023-06-05T13:15:00-04:00,1.0709899999999999,1.07139,1.07079,1.0708199999999999,1.0694422790178273,1.071192222222222,1.071294444444443,1.0713762222222192,1.0703750000000027,1.0696944000000004,1.0700189000000009,1.0729694500000035,1.0710618649610832,1.0711354674087779,-1552,-240490,-238607.4,0.09343786010809106,-201.43156716873776,-0.031741289816648026
2023-06-05T13:30:00-04:00,1.0708199999999999,1.07117,1.07073,1.07107,1.0695541878571142,1.0711473333333332,1.071273333333332,1.0713317777777749,1.0705430000000027,1.0697230000000004,1.070016600000001,1.0729525500000037,1.0710634919688666,1.0711119739270223,1526,-238964,-238921.8,0.08070798097936462,-201.07529814126337,-0.017736123816805675
2023-06-05T13:45:00-04:00,1.07107,1.07129,1.07107,1.07128,1.0696616203428297,1.0711486666666665,1.071302222222221,1.0713086666666638,1.0707130000000027,1.0697572000000002,1.070019400000001,1.0729336500000035,1.0711067935750933,1.0711019791416179,1049,-237915,-238747.8,0.06500270881701788,-200.86962530942228,0.024275923885634904
2023-06-05T14:00:00-04:00,1.07128,1.0714299999999999,1.07107,1.07125,1.0697647555291165,1.071138222222222,1.071212222222221,1.0712828888888861,1.0708770000000027,1.0697824000000002,1.070019900000001,1.0729144500000034,1.0711354348600746,1.0710979833132943,-1368,-239283,-239118,0.05215358691012024,-200.90793462164686,-0.07555547264145453
2023-06-05T14:15:00-04:00,1.07125,1.07151,1.07124,1.0714299999999999,1.069863765307952,1.071181777777778,1.0711499999999985,1.0712464444444416,1.0710255000000029,1.0698084000000003,1.070018900000001,1.0728947500000034,1.0711943478880597,1.0711123866506354,1087,-238196,-238969.6,0.030877358989910866,-200.7252881805735,-0.05223929327700034
2023-06-05T14:30:00-04:00,1.0714299999999999,1.07157,1.07112,1.07149,1.0699588146956338,1.0712497777777779,1.0711711111111097,1.071221777777775,1.0711825000000028,1.0698466000000002,1.0700261000000009,1.0728721500000036,1.0712534783104477,1.0711507093205082,2087,-236109,-238093.4,0.012733416325943811,-200.60841633640229,0.017735461588736536
2023-06-05T14:45:00-04:00,1.07149,1.07172,1.07129,1.07138,1.0700500621078084,1.0712915555555556,1.071206666666665,1.0712084444444416,1.0713495000000026,1.0698872000000004,1.070030000000001,1.0728491000000036,1.071278782648358,1.0711937674564065,-2569,-238678,-238036.2,0.00000889085291990205,-200.87215188223112,0.029876944335527237
2023-06-05T15:00:00-04:00,1.07138,1.07144,1.07111,1.07136,1.0701376596234962,1.0713222222222223,1.0712299999999984,1.071193999999997,1.0713370000000026,1.0699290000000001,1.0700375000000009,1.0728270500000034,1.0712950261186864,1.0712314139651251,-1766,-240444,-238542,-0.011947542819652912,-200.9051187100605,0.01960509732530864
2023-06-05T15:15:00-04:00,1.07136,1.07152,1.07128,1.07148,1.0702217532385563,1.0713722222222224,1.0712844444444427,1.0712084444444416,1.0713230000000027,1.0699712000000003,1.0700411000000012,1.0728042000000035,1.071332020894949,1.0712707311721001,1440,-239004,-238486.2,-0.008289544683844245,-200.74382838748,0.04575206117705128
2023-06-05T15:30:00-04:00,1.07148,1.07175,1.07129,1.07134,1.070302483109014,1.0713833333333334,1.0713422222222204,1.071246888888886,1.0712980000000027,1.0700170000000002,1.070042300000001,1.0727815500000035,1.0713336167159593,1.07129858493768,-1384,-240388,-238924.6,-0.0031558641287682252,-200.92466237411534,0.04856091593359071
2023-06-05T15:45:00-04:00,1.07134,1.07146,1.07117,1.07124,1.0703799837846535,1.0713628888888889,1.0713611111111094,1.071284888888886,1.0713065000000026,1.0700660000000002,1.070042400000001,1.0727557000000036,1.0713148933727674,1.071310867950144,-1599,-241987,-240100.2,0.0034315381471114984,-201.0739147123086,0.015871978488801244
2023-06-05T16:00:00-04:00,1.07124,1.07133,1.07114,1.07117,1.0704543844332675,1.0713246666666667,1.0713488888888871,1.0713133333333302,1.0713070000000025,1.0701006000000002,1.070042700000001,1.0727291000000037,1.0712859146982139,1.0713122943601152,-923,-242910,-240946.6,0.003920470456608957,-201.13422799411288,-0.010268090508555606
2023-06-05T16:15:00-04:00,1.07117,1.07125,1.07109,1.07111,1.0705258090559369,1.0712768888888888,1.0713333333333315,1.071333999999997,1.0712995000000025,1.0701428000000002,1.070044100000001,1.0727009500000038,1.071250731758571,1.071303435488092,-493,-243403,-241538.4,0.0025558679395618396,-201.16184265845186,-0.013068844807470618
2023-06-05T16:30:00-04:00,1.07111,1.07118,1.07097,1.07116,1.0705943766936994,1.0712422222222222,1.0713033333333317,1.0713377777777746,1.0713065000000024,1.0701772,1.070047100000001,1.0726733500000036,1.071232585406857,1.0712835483904735,587,-242816,-242300.8,0.002160273634808375,-201.134441177745,-0.0251999664000441
2023-06-05T16:45:00-04:00,1.07116,1.07129,1.07114,1.07121,1.0706602016259514,1.0712235555555554,1.0712722222222206,1.0713237777777747,1.0712640000000024,1.0702226000000001,1.0700515000000008,1.0726485500000036,1.0712280683254856,1.0712624387123788,629,-242187,-242660.6,-0.0007378650096792771,-201.10508048466454,-0.02613183510812588
2023-06-05T17:00:00-04:00,1.07121,1.07136,1.07098,1.07125,1.0707233935609133,1.0712191111111111,1.071257777777776,1.071303111111108,1.0712270000000026,1.0702618,1.0700576000000008,1.0726245500000036,1.0712324546603884,1.0712459509699026,202,-241985,-242660.2,0.0006223181976667401,-201.09753761258528,-0.012133883402710847
2023-06-05T17:15:00-04:00,1.07125,1.07139,1.0709899999999999,1.07103,1.0707840578184769,1.0711735555555555,1.0712211111111094,1.0712775555555525,1.0712135000000025,1.0702906,1.0700629000000008,1.0725996000000035,1.0711919637283107,1.0712271607759223,-166,-242151,-242508.4,0.0016225416827922142,-201.1316286277545,-0.030801971326180132
2023-06-05T17:30:00-04:00,1.07103,1.07128,1.071,1.07119,1.0708422955057377,1.0711673333333331,1.0711888888888872,1.0712486666666636,1.0712200000000025,1.0703236,1.070069300000001,1.0725768500000037,1.0711915709826485,1.0712153286207378,312,-241839,-242195.6,0.0005245502871741611,-201.08501928908046,-0.027065367529016077
2023-06-05T17:45:00-04:00,1.07119,1.07121,1.07102,1.07117,1.0708982036855081,1.0711635555555554,1.0711699999999982,1.071221999999997,1.0712210000000026,1.0703604,1.0700744000000009,1.0725515000000037,1.0711872567861187,1.0712062628965902,-76,-241915,-242015.4,-0.0028583405531162048,-201.08643827170727,-0.015867978419549674
2023-06-05T18:00:00-04:00,1.07117,1.07142,1.07107,1.07107,1.0709518755380878,1.0711435555555555,1.0711511111111094,1.0711977777777748,1.0712250000000025,1.0703880000000001,1.070077600000001,1.0725268500000036,1.071163805428895,1.071193410317272,-462,-242377,-242053.4,-0.005023229100411262,-201.1295686805126,-0.015869459691572708
2023-06-05T18:15:00-04:00,1.07107,1.07113,1.07094,1.0711,1.07224,1.0711333333333333,1.0711433333333318,1.0711748888888857,1.0712390000000025,1.0704254,1.070081100000001,1.0725025000000037,1.071151044343116,1.0711771282538174,438,-241939,-242044.2,-0.006819111292705917,-201.11730057478655,-0.0065349104250505986
2023-06-05T18:30:00-04:00,1.0711,1.07125,1.0711,1.07116,1.072214,1.0711366666666666,1.0711488888888874,1.0711604444444414,1.0712435000000027,1.0704702,1.070086200000001,1.0724779000000035,1.0711528354744928,1.0711693026030538,368,-241571,-241928.2,-0.008423742239546858,-201.09668625306125,0.0046680546349005675
2023-06-05T18:45:00-04:00,1.07116,1.0714,1.07113,1.07135,1.07218852,1.071176888888889,1.0711699999999984,1.0711566666666634,1.0712470000000027,1.0705222,1.070093000000001,1.0724539000000035,1.0711922683795942,1.071169442082443,592,-240979,-241756.2,-0.007427914556154093,-200.9916785978089,0.01773777960343315
2023-06-05T19:00:00-04:00,1.07135,1.0714299999999999,1.07085,1.07094,1.0721635496000002,1.0711308888888889,1.0711399999999984,1.0711506666666637,1.0712315000000028,1.0705613999999999,1.070096000000001,1.0724282000000036,1.0711418147036753,1.0711603536659544,-792,-241771,-241727.4,-0.007970348348056848,-201.2947728247189,-0.02520514184893648
2023-06-05T19:15:00-04:00,1.07094,1.07104,1.07074,1.0708,1.072111007616,1.071062888888889,1.0710899999999983,1.0711384444444412,1.0712000000000028,1.0705917999999999,1.070097500000001,1.0724021500000036,1.0710734517629403,1.0711422829327635,-606,-242377,-241727.4,-0.009797545545756075,-201.37399294909562,-0.04200700116686688
2023-06-05T19:30:00-04:00,1.0708,1.07105,1.07077,1.07094,1.0720287471590402,1.071032888888889,1.0710799999999983,1.0711257777777745,1.0711725000000027,1.0706214,1.0701022000000011,1.0723761000000036,1.0710467614103523,1.0711214263462108,448,-241929,-241725.4,-0.010513475474763946,-201.31541991958497,-0.00840312596285104
2023-06-05T19:45:00-04:00,1.07094,1.0712,1.07093,1.07113,1.0719514223294977,1.0710428888888888,1.0710733333333318,1.0711106666666634,1.071160000000003,1.0706688,1.070112600000001,1.0723524000000035,1.0710634091282818,1.0711035410769685,512,-241417,-241694.6,-0.007979699998665449,-201.22458383166224,-0.005601247211061625
2023-06-05T20:00:00-04:00,1.07113,1.0714299999999999,1.07098,1.07128,1.0718787369897278,1.0710842222222223,1.071085555555554,1.0710937777777745,1.071156000000003,1.0707242,1.070125500000001,1.0723276500000036,1.0711067273026253,1.0710864328615748,920,-240497,-241598.2,-0.00669497583390548,-201.09574792939074,0.010269144953653902
2023-06-05T20:15:00-04:00,1.07128,1.07144,1.07124,1.07136,1.071810412770344,1.071139111111111,1.0711177777777763,1.07108933333333,1.0711500000000032,1.0707719999999998,1.0701413000000009,1.0723027000000038,1.0711573818421003,1.0710895462892598,640,-239857,-241215.4,-0.004921207336014094,-201.04795463538727,0.02707572801031898
2023-06-05T20:30:00-04:00,1.07136,1.07162,1.07133,1.07152,1.0717461880041235,1.0712195555555557,1.0711644444444428,1.071104222222219,1.071159000000003,1.0708232,1.070160800000001,1.0722786000000035,1.0712299054736802,1.0711208370314078,686,-239171,-240574.2,-0.0008979964896292826,-200.94550541197034,0.03921202502101456
2023-06-05T20:45:00-04:00,1.07152,1.07169,1.07145,1.07161,1.07074,1.0713086666666667,1.071214444444443,1.071131111111108,1.0711775000000032,1.0708874,1.0701801000000009,1.0722541000000037,1.0713059243789442,1.0711726696251263,833,-238338,-239856,0.0026628388175384526,-200.87553938240492,0.042010530639686086
2023-06-05T21:00:00-04:00,1.07161,1.07169,1.07147,1.0715999999999999,1.070759,1.0713857777777778,1.0712422222222204,1.0711648888888858,1.0711990000000031,1.0709651999999998,1.070202300000001,1.0722310000000035,1.0713647395031554,1.071232935700101,-1026,-239364,-239445.4,0.005170003312005732,-200.88511376114351,0.023335044569922195
2023-06-05T21:15:00-04:00,1.0715999999999999,1.07165,1.07144,1.07151,1.07077762,1.0714393333333334,1.0713055555555537,1.0712088888888858,1.0712190000000033,1.0710378,1.0702257000000008,1.0722085000000037,1.0713937916025242,1.0712903485600807,-1078,-240442,-239434.4,0.005152143829929581,-200.9756512751412,0.053224270267238076
2023-06-05T21:30:00-04:00,1.07151,1.07164,1.07128,1.07138,1.0707958676,1.071454222222222,1.0713699999999982,1.0712593333333298,1.071230000000003,1.071106,1.0702462000000008,1.0721854500000036,1.0713910332820193,1.0713370788480643,-1324,-241766,-239816.2,0.008059296507624469,-201.13628440035697,0.054165110197985145
2023-06-05T21:45:00-04:00,1.07138,1.07157,1.07127,1.07157,1.070813750248,1.0714942222222221,1.0714399999999982,1.071314444444441,1.071248000000003,1.0711681999999998,1.0702683000000008,1.0721631000000036,1.0714268266256155,1.0713764630784515,1183,-240583,-240098.6,0.013424507371908603,-200.92648955632413,0.05882682503220614
2023-06-05T22:00:00-04:00,1.07157,1.07246,1.07155,1.07245,1.07083127524304,1.0716962222222224,1.071586666666665,1.0713888888888854,1.0713080000000033,1.0712502000000002,1.070295800000001,1.0721454500000036,1.0716314613004925,1.0714415704627611,1838,-238745,-240180,0.022006977692329382,-199.4170781319655,0.12323434130310867
2023-06-05T22:15:00-04:00,1.07245,1.07246,1.07184,1.07194,1.0708964242333183,1.071766888888889,1.0716599999999983,1.0714724444444408,1.071353500000003,1.0713282,1.0703220000000007,1.0721251500000035,1.071693169040394,1.0715072563702088,-1605,-240350,-240377.2,0.026500015557055844,-200.1803304980432,0.06160854305129218
2023-06-05T22:30:00-04:00,1.07194,1.07203,1.07161,1.07173,1.0709589672639857,1.071780888888889,1.0717011111111094,1.071551555555552,1.0713805000000032,1.0713306,1.0703423000000007,1.0721025500000037,1.0717005352323152,1.071568605096167,-1280,-241630,-240614.8,0.027588138034242933,-200.43109080179133,0.03453554360812252
2023-06-05T22:45:00-04:00,1.07173,1.0719,1.07162,1.07183,1.0710190085734261,1.0718066666666666,1.0717355555555539,1.0716246666666631,1.0714135000000031,1.071332,1.070359300000001,1.0720809000000036,1.0717264281858523,1.0716356840769337,1429,-240201,-240301.8,0.02912961389280264,-200.29775498026913,0.028930864566226712
2023-06-05T23:00:00-04:00,1.07183,1.07193,1.07168,1.07183,1.071076648230489,1.0718255555555556,1.0717599999999985,1.0716886666666632,1.071451500000003,1.0713318,1.0703749000000007,1.0720593000000036,1.0717471425486818,1.0716997472615468,0,-240201,-240225.4,0.029088759605724115,-200.29775498026913,0.020529856944234284
2023-06-05T23:15:00-04:00,1.07183,1.07186,1.07167,1.07178,1.0711319823012695,1.0718295555555555,1.0717799999999984,1.0717273333333297,1.0714855000000032,1.071346,1.0703921000000007,1.0720374000000035,1.0717537140389455,1.0717241978092376,-950,-241151,-240706.6,0.027519009315851984,-200.3420717096013,0.016797312430017638
2023-06-05T23:30:00-04:00,1.07178,1.07179,1.0714299999999999,1.07154,1.0711851030092188,1.0717815555555557,1.0717833333333318,1.0717519999999963,1.071504500000003,1.0713536000000001,1.070407200000001,1.0720151500000035,1.0717109712311563,1.0717277582473899,-863,-242014,-241039.4,0.025003055385996977,-200.53532032405576,0.0027997872161691904
2023-06-05T23:45:00-04:00,1.07154,1.07165,1.07152,1.07159,1.07123609888885,1.071742888888889,1.071806666666665,1.0717731111111075,1.071516500000003,1.0713602,1.0704230000000008,1.0719924000000036,1.071686776984925,1.0717250065979118,820,-241194,-240952.2,0.02383822007976438,-200.4970576367085,0.019600888573619395
2023-06-06T00:00:00-04:00,1.07159,1.07209,1.07149,1.07193,1.0712850549332962,1.0717675555555555,1.071846666666665,1.0717953333333299,1.0715660000000031,1.0713784,1.0704414000000009,1.0719704000000037,1.07173542158794,1.0717268052783293,919,-240275,-240967,0.026392904535121185,-200.2054722355756,0.03359556538538201
2023-06-06T00:15:00-04:00,1.07193,1.07209,1.0717,1.07196,1.0713320527359644,1.0717902222222224,1.0717922222222207,1.0718017777777742,1.071624000000003,1.0713764,1.070461300000001,1.0719477500000036,1.071780337270352,1.0717334442226634,983,-239292,-240785.2,0.025498505107024286,-200.17796111078204,-0.04568977574710984
2023-06-06T00:30:00-04:00,1.07196,1.07241,1.07182,1.07236,1.0713771706265258,1.0719037777777778,1.0718388888888875,1.071813555555552,1.0716950000000032,1.0713837999999998,1.0704827000000008,1.0719270000000036,1.0718962698162817,1.0717619553781306,4051,-235241,-239603.2,0.017725076028291303,-198.66633754273863,0.03918129746068689
2023-06-06T00:45:00-04:00,1.07236,1.0724,1.07213,1.07233,1.0714204838014647,1.0720020000000001,1.0719055555555541,1.0718379999999965,1.0717550000000031,1.0714043999999998,1.070503400000001,1.0719059000000035,1.0719830158530255,1.0718163643025045,-1531,-236772,-238554.8,0.015186906025786788,-198.70916830852622,0.055984249764393444
2023-06-06T01:00:00-04:00,1.07233,1.07312,1.07233,1.07302,1.0714620644494062,1.0722248888888888,1.0720377777777763,1.0718842222222187,1.0718420000000033,1.0714435999999998,1.070535900000001,1.0718880000000037,1.0721904126824204,1.0719170914420035,2267,-234505,-237217,0.018824317624261826,-197.2504475788999,0.1110250692740476
2023-06-06T01:15:00-04:00,1.07302,1.07307,1.07249,1.07252,1.071561540582442,1.0723213333333335,1.0721144444444428,1.0719377777777743,1.0719000000000032,1.0714709999999998,1.070561800000001,1.0718666500000038,1.0722563301459362,1.0720212731536027,-1141,-235646,-236291.2,0.01975178325837447,-197.78212452807156,0.06437588050342474
2023-06-06T01:30:00-04:00,1.07252,1.07292,1.07241,1.07245,1.0716550481474953,1.0723884444444445,1.0721888888888875,1.0720171111111074,1.0719465000000032,1.0715001999999998,1.070589000000001,1.0718461500000036,1.072295064116749,1.072124218522882,-1596,-237242,-235881.2,0.020692611653909905,-197.88629041775195,0.0625128291253754
2023-06-06T01:45:00-04:00,1.07245,1.07287,1.07225,1.07249,1.0717429452586456,1.0724486666666668,1.0722944444444429,1.0721082222222187,1.0719905000000032,1.0715335999999998,1.0706140000000008,1.0718247000000036,1.0723340512933992,1.0722117748183055,1649,-235593,-235951.6,0.023006100903647037,-197.82478638492984,0.08865744629225288
2023-06-06T02:00:00-04:00,1.07249,1.07279,1.07211,1.07261,1.0718255685431268,1.0725117777777777,1.0724077777777763,1.072208666666663,1.0720410000000034,1.0715644,1.0706437000000009,1.0718042500000038,1.0723892410347193,1.0722930198546443,3076,-232517,-235100.6,0.028544243577744582,-197.48061534370765,0.09518565869409204
2023-06-06T02:15:00-04:00,1.07261,1.07309,1.07227,1.07269,1.0719032344305393,1.0725682222222224,1.0724922222222208,1.072299555555552,1.0721000000000032,1.0715925999999998,1.0706749000000009,1.0717837500000038,1.0724493928277754,1.0723448158837152,3019,-229498,-234099.2,0.03396183003026279,-197.2554449649124,0.07090015206215629
2023-06-06T02:30:00-04:00,1.07269,1.07328,1.07266,1.07292,1.0719762403647068,1.0726537777777778,1.0725988888888875,1.072396444444441,1.072177000000003,1.0716259999999997,1.0707042000000009,1.0717660500000037,1.0725435142622204,1.072402252706972,2677,-226821,-232334.2,0.0369310661554581,-196.68145807214705,0.08955558043211238
2023-06-06T02:45:00-04:00,1.07292,1.07294,1.07226,1.0724,1.0720805411355303,1.0726140000000002,1.072603333333332,1.0724793333333298,1.072218500000003,1.0716454,1.070726900000001,1.0717465500000036,1.0725148114097762,1.0724462021655774,-3127,-229948,-230875.4,0.036503028521339576,-198.19698579089612,0.0037300906412063117
2023-06-06T03:00:00-04:00,1.0724,1.07274,1.07193,1.0725,1.07328,1.0725933333333333,1.0726222222222208,1.0725448888888856,1.072221000000003,1.0716655999999998,1.070756100000001,1.0717254500000037,1.072511849127821,1.0724817617324618,5125,-224823,-228721.4,0.03367697197721858,-197.71908575359666,0.01585332873275983
2023-06-06T03:15:00-04:00,1.0725,1.07261,1.07097,1.07124,1.073253,1.0723168888888888,1.072424444444443,1.072548222222219,1.0721860000000032,1.0716628,1.070775000000001,1.0716996500000038,1.0722574793022568,1.0724554093859693,-5101,-229924,-228202.8,0.02888656161998271,-203.71186897038007,-0.16588693593783105
2023-06-06T03:30:00-04:00,1.07124,1.07162,1.07071,1.071,1.0731616800000001,1.0720319999999999,1.0722555555555542,1.0725008888888854,1.0721495000000032,1.0716556,1.070792300000001,1.0716701500000037,1.0720059834418054,1.0723667275087752,-5327,-235251,-229353.4,0.01422180688920206,-204.9053270189967,-0.1417222988848661
2023-06-06T03:45:00-04:00,1.071,1.07147,1.07072,1.07146,1.0730145792,1.071872888888889,1.0721455555555544,1.072410222222219,1.0721310000000033,1.0716551999999997,1.0708132000000008,1.0716418000000036,1.0718967867534444,1.0722373820070201,4269,-230982,-230185.6,0.005534223576649332,-203.071769596027,-0.09231199589722826
2023-06-06T04:00:00-04:00,1.07146,1.07149,1.07029,1.07048,1.072876304448,1.0715397777777778,1.0719222222222209,1.072273999999997,1.0720635000000034,1.0716379999999996,1.070827500000001,1.0716069500000038,1.0716134294027555,1.072057105605616,-6889,-237871,-231770.2,-0.006844903633657482,-209.37272343471426,-0.18741433486557874
2023-06-06T04:15:00-04:00,1.07048,1.07057,1.06951,1.07015,1.0726694000921602,1.0711853333333332,1.0716488888888875,1.0720793333333303,1.0719820000000033,1.0716161999999998,1.0708411000000009,1.0715724500000037,1.0713207435222043,1.0718188844844927,-4202,-242073,-235220.2,-0.021211456229564097,-210.6680862626052,-0.22934710659047824
2023-06-06T04:30:00-04:00,1.07015,1.07036,1.06985,1.07011,1.072353460082944,1.0708775555555556,1.0713622222222208,1.0718668888888858,1.0719105000000035,1.0715949999999999,1.070847800000001,1.0715367500000037,1.0710785948177635,1.071583107587594,-3327,-245400,-238315.4,-0.03711724919180714,-210.792442661241,-0.2405168315170298
2023-06-06T04:45:00-04:00,1.07011,1.07033,1.06967,1.06993,1.0720691140746497,1.070591111111111,1.0710299999999988,1.0716217777777748,1.0718275000000035,1.0715713999999998,1.070857100000001,1.0715009500000037,1.0708488758542107,1.071351686070075,-2798,-248198,-240904.8,-0.05571762038067287,-211.2630858661448,-0.2786787458524445
2023-06-06T05:00:00-04:00,1.06993,1.07011,1.06954,1.06959,1.0718132026671847,1.0703031111111112,1.0707177777777765,1.0713362222222191,1.0717105000000033,1.0715399999999997,1.0708586000000009,1.0714640000000037,1.0705971006833686,1.0710917488560598,-2630,-250828,-244874,-0.07790762876242739,-212.0988414763249,-0.26202909362178095
2023-06-06T05:15:00-04:00,1.06959,1.06971,1.06932,1.06946,1.0715828824004663,1.0700515555555556,1.0703799999999988,1.0710277777777748,1.0715855000000034,1.071505,1.070863800000001,1.0714242500000035,1.070369680546695,1.0708429990848478,-2166,-252994,-247898.6,-0.09437571738279275,-212.36210123006225,-0.2834498834498771
2023-06-06T05:30:00-04:00,1.06946,1.06979,1.06914,1.06953,1.0713113365124103,1.0698815555555556,1.0701899999999986,1.070735999999997,1.0714440000000036,1.0714705999999998,1.070866200000001,1.0713908500000036,1.070201744437356,1.070619199267878,2779,-250215,-249527,-0.11130497696994865,-212.1802056939973,-0.1596280945446285
2023-06-06T05:45:00-04:00,1.06953,1.06964,1.06892,1.0692,1.0710073494006729,1.0696835555555555,1.0699899999999987,1.0704615555555523,1.0712875000000035,1.0714339999999998,1.070862300000001,1.0713559000000037,1.0700013955498848,1.0704037594143023,-2285,-252500,-250947,-0.11631659234902757,-212.8852350059384,-0.16806722689075854
2023-06-06T06:00:00-04:00,1.0692,1.06927,1.06834,1.06896,1.0706733734965652,1.0694775555555556,1.0697122222222208,1.0701979999999969,1.0710845000000035,1.0713893999999997,1.070856500000001,1.0713193500000036,1.069793116439908,1.0701926075314419,-2564,-255064,-252320.2,-0.12039719560713297,-213.4607681148049,-0.2333264890896691
2023-06-06T06:15:00-04:00,1.06896,1.06906,1.06823,1.06856,1.0702533662671836,1.069247111111111,1.0694988888888877,1.069954222222219,1.0708865000000034,1.0713371999999999,1.070848800000001,1.0712791500000036,1.0695464931519263,1.0699824860251534,-2414,-257478,-253650.2,-0.12766865641757053,-214.3640760028455,-0.17935879231747848
2023-06-06T06:30:00-04:00,1.06856,1.06946,1.06851,1.0694,1.069848693013747,1.0692273333333335,1.0694155555555542,1.06976133333333,1.0707340000000036,1.0713037999999997,1.070845900000001,1.0712403000000037,1.069517194521541,1.0698119888201227,2691,-254787,-254008.8,-0.1238975360570845,-212.2486683514269,-0.0700836331355444
2023-06-06T06:45:00-04:00,1.0694,1.06996,1.06937,1.0697699999999999,1.06823,1.069298222222222,1.0693777777777767,1.0695988888888857,1.0705980000000035,1.0712771999999997,1.0708513000000008,1.0712021000000036,1.0695677556172327,1.069685191056098,2215,-252572,-254480.2,-0.11554207463360466,-211.4823040349878,-0.03177243460952678
2023-06-06T07:00:00-04:00,1.0697699999999999,1.07003,1.0688,1.06887,1.0682646,1.0691966666666666,1.0692599999999988,1.0694528888888857,1.0704110000000036,1.0712313999999998,1.070850800000001,1.0711620000000037,1.0694282044937862,1.069570552844878,-2348,-254920,-254964.2,-0.1110412738317672,-213.45768191995353,-0.09907190190012999
2023-06-06T07:15:00-04:00,1.06887,1.06937,1.06874,1.06912,1.068335216,1.0691686666666667,1.0692077777777766,1.0693519999999967,1.0702325000000035,1.0711867999999998,1.070854500000001,1.0711254500000036,1.069366563595029,1.0694852422759022,1794,-253126,-254576.6,-0.10309938809464915,-213.03807991035447,-0.04394207126094769
2023-06-06T07:30:00-04:00,1.06912,1.06956,1.06893,1.06901,1.06840300736,1.0691291111111112,1.0691577777777768,1.0692837777777746,1.0700370000000035,1.0711481999999999,1.0708548000000009,1.0710888500000033,1.0692952508760232,1.0694349938207215,-2000,-255126,-254106.2,-0.09216122340534683,-213.2438566239134,-0.04207731004432718
2023-06-06T07:45:00-04:00,1.06901,1.06905,1.06762,1.06768,1.07003,1.0688335555555555,1.0689522222222212,1.0691911111111079,1.0698010000000033,1.0710857999999996,1.0708388000000009,1.0710436500000033,1.0689722007008184,1.0693259950565772,-2821,-257947,-254738.2,-0.08549777865980766,-216.75358057411043,-0.1729731751330144
2023-06-06T08:00:00-04:00,1.06768,1.0683799999999999,1.06767,1.06783,1.0699818,1.0686091111111111,1.0687999999999989,1.0690755555555522,1.0695675000000036,1.0710235999999997,1.070822500000001,1.0709973500000034,1.0687437605606547,1.0691611960452616,2756,-255191,-255262,-0.081063575477736,-216.366385909042,-0.12813318368872723
2023-06-06T08:15:00-04:00,1.06783,1.06808,1.06726,1.06742,1.0699345640000002,1.0683331111111112,1.0686288888888877,1.0689493333333302,1.0693765000000037,1.0709493999999997,1.0708091000000008,1.0709498000000035,1.0684790084485238,1.0689713568362091,-3494,-258685,-256015,-0.07510651740924819,-217.70792903856645,-0.14406525969165124
2023-06-06T08:30:00-04:00,1.06742,1.06748,1.06679,1.06723,1.0698275814400002,1.0680533333333333,1.06848111111111,1.068803999999997,1.0691880000000036,1.0708683999999997,1.070796300000001,1.0708985000000033,1.068229206758819,1.0687438854689673,-3804,-262489,-257887.6,-0.07344099870119121,-218.38503833012976,-0.12446657183499789
2023-06-06T08:45:00-04:00,1.06723,1.06751,1.06668,1.06705,1.0696453265536001,1.0677671111111113,1.068219999999999,1.0686164444444413,1.0689675000000036,1.0707821999999998,1.0707771000000008,1.0708501500000034,1.0679933654070553,1.0684835083751736,-3423,-265912,-260044.8,-0.06998411193161981,-218.96236467965093,-0.21974939218251846
2023-06-06T09:00:00-04:00,1.06705,1.06802,1.06696,1.06797,1.0694081004293121,1.0677171111111112,1.0680199999999989,1.0684299999999969,1.0688420000000036,1.0707111999999996,1.070767200000001,1.0708068500000032,1.0679886923256443,1.0682868067001388,3455,-262457,-260946.8,-0.06782546869717707,-215.98349770996805,-0.16826046720321208
2023-06-06T09:15:00-04:00,1.06797,1.06811,1.06766,1.06792,1.0691898523949672,1.067697111111111,1.0679144444444433,1.0682528888888858,1.0687305000000038,1.0706373999999996,1.070762400000001,1.0707631000000033,1.0679749538605154,1.068133045360111,-2578,-265035,-262915.6,-0.07373658706953366,-216.10419398420822,-0.08887890950255938
2023-06-06T09:30:00-04:00,1.06792,1.06827,1.06723,1.06744,1.06898906420337,1.0676022222222223,1.067727777777777,1.0680726666666636,1.0685970000000038,1.0705541999999997,1.0707597000000009,1.0707170000000032,1.0678679630884123,1.0680108362880887,-4645,-269680,-265114.6,-0.07505107599331094,-218.1919908229229,-0.15713858126310665
2023-06-06T09:45:00-04:00,1.06744,1.06762,1.06692,1.06724,1.0688043390671003,1.0675046666666665,1.06753111111111,1.0678826666666636,1.0684625000000039,1.0704687999999998,1.070753300000001,1.0706744000000035,1.0677423704707298,1.0679134690304708,-4678,-274358,-267488.4,-0.07986477224193711,-219.0684803680026,-0.16557375515664485
2023-06-06T10:00:00-04:00,1.06724,1.06824,1.06709,1.06801,1.0686343919417323,1.0676004444444442,1.0675677777777768,1.067752222222219,1.0683835000000037,1.0704013999999997,1.070753700000001,1.0706340000000032,1.067795896376584,1.0678739752243767,4950,-269408,-268187.6,-0.08067384341917042,-215.49711872488606,0.030908137269588402
2023-06-06T10:15:00-04:00,1.06801,1.06846,1.06764,1.06778,1.0684780405863936,1.067642888888889,1.0675622222222212,1.0676606666666635,1.0682995000000037,1.0703255999999997,1.070746900000001,1.0705915000000035,1.067792717101267,1.0678347801795012,-3516,-272924,-270281,-0.07167674372454123,-216.25430264638476,-0.004682393264855409
2023-06-06T10:30:00-04:00,1.06778,1.06815,1.06735,1.0675,1.06846,1.0676304444444444,1.06757111111111,1.0675919999999968,1.0681980000000038,1.0702265999999998,1.070738400000001,1.0705551000000033,1.0677341736810138,1.0677866241436007,-3475,-276399,-272553.8,-0.06603520005113937,-217.16553904339557,0.007494706863264504
2023-06-06T10:45:00-04:00,1.0675,1.06911,1.06741,1.06907,1.06668,1.0679302222222222,1.0677755555555544,1.0676015555555523,1.0681915000000037,1.0701691999999996,1.070748700000001,1.0705267500000035,1.068001338944811,1.0678132993148806,5173,-271226,-272863,-0.048540032264712415,-209.55747346962474,0.17240894652512243
2023-06-06T11:00:00-04:00,1.06907,1.0692,1.06851,1.06851,1.0667286,1.068077111111111,1.0679377777777765,1.0676828888888854,1.068169000000004,1.0701047999999997,1.070717700000001,1.0704923500000034,1.0681030711558488,1.0678854394519042,-4009,-275235,-273038.4,-0.03348290904983345,-211.65746692187724,0.13682582821798572
2023-06-06T11:15:00-04:00,1.06851,1.06921,1.06842,1.0692,1.066827456,1.0683295555555554,1.0680744444444432,1.067784222222219,1.068201000000004,1.0700522,1.0706921000000011,1.0704548500000035,1.068322456924679,1.0679907515615235,3442,-271793,-273515.4,-0.014425447273349972,-209.4347642798809,0.11517177448803265
2023-06-06T11:30:00-04:00,1.0692,1.06934,1.06898,1.06909,1.06697040864,1.0685326666666666,1.0682044444444434,1.0679126666666634,1.0681855000000038,1.0699973999999997,1.0706646000000013,1.0704221000000036,1.0684759655397431,1.0681274012492186,-2542,-274335,-273797.6,-0.006303183107248655,-209.69628691362536,0.1095587684470855
2023-06-06T11:45:00-04:00,1.06909,1.06968,1.06908,1.0694299999999999,1.0671599759488,1.0687777777777778,1.0684255555555544,1.0680835555555521,1.0681685000000039,1.0699503999999997,1.070648200000001,1.0703982000000036,1.0686667724317944,1.0683139209993746,2696,-271639,-272845.6,0.007698431873788272,-208.83888482399828,0.1864273401783647
2023-06-06T12:00:00-04:00,1.0694299999999999,1.0697699999999999,1.06928,1.06937,1.06741197835392,1.0689666666666666,1.068662222222221,1.0682608888888856,1.0681935000000038,1.0699069999999997,1.070630300000001,1.0703749000000036,1.0688074179454354,1.0684751367994996,-2232,-273871,-273374.6,0.027549019870280994,-208.96411041146067,0.19958022562872132
2023-06-06T12:15:00-04:00,1.06937,1.06939,1.06893,1.06894,1.0676949409514496,1.0690222222222223,1.0687655555555544,1.0684264444444413,1.0681845000000039,1.0698539999999999,1.0706071000000013,1.0703554500000036,1.0688339343563484,1.0686213094395993,-2102,-275973,-273522.2,0.043151080939270406,-209.80933704022326,0.08707783634985604
2023-06-06T12:30:00-04:00,1.06894,1.06902,1.0687,1.06875,1.0679439480372757,1.0690191111111111,1.068873333333332,1.068586222222219,1.068171500000004,1.0697903999999998,1.0705844000000013,1.0703332500000036,1.0688171474850787,1.068720247551679,-1663,-277636,-274690.8,0.05172865724839515,-210.1049289349974,0.09084268294968416
2023-06-06T12:45:00-04:00,1.06875,1.06895,1.06874,1.06883,1.0681630742728025,1.0690104444444446,1.0690211111111099,1.0687495555555524,1.0682290000000039,1.0697277999999997,1.0705521000000013,1.0703158000000037,1.068819717988063,1.068788998041343,1425,-276211,-275066,0.06236108176372268,-209.9982622683309,0.12459016393443124
2023-06-06T13:00:00-04:00,1.06883,1.06884,1.06819,1.06867,1.0697699999999999,1.0689402222222222,1.0689766666666654,1.0688597777777746,1.0682710000000037,1.0696539999999997,1.0705189000000013,1.0702948000000037,1.0687897743904504,1.0688135984330742,-1817,-278028,-276343.8,0.0688977299323671,-210.27026062167045,-0.03741569775598941
2023-06-06T13:15:00-04:00,1.06867,1.06879,1.06824,1.06852,1.0697383999999999,1.068848888888889,1.0689777777777765,1.0689228888888855,1.0683260000000039,1.0695777999999996,1.0704911000000012,1.0702728000000035,1.0687358195123604,1.0687992787464593,-1267,-279295,-277428.6,0.060671464754091256,-210.44809849491486,0.000935882677732868
2023-06-06T13:30:00-04:00,1.06852,1.06869,1.06844,1.06853,1.069707432,1.0687593333333332,1.068903333333332,1.0689504444444413,1.0683910000000036,1.0694879999999996,1.0704658000000014,1.0702542000000035,1.0686946556098884,1.0687714229971672,859,-278436,-277921.2,0.05590805458446455,-210.44005933795003,-0.06266367377478006
2023-06-06T13:45:00-04:00,1.06853,1.06869,1.06843,1.06857,1.06967708336,1.0686926666666667,1.068845555555554,1.0689448888888857,1.0684670000000036,1.0694089999999996,1.0704400000000014,1.0702355500000034,1.0686697244879106,1.0687419383977335,1060,-277376,-277869.2,0.044035604658569066,-210.40037865514276,-0.04863949714243664
2023-06-06T14:00:00-04:00,1.06857,1.06906,1.06847,1.06904,1.0696473416928,1.0687315555555557,1.0688022222222209,1.0689011111111077,1.0685205000000038,1.0693407999999998,1.0704205000000013,1.0702222500000034,1.0687437795903285,1.0687267507181868,1232,-276144,-277855.8,0.03469501808979521,-209.858495577759,-0.03646802502266539
2023-06-06T14:15:00-04:00,1.06904,1.06925,1.06901,1.06918,1.069618194858944,1.068807111111111,1.0687811111111098,1.0688619999999969,1.0685835000000037,1.0692745999999997,1.0704041000000013,1.0702115000000034,1.068831023672263,1.068735000574549,1106,-275038,-277257.8,0.0269612769219771,-209.71365534727178,-0.017767470566774125
2023-06-06T14:30:00-04:00,1.06918,1.06956,1.06902,1.06952,1.0695896309617652,1.068954888888889,1.068845555555554,1.0688355555555524,1.0686875000000036,1.0692127999999999,1.0703886000000014,1.0702026000000036,1.0689688189378104,1.0687816004596393,1152,-273886,-276176,0.021233276845175595,-209.34731852840125,0.05425935973955741
2023-06-06T14:45:00-04:00,1.06952,1.06963,1.0694,1.06942,1.06819,1.0690697777777778,1.0689199999999985,1.0688388888888858,1.0687965000000037,1.0691473999999999,1.0703700000000012,1.0701947000000036,1.0690590551502483,1.0688544803677114,-1464,-275350,-275558.8,0.01690046459593373,-209.48420236414063,0.06269005847952733
2023-06-06T15:00:00-04:00,1.06942,1.06944,1.06919,1.0692,1.0682188,1.0691257777777776,1.0689611111111097,1.0688619999999969,1.0688560000000036,1.0690729999999997,1.0703495000000014,1.0701847000000035,1.0690872441201986,1.0689379842941689,-1301,-276651,-275413.8,0.012376849677671274,-209.75184276734998,0.034617291805056134
2023-06-06T15:15:00-04:00,1.0692,1.06961,1.0692,1.06951,1.068247024,1.0692355555555555,1.069054444444443,1.0689124444444413,1.0689425000000037,1.0690151999999997,1.0703303000000013,1.0701746000000036,1.0691717952961588,1.0690235874353349,1052,-275599,-275304.8,0.012055261747792397,-209.44682967344798,0.07860237491460899
2023-06-06T15:30:00-04:00,1.06951,1.06955,1.06903,1.06928,1.0682746835199999,1.0692806666666665,1.0691388888888875,1.0689839999999968,1.0690315000000037,1.0689507999999999,1.0703082000000013,1.0701671500000034,1.069193436236927,1.0690960699482677,-928,-276527,-275602.6,0.011078873830725283,-209.64639769992735,0.07112641784899618
2023-06-06T15:45:00-04:00,1.06928,1.06936,1.06912,1.06918,1.0683017898496,1.0692888888888887,1.0692111111111098,1.069057111111108,1.0690370000000038,1.0689095999999998,1.070286200000001,1.0701581000000036,1.0691907489895416,1.0691404559586142,-1277,-277804,-276386.2,0.009768456837957204,-209.76582385584533,0.06083123543560213
2023-06-06T16:00:00-04:00,1.06918,1.0693,1.06901,1.06909,1.0683283540526078,1.0692646666666668,1.0692688888888877,1.0691268888888856,1.0690660000000036,1.0688714,1.0702635000000011,1.0701505000000033,1.0691705991916334,1.0691627647668909,-866,-278670,-277050.2,0.014917707617633525,-209.83872084232087,0.04866316666199463
2023-06-06T16:15:00-04:00,1.06909,1.06932,1.06909,1.06924,1.0683543869715557,1.069258888888889,1.0692911111111099,1.0691928888888858,1.0690680000000037,1.0688269999999997,1.0702411000000012,1.0701411000000034,1.0691844793533067,1.0691822118135126,484,-278186,-277357.2,0.01793273753551722,-209.77081262131054,0.01870837386814132
2023-06-06T16:30:00-04:00,1.06924,1.06925,1.06912,1.06921,1.0683798992321245,1.0692426666666666,1.0692944444444432,1.0692408888888856,1.0690740000000036,1.0688015999999998,1.0702198000000012,1.0701310500000034,1.0691895834826455,1.06918576945081,-405,-278591,-277955.6,0.019478347320572978,-209.78217583256338,0.002805888624925129
2023-06-06T16:45:00-04:00,1.06921,1.0693,1.0691599999999999,1.06925,1.068404901247482,1.0692337777777778,1.0692644444444432,1.0692659999999967,1.0690650000000035,1.0687836,1.070199900000001,1.0701211500000034,1.0692016667861164,1.0691874155606478,683,-277908,-278231.8,0.019420303928002362,-209.7566242571011,-0.02524496970603565
2023-06-06T17:00:00-04:00,1.06925,1.06946,1.06892,1.06941,1.0684294032225325,1.0692628888888889,1.069263333333332,1.0692764444444411,1.0690670000000035,1.0687696,1.070182300000001,1.0701125000000034,1.069243333428893,1.069197932448518,114,-277794,-278229.8,0.01848048458181954,-209.73956557110625,-0.0009350863084723974
2023-06-06T17:15:00-04:00,1.06941,1.06941,1.06936,1.06941,1.068453415158082,1.0692922222222223,1.0692866666666654,1.069279999999997,1.0690905000000037,1.0687592000000001,1.070165300000001,1.0701047000000032,1.0692766667431144,1.0692191459588143,0,-277794,-278054.6,0.018208745810513332,-209.73956557110625,0.019640852974190375
2023-06-06T17:30:00-04:00,1.06941,1.06958,1.06938,1.06941,1.0684769468549205,1.0693168888888889,1.0692755555555542,1.0692768888888857,1.0691235000000034,1.0687556,1.070147800000001,1.0700974500000033,1.0693033333944915,1.0692429167670512,0,-277794,-277976.2,0.01807919569651492,-209.73956557110625,-0.009350076203120027
2023-06-06T17:45:00-04:00,1.06941,1.06957,1.06932,1.06938,1.068500007917822,1.0693377777777777,1.0692866666666654,1.06927533333333,1.0691510000000035,1.068754,1.070129500000001,1.0700905000000034,1.0693186667155932,1.0692687334136408,-93,-277887,-277835.4,0.014056748107860948,-209.74217448630247,0.009352087385903504
2023-06-06T18:00:00-04:00,1.06938,1.06951,1.06929,1.0694299999999999,1.0685226077594656,1.0693664444444444,1.0693144444444431,1.06928533333333,1.0691890000000037,1.0687520000000001,1.0701113000000013,1.0700844500000033,1.0693409333724746,1.0692965867309125,331,-277556,-277765,0.012787023242679142,-209.72669822903194,0.02338240520771633
2023-06-06T18:15:00-04:00,1.0694299999999999,1.06948,1.0694299999999999,1.06944,1.0685447556042762,1.0693915555555555,1.069353333333332,1.06930333333333,1.0692350000000037,1.0687568,1.0700954000000011,1.0700791500000033,1.0693607466979798,1.0693200693847298,161,-277395,-277685.2,0.011788954991968104,-209.7251927541528,0.03273812307662127
2023-06-06T18:30:00-04:00,1.06944,1.0695,1.06937,1.0695,1.0685664604921907,1.069420888888889,1.069382222222221,1.0693224444444411,1.0692835000000036,1.0687676000000002,1.070078500000001,1.0700739000000032,1.0693885973583839,1.0693424555077837,217,-277178,-277562,0.011258472802657241,-209.71301815810253,0.02431633683737299
2023-06-06T18:45:00-04:00,1.0695,1.0695,1.06942,1.06949,1.0685877312823469,1.0694424444444444,1.069413333333332,1.0693499999999965,1.0693295000000034,1.0687862,1.070061700000001,1.0700680500000033,1.069408877886707,1.0693635644062272,-199,-277377,-277478.6,0.009320797536311225,-209.71487884066445,0.026187559038922007
2023-06-06T19:00:00-04:00,1.06949,1.06956,1.0692,1.06929,1.0686085766567,1.0694177777777776,1.0694177777777765,1.0693762222222187,1.0693420000000036,1.068784,1.070043900000001,1.0700607500000032,1.0693851023093657,1.0693768515249815,-403,-277780,-277457.2,0.006862345185523187,-209.79024186416163,0.003740939911156418
2023-06-06T19:15:00-04:00,1.06929,1.06944,1.06926,1.06941,1.0686290051235658,1.069416222222222,1.0694177777777765,1.0693968888888854,1.0693535000000036,1.0687768,1.070027000000001,1.070054050000003,1.0693900818474926,1.069386681219985,401,-277379,-277421.8,0.006710826607518049,-209.74524004052168,0
2023-06-06T19:30:00-04:00,1.06941,1.06962,1.06938,1.06954,1.0686490250210945,1.0694406666666667,1.0694322222222208,1.0694126666666632,1.0693545000000035,1.0687902,1.0700108000000013,1.070048500000003,1.0694200654779942,1.069398544975988,412,-276967,-277336.2,0.006323305254221076,-209.6951563495145,0.012156235681353595
2023-06-06T19:45:00-04:00,1.06954,1.06991,1.06942,1.06986,1.0686686445206726,1.0695262222222222,1.069482222222221,1.0694326666666634,1.0693765000000035,1.068805,1.0699959000000012,1.0700444500000033,1.0695080523823954,1.06942243598079,720,-276247,-277150,0.009017253010976865,-209.4797366363667,0.042079277358549244
2023-06-06T20:00:00-04:00,1.06986,1.07022,1.06974,1.07006,1.0687182987398456,1.0696417777777778,1.0695577777777763,1.0694615555555522,1.0694195000000035,1.0688259999999998,1.0699871000000014,1.0700415500000033,1.0696184419059163,1.069464348784632,1613,-274634,-276601.4,0.012245303258473676,-209.17820185611512,0.06358824739568852
2023-06-06T20:15:00-04:00,1.07006,1.07039,1.07002,1.07007,1.0688084008154548,1.0697442222222224,1.0696288888888874,1.0695037777777743,1.0694475000000037,1.0688738,1.0699798000000014,1.0700386500000034,1.069708753524733,1.0695290790277054,1267,-273367,-275718.8,0.014822921963694979,-209.16636139857061,0.059844964139793726
2023-06-06T20:30:00-04:00,1.07007,1.0704,1.06978,1.07036,1.0689349287502183,1.0698904444444446,1.0697311111111096,1.069566444444441,1.0695015000000037,1.0689244,1.0699740000000013,1.0700381000000032,1.0698390028197864,1.0696188632221642,875,-272492,-274741.4,0.019733464652499495,-208.92922737930093,0.08602633153800418
2023-06-06T20:45:00-04:00,1.07036,1.07043,1.06985,1.0700399999999999,1.0690814358751966,1.0699522222222224,1.0697911111111096,1.0696382222222187,1.0695445000000037,1.0689767999999997,1.0699631000000012,1.0700378500000034,1.069879202255829,1.0697106905777312,-1237,-273729,-274093.8,0.021958969852022853,-209.29904687928234,0.05049088359046143
2023-06-06T21:00:00-04:00,1.0700399999999999,1.07012,1.06983,1.06994,1.069243263570173,1.0699819999999998,1.0698411111111095,1.0697099999999964,1.0695870000000036,1.0690309999999998,1.0699497000000011,1.0700376000000034,1.0698913618046633,1.0697873524621848,-1519,-275248,-273894,0.022688386849685282,-209.44100418928943,0.04207612974406861
2023-06-06T21:15:00-04:00,1.06994,1.07002,1.0697,1.06996,1.0693856719417523,1.0700057777777776,1.0699155555555542,1.069781555555552,1.0696230000000038,1.0690891999999999,1.0699357000000012,1.0700385000000032,1.0699050894437305,1.0698446819697476,1559,-273689,-273705,0.023208394734366505,-209.41186236825254,0.06265839949872798
2023-06-06T21:30:00-04:00,1.06996,1.07015,1.06941,1.0695,1.07043,1.0699226666666666,1.069925555555554,1.0698408888888855,1.0696375000000038,1.0691198,1.0699155000000011,1.0700381500000031,1.0698240715549845,1.0698677455757981,-2580,-276269,-274285.4,0.024013932889435523,-210.52106271219094,0.008415855471701544
2023-06-06T21:45:00-04:00,1.0695,1.06968,1.06927,1.06964,1.0704096,1.0698655555555554,1.069936666666665,1.0698819999999964,1.0696570000000036,1.0691542,1.0698958000000012,1.0700379500000032,1.0697872572439875,1.0698573964606382,1507,-274762,-274739.4,0.024249423147100255,-210.32379295997023,0.00934981393870159
2023-06-06T22:00:00-04:00,1.06964,1.06966,1.0689899999999999,1.06903,1.070364016,1.0696842222222223,1.0698444444444428,1.069892666666663,1.0696380000000036,1.069186,1.069870100000001,1.0700362000000034,1.06963580579519,1.0698087171685102,-1622,-276384,-275270.4,0.020461068543455765,-211.2487957646522,-0.07758024414410375
2023-06-06T22:15:00-04:00,1.06903,1.0693,1.06887,1.06928,1.07028157504,1.0695713333333332,1.0697577777777763,1.0698759999999963,1.0696315000000036,1.0692268,1.0698478000000011,1.0700367500000034,1.069564644636152,1.069743373734808,1505,-274879,-275196.6,0.01561745950079047,-210.89684118900874,-0.07289310879763779
2023-06-06T22:30:00-04:00,1.06928,1.06946,1.06911,1.06938,1.0701686490368,1.0694957777777778,1.0696811111111095,1.0698291111111071,1.0696300000000036,1.0692541999999998,1.069827800000001,1.0700370000000035,1.0695277157089216,1.0696678989878463,1285,-273594,-275177.6,0.009393638414596284,-210.77666686609987,-0.06448176287533333
2023-06-06T22:45:00-04:00,1.06938,1.06944,1.06922,1.06929,1.0700647571138562,1.0694175555555556,1.0695622222222205,1.0697564444444407,1.0696255000000037,1.0692844,1.069805000000001,1.0700366500000034,1.0694801725671372,1.069599119190277,-919,-274513,-274826.4,0.0026355751900104707,-210.85401074760125,-0.09996636645613666
2023-06-06T23:00:00-04:00,1.06929,1.06935,1.06893,1.0689899999999999,1.0699691765447477,1.069303111111111,1.069445555555554,1.0696582222222184,1.0696035000000037,1.0693142,1.069770400000001,1.0700331000000034,1.0693821380537099,1.0695180953522212,-1787,-276300,-275134,-0.008436658281701878,-211.35537146359067,-0.09812717281596908
2023-06-06T23:15:00-04:00,1.0689899999999999,1.06922,1.06894,1.06909,1.0698812424211679,1.0692319999999997,1.0693511111111096,1.0695595555555517,1.069586000000004,1.0693146,1.069741900000001,1.0700319500000033,1.0693237104429678,1.0694556762817768,964,-275336,-274924.4,-0.015805060824754004,-211.26519288380956,-0.07944370712374484
2023-06-06T23:30:00-04:00,1.06909,1.06936,1.06906,1.0692,1.0698003430274745,1.0692017777777778,1.069266666666665,1.0694613333333294,1.0695710000000038,1.0693284,1.069716600000001,1.0700294500000034,1.0692989683543743,1.0694025410254213,889,-274447,-274838,-0.021655390785167292,-211.1737225679336,-0.07103069273618583
2023-06-06T23:45:00-04:00,1.0692,1.06936,1.06907,1.06927,1.0697259155852765,1.0692024444444443,1.0692411111111095,1.0693733333333295,1.0695600000000038,1.0693298,1.069691000000001,1.0700251500000035,1.0692931746834995,1.0693556328203369,859,-273588,-274836.8,-0.027082872342504415,-211.1174842589175,-0.02150537634408158
2023-06-07T00:00:00-04:00,1.06927,1.0695,1.06921,1.0695,1.0696574423384544,1.069254222222222,1.0692255555555539,1.069305999999996,1.0695705000000035,1.0693380000000001,1.069667700000001,1.0700213000000034,1.0693345397467995,1.0693265062562693,668,-272920,-274518.2,-0.02712738249451288,-210.97379744454884,-0.013088515762315265
2023-06-07T00:15:00-04:00,1.0695,1.06956,1.06938,1.0694,1.069594446951378,1.0692891111111111,1.069266666666665,1.0692702222222183,1.0695700000000037,1.0693374,1.069643900000001,1.0700180000000035,1.0693476317974395,1.069319605005015,-694,-273614,-273981,-0.029860899940579225,-211.0386875801262,0.03461081541210083
2023-06-07T00:30:00-04:00,1.0694,1.0694,1.06914,1.0692,1.06956,1.0692757777777777,1.069257777777776,1.0692515555555517,1.0695530000000038,1.069334,1.0696205000000012,1.0700138500000034,1.0693181054379517,1.0693184840040122,-646,-274260,-273765.8,-0.027336758590347673,-211.15950299063675,-0.007481669908731109
2023-06-07T00:45:00-04:00,1.0692,1.06921,1.06892,1.06903,1.06956,1.069230222222222,1.0692188888888872,1.069241999999996,1.0695115000000037,1.0693358,1.0695949000000011,1.0700089500000034,1.0692604843503613,1.0693107872032095,-1352,-275612,-273998.8,-0.02740416445321634,-211.37446745004567,-0.03272924498308108
2023-06-07T01:00:00-04:00,1.06903,1.06904,1.06842,1.06857,1.0695048,1.0691004444444443,1.0691388888888875,1.0692215555555518,1.0694370000000037,1.0693322,1.069561300000001,1.0700013500000032,1.069122387480289,1.0692766297625673,-1382,-276994,-274680,-0.02923575613987935,-211.96913738447208,-0.06733439946132984
2023-06-07T01:15:00-04:00,1.06857,1.06863,1.06831,1.06849,1.06939632,1.0689706666666667,1.069083333333332,1.0691931111111073,1.0693580000000036,1.0693254,1.069526600000001,1.0699939500000033,1.0689959099842312,1.0692089038100536,-1127,-278121,-275720.2,-0.029727620013426763,-212.05351182882302,-0.0467731222930004
2023-06-07T01:30:00-04:00,1.06849,1.06885,1.06848,1.0688199999999999,1.0692659616,1.068918,1.0690533333333319,1.0691504444444406,1.0692810000000037,1.0693284,1.069491200000001,1.0699869500000032,1.068960727987385,1.069131523048043,1162,-276959,-276389.2,-0.025752605764455715,-211.6946315398171,-0.025255123516281557
2023-06-07T01:45:00-04:00,1.0688199999999999,1.0688199999999999,1.0684,1.06849,1.069151246208,1.0688053333333334,1.0689744444444431,1.069093777777774,1.0692035000000035,1.0693278,1.0694528000000012,1.0699781000000033,1.068866582389908,1.069041218438434,-1496,-278455,-277228.2,-0.023038098592838268,-212.15652409422282,-0.06640478862700977
2023-06-07T02:00:00-04:00,1.06849,1.06859,1.06799,1.06833,1.06905029666304,1.0686764444444443,1.0688699999999987,1.0690239999999964,1.0691230000000036,1.0693238,1.0694059000000011,1.0699709000000033,1.0687592659119263,1.068940974750747,-2545,-281000,-278305.8,-0.023560955621418606,-212.53762265387226,-0.08791044357364752
2023-06-07T02:15:00-04:00,1.06833,1.06839,1.06747,1.06781,1.0689018551302143,1.0684644444444444,1.068682222222221,1.068932666666663,1.0690155000000037,1.0693086,1.0693588000000012,1.0699603000000033,1.068569412729541,1.0688303798005974,-2215,-283215,-279550,-0.027732405890641822,-213.6157539428936,-0.1580177653108901
2023-06-07T02:30:00-04:00,1.06781,1.0679,1.06726,1.0674,1.06867275830938,1.068208,1.0684599999999986,1.0688079999999964,1.0689105000000036,1.0692758,1.069308300000001,1.0699486500000033,1.0683355301836328,1.0686983038404776,-2308,-285523,-281030.4,-0.03597694375034747,-214.50194156054098,-0.18702075930428297
2023-06-07T02:45:00-04:00,1.0674,1.06774,1.06728,1.06764,1.0684184618136916,1.0680440000000002,1.068286666666665,1.068654666666663,1.0688105000000037,1.069245,1.0692598000000009,1.0699369000000034,1.0681964241469062,1.068545443072382,2540,-282983,-282235.2,-0.0441596107964039,-213.93083419685348,-0.14590347923681313
2023-06-07T03:00:00-04:00,1.06764,1.06817,1.0668199999999999,1.06698,1.068209938687227,1.0677826666666668,1.0680588888888873,1.068471555555552,1.0687080000000035,1.0691941999999999,1.069203500000001,1.0699236000000034,1.067953139317525,1.068362754457905,-4089,-287072,-283958.6,-0.05308514520415629,-216.4585963638756,-0.19176262593190888
2023-06-07T03:15:00-04:00,1.06698,1.06766,1.06698,1.06762,1.06817,1.0676948888888886,1.0679533333333318,1.0682882222222188,1.0686250000000035,1.0691581999999997,1.069152800000001,1.0699138500000034,1.06788651145402,1.068188203566324,3327,-283745,-284507.6,-0.0599996969934841,-214.46298257542605,-0.08890386217093933
2023-06-07T03:30:00-04:00,1.06762,1.06837,1.0675999999999999,1.06837,1.0668199999999999,1.067778222222222,1.0679399999999983,1.0681397777777741,1.0685745000000035,1.0691415999999998,1.069107300000001,1.0699057500000033,1.067983209163216,1.068070962853059,2683,-281062,-284077,-0.057818613983954756,-212.57818274027863,-0.011230802347228142
2023-06-07T03:45:00-04:00,1.06837,1.06863,1.06822,1.06842,1.0668509999999998,1.0678742222222222,1.067895555555554,1.0680268888888853,1.0685310000000037,1.0691198,1.069067500000001,1.0698972000000033,1.0680705673305728,1.0680179702824468,2295,-278767,-282725.8,-0.054198078334250825,-212.47077613020934,-0.03742444939278419
2023-06-07T04:00:00-04:00,1.06842,1.0689,1.06791,1.0688199999999999,1.0669221599999998,1.068059111111111,1.0679322222222207,1.0679559999999966,1.0685225000000036,1.0691105999999997,1.069030700000001,1.0698934000000033,1.0682204538644582,1.0680227762259573,2491,-276276,-281384.4,-0.052104687104224966,-211.5381840783946,0.030884706454898173
2023-06-07T04:15:00-04:00,1.0688199999999999,1.06888,1.06846,1.06861,1.0670408303999999,1.0681946666666666,1.0679633333333318,1.0679368888888854,1.0684985000000036,1.0690992,1.069004400000001,1.0698897000000034,1.0682983630915666,1.0680918209807655,-2316,-278592,-279688.4,-0.04928905221491999,-211.99322795856114,0.026209130137696966
2023-06-07T04:30:00-04:00,1.06861,1.06871,1.06841,1.06863,1.067152380576,1.068328,1.068054444444443,1.0679571111111077,1.0684700000000036,1.0690899999999999,1.068980700000001,1.0698865000000033,1.0683646904732533,1.0681874567846124,1980,-276612,-278261.8,-0.04443236209006834,-211.95617047266842,0.07679268783772797
2023-06-07T04:45:00-04:00,1.06863,1.06933,1.06847,1.0693,1.06725723774144,1.068577111111111,1.0682655555555542,1.0680222222222189,1.0684715000000033,1.0690911999999997,1.068959100000001,1.0698861500000034,1.0685517523786026,1.0683011654276897,2195,-274417,-276932.8,-0.030933164577010626,-210.57996916819457,0.17800262319655358
2023-06-07T05:00:00-04:00,1.0693,1.06974,1.069,1.06947,1.0674230587221247,1.0688179999999998,1.0684688888888876,1.0681368888888856,1.0684700000000036,1.0690963999999998,1.0689490000000008,1.0698882500000035,1.068735401902882,1.0684341323421513,2894,-271523,-275484,-0.012451590763995693,-210.1198737786874,0.1714060919411036
2023-06-07T05:15:00-04:00,1.06947,1.0697699999999999,1.06926,1.06944,1.0676547528499123,1.069012222222222,1.068742222222221,1.0682988888888856,1.0684720000000036,1.0691001999999998,1.0689419000000009,1.0698915000000033,1.0688763215223056,1.068565305873721,-1929,-273452,-274919.2,0.004661560045262037,-210.17398469343954,0.23055727380081226
2023-06-07T05:30:00-04:00,1.06944,1.06976,1.06918,1.06956,1.0679085825079229,1.0691757777777777,1.0689577777777766,1.0684977777777747,1.0684900000000037,1.0691031999999998,1.068936400000001,1.0698921000000035,1.0690130572178445,1.0687082446989766,1874,-271578,-273516.4,0.028093943580631112,-209.9637064169582,0.18171259436878784
2023-06-07T05:45:00-04:00,1.06956,1.06972,1.06928,1.06962,1.0681319526069721,1.0693082222222223,1.0690966666666655,1.068706222222219,1.0685195000000036,1.0691073999999998,1.0689333000000008,1.0698952000000035,1.0691344457742755,1.068862195759181,1876,-269702,-272134.4,0.044938772927550094,-209.85846687920443,0.11700066456377223
2023-06-07T06:00:00-04:00,1.06962,1.07045,1.06962,1.07011,1.0683285182941356,1.069510888888889,1.069284444444443,1.0689099999999967,1.0685965000000037,1.0691213999999998,1.068938500000001,1.0698985500000036,1.0693295566194203,1.0690177566073444,2276,-267426,-270736.2,0.05640694280453646,-208.81581621822227,0.15817749574137224
2023-06-07T06:15:00-04:00,1.07011,1.0709,1.06991,1.07075,1.0686255257329567,1.069804,1.0694988888888877,1.0691159999999968,1.0687095000000038,1.0691487999999998,1.0689514000000009,1.0699076000000034,1.0696136452955363,1.0691934052858751,2258,-265168,-269465.2,0.06849003773194728,-207.4653756093125,0.18057296832022318
2023-06-07T06:30:00-04:00,1.07075,1.07127,1.07048,1.07127,1.0689894416156835,1.0701582222222221,1.0697944444444432,1.0693264444444412,1.0688320000000036,1.0691855999999997,1.0689688000000008,1.0699175000000034,1.069944916236429,1.0694071242286998,2667,-262501,-267275,0.07901820680021865,-206.1701713132587,0.24892149614919237
2023-06-07T06:45:00-04:00,1.07127,1.0718699999999999,1.07108,1.07148,1.0693999421248606,1.0704953333333334,1.07011111111111,1.069557111111108,1.0689815000000036,1.0692263999999998,1.0689916000000008,1.0699269500000035,1.0702519329891431,1.0696548993829598,3242,-259259,-264811.2,0.09400787237443506,-205.53464525540198,0.26669661154936875
2023-06-07T07:00:00-04:00,1.07148,1.07208,1.07129,1.07174,1.0698939536998884,1.070821111111111,1.070382222222221,1.069814222222219,1.0691520000000037,1.0692712,1.069019400000001,1.0699379500000035,1.0705495463913144,1.0699379195063674,3016,-256243,-262119.4,0.10860807157898608,-204.80279771741735,0.22818666417282316
2023-06-07T07:15:00-04:00,1.07174,1.0720399999999999,1.07144,1.07184,1.0703311629599106,1.0711126666666668,1.0706455555555545,1.0700864444444411,1.0693535000000036,1.0693181999999999,1.069052200000001,1.0699505000000036,1.0708076371130515,1.0702335356050936,2750,-253493,-259332.8,0.11671405057639216,-204.54620563351642,0.22160509411203524
2023-06-07T07:30:00-04:00,1.07184,1.07231,1.07157,1.07185,1.0706809303679286,1.0713535555555556,1.0709133333333323,1.07036933333333,1.0695760000000036,1.0693693999999998,1.069076700000001,1.0699613000000034,1.0710161096904411,1.0705140284840744,2178,-251315,-256562.2,0.12095862134095278,-204.52588543647195,0.22535158587672272
2023-06-07T07:45:00-04:00,1.07185,1.0718699999999999,1.07139,1.07154,1.071006744294343,1.0714788888888889,1.0711333333333324,1.0706371111111077,1.0697710000000034,1.0694119999999998,1.069094400000001,1.0699728500000036,1.0711208877523528,1.0707492227872595,-2672,-253987,-254859.4,0.12213830172763913,-205.29868013722307,0.18512285425781355
2023-06-07T08:00:00-04:00,1.07154,1.0718,1.07135,1.0715999999999999,1.0712673954354743,1.0715722222222221,1.0713533333333323,1.070885555555552,1.0700020000000035,1.0694531999999997,1.069121700000001,1.0699862500000037,1.0712167102018821,1.0709421782298072,2820,-251167,-253241,0.12355888764982008,-205.14077655919533,0.18511246984909321
2023-06-07T08:15:00-04:00,1.0715999999999999,1.07172,1.07071,1.07083,1.07231,1.0714675555555555,1.0714333333333323,1.0710957777777745,1.0701625000000035,1.0694725999999997,1.069138800000001,1.0699966500000035,1.0711393681615058,1.0710601425838455,-3146,-254313,-252855,0.11771239831862981,-207.40134020234558,0.06728280270253095
2023-06-07T08:30:00-04:00,1.07083,1.07121,1.07052,1.07074,1.072278,1.0713288888888888,1.071432222222221,1.0712531111111077,1.0702810000000034,1.0694861999999998,1.0691561000000012,1.0700054500000036,1.0710594945292047,1.071110514067076,-3169,-257482,-253652.8,0.10970014670321311,-207.66768500030582,-0.0009339248190581846
2023-06-07T08:45:00-04:00,1.07074,1.0718,1.07062,1.07161,1.07220768,1.0713644444444443,1.0714699999999988,1.0713644444444408,1.0704405000000032,1.0695169999999998,1.069195400000001,1.0700171000000036,1.0711695956233638,1.0711412112536605,2831,-254651,-254320,0.10330454419899683,-205.36743470611697,0.03173803056185714
2023-06-07T09:00:00-04:00,1.07161,1.07216,1.07139,1.07216,1.07052,1.0715024444444445,1.0715455555555544,1.0714468888888855,1.0706075000000033,1.0695529999999998,1.069238700000001,1.0700306000000035,1.071367676498691,1.0711905690029282,3560,-251091,-253740.8,0.09496476353138282,-203.54027743808086,0.06346362041288815
2023-06-07T09:15:00-04:00,1.07216,1.07229,1.07169,1.07171,1.0705528,1.0715353333333333,1.071542222222221,1.0714846666666633,1.0707625000000032,1.0695863999999997,1.0692816000000012,1.0700453500000036,1.0714361411989528,1.0712344552023423,-2655,-253746,-254256.6,0.08424709991996213,-204.65461671580076,-0.0027991863698261232
2023-06-07T09:30:00-04:00,1.07171,1.07278,1.07149,1.07277,1.070622288,1.071780888888889,1.0716455555555544,1.0715271111111078,1.0709695000000032,1.0696429999999997,1.069337000000001,1.0700666500000036,1.0717029129591622,1.0713471641618737,5024,-248722,-253138.4,0.07535123145593539,-199.6855112674982,0.0867666815942769
2023-06-07T09:45:00-04:00,1.07277,1.0738699999999999,1.07264,1.07371,1.07075175072,1.0721937777777777,1.071852222222221,1.0716111111111077,1.0711900000000032,1.0697179999999997,1.0694036000000011,1.0700903500000036,1.0721043303673297,1.0715561313294988,5750,-242972,-250236.4,0.07020819718072542,-194.64715262585122,0.17353174418061976
2023-06-07T10:00:00-04:00,1.07371,1.07396,1.07228,1.0723799999999999,1.0710012106623998,1.0722993333333333,1.0719455555555544,1.071706222222219,1.0713355000000033,1.0697755999999996,1.0694477000000011,1.0701074500000036,1.0721594642938637,1.0717541050635986,-12031,-255003,-250306.8,0.061454878117362985,-209.54990104022815,0.07839184724788173
2023-06-07T10:15:00-04:00,1.0723799999999999,1.07256,1.07129,1.07153,1.07396,1.0722162222222222,1.0719377777777765,1.0717846666666633,1.0714400000000033,1.0698133999999997,1.069483800000001,1.0701231000000035,1.072033571435091,1.0718872840508786,-7481,-262484,-252585.4,0.05219963872757222,-215.4795621678121,-0.00653228816720721
2023-06-07T10:30:00-04:00,1.07153,1.07185,1.07089,1.07096,1.07396,1.0720206666666665,1.071952222222221,1.0718666666666634,1.0715100000000035,1.0698519999999998,1.069519000000001,1.0701393500000036,1.071818857148073,1.0719638272407026,-6581,-269065,-255649.2,0.03946708764921715,-218.98032276247693,0.01214011561125141
2023-06-07T10:45:00-04:00,1.07096,1.0712,1.0703,1.07075,1.0738372,1.0717802222222221,1.0719533333333322,1.0719282222222188,1.0715665000000034,1.0698813999999996,1.069554100000001,1.0701537000000036,1.0716050857184583,1.0719442617925619,-6057,-275122,-260929.2,0.033429699635192565,-220.16801417952232,0.0009339335412953203
2023-06-07T11:00:00-04:00,1.07075,1.07083,1.07017,1.0703,1.073624968,1.0714495555555554,1.0718077777777766,1.07191933333333,1.0715760000000034,1.0698997999999997,1.069577000000001,1.0701653500000037,1.0713440685747666,1.0717922094340495,-4385,-279507,-268236.2,0.026300316910664458,-222.01088132871706,-0.12224596634969087
2023-06-07T11:15:00-04:00,1.0703,1.07078,1.07025,1.07051,1.07334857056,1.07119,1.0716244444444432,1.0718551111111077,1.0715640000000035,1.0699241999999998,1.069604300000001,1.0701756000000036,1.0711772548598133,1.0715957675472394,3265,-276242,-272484,0.01425649152571885,-221.37026654781437,-0.1538949410535675
2023-06-07T11:30:00-04:00,1.07051,1.07104,1.07037,1.0704,1.0730942849152,1.0709451111111112,1.0714788888888878,1.0717633333333298,1.0715205000000034,1.0699523999999996,1.0696333000000011,1.0701858500000037,1.0710218038878507,1.0713934140377912,-3176,-279418,-275870.8,-0.0006132875408741163,-221.6966156711296,-0.1222345597223057
2023-06-07T11:45:00-04:00,1.0704,1.0704,1.06953,1.0701,1.072860342121984,1.0706693333333335,1.0711822222222211,1.0716093333333299,1.0714515000000033,1.0699725999999996,1.0696436000000011,1.0701961500000037,1.0708374431102805,1.0711971312302329,-3700,-283118,-278681.4,-0.010439763365070331,-222.73361118682453,-0.24888839173354496
2023-06-07T12:00:00-04:00,1.0701,1.07067,1.07008,1.07017,1.0725273079097857,1.0704668888888889,1.070788888888888,1.071376444444441,1.0713730000000035,1.0699919999999998,1.069660200000001,1.0701889500000035,1.0707039544882244,1.071016904984186,3348,-279770,-279611,-0.02888547148312768,-222.51460361743844,-0.32969796313714844
2023-06-07T12:15:00-04:00,1.07017,1.07059,1.0701,1.07024,1.0722275771188072,1.0703571111111112,1.0705511111111101,1.0711251111111078,1.0712930000000034,1.0700113999999998,1.0696706000000014,1.0701813500000037,1.0706111635905795,1.0708703239873487,2308,-277462,-279202,-0.054610026802431974,-222.3636369485914,-0.19955612749210253
2023-06-07T12:30:00-04:00,1.07024,1.07047,1.06955,1.06961,1.0719578194069266,1.070168888888889,1.0703377777777767,1.0708677777777744,1.0711810000000033,1.0700136,1.0696758000000013,1.0701702000000037,1.0704109308724636,1.0707170591898787,-2115,-279577,-279869,-0.07056087292210915,-223.60863806983548,-0.1791830373391453
2023-06-07T12:45:00-04:00,1.06961,1.06992,1.06925,1.06932,1.0717150374662339,1.0699653333333334,1.0701555555555544,1.0706031111111076,1.0710700000000035,1.0700119999999997,1.069674700000001,1.0701614500000038,1.0701927446979709,1.0705512473519028,-2463,-282040,-280393.4,-0.07995397666970092,-224.2764235243467,-0.153133637110617
2023-06-07T13:00:00-04:00,1.06932,1.06949,1.0691,1.06932,1.0714192329702859,1.0697982222222222,1.0699966666666656,1.0703659999999964,1.0709560000000033,1.0700143999999998,1.0696742000000012,1.0701522500000038,1.0700181957583768,1.070387397881522,0,-282040,-280177.8,-0.08540411334065363,-224.2764235243467,-0.13355124912444943
2023-06-07T13:15:00-04:00,1.06932,1.06951,1.06927,1.06935,1.0710945403544458,1.069668888888889,1.0698911111111102,1.0701864444444409,1.0708820000000032,1.0700207999999998,1.0696783000000012,1.0701427000000039,1.0698845566067015,1.0702235183052173,2303,-279737,-280171.2,-0.08848089709940062,-224.2118123695942,-0.08876016070260734
2023-06-07T13:30:00-04:00,1.06935,1.06952,1.06909,1.06947,1.0708153047048234,1.0695846666666666,1.0697755555555546,1.0700313333333296,1.0708185000000032,1.0700387999999998,1.0696855000000012,1.0701349500000037,1.0698016452853611,1.0700616146441737,1891,-277846,-280248,-0.09018944630916623,-223.99960869446465,-0.09714995656277399
2023-06-07T13:45:00-04:00,1.06947,1.06995,1.06944,1.06987,1.0705392559520517,1.0696035555555556,1.0697166666666658,1.0699071111111076,1.0707315000000033,1.0700663999999998,1.0696959000000013,1.0701240000000038,1.0698153162282888,1.0699424917153386,1843,-276003,-279533.2,-0.09230089156713676,-223.31029529623905,-0.04951420029894613
2023-06-07T14:00:00-04:00,1.06987,1.07017,1.06973,1.07007,1.0703073749997234,1.0696742222222222,1.0697133333333324,1.0698186666666631,1.0706270000000033,1.0700913999999997,1.0697099000000012,1.0701144000000038,1.069866252982631,1.0698771933722706,1632,-274371,-277999.4,-0.088540207340676,-223.00521150101162,-0.0028034763106227914
2023-06-07T14:15:00-04:00,1.07007,1.07016,1.06997,1.07008,1.06909,1.0697475555555553,1.0697033333333323,1.0697599999999965,1.0705455000000035,1.0701231999999998,1.0697255000000012,1.0701083000000038,1.0699090023861049,1.0698553546978162,1394,-272977,-276186.8,-0.07948361890175262,-222.9921843158744,-0.008409878804315717
2023-06-07T14:30:00-04:00,1.07008,1.0702099999999999,1.06986,1.06992,1.0691114000000002,1.069790888888889,1.0696677777777768,1.0697153333333298,1.0704030000000035,1.0701549999999997,1.0697394000000011,1.0701026000000038,1.069911201908884,1.0698606837582527,-1351,-274328,-275105,-0.07386293121705735,-223.19418790439107,-0.029899835550913623
2023-06-07T14:45:00-04:00,1.06992,1.07033,1.06988,1.07024,1.0691553440000001,1.0699053333333333,1.069737777777777,1.0697077777777744,1.0702295000000035,1.0702036,1.069756100000001,1.070098050000004,1.069976961527107,1.069895747006602,2106,-272222,-273980.2,-0.0626159451556672,-222.5643090349427,0.05889997288732627
2023-06-07T15:00:00-04:00,1.07024,1.07053,1.07013,1.07037,1.06922582336,1.070031777777778,1.0698544444444436,1.06973533333333,1.0701290000000037,1.0702629999999997,1.069769400000001,1.0700949500000039,1.0700555692216858,1.0699437976052812,1743,-270479,-272875.4,-0.04066303121307969,-222.35259016814655,0.0981932443047914
2023-06-07T15:15:00-04:00,1.07037,1.07052,1.07014,1.07018,1.0693301574912,1.0700968888888889,1.069949999999999,1.0697826666666632,1.0700615000000036,1.0703137999999999,1.069779400000001,1.0700917500000038,1.0700804553773486,1.069986638084225,-1106,-271585,-272318.2,-0.022840986153583764,-222.54891480355315,0.08042494295438792
2023-06-07T15:30:00-04:00,1.07018,1.07026,1.07001,1.07007,1.069426144891904,1.070120888888889,1.0700299999999991,1.0698479999999966,1.0700170000000035,1.0703755999999998,1.069784900000001,1.0700867500000038,1.070078364301879,1.0700205104673794,-1594,-273179,-272358.6,-0.00933635348168943,-222.71275640029364,0.06733062140553177
2023-06-07T15:45:00-04:00,1.07007,1.07011,1.06935,1.06936,1.07053,1.069986888888889,1.070017777777777,1.0699179999999966,1.0699475000000036,1.0704103999999999,1.0697843000000011,1.0700771500000037,1.069934691441503,1.0700252083739035,-2626,-275805,-272654,-0.0021228587828532766,-224.45512839464914,-0.01028546850307465
2023-06-07T16:00:00-04:00,1.06936,1.0699,1.06936,1.06987,1.0705064,1.0699573333333334,1.070017777777777,1.0699739999999966,1.0699260000000035,1.0704403999999998,1.069791000000001,1.0700702500000039,1.0699217531532026,1.0700141666991225,1356,-274449,-273099.4,0.005532110720870777,-223.8084238236908,0
2023-06-07T16:15:00-04:00,1.06987,1.07,1.06962,1.06974,1.070483272,1.0699017777777777,1.0699811111111104,1.06999933333333,1.0698875000000034,1.0704667999999997,1.069793300000001,1.070061800000004,1.0698854025225621,1.069980133359298,-769,-275218,-274047.2,0.006809606084633644,-223.90186508290932,-0.0308391039838668
2023-06-07T16:30:00-04:00,1.06974,1.06987,1.06971,1.06983,1.07046060656,1.0698715555555556,1.0699533333333326,1.0699999999999967,1.0698590000000032,1.0704869999999997,1.0697988000000012,1.070053500000004,1.0698743220180498,1.069938906687438,436,-274782,-274686.6,0.007593163126923003,-223.86518327237587,-0.023362739234436814
2023-06-07T16:45:00-04:00,1.06983,1.06996,1.0698,1.06984,1.0704383944288,1.0698488888888888,1.0699444444444437,1.0699828888888856,1.0698460000000032,1.0705116,1.069805400000001,1.070045800000004,1.0698674576144398,1.0698967253499503,600,-274182,-274887.2,0.00784260662994215,-223.85957490469139,-0.007477194556609841
2023-06-07T17:00:00-04:00,1.06984,1.06987,1.06924,1.0697699999999999,1.070416626540224,1.069814,1.0698922222222214,1.0699577777777747,1.0698260000000033,1.0705343999999999,1.069812200000001,1.0700378500000038,1.0698479660915519,1.0698793802799602,-215,-274397,-274605.6,0.007909487334680183,-223.87364242880713,-0.04391538346540892
2023-06-07T17:15:00-04:00,1.0697699999999999,1.06985,1.06972,1.0698,1.070369561478615,1.0697955555555556,1.069828888888888,1.0699199999999967,1.0698040000000035,1.0705444,1.069817800000001,1.0700294500000038,1.0698383728732415,1.069862704223968,135,-274262,-274568.2,0.0054437041761610065,-223.86985656829503,-0.05325261358221544
2023-06-07T17:30:00-04:00,1.0698,1.06987,1.06978,1.06979,1.0703243790194705,1.0697877777777776,1.0697855555555547,1.0698808888888856,1.0698130000000035,1.0705507999999997,1.069823600000001,1.0700217000000039,1.0698286982985932,1.0698513633791742,-307,-274569,-274438.4,0.0020252943690507496,-223.8727262635652,-0.03644246762225892
2023-06-07T17:45:00-04:00,1.06979,1.06986,1.06979,1.06986,1.0702810038586916,1.0698026666666667,1.0697622222222214,1.0698426666666634,1.0698400000000035,1.0705592,1.069829700000001,1.070014800000004,1.0698349586388745,1.0698434907033392,115,-274454,-274372.8,-0.00207868559382476,-223.8652014222412,-0.01962488435336412
2023-06-07T18:00:00-04:00,1.06986,1.07003,1.0698,1.06998,1.070239363704344,1.0698462222222223,1.0698311111111103,1.0698199999999969,1.0698730000000034,1.0705675999999997,1.069835400000001,1.070008850000004,1.0698639669110996,1.069842792562671,381,-274073,-274351,-0.0058575372168693,-223.82246685884041,0.05797860402482259
2023-06-07T18:15:00-04:00,1.06998,1.07017,1.0699,1.0700399999999999,1.07019938915617,1.069888,1.0698499999999993,1.0698115555555525,1.0699075000000033,1.0705759999999998,1.0698417000000011,1.0700035000000039,1.0698991735288796,1.0698530340501367,448,-273625,-274196.6,-0.002706131077920436,-223.7973448939439,0.01588978100140965
2023-06-07T18:30:00-04:00,1.0700399999999999,1.07012,1.06973,1.06978,1.07017,1.069874,1.0698544444444436,1.0698166666666635,1.0699230000000033,1.0705693999999997,1.069845400000001,1.0699966000000039,1.0698753388231037,1.069860427240109,-812,-274437,-274231.6,-0.005461117245479957,-223.99464592941914,0.0037392263540710832
2023-06-07T18:45:00-04:00,1.06978,1.06998,1.06974,1.06994,1.07017,1.0698911111111111,1.0698666666666656,1.0698328888888855,1.0699265000000033,1.0705531999999998,1.069851000000001,1.0699902500000038,1.069888271058483,1.069872341792087,482,-273955,-274108.8,-0.005683537768285066,-223.92255634090563,0.010282007421724242
2023-06-07T19:00:00-04:00,1.06994,1.07008,1.06983,1.0699,1.0701328,1.0698977777777778,1.0698733333333326,1.0698551111111079,1.0699180000000035,1.0705257999999995,1.069855700000001,1.0699835000000038,1.0698906168467863,1.0698834734336693,-448,-274403,-274098.6,-0.005162799536619446,-223.93930494363093,0.005608315262111254
2023-06-07T19:15:00-04:00,1.0699,1.06994,1.06965,1.06974,1.070097088,1.069871111111111,1.069869999999999,1.0698628888888855,1.0699010000000033,1.0704909999999996,1.0698587000000013,1.0699770500000039,1.069860493477429,1.0698827787469352,-300,-274703,-274224.6,-0.00462878481014509,-223.98416894961284,-0.0028043411200514594
2023-06-07T19:30:00-04:00,1.06974,1.07054,1.06973,1.07048,1.06924,1.0699931111111112,1.0699455555555548,1.0698819999999967,1.0699290000000035,1.0704657999999998,1.0698685000000012,1.069973500000004,1.0699843947819432,1.0698998229975478,865,-273838,-274267.2,0.0002269844452266081,-223.38579925230306,0.06356328285661
2023-06-07T19:45:00-04:00,1.07048,1.07071,1.0704,1.07069,1.069266,1.070142,1.0700455555555548,1.0699202222222186,1.0699515000000033,1.0704427999999997,1.0698805000000011,1.069971100000004,1.0701255158255545,1.0699498583980378,891,-272947,-273969.2,0.005118101300487922,-223.21100850422758,0.08412866076518764
2023-06-07T20:00:00-04:00,1.07069,1.0709899999999999,1.07058,1.07085,1.06932376,1.0703028888888888,1.0701555555555546,1.0699779999999965,1.0699755000000033,1.0704227999999998,1.0698961000000011,1.069970000000004,1.0702704126604436,1.0700262867184303,1453,-271494,-273477,0.012309812068749551,-222.99387749525184,0.09253547193091118
2023-06-07T20:15:00-04:00,1.07085,1.07087,1.07069,1.07071,1.0694237344000002,1.0704137777777778,1.0702366666666656,1.070050666666663,1.0700020000000035,1.0704061999999999,1.0699091000000012,1.069968050000004,1.070358330128355,1.0701198293747438,-806,-272300,-273056.4,0.018740359462780867,-223.0992517306723,0.06822557430981135
2023-06-07T20:30:00-04:00,1.07071,1.07093,1.07064,1.0707,1.069517710336,1.0705064444444443,1.070309999999999,1.070138666666663,1.0700335000000034,1.0703881999999998,1.069920700000001,1.069965750000004,1.070426664102684,1.070233063499795,-1003,-273303,-272776.4,0.023154555658059246,-223.1086193465534,0.061679937198619215
2023-06-07T20:45:00-04:00,1.0707,1.0709899999999999,1.07063,1.07085,1.06960604771584,1.0706144444444445,1.070428888888888,1.0702353333333299,1.0701080000000034,1.0703885999999998,1.069930600000001,1.0699632500000038,1.0705113312821473,1.0703384507998357,1486,-271817,-272372.2,0.027252273099807905,-222.90043778309013,0.10002056497598819
2023-06-07T21:00:00-04:00,1.07085,1.071,1.07066,1.07071,1.0696890848528895,1.0706706666666668,1.0705144444444434,1.0703291111111075,1.0701500000000035,1.070388,1.0699371000000009,1.069962100000004,1.0705510650257177,1.0704235606398684,-1237,-273054,-272393.6,0.02993387137502971,-223.06215977963495,0.0719666523356599
2023-06-07T21:15:00-04:00,1.07071,1.07092,1.07049,1.07057,1.0697939580646583,1.0706817777777777,1.0705888888888877,1.070415777777774,1.0701915000000035,1.0703672,1.069942100000001,1.069960950000004,1.070554852020574,1.0704804485118946,-1211,-274265,-272947.8,0.03270508423929142,-223.22050330869513,0.06262267501635184
2023-06-07T21:30:00-04:00,1.07057,1.07085,1.0703,1.07072,1.0698904414194856,1.070708,1.0706977777777766,1.0705079999999962,1.0702360000000035,1.0703383999999998,1.069945700000001,1.0699598500000038,1.0705878816164593,1.0705263588095155,2208,-272057,-272899.2,0.03600517029294287,-222.9111354018794,0.09161104567464813
2023-06-07T21:45:00-04:00,1.07072,1.07098,1.07057,1.07087,1.0699792061059268,1.0707424444444444,1.0707411111111103,1.0705942222222187,1.0702875000000034,1.0703216,1.069954000000001,1.0699585500000037,1.0706443052931676,1.0705698870476124,1502,-270555,-272349.6,0.04193438303544006,-222.70071624467664,0.03643225468947485
2023-06-07T22:00:00-04:00,1.07087,1.07115,1.07072,1.0708,1.0700608696174527,1.0707542222222222,1.0707533333333323,1.0706591111111075,1.0703390000000035,1.0702821999999999,1.069962600000001,1.0699561500000039,1.070675444234534,1.0706027096380897,-1446,-272001,-272386.4,0.04065125653215214,-222.7952375217691,0.010273748704111789
2023-06-07T22:15:00-04:00,1.0708,1.07115,1.07072,1.07094,1.0701697826557075,1.0707915555555556,1.0707633333333324,1.0707088888888854,1.0703960000000035,1.0702267999999997,1.069972400000001,1.069954050000004,1.0707283553876272,1.0706381677104715,1147,-270854,-271946.4,0.03777963245414518,-222.6452748770175,0.008404538450756265
2023-06-07T22:30:00-04:00,1.07094,1.071,1.07067,1.07074,1.0702678043901368,1.0707868888888887,1.0707666666666658,1.070744444444441,1.0704435000000034,1.0701939999999999,1.069984800000001,1.069950150000004,1.0707306843101019,1.0706733341683772,-1181,-272035,-271500.4,0.032568667349711845,-222.8658287829319,0.0028018791269320813
2023-06-07T22:45:00-04:00,1.07074,1.07088,1.07064,1.07068,1.0703560239511232,1.0707695555555554,1.0707644444444435,1.0707577777777744,1.0704845000000032,1.0701769999999997,1.069995200000001,1.0699455000000038,1.0707205474480814,1.0706998673347017,-1062,-273097,-271708.4,0.028327969199007194,-222.9253390281828,-0.0018679368637255047
2023-06-07T23:00:00-04:00,1.07068,1.07095,1.07059,1.07091,1.0704354215560108,1.0707986666666667,1.0707711111111102,1.0707637777777745,1.0705310000000032,1.0701759999999998,1.0700140000000011,1.0699420500000039,1.0707584379584651,1.0707226938677612,1113,-271984,-271994.2,0.025617643657548702,-222.68624798323944,0.0056030256338375104
2023-06-07T23:15:00-04:00,1.07091,1.07104,1.0708,1.07101,1.0705068794004098,1.0708464444444445,1.0708044444444436,1.0707739999999966,1.0705795000000033,1.0701811999999997,1.070031300000001,1.069939550000004,1.070808750366772,1.0707493550942089,967,-271017,-271797.4,0.022529505200805332,-222.59595094614016,0.028018791269341554
2023-06-07T23:30:00-04:00,1.07101,1.07108,1.07088,1.07102,1.0705711914603688,1.0708895555555558,1.0708544444444434,1.0707922222222188,1.0706415000000034,1.0701956,1.070047700000001,1.069937750000004,1.0708510002934177,1.0707738840753669,1010,-270007,-271628,0.02106516992500628,-222.58652059534973,0.04203368299130944
2023-06-07T23:45:00-04:00,1.07102,1.07107,1.07075,1.0708199999999999,1.070629072314332,1.0708826666666666,1.0708655555555544,1.0708119999999965,1.0706855000000033,1.0702017999999998,1.070063000000001,1.069934000000004,1.0708448002347342,1.0707967072602933,-1155,-271162,-271453.4,0.01877364218034768,-222.80220284218007,0.009339509862521387
2023-06-08T00:00:00-04:00,1.0708199999999999,1.07097,1.07055,1.07073,1.07115,1.0708555555555554,1.070849999999999,1.0708291111111077,1.0707270000000033,1.0702083999999998,1.070080400000001,1.0699254000000038,1.0708218401877874,1.0708169658082345,-910,-272072,-271248.4,0.01535283956405483,-222.8786862847754,-0.013073482308779683
2023-06-08T00:15:00-04:00,1.07073,1.07103,1.07071,1.071,1.0711380000000001,1.0708855555555556,1.0708722222222211,1.07084933333333,1.0707900000000032,1.0702263999999997,1.070099500000001,1.0699207000000037,1.07085747215023,1.0708367726465873,901,-271171,-271085.8,0.011674169266461084,-222.65148615028772,0.018677624206198916
2023-06-08T00:30:00-04:00,1.071,1.07103,1.0708199999999999,1.0708199999999999,1.0711262400000001,1.070875111111111,1.070858888888888,1.070860222222219,1.0708070000000034,1.0702393999999997,1.070115700000001,1.0699161500000038,1.0708499777201839,1.07084501811727,-774,-271945,-271271.4,0.007057530211627827,-222.7815701839012,-0.011205109529956861
2023-06-08T00:45:00-04:00,1.0708199999999999,1.07136,1.07075,1.07115,1.07055,1.070933333333333,1.0709044444444433,1.070870222222219,1.0708300000000033,1.0702575999999997,1.070134500000001,1.0699127500000039,1.0709099821761472,1.0708568144938158,908,-271037,-271477.4,0.00603896690120467,-222.5017472444715,0.03829127519285928
2023-06-08T01:00:00-04:00,1.07115,1.07145,1.07107,1.07124,1.0705661999999998,1.0710004444444445,1.0709666666666655,1.0708904444444411,1.0708495000000033,1.0702901999999996,1.070151900000001,1.069909800000004,1.0709759857409178,1.0708830515950525,1185,-269852,-271215.4,0.00826224306147613,-222.4021813573409,0.05230320917546735
2023-06-08T01:15:00-04:00,1.07124,1.07163,1.07119,1.07161,1.0706015519999998,1.071129111111111,1.0710444444444434,1.0709293333333298,1.0708945000000034,1.0703359999999997,1.0701740000000008,1.0699089500000039,1.0711027885927342,1.070939241276042,1265,-268587,-270518.4,0.013566873883111475,-221.96525779212678,0.06536496997879587
2023-06-08T01:30:00-04:00,1.07161,1.07173,1.07138,1.0714299999999999,1.0706632588799998,1.071206222222222,1.0710911111111097,1.0709731111111076,1.0709310000000034,1.0703781999999997,1.070196300000001,1.0699084000000039,1.0711682308741874,1.0710013930208333,-1800,-270387,-270361.6,0.015220558025220177,-222.26760659439637,0.039215320118380304
2023-06-08T01:45:00-04:00,1.0714299999999999,1.0714299999999999,1.0709,1.07101,1.0707485981695999,1.0711899999999999,1.071089999999999,1.07101933333333,1.0709390000000034,1.0704113999999998,1.070216100000001,1.069905500000004,1.07113658469935,1.0710587144166666,-1439,-271826,-270337.8,0.013841935149990246,-222.83169384227986,-0.0009336893802231062
2023-06-08T02:00:00-04:00,1.07101,1.0713,1.07089,1.0709899999999999,1.0708271103160318,1.0711699999999997,1.0711088888888876,1.0710602222222187,1.0709530000000034,1.0704417999999998,1.070240300000001,1.0699008000000039,1.07110726775948,1.0710981715333332,-2374,-274200,-270970.4,0.012939216364069887,-222.8760258279759,0.01587568405521035
2023-06-08T02:15:00-04:00,1.0709899999999999,1.07106,1.07074,1.07081,1.07173,1.0711102222222222,1.0711177777777765,1.071090444444441,1.0709650000000035,1.0704605999999999,1.0702635000000007,1.069895050000004,1.0710478142075839,1.0711125372266666,-1736,-275936,-272187.2,0.01240113882421175,-223.16779325811038,0.007471538109521543
2023-06-08T02:30:00-04:00,1.07081,1.07178,1.07079,1.07153,1.07074,1.0711926666666667,1.0711766666666653,1.0711168888888853,1.0710055000000036,1.0704897999999998,1.0702906000000008,1.0698909000000039,1.0711442513660672,1.0711208297813328,2346,-273590,-273187.8,0.015601914202716439,-221.59037055940553,0.04948646125118034
2023-06-08T02:45:00-04:00,1.07153,1.07191,1.07095,1.0711,1.07074,1.0711773333333332,1.0712077777777766,1.0711402222222186,1.0710170000000034,1.0705101999999997,1.0703167000000007,1.069884750000004,1.0711354010928538,1.0711142638250661,-2628,-276218,-274354,0.014845799759460225,-222.64497472354503,0.026148185502704285
2023-06-08T03:00:00-04:00,1.0711,1.07125,1.07053,1.07083,1.07191,1.0711017777777778,1.0711722222222209,1.071156666666663,1.0710185000000034,1.0705283999999997,1.0703417000000008,1.0698738000000039,1.071074320874283,1.0711018110600528,-4652,-280870,-276162.8,0.015117043711309328,-223.8176383403875,-0.029874434019520887
2023-06-08T03:15:00-04:00,1.07083,1.07104,1.0701,1.07019,1.07191,1.0709053333333334,1.0710555555555543,1.0711459999999966,1.0709810000000037,1.0705273999999998,1.0703655000000007,1.0698621500000038,1.0708974566994265,1.071059848848042,-3463,-284333,-278189.4,0.008865941977784798,-225.8873599581979,-0.09801725103618195
2023-06-08T03:30:00-04:00,1.07019,1.07075,1.07014,1.07055,1.0718375999999998,1.070804222222222,1.0709377777777764,1.0711099999999965,1.0709715000000037,1.070531,1.0703970000000007,1.0698526500000038,1.0708279653595412,1.0710158790784337,3498,-280835,-279169.2,0.004157371865492338,-224.7106717065793,-0.09891658345854004
2023-06-08T03:45:00-04:00,1.07055,1.07131,1.07052,1.0713,1.0717680959999998,1.0708766666666665,1.0709233333333321,1.07105933333333,1.0710025000000036,1.0705534,1.0704336000000008,1.0698467000000038,1.0709223722876329,1.0709715032627467,2308,-278527,-280156.6,-0.00122717226128279,-223.09374582735828,-0.012133317155573718
2023-06-08T04:00:00-04:00,1.0713,1.07168,1.07097,1.07153,1.0717013721599997,1.0709980000000001,1.07098111111111,1.0710139999999966,1.0710335000000035,1.0705826,1.070479100000001,1.069841300000004,1.0710438978301062,1.070953202610197,2540,-275987,-280110.4,-0.0040726351813383955,-222.54842705577195,0.048552301098969755
2023-06-08T04:15:00-04:00,1.07153,1.07193,1.0713,1.07185,1.0701,1.0711717777777778,1.0710766666666653,1.0709948888888856,1.0710755000000036,1.0706324,1.0705214000000007,1.069837100000004,1.071205118264085,1.0709793620881574,2294,-273693,-278675,-0.0004090248665523994,-221.8633505763456,0.08029953594338723
2023-06-08T04:30:00-04:00,1.07185,1.0722,1.07151,1.07189,1.0701366,1.0713344444444446,1.0711966666666655,1.0710231111111077,1.0711190000000035,1.0706727999999999,1.0705566000000009,1.069831950000004,1.071342094611268,1.0710682896705257,3080,-270613,-275931,0.0040811971515452685,-221.74840911998498,0.10085822881743445
2023-06-08T04:45:00-04:00,1.07189,1.073,1.07188,1.07266,1.0702191360000002,1.071627111111111,1.071322222222221,1.0710999999999966,1.0712110000000037,1.0707312,1.0705990000000007,1.0698332500000038,1.0716056756890144,1.0712238317364204,3719,-266894,-273142.8,0.014060877420461299,-219.0768383431331,0.10545668343395455
2023-06-08T05:00:00-04:00,1.07266,1.07338,1.07208,1.07224,1.0703859878400002,1.0718106666666667,1.0714488888888878,1.0712051111111078,1.0712865000000036,1.0707794,1.070633200000001,1.069831950000004,1.0717325405512115,1.0713858653891362,-3823,-270717,-271580.8,0.014375595094020716,-220.57373391115976,0.10643263934274493
2023-06-08T05:15:00-04:00,1.07224,1.07325,1.0722,1.07288,1.0706255088128,1.0720968888888889,1.0716766666666657,1.0713442222222187,1.0713805000000036,1.0708402000000001,1.070675900000001,1.0698401500000039,1.071962032440969,1.0715694923113088,2533,-268184,-270020.2,0.021432435159714953,-219.06183359033614,0.19144028463902837
2023-06-08T05:30:00-04:00,1.07288,1.07289,1.07233,1.07269,1.0708458681077762,1.0722995555555557,1.0719544444444433,1.0715197777777745,1.0714740000000036,1.0708986000000003,1.070716500000001,1.069848600000004,1.0721076259527753,1.0717499938490467,-2031,-270215,-269324.6,0.03127958293925774,-219.42151034822172,0.23360337883926655
2023-06-08T05:45:00-04:00,1.07269,1.07314,1.07258,1.07288,1.071048598659154,1.0724846666666665,1.0722133333333324,1.0717231111111079,1.0715605000000035,1.0709602,1.070752300000001,1.0698557000000037,1.0722621007622202,1.0719339950792373,2185,-268030,-268808,0.047226157612294324,-219.03449266370868,0.21764513567793803
2023-06-08T06:00:00-04:00,1.07288,1.0733,1.07285,1.0731,1.0712351107664217,1.072662,1.0724133333333323,1.07194133333333,1.0716535000000036,1.0710264000000003,1.0707886000000009,1.0698688000000038,1.0724296806097762,1.0720987960633896,1732,-266298,-268688.8,0.06235250047694952,-218.6793364486615,0.16802016241949258
2023-06-08T06:15:00-04:00,1.0731,1.07311,1.07266,1.0727,1.0714067019051081,1.0727193333333334,1.0725433333333323,1.072160222222219,1.0717080000000037,1.0710832000000001,1.0708212000000008,1.0698815500000038,1.072483744487821,1.0722490368507116,-1441,-267739,-268093.2,0.06892454690545534,-219.2164718507675,0.10918966337852354
2023-06-08T06:30:00-04:00,1.0727,1.07329,1.07261,1.07276,1.0715645657526995,1.0727626666666668,1.0726444444444434,1.0723537777777747,1.0717745000000036,1.0711388000000002,1.0708532000000008,1.0698948000000037,1.072538995590257,1.072364429480569,1590,-266149,-267686.2,0.07528795588234952,-219.12753738633205,0.08489993935718304
2023-06-08T06:45:00-04:00,1.07276,1.07325,1.07276,1.07298,1.0717098004924837,1.0728297777777778,1.0727655555555544,1.0725159999999967,1.0718730000000036,1.0711976,1.070886800000001,1.0699100500000036,1.0726271964722056,1.072468343584455,1700,-264449,-266533,0.07893917267622438,-218.77890395480944,0.10168953903852404
2023-06-08T07:00:00-04:00,1.07298,1.07311,1.0723799999999999,1.07294,1.071843416453085,1.0728646666666666,1.0727966666666653,1.0726326666666632,1.0719705000000037,1.0712608000000001,1.0709151000000008,1.0699268000000037,1.0726897571777645,1.0725538748675638,-2113,-266562,-266239.4,0.08015406212273421,-218.85767522734022,0.026103331903870566
2023-06-08T07:15:00-04:00,1.07294,1.07367,1.07286,1.07361,1.0719663431368383,1.0730273333333333,1.0729488888888876,1.0727397777777745,1.0721105000000037,1.0713342000000001,1.0709437000000008,1.0699475500000037,1.0728738057422116,1.072642699894051,2409,-264153,-265810.4,0.07736856272538527,-217.3533693015663,0.1277699022606759
2023-06-08T07:30:00-04:00,1.07361,1.07366,1.07301,1.07348,1.0721367088231544,1.0731335555555555,1.0730155555555543,1.072834222222219,1.0722080000000036,1.0714058000000002,1.0709658000000006,1.0699673000000036,1.0729950445937693,1.0727449599152405,-2318,-266471,-265556.8,0.07706625912897169,-217.63404850537393,0.05592424129445361
2023-06-08T07:45:00-04:00,1.07348,1.07394,1.07338,1.07358,1.0722900379408389,1.0732464444444445,1.0731144444444431,1.072928222222219,1.0723320000000036,1.0714826000000002,1.0709868000000007,1.0699892000000037,1.0731120356750155,1.0728595679321924,2377,-264094,-265145.8,0.07448349612382725,-217.4126191354742,0.08296898451556904
2023-06-08T08:00:00-04:00,1.07358,1.07401,1.07334,1.07364,1.0724880333879383,1.0733515555555555,1.0731988888888877,1.0730148888888853,1.0724725000000037,1.0715458000000002,1.071005800000001,1.0700126000000036,1.0732176285400123,1.0729776543457537,2779,-261315,-264519,0.07205505437797069,-217.25730700223787,0.07083737230630377
2023-06-08T08:15:00-04:00,1.07364,1.07424,1.0734,1.0738,1.072701108713627,1.0734717777777778,1.0732766666666653,1.0731108888888854,1.0726530000000039,1.0716080000000003,1.0710254000000008,1.0700388000000038,1.0733341028320098,1.0731065234766026,3984,-257331,-262672.8,0.06743698178582895,-216.6635884373552,0.06523157208090066
2023-06-08T08:30:00-04:00,1.0738,1.0759,1.07378,1.0750899999999999,1.0729473313194466,1.0738344444444445,1.073542222222221,1.073229555555552,1.0728800000000036,1.0716928000000003,1.0710578000000006,1.070067250000004,1.0736852822656078,1.0732688187812818,11553,-245778,-258997.8,0.06422187352300948,-202.7844954964001,0.22280227463409083
2023-06-08T08:45:00-04:00,1.0750899999999999,1.07519,1.0741,1.07468,1.0734,1.0740619999999999,1.0737555555555542,1.073377555555552,1.0730490000000037,1.0717722000000003,1.0710892000000007,1.070091800000004,1.0738842258124863,1.0734466550250252,-5299,-251077,-255919,0.0643343682932802,-204.8053402628838,0.17897759051420112
2023-06-08T09:00:00-04:00,1.07468,1.07521,1.07418,1.07502,1.07378,1.0743148888888887,1.073982222222221,1.0735511111111076,1.0732235000000039,1.0718586,1.0711234000000007,1.070122550000004,1.0741113806499891,1.07364652402002,4896,-246181,-252336.4,0.06887646432409761,-203.25637685051916,0.1901246994352217
2023-06-08T09:15:00-04:00,1.07502,1.07566,1.07481,1.07519,1.0741,1.0745564444444444,1.074232222222221,1.0737577777777743,1.0733905000000037,1.0719454000000002,1.0711670000000009,1.0701529000000038,1.0743271045199914,1.0738684192160157,4229,-241952,-248463.8,0.07321760842923038,-202.5876171995359,0.2097041773072199
2023-06-08T09:30:00-04:00,1.07519,1.0764,1.07498,1.07606,1.07418,1.074922,1.0745044444444434,1.0740033333333299,1.0735990000000037,1.0720524000000002,1.0712202000000008,1.070188150000004,1.0746736836159931,1.0741363353728126,7260,-234692,-243936,0.08359256862323469,-196.71312059893557,0.2282020472983731
2023-06-08T09:45:00-04:00,1.07606,1.07691,1.07585,1.07655,1.074624,1.075331111111111,1.0748455555555543,1.0742639999999966,1.0737935000000038,1.0721720000000001,1.0712696000000008,1.070232500000004,1.0750489468927944,1.07440906829825,6319,-228373,-240455,0.09028969959493567,-193.8356695274347,0.2859857659201761
2023-06-08T10:00:00-04:00,1.07655,1.07722,1.07645,1.07668,1.07498,1.075698,1.0751899999999988,1.0745508888888855,1.0740155000000038,1.0722912000000002,1.0713148000000008,1.0702767500000039,1.0753751575142356,1.0747072546385996,5520,-222853,-234810.2,0.1022456440627349,-193.16909575008947,0.28875351627266743
2023-06-08T10:15:00-04:00,1.07668,1.07747,1.07617,1.07741,1.075428,1.076142,1.0756088888888877,1.0748762222222188,1.0742420000000035,1.0724220000000002,1.0713718000000008,1.0703267000000039,1.0757821260113885,1.0750414037108793,4337,-218516,-229277.2,0.11495842664982786,-190.22856560185642,0.35114190976491666
2023-06-08T10:30:00-04:00,1.07741,1.07758,1.0768,1.07703,1.0758364,1.076426222222222,1.0759677777777767,1.07522333333333,1.0744590000000034,1.0725466000000001,1.0714144000000008,1.0703757000000038,1.0760317008091107,1.0753823229687032,-4721,-223237,-225534.2,0.12809665156333622,-191.8936513166727,0.30080089402121846
2023-06-08T10:45:00-04:00,1.07703,1.07748,1.07667,1.07692,1.07617,1.0766166666666666,1.07617111111111,1.0755566666666634,1.0746610000000036,1.0726662000000002,1.0714465000000006,1.0704250500000037,1.0762093606472887,1.0756894583749625,-5453,-228690,-224333.8,0.1383624108732673,-192.4505810215083,0.17021830730452525
2023-06-08T11:00:00-04:00,1.07692,1.07758,1.07669,1.07751,1.076452,1.0768844444444445,1.0764855555555546,1.0758846666666635,1.0748815000000034,1.0728016000000002,1.0714978000000008,1.0704727500000037,1.076469488517831,1.07597356669997,4616,-224074,-223474,0.1403366218109366,-189.92166522460658,0.26333420180890016
2023-06-08T11:15:00-04:00,1.07751,1.07781,1.07725,1.07778,1.07667,1.0771433333333333,1.0767922222222213,1.0762051111111082,1.0751355000000034,1.0729436,1.071560300000001,1.0705220500000037,1.0767315908142647,1.0762448533599758,3271,-220803,-223064,0.1484136943695564,-189.10202549968525,0.25673940949934637
2023-06-08T11:30:00-04:00,1.07778,1.07832,1.0775,1.07756,1.07669,1.0772968888888887,1.0770555555555548,1.0764944444444413,1.0753755000000036,1.0730766,1.0716263000000008,1.0705726500000037,1.0768972726514119,1.0764678826879803,-3192,-223995,-224159.8,0.15048092870489108,-189.753587042857,0.22042615723732392
2023-06-08T11:45:00-04:00,1.07756,1.07821,1.07756,1.07788,1.077016,1.077461777777778,1.077257777777777,1.0767524444444416,1.0756205000000034,1.0732140000000001,1.071697600000001,1.0706258500000034,1.0770938181211296,1.0766803061503842,3300,-220695,-223651.4,0.1527890375152842,-188.77359520945598,0.16913555006225794
2023-06-08T12:00:00-04:00,1.07788,1.07834,1.07771,1.07793,1.0772768,1.0775962222222222,1.0774111111111102,1.0770004444444417,1.0758700000000034,1.0733522000000002,1.0717739000000008,1.0706754500000035,1.0772610544969037,1.076890644920307,2722,-217973,-221508,0.1482270740505697,-188.64732883472013,0.12818726487391752
2023-06-08T12:15:00-04:00,1.07793,1.07871,1.07778,1.07862,1.07748944,1.077838,1.077626666666666,1.0772286666666637,1.0761205000000034,1.0735082000000002,1.0718550000000007,1.0707296500000036,1.0775328435975229,1.0771033159362455,2918,-215055,-219704.2,0.14229054497238153,-186.77947099608537,0.18018352713896707
2023-06-08T12:30:00-04:00,1.07862,1.07863,1.07826,1.0785,1.07771,1.0780126666666665,1.077747777777777,1.077419777777775,1.0763715000000034,1.0736636000000004,1.0719360000000007,1.0707846500000036,1.0777262748780183,1.077302252748996,-2254,-217309,-219005.4,0.13753428512423138,-187.0302358623031,0.10116854308016776
2023-06-08T12:45:00-04:00,1.0785,1.07859,1.07821,1.07846,1.07778,1.078155111111111,1.0779066666666661,1.0775899999999974,1.0766155000000033,1.0738128000000002,1.0720196000000006,1.0708316000000035,1.0778730199024147,1.0774974021991968,-1673,-218982,-218002.8,0.12522842498159578,-187.09228500463047,0.13277253187005397
2023-06-08T13:00:00-04:00,1.07846,1.07856,1.07796,1.07813,1.07871,1.0781997777777779,1.0780411111111106,1.077746666666664,1.0768400000000031,1.0739590000000003,1.072099200000001,1.0708797000000034,1.0779244159219317,1.0776635217593573,-1877,-220859,-218035.6,0.11529629675526606,-187.66663175833472,0.11235746387846203
2023-06-08T13:15:00-04:00,1.07813,1.07837,1.07795,1.07816,1.078695,1.0782235555555555,1.0781133333333328,1.0778871111111086,1.0770580000000032,1.0740992000000003,1.0721784000000008,1.0709245000000036,1.0779715327375454,1.0778056174074855,1934,-218925,-218226,0.10680098483513871,-187.61281635573954,0.06032426613210452
2023-06-08T13:30:00-04:00,1.07816,1.07835,1.07798,1.07812,1.0786651999999999,1.0782248888888888,1.0781511111111104,1.0779919999999976,1.0772095000000033,1.0742368000000004,1.072263500000001,1.0709696500000034,1.0780012261900362,1.0778992939259882,-1446,-220371,-219289.2,0.09334514626492484,-187.6664633098095,0.03154632670860537
2023-06-08T13:45:00-04:00,1.07812,1.0782,1.07778,1.07781,1.0786365919999998,1.0781566666666667,1.0781788888888881,1.0780782222222196,1.0773660000000032,1.0743608000000002,1.072348400000001,1.0710115500000035,1.077962980952029,1.0779466351407903,-1608,-221979,-220223.2,0.08158871894647927,-188.12882371495925,0.0232005642377094
2023-06-08T14:00:00-04:00,1.07781,1.07802,1.07777,1.07802,1.07858519648,1.0781248888888888,1.0781944444444438,1.0781357777777751,1.0775160000000032,1.0744926000000001,1.072435400000001,1.0710548000000033,1.0779743847616232,1.077966908112632,1459,-220520,-220530.8,0.07108401464938184,-187.8445528323361,0.01298845882658821
2023-06-08T14:15:00-04:00,1.07802,1.07823,1.07789,1.07816,1.0785199807616,1.078118,1.0782199999999995,1.0781715555555529,1.0776645000000031,1.0746356000000004,1.0725235000000009,1.0711009000000034,1.0780115078092987,1.0779843264901054,1260,-219260,-220211,0.05979632746023057,-187.6809195045685,0.021337192582074203
2023-06-08T14:30:00-04:00,1.07816,1.07823,1.07794,1.07805,1.078459982300672,1.078084,1.078156666666666,1.0781802222222194,1.0777640000000033,1.0747768000000004,1.0726093000000008,1.0711474000000034,1.078019206247439,1.077993861192084,-1495,-220755,-220577,0.048264928192806755,-187.8334478862559,-0.05284530233075221
2023-06-08T14:45:00-04:00,1.07805,1.07812,1.07781,1.0779,1.0784047837166182,1.0780326666666666,1.0780899999999993,1.0781679999999974,1.0778315000000032,1.0749186000000004,1.0726896000000008,1.0711927500000034,1.0779953649979512,1.077992688953667,-1881,-222636,-221030,0.03345088935833017,-188.09517044086817,-0.05563282336577969
2023-06-08T15:00:00-04:00,1.0779,1.07796,1.07765,1.07776,1.0783540010192887,1.0779666666666667,1.0780122222222217,1.0781346666666642,1.077885500000003,1.0750432000000003,1.0727665000000008,1.0712382000000034,1.077948291998361,1.0779897511629335,-1252,-223888,-221411.8,0.021237594651641697,-188.2577829281119,-0.06490736791349914
2023-06-08T15:15:00-04:00,1.07776,1.07777,1.07734,1.07748,1.0782836009173598,1.0778602222222222,1.0779399999999992,1.0780837777777752,1.077889000000003,1.0751708000000004,1.0728405000000008,1.0712830000000033,1.0778546335986887,1.0779658009303463,-1418,-225306,-222369,0.008610486592204092,-188.62617663357517,-0.06028957546863916
2023-06-08T15:30:00-04:00,1.07748,1.07789,1.07736,1.07786,1.0781703688072766,1.0778442222222222,1.0779066666666661,1.0780211111111087,1.077930500000003,1.0753114000000004,1.072919900000001,1.0713296500000034,1.077855706878951,1.0779346407442767,1687,-223619,-223240.8,0.004117400701146459,-188.03121431408888,-0.027825183646209
2023-06-08T15:45:00-04:00,1.07786,1.07799,1.07776,1.0779,1.0780707245504033,1.0778428888888891,1.0778822222222217,1.0779662222222197,1.077979500000003,1.0754656000000005,1.0729965000000008,1.0713763000000034,1.0778645655031607,1.0779037125954212,1394,-222225,-223534.8,-0.0021381387852268787,-187.97948217818993,-0.020405891737458444
2023-06-08T16:00:00-04:00,1.0779,1.07821,1.0778699999999999,1.07817,1.07734,1.0779004444444444,1.0779222222222218,1.0779326666666642,1.078012500000003,1.0756180000000004,1.0730745000000008,1.0714219500000033,1.0779256524025285,1.0778897700763366,827,-221398,-223287.2,-0.007195941647630337,-187.77232938108446,0.03340106326719348
2023-06-08T16:15:00-04:00,1.07817,1.07822,1.07802,1.07809,1.0773574,1.077934,1.0779299999999994,1.0779162222222198,1.0780280000000029,1.0757538000000004,1.0731536000000008,1.0714665000000032,1.0779585219220227,1.0778918160610689,-610,-222008,-222911.2,-0.0071604190056992366,-187.81759126000898,0.006493386022524118
2023-06-08T16:30:00-04:00,1.07809,1.07813,1.07801,1.07809,1.077391904,1.077966,1.0779222222222218,1.0779126666666643,1.0780545000000028,1.0758850000000004,1.0732338000000008,1.0715093500000032,1.077984817537618,1.0779178528488547,0,-222008,-222251.6,-0.00788032855288461,-187.81759126000898,-0.00649254285078416
2023-06-08T16:45:00-04:00,1.07809,1.0783099999999999,1.0780399999999999,1.07818,1.07742502784,1.0780175555555556,1.077936666666666,1.0779186666666642,1.078069500000003,1.0760116000000004,1.0733220000000008,1.0715531500000033,1.0780238540300944,1.0779514822790834,546,-221462,-221820.2,-0.010433198596670601,-187.77201064985587,0.012058809888220721
2023-06-08T17:00:00-04:00,1.07818,1.07818,1.0776999999999999,1.078,1.0774781261696,1.0780302222222222,1.0779477777777773,1.0779317777777755,1.078073000000003,1.0761338000000005,1.073403300000001,1.0715971500000032,1.0780190832240755,1.0779823858232664,-52,-221514,-221678,-0.011426986327502418,-187.7806919461144,0.009277298450690136
2023-06-08T17:15:00-04:00,1.078,1.07825,1.07791,1.07825,1.077528038599424,1.0780906666666668,1.0780022222222216,1.0779477777777753,1.0780545000000028,1.0762456000000007,1.073488400000001,1.0716408500000032,1.0780652665792603,1.0780103086586128,134,-221380,-221674.4,-0.009593762463979848,-187.74961587932404,0.045464667458421114
2023-06-08T17:30:00-04:00,1.07825,1.07844,1.07818,1.07839,1.0775749562834585,1.078168222222222,1.0781033333333327,1.0779824444444421,1.0780490000000027,1.0763686000000008,1.073574000000001,1.0716864000000033,1.0781302132634083,1.0780446469268898,235,-221145,-221501.8,-0.0027341617383908412,-187.71910347496512,0.08445632401529182
2023-06-08T17:45:00-04:00,1.07839,1.07839,1.07814,1.0782,1.0776441597807818,1.0781875555555556,1.0781411111111108,1.0780262222222199,1.0780360000000027,1.0764750000000007,1.0736576000000009,1.0717315000000032,1.0781441706107266,1.0780765175415117,-209,-221354,-221371,0.005269625490264373,-187.75592688764513,0.03154398530421455
2023-06-08T18:00:00-04:00,1.0782,1.07833,1.07814,1.07833,1.0777078269983191,1.0782253333333334,1.0781888888888884,1.0780766666666644,1.0780460000000027,1.0765878000000009,1.073743200000001,1.0717777000000033,1.0781813364885813,1.078108014033209,290,-221064,-221291.4,0.010203608367252264,-187.7209612040985,0.03989238333796553
2023-06-08T18:15:00-04:00,1.07833,1.07834,1.07826,1.07829,1.0777664008384535,1.0782455555555557,1.0782022222222218,1.0781275555555534,1.0780525000000027,1.0766960000000008,1.073828100000001,1.0718229500000034,1.078203069190865,1.0781448112265668,-145,-221209,-221230.4,0.01311441521179085,-187.7263398915133,0.011129970227320178
2023-06-08T18:30:00-04:00,1.07829,1.07835,1.07823,1.07826,1.0778202887713773,1.0782571111111112,1.0782211111111109,1.0781713333333311,1.0780595000000028,1.0767992000000006,1.0739128000000009,1.0718682000000033,1.078214455352692,1.0781746489812534,-278,-221487,-221251.8,0.013507478805975356,-187.73407435997726,0.015768627851107372
2023-06-08T18:45:00-04:00,1.07826,1.07843,1.07823,1.0784,1.077869865669667,1.0782928888888887,1.078255555555555,1.0782017777777757,1.0780890000000027,1.0769132000000008,1.073998200000001,1.0719139500000032,1.0782515642821535,1.0781989191850023,245,-221242,-221271.2,0.015146034005340307,-187.70226385045265,0.02875455666966881
2023-06-08T19:00:00-04:00,1.0784,1.0784799999999999,1.07836,1.0784,1.0779154764160936,1.078321777777778,1.0782799999999995,1.0782295555555534,1.0781080000000027,1.0770260000000007,1.0740824000000009,1.0719589000000032,1.0782812514257227,1.0782263353480015,0,-221242,-221248.8,0.01541507178860838,-187.70226385045265,0.02040475616317396
2023-06-08T19:15:00-04:00,1.0784,1.07846,1.07827,1.07827,1.0779719287744842,1.0783197777777778,1.0783099999999994,1.0782537777777756,1.0781135000000028,1.0771318000000007,1.074164700000001,1.0720032000000033,1.0782790011405783,1.0782458682784006,-509,-221751,-221386.2,0.015145472060708596,-187.7636232718176,0.02504638218923863
2023-06-08T19:30:00-04:00,1.07827,1.07849,1.07827,1.07849,1.0780227358970358,1.0783557777777777,1.078336666666666,1.0782806666666644,1.0781355000000026,1.0772428000000007,1.0742518000000008,1.0720486000000031,1.0783212009124625,1.0782694946227203,645,-221106,-221365.6,0.01823260349948532,-187.6320235797183,0.022258288894042938
2023-06-08T19:45:00-04:00,1.07849,1.07851,1.07816,1.07819,1.0780788075893915,1.0783264444444447,1.078314444444444,1.078299333333331,1.0781500000000026,1.0773344000000007,1.074334300000001,1.0720926500000032,1.07829496072997,1.0782855956981758,-564,-221670,-221402.2,0.01705762580138392,-187.78890959627847,-0.01854616604382255
2023-06-08T20:00:00-04:00,1.07819,1.07851,1.07815,1.0784,1.0781391745268767,1.0783435555555558,1.0783366666666663,1.0783155555555533,1.0781820000000026,1.0774328000000006,1.0744193000000009,1.0721375000000033,1.078315968583976,1.0782984765585404,1736,-219934,-221140.6,0.014941655551646636,-187.4507873729226,0.018549434242253568
2023-06-08T20:15:00-04:00,1.0784,1.0785,1.07821,1.07834,1.07815,1.0783442222222221,1.0783377777777774,1.078327111111109,1.0782250000000027,1.0775280000000005,1.0745053000000007,1.0721820000000033,1.0783207748671808,1.0783063812468319,-1233,-221167,-221125.6,0.01367813238979915,-187.51938900497004,0.0009273598991093182
2023-06-08T20:30:00-04:00,1.07834,1.0785,1.07822,1.0783,1.07815,1.0783366666666667,1.0783388888888887,1.0783328888888868,1.0782470000000026,1.0776212000000005,1.0745835000000008,1.0722260000000032,1.0783166198937446,1.0783139049974653,-1165,-222332,-221241.8,0.00977794265757912,-187.5626035755137,0.0009273943002407063
2023-06-08T20:45:00-04:00,1.0783,1.07849,1.07814,1.07818,1.07851,1.0783048888888889,1.0783299999999998,1.0783315555555535,1.0782610000000026,1.0777088000000006,1.0746584000000008,1.0722694500000032,1.0782892959149957,1.0783075239979718,-1700,-224032,-221827,0.007344394235738031,-187.75179025825523,-0.007419360822072599
2023-06-08T21:00:00-04:00,1.07818,1.07841,1.07815,1.07822,1.0785026,1.078282888888889,1.0783099999999999,1.0783306666666648,1.0782635000000025,1.0777714000000005,1.0747321000000007,1.0723141000000034,1.0782754367319964,1.0783036191983773,1750,-222282,-221949.4,0.0055601092416790975,-187.68686603409964,-0.016691394658760107
2023-06-08T21:15:00-04:00,1.07822,1.0784,1.0780399999999999,1.07821,1.078495348,1.078262888888889,1.0782888888888889,1.0783211111111093,1.0782695000000024,1.0778420000000006,1.0748071000000008,1.0723581000000033,1.0782623493855972,1.0782928953587014,-1425,-223707,-222704,0.0036213514886933675,-187.7000822608438,-0.017618694362030278
2023-06-08T21:30:00-04:00,1.07821,1.0785,1.07808,1.0781,1.0780399999999999,1.078225111111111,1.0782699999999998,1.0783075555555537,1.0782700000000025,1.0779036000000006,1.0748811000000007,1.0724009000000034,1.0782298795084777,1.0782747162869608,-2103,-225810,-223632.6,0.0007949304637600416,-187.9146323021156,-0.015765995529876883
2023-06-08T21:45:00-04:00,1.0781,1.07832,1.07794,1.07807,1.0785,1.0781851111111111,1.078223333333333,1.0782844444444426,1.0782645000000026,1.0779612000000005,1.0749533000000007,1.0724419500000035,1.0781979036067821,1.0782509730295682,-1611,-227421,-224650.4,-0.0009715825354101247,-187.95946116771245,-0.03894333744400643
2023-06-08T22:00:00-04:00,1.07807,1.07811,1.07779,1.07783,1.0785,1.0781064444444446,1.078183333333333,1.0782551111111094,1.0782560000000025,1.0779966000000005,1.0750245000000007,1.0724808000000035,1.0781243228854258,1.0782179784236543,-1532,-228953,-225634.6,-0.005546938760785126,-188.30051508814435,-0.0333892913122841
2023-06-08T22:15:00-04:00,1.07783,1.07797,1.0776999999999999,1.07778,1.0784716,1.0780257777777777,1.0781144444444442,1.0782159999999983,1.0782325000000026,1.0780212000000007,1.0750966000000008,1.0725193500000034,1.0780554583083406,1.0781739827389232,-1092,-230045,-227187.2,-0.00837790212353288,-188.35117242742803,-0.05749258160237991
2023-06-08T22:30:00-04:00,1.07778,1.07798,1.0776,1.0776999999999999,1.078425304,1.077942888888889,1.078043333333333,1.0781668888888871,1.0781980000000027,1.0780416000000006,1.0751664000000007,1.0725560500000035,1.0779843666466724,1.078118386191138,-1114,-231159,-228677.6,-0.012441288116870041,-188.4338609167302,-0.05935048315004506
2023-06-08T22:45:00-04:00,1.0776999999999999,1.07775,1.07756,1.07768,1.0783592796800001,1.0778702222222223,1.0779744444444441,1.078107777777776,1.0781720000000026,1.0780470000000006,1.0752345000000008,1.0725942500000034,1.0779234933173378,1.0780571089529103,-1179,-232338,-229983.2,-0.0154273277020953,-188.45574084620955,-0.057497913382181666
2023-06-08T23:00:00-04:00,1.07768,1.07794,1.07764,1.07792,1.0782793517120002,1.0778593333333333,1.0779455555555553,1.0780522222222204,1.0781515000000026,1.0780648000000006,1.0753057000000006,1.0726341500000034,1.0779227946538703,1.0780020871623281,802,-231536,-230806.2,-0.017715366921117595,-188.27713495206658,-0.02411471182918687
2023-06-08T23:15:00-04:00,1.07792,1.07798,1.07782,1.07796,1.0782074165408002,1.0778622222222223,1.0779166666666662,1.077998888888887,1.0781350000000027,1.0780856000000005,1.0753759000000007,1.0726741500000037,1.0779302357230962,1.0779632697298622,884,-230652,-231146,-0.01812199908188359,-188.24433103340837,-0.02411381721725872
2023-06-08T23:30:00-04:00,1.07796,1.07801,1.07783,1.07788,1.0781426748867202,1.0778548888888888,1.0778799999999995,1.077951999999998,1.0781160000000027,1.0780930000000004,1.0754473000000007,1.0727160500000037,1.077920188578477,1.0779362157838894,-1007,-231659,-231468.8,-0.01946504903994457,-188.31906478976305,-0.03060628263510276
2023-06-08T23:45:00-04:00,1.07788,1.07796,1.0776999999999999,1.07777,1.0780844073980482,1.0778328888888886,1.077843333333333,1.0779119999999982,1.0780845000000026,1.0780928000000005,1.0755182000000005,1.0727567000000036,1.0778901508627816,1.0779173726271114,-956,-232615,-231760,-0.021382423832781872,-188.41662667049192,-0.03060940543550352
2023-06-09T00:00:00-04:00,1.07777,1.07785,1.07759,1.07771,1.0780319666582434,1.077806222222222,1.0778033333333328,1.077877777777776,1.0780500000000024,1.0780958000000005,1.0755862000000007,1.0728001000000038,1.0778541206902252,1.0779034981016888,-982,-233597,-232011.8,-0.02195287860950664,-188.47129510624347,-0.03339300787519715
2023-06-09T00:15:00-04:00,1.07771,1.07773,1.07745,1.07763,1.077984769992419,1.0777715555555554,1.0777811111111106,1.0778448888888867,1.0780180000000026,1.0780908000000005,1.0756524000000005,1.0728418500000036,1.0778092965521802,1.0778807984813508,-909,-234506,-232605.8,-0.022633878463155763,-188.53877151455356,-0.018555801935368096
2023-06-09T00:30:00-04:00,1.07763,1.07769,1.07754,1.07761,1.0779205975933288,1.0777373333333333,1.0777622222222218,1.0778139999999978,1.0779740000000027,1.0780844000000005,1.0757183000000006,1.0728830000000036,1.0777694372417441,1.0778486387850805,-661,-235167,-233508.8,-0.021759901616289597,-188.55103917599587,-0.015773163354302684
2023-06-09T00:45:00-04:00,1.07761,1.07772,1.0775,1.07751,1.0778641258821293,1.0776868888888889,1.0777411111111104,1.07778622222222,1.0779400000000028,1.0780622000000006,1.0757852000000006,1.0729241000000036,1.0777175497933953,1.077808111028064,-793,-235960,-234369,-0.01993639613715447,-188.6246279511557,-0.017630138257391896
2023-06-09T01:00:00-04:00,1.07751,1.07796,1.0775,1.0778699999999999,1.07745,1.0777126666666665,1.0777622222222218,1.077769999999998,1.0779135000000026,1.0780496000000006,1.0758566000000005,1.0729685000000035,1.0777480398347161,1.077779688822451,852,-235108,-234867.6,-0.016945955389772453,-188.33997166026288,0.017630465444279608
2023-06-09T01:15:00-04:00,1.0778699999999999,1.07789,1.07761,1.07774,1.0774602,1.0777082222222223,1.077742222222222,1.0777577777777756,1.0778835000000027,1.0780352000000004,1.0759240000000005,1.0730117500000036,1.077746431867773,1.0777581510579606,-965,-236073,-235362.8,-0.013474106081101387,-188.45635860859613,-0.01669882737123989
2023-06-09T01:30:00-04:00,1.07774,1.07822,1.0776999999999999,1.0782,1.077470196,1.077799777777778,1.0777688888888886,1.0777553333333312,1.0778785000000028,1.0780366000000006,1.0759978000000006,1.0730567500000034,1.0778371454942184,1.077763720846368,1314,-234759,-235413.4,-0.010258055024723515,-187.8955183317203,0.022264276967607143
2023-06-09T01:45:00-04:00,1.0782,1.07839,1.07771,1.07779,1.07750018816,1.077804,1.0777588888888883,1.0777546666666644,1.0778590000000026,1.0780292000000005,1.0760642000000005,1.0730993500000034,1.0778277163953747,1.077775376677094,-1625,-236384,-235656.8,-0.009582352566630904,-188.51344635991546,-0.008349723531369306
2023-06-09T02:00:00-04:00,1.07779,1.07818,1.07725,1.0774299999999999,1.07839,1.077738222222222,1.0777211111111107,1.0777506666666645,1.0778195000000026,1.0780154000000006,1.0761261000000004,1.0731390000000034,1.0777481731162997,1.077781501341675,-2675,-239059,-236276.6,-0.010444182603217332,-189.4069413821372,-0.031546619408594316
2023-06-09T02:15:00-04:00,1.0774299999999999,1.07789,1.07728,1.07765,1.07839,1.077724,1.077714444444444,1.0777411111111088,1.0777915000000027,1.0780122000000005,1.0761865000000006,1.0731802500000034,1.0777285384930397,1.0777776010733395,1986,-237073,-236669.6,-0.009039482124824407,-189.0014208378789,-0.005567360421630029
2023-06-09T02:30:00-04:00,1.07765,1.07822,1.07758,1.0779,1.0783672,1.0777611111111112,1.077744444444444,1.0777415555555534,1.0777815000000026,1.0780098000000007,1.0762512000000006,1.0732237500000035,1.0777628307944318,1.0777808808586715,2229,-234844,-236423.8,-0.0059071129677746225,-188.4843234500441,0.025054981765540347
2023-06-09T02:45:00-04:00,1.0779,1.07806,1.07763,1.0778699999999999,1.078344856,1.0777862222222223,1.0777733333333328,1.0777424444444423,1.0777715000000028,1.0780040000000006,1.0763198000000007,1.0732679500000035,1.0777842646355453,1.0777703046869367,-2150,-236994,-236870.8,-0.002664192457751032,-188.54416202505143,0.024127467265516
2023-06-09T03:00:00-04:00,1.0778699999999999,1.07796,1.0772,1.07732,1.07832295888,1.0776955555555556,1.0777522222222218,1.0777411111111088,1.0777460000000025,1.0779894000000005,1.0763831000000006,1.0733117000000036,1.0776914117084362,1.077743043749549,-4057,-241051,-237804.2,-0.0020412897236292056,-190.6143096309773,-0.01763324702322136
2023-06-09T03:15:00-04:00,1.07732,1.07738,1.07686,1.07729,1.0782780405248,1.077603111111111,1.0776877777777774,1.077734444444442,1.0777215000000024,1.0779772000000005,1.0764479000000007,1.0733557000000036,1.077611129366749,1.0777156349996388,-3809,-244860,-238964.4,-0.0016966968755081423,-190.72037839420446,-0.05380982864351016
2023-06-09T03:30:00-04:00,1.07729,1.07746,1.07679,1.07695,1.078192958093312,1.0774555555555556,1.0775999999999997,1.0777115555555532,1.0776840000000025,1.0779610000000006,1.0765021000000008,1.0733963500000037,1.0774789034933991,1.0776657079997107,-2781,-247641,-241078,-0.006566104231920183,-191.59808077703548,-0.07330153840442467
2023-06-09T03:45:00-04:00,1.07695,1.07776,1.07675,1.07754,1.078080721445847,1.0774435555555555,1.0775266666666663,1.0776679999999978,1.0776770000000027,1.0779622000000006,1.0765665000000006,1.0734416000000033,1.0774911227947193,1.0776113663997682,2826,-244815,-243072.2,-0.007715006084142382,-190.04987519646104,-0.061213132999453246
2023-06-09T04:00:00-04:00,1.07754,1.0776,1.07624,1.0766499999999999,1.0779476493012623,1.0772682222222223,1.0773999999999997,1.0775933333333314,1.0776135000000027,1.0779380000000005,1.0766247000000007,1.0734832000000034,1.0773228982357754,1.0775190931198142,-3558,-248373,-245348,-0.017547355987396606,-192.98862457003437,-0.1057719964000539
2023-06-09T04:15:00-04:00,1.0766499999999999,1.07666,1.07618,1.07643,1.07776,1.0770742222222223,1.0772888888888885,1.0775006666666644,1.0775370000000026,1.0779086000000004,1.0766871000000007,1.0735263000000033,1.0771443185886203,1.077409674495851,-2503,-250876,-247313,-0.02358509326617666,-193.50008140373123,-0.09281345423831618
2023-06-09T04:30:00-04:00,1.07643,1.07664,1.07605,1.07636,1.0776,1.0768884444444444,1.0771455555555554,1.0773922222222203,1.0774610000000024,1.0778724000000006,1.0767452000000006,1.0735711000000032,1.0769874548708962,1.0772849395966806,-2520,-253396,-249020.2,-0.02644616411260462,-193.6639564350849,-0.11970491346912387
2023-06-09T04:45:00-04:00,1.07636,1.07662,1.07591,1.07634,1.0773519999999999,1.0767273333333334,1.076972222222222,1.0772666666666646,1.0773895000000027,1.0778374000000006,1.0767956000000007,1.0736146000000033,1.076857963896717,1.077160751677344,-2870,-256266,-250745.2,-0.031800317870231284,-193.71728431794915,-0.1447258558307826
2023-06-09T05:00:00-04:00,1.07634,1.0768199999999999,1.07611,1.0763,1.07709244,1.076592888888889,1.0767977777777777,1.077120888888887,1.0773190000000024,1.0778016000000006,1.0768433000000008,1.0736612000000034,1.0767463711173737,1.0770118013418748,-2688,-258954,-253573,-0.04015631125902945,-193.81717840346127,-0.14565763960401992
2023-06-09T05:15:00-04:00,1.0763,1.0765,1.0761,1.0763,1.0768796008,1.0764933333333333,1.0766844444444443,1.0769777777777758,1.0772525000000024,1.0777640000000006,1.0768878000000008,1.0737046000000035,1.0766570968938989,1.0768786410734996,0,-258954,-255689.2,-0.04850000088370726,-193.81717840346127,-0.09467938959640783
2023-06-09T05:30:00-04:00,1.0763,1.07653,1.07619,1.07622,1.0768199999999999,1.0764004444444444,1.0765655555555553,1.0768331111111091,1.0771830000000027,1.0777284000000007,1.0769311000000008,1.0737438500000034,1.076569677515119,1.0767637128587992,-1837,-260791,-257672.2,-0.05248158038839034,-193.95372025982115,-0.09932330198926254
2023-06-09T05:45:00-04:00,1.07622,1.07639,1.0758,1.0758699999999999,1.0766562,1.0762613333333333,1.0764455555555554,1.076693111111109,1.0771010000000025,1.0776808000000004,1.0769632000000007,1.0737811000000033,1.0764297420120952,1.076652170287039,-2506,-263297,-259652.4,-0.05797644778615605,-194.76870232668497,-0.10028320720555196
2023-06-09T06:00:00-04:00,1.0758699999999999,1.07611,1.07564,1.0759,1.07653,1.0761522222222222,1.0762633333333331,1.0765513333333314,1.0770025000000027,1.0776310000000004,1.0769998000000007,1.0738165000000033,1.0763237936096761,1.0765453362296307,2266,-261031,-260605.4,-0.06061123215538157,-194.7055162540178,-0.15219852627279395
2023-06-09T06:15:00-04:00,1.0759,1.07618,1.07584,1.0761,1.07639,1.0761195555555554,1.0762022222222223,1.0764322222222202,1.0769205000000028,1.0775890000000006,1.0770320000000009,1.0738539500000033,1.076279034887741,1.0764518689837044,2002,-259029,-260620.4,-0.06616068605806276,-194.33336270814925,-0.05108438211116226
2023-06-09T06:30:00-04:00,1.0761,1.07614,1.07571,1.07601,1.0762399999999999,1.0760811111111113,1.0761555555555553,1.0763264444444425,1.0768110000000028,1.0775426000000004,1.077065200000001,1.0738908500000033,1.0762252279101927,1.076365495186963,-2160,-261189,-261067.4,-0.06445887181682558,-194.51401506387856,-0.03901786460801789
2023-06-09T06:45:00-04:00,1.07601,1.07627,1.07586,1.07612,1.07564,1.076074,1.0761288888888887,1.0762391111111091,1.0767275000000027,1.0774992000000005,1.077097600000001,1.0739249500000034,1.076204182328154,1.07629239614957,1835,-259354,-260780,-0.05814524281839029,-194.32642387048807,-0.022297372626260543
2023-06-09T07:00:00-04:00,1.07612,1.07675,1.07601,1.07667,1.0756526,1.0761822222222222,1.0761655555555554,1.076183111111109,1.0766895000000027,1.0774674000000004,1.0771333000000007,1.0739609500000034,1.0762973458625233,1.0762659169196556,2329,-257025,-259525.6,-0.05031572820891391,-193.13608264460237,0.030659457048882455
2023-06-09T07:15:00-04:00,1.07667,1.07707,1.07647,1.07683,1.075696496,1.0763151111111111,1.0762244444444444,1.0761753333333313,1.076648500000003,1.0774360000000005,1.0771746000000009,1.0739979000000033,1.0764038766900186,1.076281933535724,2295,-254730,-258265.4,-0.0431124843101326,-192.7950310689108,0.04924277617763815
2023-06-09T07:30:00-04:00,1.07683,1.07755,1.07673,1.07751,1.07577890624,1.076572222222222,1.0763588888888889,1.0762066666666645,1.076629000000003,1.0774182000000005,1.0772221000000008,1.0740376500000033,1.076625101352015,1.076351146828579,2511,-252219,-256903.4,-0.031255417841293036,-191.2093768802273,0.11242218712254327
2023-06-09T07:45:00-04:00,1.07751,1.07817,1.07724,1.07731,1.0759205937408,1.0767624444444444,1.0764799999999999,1.0762715555555535,1.076601000000003,1.0773990000000004,1.0772654000000008,1.0740761000000034,1.0767620810816119,1.076458517462863,-3104,-255323,-255730.2,-0.019265905318100837,-191.78552002507044,0.10128040735166002
2023-06-09T08:00:00-04:00,1.07731,1.07798,1.07731,1.07785,1.0761455343667201,1.0770364444444445,1.0766999999999998,1.0763857777777757,1.076627500000003,1.0773862000000003,1.0773145000000008,1.0741148000000034,1.0769796648652894,1.0766136139702898,3310,-252013,-254262,-0.0040380594843097825,-190.12638755623607,0.18403710485468439
2023-06-09T08:15:00-04:00,1.07785,1.0784,1.07751,1.07755,1.076347980930048,1.0772064444444445,1.0768833333333334,1.0765293333333312,1.076640500000003,1.0773734000000004,1.077353900000001,1.0741488000000035,1.0770937318922316,1.0767728911762315,-3999,-256012,-254059.4,0.010548383245002192,-191.23943668181,0.15335997769308757
2023-06-09T08:30:00-04:00,1.07755,1.07842,1.07716,1.07725,1.0765942232184422,1.0772797777777778,1.0770111111111111,1.0766866666666646,1.0766555000000033,1.0773504000000005,1.0773916000000008,1.0741787000000034,1.0771249855137852,1.076917112940985,-6527,-262539,-255621.2,0.02326398072393923,-193.0566145389858,0.10686739150636412
2023-06-09T08:45:00-04:00,1.07725,1.0773,1.07632,1.07669,1.07842,1.0772155555555556,1.0770866666666665,1.0768322222222202,1.0766130000000032,1.0773174000000005,1.077422700000001,1.0742047500000032,1.0770379884110282,1.0769996903527874,-4237,-266776,-258532.6,0.029894116710763127,-195.25918590125127,0.06319643869480897
2023-06-09T09:00:00-04:00,1.07669,1.07704,1.07613,1.07684,1.07842,1.0771662222222222,1.0771666666666664,1.0769695555555534,1.0766225000000031,1.0772882000000004,1.077454700000001,1.0742302500000032,1.0769983907288225,1.0770469522822297,3560,-263216,-260111.2,0.04070042593500495,-194.76322141750913,0.06690703638999869
2023-06-09T09:15:00-04:00,1.07684,1.0769,1.0763,1.07684,1.0783284,1.0771008888888889,1.0771855555555554,1.0770666666666646,1.0766430000000031,1.0772614000000005,1.077485100000001,1.074255250000003,1.076966712583058,1.0770443618257832,0,-263216,-262351.8,0.046547237883519575,-194.76322141750913,0.015789424800542736
2023-06-09T09:30:00-04:00,1.07684,1.07751,1.07666,1.07717,1.078240464,1.0770977777777777,1.0772233333333332,1.0771346666666646,1.0766835000000032,1.0772404000000004,1.0775059000000011,1.0742818500000033,1.0770073700664464,1.0770270894606262,6460,-256756,-262500.6,0.04791678737299407,-192.78354012781,0.031574157480754345
2023-06-09T09:45:00-04:00,1.07717,1.07737,1.07691,1.0770899999999999,1.07815604544,1.077071111111111,1.0771766666666664,1.0771677777777753,1.0767210000000031,1.0772180000000005,1.077530000000001,1.0743096000000032,1.077023896053157,1.0770068715685006,-5196,-261952,-262383.2,0.04710146850468139,-193.16944021786117,-0.038978756577673246
2023-06-09T10:00:00-04:00,1.0770899999999999,1.0772,1.07663,1.07695,1.0780750036224,1.0770257777777779,1.0771366666666666,1.0771777777777753,1.076753500000003,1.0771950000000003,1.077549300000001,1.0743363500000032,1.0770091168425258,1.0770010972548003,-3817,-265769,-262181.8,0.03920151675934389,-193.66557331723007,-0.033416565334018614
2023-06-09T10:15:00-04:00,1.07695,1.07734,1.07679,1.0769,1.077997203477504,1.0769784444444443,1.0770311111111108,1.0771506666666641,1.076783500000003,1.0771716000000005,1.077566400000001,1.0743667000000032,1.0769872934740206,1.0769988778038397,-3545,-269314,-263401.4,0.03273929693019617,-193.83015848831542,-0.08813842371387544
2023-06-09T10:30:00-04:00,1.0769,1.07694,1.07537,1.07589,1.077922515338404,1.076750222222222,1.0768466666666665,1.0770828888888866,1.0767670000000031,1.0771328000000004,1.077564700000001,1.074392450000003,1.0767678347792164,1.0769591022430716,-5701,-275015,-265761.2,0.016350043960117962,-199.1769966348469,-0.1540531761867194
2023-06-09T10:45:00-04:00,1.07589,1.07603,1.07541,1.07566,1.0777693644180997,1.0765128888888889,1.0766699999999998,1.07697222222222,1.0767565000000032,1.0770904000000003,1.0775558000000012,1.0744127000000032,1.0765462678233733,1.0768668817944569,-5564,-280579,-270525.8,0.001273716333057217,-200.36644908816436,-0.1475980505917828
2023-06-09T11:00:00-04:00,1.07566,1.07583,1.07535,1.07577,1.0776254025530136,1.076332888888889,1.0765677777777778,1.076850444444442,1.076750000000003,1.0770518000000004,1.077546700000001,1.0744307500000032,1.0763910142586985,1.076740305435565,3707,-276872,-273509.8,-0.01202959634485674,-199.98736090044764,-0.08544706461470172
2023-06-09T11:15:00-04:00,1.07577,1.07596,1.07522,1.07538,1.0774433703487725,1.0760953333333334,1.0764055555555554,1.07670422222222,1.076714000000003,1.0770058000000002,1.0775264000000009,1.0744491000000034,1.0761888114069589,1.0765762443484514,-3173,-280045,-276365,-0.02189702251771077,-201.13767184051815,-0.13558188774562765
2023-06-09T11:30:00-04:00,1.07538,1.07546,1.0748199999999999,1.07497,1.0772210333138952,1.0758082222222223,1.0761977777777776,1.0765375555555532,1.0766620000000031,1.0769468000000002,1.077505800000001,1.0744601000000034,1.075945049125567,1.076367795478761,-3172,-283217,-279145.6,-0.03426915974630401,-202.3470303928439,-0.17365625348241506
2023-06-09T11:45:00-04:00,1.07497,1.07504,1.07464,1.0748,1.0769329093162276,1.0755286666666666,1.0759344444444443,1.076355111111109,1.0765960000000032,1.0768836000000004,1.0774846000000011,1.0744655500000035,1.0757160393004537,1.0761574363830084,-2882,-286099,-281362.4,-0.04786792663115094,-202.80280125156554,-0.22002098090366268
2023-06-09T12:00:00-04:00,1.0748,1.07505,1.07471,1.07496,1.0766119020119558,1.0753337777777778,1.0756977777777774,1.0761606666666643,1.0765105000000033,1.0768252000000003,1.0774591000000011,1.0744784500000033,1.075564831440363,1.0759611491064063,2663,-283436,-281933.8,-0.06326835016568798,-202.40637400928807,-0.19775506225106218
2023-06-09T12:15:00-04:00,1.07496,1.07524,1.07479,1.07496,1.076335835730282,1.0751862222222224,1.0754766666666664,1.075942444444442,1.0764170000000033,1.0767690000000003,1.077430900000001,1.0744956000000032,1.0754438651522904,1.0757717192851246,0,-283436,-283246.6,-0.07549600379000643,-202.40637400928807,-0.18478109475836002
2023-06-09T12:30:00-04:00,1.07496,1.07503,1.07435,1.07467,1.0760984187280425,1.0750248888888887,1.0752288888888886,1.0757071111111087,1.076275000000003,1.0767082000000003,1.077402000000001,1.0745141500000033,1.0752890921218323,1.0755917754280993,-2003,-285439,-284325.4,-0.087129988439323,-202.94673830191272,-0.20707586591140814
2023-06-09T12:45:00-04:00,1.07467,1.07489,1.0745,1.0748199999999999,1.0758186717315557,1.074943111111111,1.0751099999999996,1.0754895555555533,1.076150500000003,1.0766520000000004,1.077371400000001,1.0745345000000033,1.075195273697466,1.0754418203424791,1615,-283824,-284446.8,-0.09456503270724376,-202.72132026660904,-0.09945254626403502
2023-06-09T13:00:00-04:00,1.0748199999999999,1.07506,1.07462,1.07498,1.0755836842545068,1.074917111111111,1.075034444444444,1.0753095555555532,1.0760070000000028,1.0765994000000003,1.077341900000001,1.0745579000000034,1.0751522189579727,1.075329056273983,1687,-282137,-283654.4,-0.09272063577308634,-202.47018984477072,-0.06321700165479928
2023-06-09T13:15:00-04:00,1.07498,1.07518,1.07489,1.07495,1.0753862947737858,1.0749002222222221,1.074943333333333,1.0751586666666644,1.0758770000000029,1.0765482000000004,1.077305200000001,1.0745801000000035,1.0751117751663781,1.075238445019186,-1180,-283317,-283630.6,-0.0864966680811364,-202.5031206899957,-0.07622447177368963
2023-06-09T13:30:00-04:00,1.07495,1.07503,1.07462,1.07498,1.07522048760998,1.0749075555555556,1.0748988888888884,1.0750431111111087,1.075763500000003,1.0764904000000002,1.0772700000000008,1.0746030000000033,1.0750854201331026,1.0751667560153484,1041,-282276,-283398.6,-0.08247419942504242,-202.4740681759253,-0.037196153917680816
2023-06-09T13:45:00-04:00,1.07498,1.07522,1.07473,1.07484,1.07435,1.074895777777778,1.0748844444444439,1.0749742222222198,1.075671000000003,1.0764324000000003,1.077233800000001,1.0746267000000034,1.075036336106482,1.0751162048122784,-1414,-283690,-283048.8,-0.07683450855234188,-202.65822043922327,-0.012093360744947625
2023-06-09T14:00:00-04:00,1.07484,1.07504,1.07476,1.07503,1.0743673999999999,1.0749248888888887,1.0749099999999996,1.0749342222222198,1.075580500000003,1.0763690000000004,1.077202800000001,1.0746510000000034,1.0750350688851857,1.0750841638498223,1093,-282597,-282803.4,-0.06893345935617948,-202.46501028701465,0.021399330107922634
2023-06-09T14:15:00-04:00,1.07503,1.07506,1.07472,1.0748,1.0743844519999999,1.074902888888889,1.0748922222222217,1.0749057777777753,1.075478500000003,1.0763092000000003,1.0771692000000008,1.0746738000000033,1.0749880551081485,1.0750513310798575,-1090,-283687,-283113.4,-0.059907705562513985,-202.69821308135522,-0.014884274763706368
2023-06-09T14:30:00-04:00,1.0748,1.07484,1.07466,1.07469,1.0744011629599999,1.0748624444444443,1.0748622222222215,1.0748895555555529,1.0753545000000029,1.0762544000000005,1.077134900000001,1.0746992000000033,1.0749284440865188,1.0750146648638856,-1155,-284842,-283418.4,-0.05290410223729318,-202.81642112006014,-0.025117213663763533
2023-06-09T14:45:00-04:00,1.07469,1.07501,1.07458,1.07497,1.0744175397007998,1.0748839999999997,1.0748955555555548,1.0748888888888863,1.075248500000003,1.0762008000000005,1.0771065000000009,1.0747274500000032,1.074936755269215,1.0749849318911082,1550,-283292,-283621.6,-0.04307401539068957,-202.41258373439535,0.027915546167657696
2023-06-09T15:00:00-04:00,1.07497,1.07507,1.0748199999999999,1.07499,1.0744335889067838,1.0749028888888887,1.0749144444444436,1.074894888888886,1.0751505000000028,1.0761426000000005,1.077076200000001,1.0747558000000033,1.074947404215372,1.0749671455128862,1009,-282283,-283340.2,-0.030801648895476236,-202.3938111174852,0.015816601849612352
2023-06-09T15:15:00-04:00,1.07499,1.07504,1.07472,1.07473,1.074449317128648,1.0748659999999999,1.0748866666666659,1.0748902222222194,1.075042000000003,1.0760798000000005,1.0770419000000009,1.0747827000000034,1.0749039233722975,1.0749409164103085,-808,-283091,-283439,-0.021809091609456287,-202.58923619120677,-0.023256246627852004
2023-06-09T15:30:00-04:00,1.07473,1.07484,1.0745,1.07458,1.074464730786075,1.0748046666666666,1.0748455555555547,1.074880888888886,1.0749765000000029,1.0760250000000005,1.0770072000000008,1.0748082500000034,1.074839138697838,1.0749111331282464,-1049,-284140,-283529.6,-0.015255530129387754,-202.73564505668912,-0.034420205590955995
2023-06-09T15:45:00-04:00,1.07458,1.07463,1.07427,1.0744,1.07522,1.0747155555555556,1.0747811111111103,1.0748646666666637,1.074913500000003,1.0759672000000005,1.0769722000000008,1.0748309000000034,1.0747513109582705,1.074875706502597,-1812,-285952,-283751.6,-0.01377252432314457,-203.03916829367486,-0.05395449217660095
2023-06-09T16:00:00-04:00,1.0744,1.07464,1.07438,1.07453,1.075201,1.0746653333333331,1.0747466666666659,1.074834888888886,1.0748515000000027,1.0759188000000006,1.0769399000000008,1.0748532000000035,1.0747070487666164,1.074829765202077,1187,-284765,-284046.2,-0.012953643322688129,-202.89554394520133,-0.02884150199099703
2023-06-09T16:15:00-04:00,1.07453,1.07491,1.07452,1.07487,1.07518238,1.0746900000000001,1.074728888888888,1.0747977777777749,1.074826000000003,1.0758654000000005,1.076913800000001,1.0748771500000034,1.074739639013293,1.074788212161661,667,-284098,-284409.2,-0.008687793229338435,-202.68449353246274,-0.01488330558216403
2023-06-09T16:30:00-04:00,1.07487,1.07487,1.07467,1.07477,1.0751641324,1.0746982222222223,1.0747255555555548,1.0747655555555526,1.0748160000000029,1.0758278000000006,1.0768829000000009,1.0749014000000034,1.0747457112106344,1.0747565697293286,-519,-284617,-284714.4,-0.008404481976591008,-202.73277844133543,-0.002791216970596808
2023-06-09T16:45:00-04:00,1.07477,1.07497,1.07467,1.07481,1.0751462497520001,1.074715111111111,1.0747388888888882,1.0747442222222194,1.074816500000003,1.0757954000000007,1.076852000000001,1.0749242500000034,1.0747585689685075,1.0747404557834623,681,-283936,-284673.6,-0.0076026322117505865,-202.7074334838096,0.011166010663551352
2023-06-11T17:00:00-04:00,1.0746,1.07483,1.07451,1.07478,1.07512872475696,1.0747233333333333,1.074717777777777,1.0747315555555528,1.0748075000000028,1.0757638000000005,1.076818100000001,1.0749463000000035,1.074762855174806,1.0747427646267695,-121,-284057,-284294.6,-0.00667667651231535,-202.71081082492105,-0.017674911857997196
2023-06-11T17:15:00-04:00,1.07478,1.07483,1.07447,1.07447,1.075111550261821,1.0746737777777777,1.074659999999999,1.0747142222222195,1.074783000000003,1.0757264000000006,1.076781900000001,1.0749677500000034,1.0747042841398449,1.0747422117014154,-144,-284201,-284181.8,-0.009157922998759137,-202.75234490631445,-0.04837254300038642
2023-06-11T17:30:00-04:00,1.07447,1.07475,1.07441,1.07453,1.0750947192565845,1.0746477777777779,1.074637777777777,1.0746959999999972,1.0747760000000028,1.0756910000000008,1.0767463000000008,1.0749900500000034,1.074669427311876,1.074728169361132,131,-284070,-284176.2,-0.011532911331008637,-202.74502967182676,-0.01860932513282201
2023-06-11T17:45:00-04:00,1.07453,1.07476,1.07442,1.07451,1.0750782248714528,1.0746222222222224,1.074629999999999,1.074676888888886,1.074760500000003,1.0756552000000006,1.076709600000001,1.0750158000000034,1.0746375418495009,1.0747065354889052,-212,-284282,-284109.2,-0.012871050680637533,-202.74897558306236,-0.006514172979211831
2023-06-11T18:00:00-04:00,1.07451,1.07498,1.0744,1.07469,1.0750620603740237,1.0746342222222223,1.0746622222222215,1.0746615555555525,1.0747460000000026,1.0756246000000007,1.076676500000001,1.0750399000000035,1.0746480334796007,1.0746844283911239,639,-283643,-284050.6,-0.011271649408896774,-202.64193144201212,0.026991809381971467
2023-06-11T18:15:00-04:00,1.07469,1.07485,1.07464,1.07471,1.0750462191665433,1.0746437777777778,1.0746822222222212,1.0746544444444415,1.0747340000000027,1.0756014000000007,1.0766411000000007,1.0750647500000035,1.0746604267836806,1.0746639427128986,374,-283269,-283893,-0.007191079339550915,-202.63497129536515,0.016751509962501653
2023-06-11T18:30:00-04:00,1.07471,1.07471,1.0743,1.07436,1.0750306947832124,1.0745793333333333,1.0746255555555546,1.0746475555555526,1.0747030000000029,1.0755706000000007,1.0766008000000007,1.0750874000000037,1.0746003414269445,1.0746431541703187,-492,-283761,-283805,-0.006158879597625006,-202.7952005665174,-0.047447598314215716
2023-06-11T18:45:00-04:00,1.07436,1.07452,1.0743,1.07449,1.0750154808875483,1.0745522222222221,1.0745944444444435,1.0746388888888858,1.0746855000000028,1.0755384000000006,1.0765637000000008,1.0751106500000036,1.0745782731415556,1.0746249233362548,193,-283568,-283704.6,-0.007523744325338796,-202.77184712819133,-0.026052085562497836
2023-06-11T19:00:00-04:00,1.07449,1.0746499999999999,1.07438,1.0746499999999999,1.0750005712697974,1.0745633333333333,1.0745766666666658,1.0746282222222192,1.0746665000000026,1.0755112000000007,1.0765269000000008,1.0751350500000036,1.0745926185132444,1.0746159386690035,401,-283167,-283481.6,-0.007798528559190468,-202.71213507875393,-0.014886352006416019
2023-06-11T19:15:00-04:00,1.0746499999999999,1.07491,1.07461,1.0748,1.0749859598444014,1.074608,1.0745788888888879,1.0746115555555524,1.0746665000000026,1.0754848000000006,1.076492000000001,1.0751600500000036,1.0746340948105955,1.0746131509352024,467,-282700,-283293,-0.0068725233324324125,-202.6469510653542,0.0018608459405561118
2023-06-11T19:30:00-04:00,1.0748,1.07496,1.0748,1.0749,1.0749716406475134,1.074672222222222,1.0746266666666657,1.0746004444444412,1.0746770000000025,1.0754494000000008,1.0764584000000008,1.0751856000000037,1.0746872758484765,1.0746185207481616,497,-282203,-283079.8,-0.006198979715909278,-202.60070990420795,0.04001973065789928
2023-06-11T19:45:00-04:00,1.0749,1.07516,1.0748199999999999,1.075,1.07427,1.0747468888888887,1.0746788888888879,1.074611111111108,1.0746785000000028,1.0754128000000005,1.076424400000001,1.0752113000000036,1.074749820678781,1.0746484165985288,727,-281476,-282622.8,-0.0026408442900932695,-202.53307570567785,0.043740053790957016
2023-06-11T20:00:00-04:00,1.075,1.07504,1.07447,1.07464,1.0742878,1.074739111111111,1.0746933333333324,1.0746308888888858,1.0746610000000028,1.0753554000000007,1.0763868000000008,1.0752346000000037,1.074727856543025,1.0746783332788226,-972,-282448,-282398.8,-0.00015508540528590443,-202.85858268242197,0.012098537938219604
2023-06-11T20:15:00-04:00,1.07464,1.0748199999999999,1.0745,1.07458,1.074305244,1.0747164444444444,1.0746811111111103,1.0746517777777747,1.0746535000000026,1.0753008000000006,1.076349900000001,1.0752573000000036,1.07469828523442,1.0746994666230578,-646,-283094,-282384.2,0.00231303006966108,-202.89465057492546,-0.010235509774896246
2023-06-11T20:30:00-04:00,1.07458,1.07483,1.07452,1.07469,1.07432233912,1.0747182222222222,1.0746788888888879,1.0746717777777746,1.0746590000000027,1.0752376000000006,1.0763119000000008,1.0752818500000036,1.074696628187536,1.0747119732984458,718,-282376,-282319.4,0.0024902781670100784,-202.82115209179727,-0.0018609671446372532
2023-06-11T20:45:00-04:00,1.07469,1.07469,1.07442,1.07452,1.0743390923376002,1.0746864444444444,1.0746966666666657,1.0746857777777747,1.0746650000000026,1.0751770000000007,1.0762752000000007,1.0753047500000035,1.074661302550029,1.0747067786387563,-853,-283229,-282524.6,0.0009881379142069285,-202.95608402565728,0.014892587214708103
2023-06-11T21:00:00-04:00,1.07452,1.07454,1.07426,1.07436,1.07516,1.0746191111111112,1.0746822222222212,1.0746864444444415,1.0746565000000026,1.0751192000000005,1.0762348000000008,1.0753270500000036,1.0746010420400232,1.0746770229110045,-1109,-284338,-283097,0.0011653844486612145,-203.12121822511372,-0.012098763134134658
2023-06-11T21:15:00-04:00,1.07436,1.07459,1.0742099999999999,1.07422,1.0751419999999998,1.0745266666666669,1.0746344444444436,1.0746746666666636,1.0746240000000025,1.0750698000000005,1.0761936000000007,1.0753494500000036,1.0745248336320186,1.0746364183288033,-1198,-285536,-283714.6,0.000026587082941164883,-203.277329770592,-0.04001302749731824
2023-06-11T21:30:00-04:00,1.07422,1.07442,1.07415,1.07428,1.07510472,1.0744557777777777,1.074576666666666,1.0746537777777747,1.0745995000000028,1.0750186000000006,1.0761534000000006,1.0753684500000036,1.074475866905615,1.0745919346630424,1637,-283899,-283875.6,-0.0008020646292720224,-203.18589598607866,-0.048381094157059545
2023-06-11T21:45:00-04:00,1.07428,1.0743,1.07359,1.07368,1.0750474367999998,1.0742764444444444,1.0744411111111105,1.0746062222222192,1.0745430000000027,1.0749554000000006,1.0761084000000007,1.0753834000000035,1.0743166935244919,1.0745159477304334,-1825,-285724,-284545.2,-0.006394669424572404,-204.2051833227133,-0.11349893013303552
2023-06-11T22:00:00-04:00,1.07368,1.07384,1.07354,1.07363,1.0749308418559997,1.0741142222222222,1.0742888888888882,1.074524666666664,1.0744855000000026,1.0748846000000005,1.0760625000000008,1.0753973000000034,1.0741793548195935,1.0744195581843463,-1287,-287011,-285301.6,-0.012985004314016961,-204.26511738127812,-0.1274418604651043
2023-06-11T22:15:00-04:00,1.07363,1.07386,1.07352,1.07363,1.0747917576703998,1.0739824444444444,1.074176666666666,1.0744235555555528,1.0744435000000028,1.0748154000000005,1.076016700000001,1.0754119000000033,1.0740694838556748,1.0743132465474765,0,-287011,-285836.2,-0.020639674799635962,-204.26511738127812,-0.09398496240601088
2023-06-11T22:30:00-04:00,1.07363,1.07364,1.0733,1.07348,1.0746391467499519,1.073843111111111,1.0740544444444438,1.074307555555553,1.0743910000000025,1.0747460000000006,1.0759705000000008,1.0754258000000037,1.0739515870845397,1.0741985972379808,-1201,-288212,-286371.4,-0.02704948730932339,-204.4329126179985,-0.10236557538760267
2023-06-11T22:45:00-04:00,1.07348,1.0738699999999999,1.07344,1.07385,1.0744516662049586,1.0738022222222223,1.0739611111111105,1.0741844444444417,1.0743580000000026,1.0746850000000006,1.0759283000000008,1.0754408000000035,1.0739312696676317,1.0740896777903841,917,-287295,-287050.6,-0.03083105106995088,-204.11684711142178,-0.07816207464477681
2023-06-11T23:00:00-04:00,1.07385,1.074,1.0737,1.07386,1.0742904329362644,1.073782,1.0738877777777769,1.0740737777777751,1.0743165000000026,1.0746444000000006,1.0758886000000007,1.0754565500000035,1.0739170157341054,1.074009742232307,922,-286373,-287180.4,-0.03567657845226865,-204.10826118228823,-0.061422774820374025
2023-06-11T23:15:00-04:00,1.07386,1.07389,1.07363,1.07375,1.0741517723251874,1.0737544444444445,1.073819999999999,1.0739799999999973,1.0742685000000027,1.0746062000000007,1.0758483000000008,1.0754724500000035,1.0738836125872844,1.0739505937858451,-800,-287173,-287212.8,-0.038678940854530316,-204.1902085497291,-0.0567779887560966
2023-06-11T23:30:00-04:00,1.07375,1.07407,1.07375,1.07395,1.0733,1.0737804444444445,1.0737899999999994,1.073902666666664,1.0742480000000025,1.0745698000000008,1.0758108000000006,1.0754886000000037,1.0738968900698276,1.0739160750286758,871,-286302,-287071,-0.039127952437985065,-204.02797339256963,-0.025134516207107712
2023-06-11T23:45:00-04:00,1.07395,1.07414,1.07381,1.07408,1.0733154,1.0738384444444444,1.0737677777777772,1.0738453333333307,1.0742275000000026,1.0745438000000007,1.0757748000000007,1.0755046500000036,1.073933512055862,1.0739124600229402,638,-285664,-286561.4,-0.039190497467667715,-203.95074447129772,-0.018617120303829355
2023-06-12T00:00:00-04:00,1.07408,1.07443,1.07389,1.07424,1.073348384,1.0739328888888888,1.0738299999999994,1.0738191111111086,1.0742070000000026,1.0745292000000009,1.0757380000000007,1.0755218500000037,1.0739948096446896,1.0739251680183517,1013,-284651,-286032.6,-0.03845507671257601,-203.7998432348906,0.052157067282627596
2023-06-12T00:15:00-04:00,1.07424,1.07428,1.07412,1.0742,1.0734132809599999,1.0740068888888887,1.073893333333333,1.0738202222222197,1.0741770000000026,1.0745172000000007,1.075700400000001,1.0755381500000036,1.0740358477157517,1.0739489344146809,-729,-285380,-285834,-0.031620234467314,-203.8269880070086,0.05309091586486586
2023-06-12T00:30:00-04:00,1.0742,1.07425,1.07399,1.07405,1.0734742841023999,1.0740382222222222,1.0739399999999995,1.07384422222222,1.0741345000000027,1.0744990000000008,1.0756621000000008,1.0755547000000036,1.0740386781726012,1.0739799475317444,-646,-286026,-285604.6,-0.02438647036288119,-203.91719467243408,0.039119622216207156
2023-06-12T00:45:00-04:00,1.07405,1.0742099999999999,1.07398,1.0741,1.0735316270562558,1.0740702222222223,1.0740088888888883,1.0738879999999977,1.0740895000000026,1.0744818000000007,1.075625400000001,1.0755718000000036,1.074050942538081,1.0740107580253953,720,-285306,-285405.4,-0.01646510873191149,-203.88367667978935,0.057756083019717644
2023-06-12T01:00:00-04:00,1.0741,1.07454,1.07405,1.07438,1.0735855294328804,1.0741444444444446,1.0740677777777772,1.0739479999999977,1.0740765000000025,1.0744760000000009,1.0755921000000008,1.0755891500000037,1.0741167540304648,1.0740474064203158,1102,-284204,-285113.4,-0.005337785625531648,-203.59640361396697,0.04935512408622428
2023-06-12T01:15:00-04:00,1.07438,1.07459,1.07437,1.07443,1.07366188707825,1.0742168888888888,1.0741311111111105,1.0740082222222198,1.0740690000000026,1.0744682000000008,1.0755601000000008,1.0756062500000036,1.0741794032243719,1.0740843251362524,946,-283258,-284834.8,0.0009930856415478503,-203.55237822257837,0.05307954481961889
2023-06-12T01:30:00-04:00,1.07443,1.07484,1.07441,1.07453,1.073754698370425,1.0742966666666665,1.074217777777777,1.0740731111111086,1.0740610000000026,1.0744592000000006,1.0755293000000008,1.0756238000000038,1.0742495225794975,1.0741270601090016,1061,-282197,-284198.2,0.007452592247777897,-203.45362818767614,0.07264260768335301
2023-06-12T01:45:00-04:00,1.07453,1.07507,1.07447,1.07492,1.073884934565974,1.0744371111111113,1.0743255555555549,1.07415022222222,1.0740810000000025,1.0744586000000007,1.075503400000001,1.0756443000000038,1.074383618063598,1.0741960480872008,1120,-281077,-283208.4,0.017325659443811297,-203.0471248792528,0.09032077843476302
2023-06-12T02:00:00-04:00,1.07492,1.07534,1.07491,1.07514,1.0740508437267375,1.0746,1.0744433333333328,1.0742371111111086,1.0741200000000026,1.0744618000000008,1.075476100000001,1.0756663500000037,1.0745348944508784,1.0742928384697603,1741,-279336,-282014.4,0.02565528027994038,-202.69080068768525,0.09868911068077434
2023-06-12T02:15:00-04:00,1.07514,1.07537,1.07512,1.07528,1.0742571087304595,1.0747673333333334,1.0745588888888884,1.0743353333333308,1.0741730000000025,1.0744706000000008,1.0754515000000011,1.0756877500000037,1.0746839155607026,1.0744062707758077,1528,-277808,-280735.2,0.03274716194249868,-202.49183125114672,0.09681263032468813
2023-06-12T02:30:00-04:00,1.07528,1.0753,1.07469,1.07494,1.0744574291589768,1.0748435555555556,1.0746411111111103,1.0744373333333308,1.0742060000000024,1.074468800000001,1.0754189000000012,1.0757083500000038,1.0747351324485621,1.074517416620646,-1669,-279477,-279979,0.03607082062589642,-203.0195635627307,0.06888847514428997
2023-06-12T02:45:00-04:00,1.07494,1.07505,1.07453,1.0749,1.07537,1.0748953333333333,1.0747355555555549,1.0745408888888865,1.0742670000000027,1.074470800000001,1.075390000000001,1.075727100000004,1.0747681059588496,1.074621133296516,-1716,-281193,-279778.2,0.03983772344752767,-203.0834182895062,0.07913970485545528
2023-06-12T03:00:00-04:00,1.0749,1.07511,1.07457,1.07485,1.0753532,1.0749182222222222,1.0748188888888883,1.0746395555555532,1.0743280000000026,1.0744740000000008,1.075364200000001,1.075745150000004,1.0747844847670798,1.0747013066372126,-3575,-284768,-280516.4,0.042096276671758824,-203.2497128285327,0.06982590075412237
2023-06-12T03:15:00-04:00,1.07485,1.07539,1.07441,1.07533,1.07441,1.0750204444444442,1.074924444444444,1.0747357777777755,1.0744130000000027,1.0744812000000008,1.075341000000001,1.075763750000004,1.0748935878136638,1.0747730453097697,2719,-282049,-281059,0.04600678400644327,-202.03547828417814,0.08842309052662992
2023-06-12T03:30:00-04:00,1.07533,1.07567,1.07503,1.07566,1.07441,1.0751675555555558,1.0750611111111104,1.0748362222222196,1.0745220000000024,1.074494600000001,1.075318600000001,1.075784900000004,1.075046870250931,1.0748456362478156,3026,-279023,-281302,0.048918804888843356,-201.106851723029,0.11447930530607525
2023-06-12T03:45:00-04:00,1.07566,1.07723,1.07563,1.07696,1.07441,1.0755473333333334,1.0753311111111106,1.0749742222222198,1.0746775000000024,1.074539200000001,1.075309500000001,1.0758146500000039,1.075429496200745,1.0749845089982522,3866,-275157,-280438,0.057033597136024176,-196.43455750366653,0.2261453844936793
2023-06-12T04:00:00-04:00,1.07696,1.07786,1.07677,1.0778,1.0745792,1.076041111111111,1.0756511111111107,1.075157333333331,1.0748745000000024,1.0746036000000008,1.075314300000001,1.0758487000000039,1.075903596960596,1.0752116071986015,3863,-271294,-278458.2,0.06994707893003228,-193.42152080778118,0.2679269154913848
2023-06-12T04:15:00-04:00,1.0778,1.07794,1.07729,1.07768,1.074841664,1.0764468888888887,1.0759333333333325,1.0753802222222197,1.0750710000000026,1.0746692000000009,1.075318200000001,1.0758830500000038,1.0762588775684767,1.0755064857588807,-3069,-274363,-276377.2,0.07868822250321154,-193.7632168552857,0.23624830254664386
2023-06-12T04:30:00-04:00,1.07768,1.07841,1.07759,1.078,1.0751514976,1.076860222222222,1.076235555555555,1.075642444444442,1.0752735000000027,1.0747386000000008,1.075328700000001,1.075915400000004,1.0766071020547814,1.0758491886071042,3541,-270822,-274131.8,0.08645040483804235,-192.7117730129574,0.25295736924336504
2023-06-12T04:45:00-04:00,1.078,1.07807,1.07747,1.0776999999999999,1.075542517888,1.0771531111111112,1.0765422222222216,1.0759386666666644,1.0754545000000024,1.074795200000001,1.075330300000001,1.0759484000000041,1.076825681643825,1.076204950885683,-2619,-273441,-273015.4,0.09233424714105638,-193.44062273466471,0.25675851675441175
2023-06-12T05:00:00-04:00,1.0776999999999999,1.07791,1.07746,1.0776999999999999,1.07588661574144,1.0773846666666667,1.0768533333333328,1.0762431111111088,1.0756275000000026,1.074853800000001,1.0753408000000009,1.075982750000004,1.07700054531506,1.0765191607085458,0,-273441,-272672.2,0.10195339842486088,-193.44062273466471,0.2604893478463033
2023-06-12T05:15:00-04:00,1.0776999999999999,1.078,1.07745,1.07799,1.0761894218524672,1.077612,1.0772022222222217,1.0765533333333308,1.0758170000000027,1.0749174000000008,1.0753564000000009,1.076021750000004,1.077198436252048,1.0767781285668363,2075,-271366,-272686.6,0.1140610184620692,-192.88225769801235,0.2921337861096823
2023-06-12T05:30:00-04:00,1.07799,1.07901,1.07783,1.07861,1.0764558912301712,1.0778935555555555,1.077566666666666,1.0768799999999976,1.0760450000000028,1.074994000000001,1.075378900000001,1.076062050000004,1.0774807490016383,1.0770225028534688,3149,-268217,-271457.4,0.12946698266682946,-191.0711277246358,0.30502264421156033
2023-06-12T05:45:00-04:00,1.07861,1.07874,1.07776,1.07853,1.0768134664579472,1.0780862222222223,1.0778855555555549,1.0772099999999978,1.0762665000000027,1.0750752000000008,1.0754008000000008,1.076098200000004,1.0776905992013106,1.0772392022827746,-2842,-271059,-271504.8,0.13935307217958506,-191.28191753745065,0.26681293345480245
2023-06-12T06:00:00-04:00,1.07853,1.07875,1.07784,1.07819,1.0771209811538345,1.0781471111111112,1.0780222222222215,1.0775059999999974,1.0764570000000027,1.0751484000000007,1.075419700000001,1.0761315000000038,1.0777904793610484,1.0774321618262193,-2889,-273948,-271606.2,0.14473851860274223,-192.19265715526382,0.11421036993017981
2023-06-12T06:15:00-04:00,1.07819,1.07837,1.07783,1.078,1.0773854437922976,1.0781426666666667,1.078044444444444,1.0777442222222198,1.0766355000000025,1.075218200000001,1.075436700000001,1.0761622500000039,1.0778323834888388,1.077598529460975,-2593,-276541,-272226.2,0.1383633666181555,-192.64959888167547,0.018556318426422153
2023-06-12T06:30:00-04:00,1.078,1.0783099999999999,1.07758,1.07763,1.07901,1.0780597777777778,1.0780388888888883,1.0779115555555532,1.0767905000000026,1.0752770000000007,1.075450800000001,1.0761909500000038,1.077791906791071,1.0777172235687797,-2888,-279429,-273838.8,0.12261204387053636,-193.64084192434703,-0.00463959616953859
2023-06-12T06:45:00-04:00,1.07763,1.07763,1.07675,1.0772599999999999,1.0789814,1.077904,1.0779566666666662,1.0779895555555532,1.0769075000000026,1.0753280000000007,1.0754647000000008,1.0762139500000039,1.0776855254328568,1.0777581788550232,-3532,-282961,-276787.6,0.10662417796471456,-194.85354016029137,-0.06864564007422866
2023-06-12T07:00:00-04:00,1.0772599999999999,1.07755,1.0771,1.07732,1.0788921439999999,1.0777766666666666,1.0779144444444437,1.077995333333331,1.0770165000000025,1.0753872000000009,1.075478900000001,1.0762393500000038,1.0776124203462853,1.0777425430840184,2316,-280645,-278704.8,0.08968639608233352,-194.7245462312488,-0.03526027651478379
2023-06-12T07:15:00-04:00,1.07732,1.07732,1.07662,1.0768,1.0788064582399999,1.077553777777778,1.0778144444444437,1.0779537777777752,1.0770925000000025,1.0754334000000008,1.075485900000001,1.076258950000004,1.0774499362770282,1.0776744344672142,-2128,-282773,-280469.8,0.07398374594868891,-195.7516876562666,-0.08351118121925406
2023-06-12T07:30:00-04:00,1.0768,1.07725,1.07661,1.07669,1.0786752707455998,1.077328888888889,1.0776699999999992,1.0778788888888866,1.0771800000000025,1.0754742000000008,1.0754927000000007,1.0762789500000038,1.0772979490216226,1.077567547573771,-2040,-284813,-282124.2,0.05836804674434079,-195.96008290143757,-0.12059481071253712
2023-06-12T07:45:00-04:00,1.07669,1.07676,1.07612,1.07628,1.0785100490859518,1.0770508888888888,1.0774111111111102,1.077753333333331,1.0772490000000026,1.0755038000000008,1.0754943000000008,1.076295950000004,1.0770943592172981,1.0774280380590164,-2739,-287552,-283748.8,0.03656518071753824,-197.00308506547742,-0.21601876489186686
2023-06-12T08:00:00-04:00,1.07628,1.07712,1.07626,1.0768199999999999,1.0782710441773566,1.0769326666666665,1.0772211111111103,1.0776062222222196,1.0773475000000026,1.0755422000000008,1.0754958000000008,1.0763145500000038,1.0770394873738385,1.0772988304472129,2654,-284898,-284136.2,0.011457974166891488,-195.6714984894935,-0.15854913632445092
2023-06-12T08:15:00-04:00,1.0768199999999999,1.07712,1.07639,1.07645,1.078055939759621,1.0767784444444444,1.077027777777777,1.0774288888888863,1.0774035000000026,1.0755712000000008,1.0754920000000008,1.076333300000004,1.0769215898990707,1.07716066435777,-3424,-288322,-285671.6,-0.014922602260982016,-196.84799966889204,-0.16138157467608444
2023-06-12T08:30:00-04:00,1.07645,1.07652,1.07606,1.0764,1.077862345783659,1.076652888888889,1.0768499999999992,1.0772359999999974,1.0774405000000027,1.075606400000001,1.0754809000000007,1.076351500000004,1.0768172719192566,1.0770341314862155,-3225,-291547,-287426.4,-0.036266042916853,-196.99779761584696,-0.14842300556586696
2023-06-12T08:45:00-04:00,1.0764,1.07686,1.07635,1.07661,1.07764606428962,1.0766048888888888,1.0767366666666658,1.0770493333333309,1.0774230000000027,1.075647000000001,1.0754739000000009,1.076369650000004,1.0767758175354052,1.0769297051889721,2549,-288998,-288263.4,-0.05336475521741371,-196.5005010718112,-0.09465215333649034
2023-06-12T09:00:00-04:00,1.07661,1.07692,1.07643,1.0768,1.0774557365748656,1.0766175555555557,1.0766855555555548,1.0769042222222196,1.0773730000000026,1.0756892000000007,1.0754634000000007,1.076388950000004,1.0767806540283242,1.0768669641511772,2810,-286188,-287990.6,-0.06036173727907899,-196.00459261842533,-0.04270092642443839
2023-06-12T09:15:00-04:00,1.0768,1.07716,1.07658,1.0766499999999999,1.0772882481858816,1.0766104444444444,1.0766111111111103,1.0767822222222196,1.0773215000000025,1.0757318000000007,1.0754544000000008,1.0764041500000041,1.0767545232226594,1.0768099713209416,-2918,-289106,-288832.2,-0.060943833812289364,-196.41107478781637,-0.06219136375451773
2023-06-12T09:30:00-04:00,1.0766499999999999,1.07672,1.07525,1.07569,1.07716,1.076426222222222,1.0764877777777768,1.0766742222222196,1.0772060000000026,1.075758400000001,1.0754388000000008,1.076415200000004,1.0765416185781276,1.076733977056753,-4986,-294092,-289986.2,-0.06728370285327223,-200.85686497032626,-0.10308320950965308
2023-06-12T09:45:00-04:00,1.07569,1.07573,1.0743,1.07529,1.07716,1.0761866666666666,1.0763322222222211,1.0765706666666641,1.0770855000000026,1.0757798000000007,1.0754248000000008,1.0764237500000038,1.076291294862502,1.076628781645402,-6238,-300330,-291742.8,-0.06932983663108433,-203.17649237227266,-0.13002814180496206
2023-06-12T10:00:00-04:00,1.07529,1.07616,1.07521,1.07582,1.07672,1.0760842222222222,1.0762811111111101,1.076479555555553,1.0769915000000025,1.0758106000000007,1.0754146000000007,1.076434650000004,1.0761970358900017,1.0765130253163213,4951,-295379,-293019,-0.06910126790993715,-200.7361925461796,-0.04273980748503224
2023-06-12T10:15:00-04:00,1.07582,1.076,1.07499,1.0750899999999999,1.0763327999999999,1.0758459999999999,1.0760888888888878,1.0763602222222197,1.0768465000000025,1.0758388000000005,1.0753971000000009,1.0764411000000038,1.0759756287120013,1.0763520202530568,-4274,-299653,-295712,-0.06861841651404268,-203.6363245385208,-0.1606582344310107
2023-06-12T10:30:00-04:00,1.0750899999999999,1.07565,1.07505,1.07546,1.07616,1.0757202222222222,1.075978888888888,1.0762337777777753,1.0766890000000024,1.0758754000000008,1.075380000000001,1.076442950000004,1.075872502969601,1.0761756162024452,3916,-295737,-297038.2,-0.07006778142387345,-202.28860481272966,-0.09196897208414924
2023-06-12T10:45:00-04:00,1.07546,1.07553,1.07449,1.07471,1.076,1.0754664444444446,1.07579111111111,1.076094444444442,1.0764980000000024,1.0758970000000008,1.0753562000000008,1.0764431000000036,1.075640002375681,1.0759952929619558,-4977,-300714,-298362.6,-0.06899178140562566,-205.75944519730942,-0.15700483091787154
2023-06-12T11:00:00-04:00,1.07471,1.07563,1.07443,1.07551,1.075728,1.0754102222222222,1.075668888888888,1.0759617777777752,1.0763640000000025,1.0759376000000007,1.075341800000001,1.0764455500000039,1.0756140019005447,1.0758598343695644,3985,-296729,-297642.4,-0.06390931044529068,-202.7930635687774,-0.10217256016571469
2023-06-12T11:15:00-04:00,1.07551,1.07568,1.0750899999999999,1.07545,1.0743,1.0753664444444446,1.0755188888888878,1.0758093333333307,1.0762365000000025,1.0759696000000007,1.0753273000000008,1.076446850000004,1.0755812015204358,1.0757366674956512,-3020,-299749,-298516.4,-0.06257208753065902,-202.96154177911467,-0.12537147102525653
2023-06-12T11:30:00-04:00,1.07545,1.07551,1.07491,1.07535,1.0743276,1.0753326666666667,1.0753744444444433,1.0756664444444417,1.0761225000000025,1.0759994000000008,1.075321900000001,1.0764433000000038,1.0755349612163487,1.075648533996521,-2689,-302438,-299073.4,-0.06432720592102233,-203.2115766482392,-0.12074490317186244
2023-06-12T11:45:00-04:00,1.07535,1.0754,1.07446,1.0746,1.074354648,1.0751777777777778,1.0752533333333323,1.0755213333333304,1.0759895000000026,1.0760164000000008,1.075311300000001,1.0764335500000037,1.075347968973079,1.0755436271972165,-2390,-304828,-300891.6,-0.06997816086578029,-204.8784757973535,-0.1013303089180001
2023-06-12T12:00:00-04:00,1.0746,1.07506,1.07452,1.07477,1.07438115504,1.0750811111111112,1.0751955555555546,1.0754022222222195,1.0758620000000025,1.0760328000000008,1.075301300000001,1.0764240000000038,1.0752323751784632,1.075462101757773,2144,-302684,-301285.6,-0.0675162516991321,-204.5392984290304,-0.04835904732677472
2023-06-12T12:15:00-04:00,1.07477,1.07481,1.07437,1.07443,1.07568,1.0749279999999999,1.07504111111111,1.0752766666666642,1.0757435000000026,1.0760398000000007,1.075291800000001,1.0764091000000038,1.0750719001427704,1.075353681406218,-1851,-304535,-302846.8,-0.06272665987030812,-205.12485626931252,-0.12920377014742265
2023-06-12T12:30:00-04:00,1.07443,1.07497,1.0744,1.07487,1.0756538,1.0748937777777776,1.0750166666666656,1.0751762222222196,1.0756525000000026,1.0760524000000007,1.075290800000001,1.0763983000000037,1.0750315201142164,1.0752437451249741,1982,-302553,-303407.6,-0.06301976029790898,-204.3131886874319,-0.020463403063919017
2023-06-12T12:45:00-04:00,1.07487,1.07517,1.07468,1.07485,1.075628124,1.0748604444444445,1.0749488888888878,1.0750911111111083,1.0755810000000028,1.0760654000000007,1.075291300000001,1.0763879500000038,1.0749952160913732,1.0751357960999792,-1673,-304226,-303765.2,-0.05711022272949372,-204.34431803330614,-0.05671991519907755
2023-06-12T13:00:00-04:00,1.07485,1.07515,1.07461,1.07502,1.07560296152,1.0748746666666666,1.0749833333333325,1.0750371111111083,1.0754910000000026,1.0760848000000007,1.075291900000001,1.0763755000000037,1.0750001728730985,1.0750662368799833,2285,-301941,-303187.8,-0.05562580357200086,-203.98291876829242,0.028844990741691477
2023-06-12T13:15:00-04:00,1.07502,1.0752,1.07455,1.0747,1.0755783022896,1.074818,1.0748933333333324,1.074976666666664,1.0754035000000026,1.0760968000000006,1.075289300000001,1.0763601000000036,1.0749401382984787,1.0750077895039865,-1857,-303798,-303410.6,-0.0463370485620889,-204.53568987952772,-0.07531310727003723
2023-06-12T13:30:00-04:00,1.0747,1.07489,1.0744799999999999,1.07485,1.075554136243808,1.0748093333333335,1.0748266666666657,1.0749337777777752,1.0753260000000027,1.0761062000000008,1.075291100000001,1.0763465500000038,1.074922110638783,1.0749778316031888,1617,-302181,-302939.8,-0.04539271272233798,-204.3099989890465,-0.055790599284014496
2023-06-12T13:45:00-04:00,1.07485,1.07542,1.07484,1.07535,1.0755304535189318,1.0749140000000001,1.0748266666666657,1.0748957777777752,1.0752630000000027,1.0761246000000007,1.075296400000001,1.0763339000000038,1.0750076885110265,1.0749730652825507,1379,-300802,-302589.6,-0.04167502514145157,-203.66851413069423,0
2023-06-12T14:00:00-04:00,1.07535,1.07557,1.07517,1.07542,1.07437,1.0750326666666665,1.0749177777777765,1.0748895555555529,1.0751940000000029,1.0761424000000006,1.075300800000001,1.0763213500000037,1.075090150808821,1.0749920522260403,1475,-299327,-301609.8,-0.03575623054715006,-203.57249887984565,0.0763074632421406
2023-06-12T14:15:00-04:00,1.07542,1.07559,1.07504,1.0750899999999999,1.074394,1.0750671111111112,1.0749533333333323,1.074883555555553,1.0751160000000026,1.0761458000000008,1.075302200000001,1.0763037000000037,1.075090120647057,1.075010041780832,-1638,-300965,-301414.6,-0.023628181444549437,-204.0751304098528,0.02977381207140839
2023-06-12T14:30:00-04:00,1.0750899999999999,1.07567,1.07503,1.07567,1.07444184,1.0752104444444444,1.0750911111111099,1.0749231111111084,1.0751150000000027,1.0761564000000008,1.075309100000001,1.0762895500000038,1.0752060965176455,1.0750632334246653,1265,-299700,-300595,-0.01091771233805532,-203.39267591767072,0.11541003136545963
2023-06-12T14:45:00-04:00,1.07567,1.07592,1.0754,1.07559,1.0745155296,1.0753102222222222,1.0751711111111097,1.0749919999999973,1.0751300000000028,1.0761626000000009,1.075316600000001,1.0762752000000038,1.0752828772141165,1.075135386739732,-1579,-301279,-300414.6,0.00031446694127984515,-203.51010970312515,0.06698484467889641
2023-06-12T15:00:00-04:00,1.07559,1.0758699999999999,1.07559,1.07581,1.0746278872319999,1.0754380000000001,1.0752777777777767,1.0750822222222194,1.0751295000000027,1.0761800000000008,1.0753244000000008,1.0762636000000037,1.0753883017712933,1.0752115093917853,1563,-299716,-300197.4,0.006754240002231903,-203.1904153958149,0.08931478810995486
2023-06-12T15:15:00-04:00,1.07581,1.07606,1.07574,1.07601,1.07473125625344,1.0755844444444445,1.0753877777777765,1.0751762222222194,1.0751755000000027,1.0762022000000007,1.075336500000001,1.0762528500000037,1.0755126414170346,1.0752960075134281,1682,-298034,-299938.8,0.016701655550324004,-202.8777207750176,0.09209130992910125
2023-06-12T15:30:00-04:00,1.07601,1.07635,1.07601,1.07623,1.074864130628096,1.0757528888888888,1.0755577777777765,1.0752971111111083,1.0752140000000028,1.0762298000000008,1.075351900000001,1.0762434000000036,1.0756561131336277,1.0754092060107423,1448,-296586,-299063,0.02290548961187967,-202.5816640469201,0.142365311249654
2023-06-12T15:45:00-04:00,1.07623,1.07625,1.07595,1.076,1.0750424349527243,1.0758413333333332,1.0756855555555545,1.0754159999999973,1.0752785000000027,1.0762432000000008,1.075362200000001,1.0762343500000038,1.0757248905069021,1.0755129648085937,-1346,-297932,-298709.4,0.03260367010543625,-202.869316314558,0.10699167325673203
2023-06-12T16:00:00-04:00,1.076,1.0760399999999999,1.07578,1.0758699999999999,1.0751993427583975,1.075878222222222,1.0757433333333322,1.0755304444444416,1.0752965000000028,1.0762474000000006,1.0753710000000012,1.0762236000000036,1.0757539124055218,1.0756071718468747,-867,-298799,-298213.4,0.03695069933577827,-202.97406538519013,0.04835634909562969
2023-06-12T16:15:00-04:00,1.0758699999999999,1.07602,1.07578,1.07594,1.0753374216273897,1.0759175555555556,1.0758011111111099,1.0756351111111084,1.0753210000000029,1.0762270000000007,1.0753831000000011,1.0762125000000038,1.0757911299244174,1.0756877374774994,584,-298215,-297913.2,0.04053251568666518,-202.93606822939992,0.048353201539849906
2023-06-12T16:30:00-04:00,1.07594,1.07601,1.07583,1.07592,1.075458931032103,1.0759413333333334,1.0758933333333323,1.0757362222222195,1.0753495000000028,1.0761894000000007,1.075396500000001,1.0762018500000037,1.075816903939534,1.0757485899819994,-644,-298859,-298078.2,0.04310005074801878,-202.94803915714678,0.07720283883210788
2023-06-12T16:45:00-04:00,1.07592,1.07593,1.07564,1.07564,1.0755658593082507,1.0758906666666666,1.075889999999999,1.075802666666664,1.075401500000003,1.0761486000000007,1.0754089000000011,1.0761905500000037,1.0757815231516272,1.0757736719855993,-651,-299510,-298663,0.04692987486440602,-203.11745695772677,-0.002788959439230851
2023-06-12T17:00:00-04:00,1.07564,1.07576,1.07529,1.07548,1.07635,1.0758086666666666,1.0758777777777766,1.0758411111111086,1.0754370000000029,1.0760982000000008,1.075418400000001,1.0761791500000037,1.0757212185213019,1.0757729375884792,-113,-299623,-299001.2,0.04126462184174896,-203.13426555539885,-0.010226945211470401
2023-06-12T17:15:00-04:00,1.07548,1.07561,1.07529,1.07548,1.0763288,1.0757291111111111,1.07584111111111,1.0758606666666641,1.0754895000000029,1.0760538000000008,1.0754245000000011,1.0761691500000037,1.0756729748170415,1.0757567500707832,0,-299623,-299166,0.03709669849162495,-203.13426555539885,-0.030674561493195033
2023-06-12T17:30:00-04:00,1.07548,1.0756999999999999,1.07546,1.0756999999999999,1.076308024,1.0757008888888888,1.0758066666666655,1.0758617777777753,1.075531000000003,1.0760138000000008,1.0754338000000012,1.0761583500000034,1.0756783798536331,1.0757342000566263,260,-299363,-299395.6,0.030448752717285685,-203.08108000104176,-0.028810141169694752
2023-06-12T17:45:00-04:00,1.0756999999999999,1.07582,1.07568,1.07569,1.07628766352,1.0756775555555553,1.0757466666666655,1.0758324444444418,1.0755730000000028,1.0759678000000008,1.075442600000001,1.0761473000000037,1.0756807038829066,1.0757069600453009,-90,-299453,-299514.4,0.02384187589776538,-203.08191666553927,-0.050175148434812716
2023-06-12T18:00:00-04:00,1.07569,1.07598,1.07569,1.07595,1.0762677102496,1.0757182222222221,1.07574111111111,1.075802666666664,1.0756195000000026,1.0759146000000008,1.0754543000000012,1.0761362000000034,1.0757345631063253,1.0756975680362406,309,-299144,-299441.2,0.01636752509509696,-203.0072297204157,-0.0046468401487086905
2023-06-12T18:15:00-04:00,1.07595,1.07603,1.0759,1.07594,1.076248156044608,1.075758,1.0757488888888878,1.0757768888888863,1.0756815000000026,1.0758628000000008,1.0754690000000011,1.0761254500000035,1.0757756504850602,1.075708454428992,-440,-299584,-299433.4,0.011736148710784646,-203.0113191297749,0.00650636229284342
2023-06-12T18:30:00-04:00,1.07594,1.07614,1.0759,1.07609,1.0762289929237159,1.0758262222222221,1.0757655555555545,1.0757617777777753,1.0757435000000026,1.0758208000000007,1.0754846000000011,1.0761154500000034,1.075838520388048,1.0757415635431933,397,-299187,-299346.2,0.007627363243485508,-202.95597217734257,0.01394129784189588
2023-06-12T18:45:00-04:00,1.07609,1.07609,1.07594,1.07599,1.0762102130652416,1.075871111111111,1.0757733333333321,1.0757551111111083,1.0757755000000027,1.0757806000000008,1.0754994000000013,1.0761045000000036,1.0758688163104384,1.0757796508345545,-544,-299731,-299419.8,0.0030454794553645683,-203.0065255697168,0.006506059930107675
2023-06-12T19:00:00-04:00,1.07599,1.07626,1.07593,1.07623,1.07529,1.0759624444444444,1.075838888888888,1.075773555555553,1.0758160000000028,1.0757526000000008,1.0755148000000012,1.0760956500000036,1.0759410530483506,1.0758317206676433,730,-299001,-299329.4,0.0020317160169784805,-202.84369877764624,0.05485106541222812
2023-06-12T19:15:00-04:00,1.07623,1.07642,1.07614,1.07615,1.0753094,1.0760246666666666,1.0759133333333322,1.0758079999999972,1.0758690000000026,1.0757304000000008,1.0755292000000012,1.0760851500000037,1.0759828424386806,1.0758813765341144,-730,-299731,-299446.8,0.0035410028212578726,-202.89796227150913,0.06229776471900439
2023-06-12T19:30:00-04:00,1.07615,1.07639,1.07615,1.07633,1.075353824,1.0761079999999998,1.0760077777777766,1.0758597777777752,1.0759020000000026,1.0757106000000007,1.0755489000000014,1.0760748500000037,1.0760522739509444,1.0759367012272911,541,-299190,-299368,0.005952984260215519,-202.80747302744462,0.07903447762859536
2023-06-12T19:45:00-04:00,1.07633,1.07637,1.0762,1.07622,1.07539647104,1.0761504444444445,1.0760655555555543,1.075919777777775,1.0759335000000028,1.0756990000000008,1.0755662000000012,1.0760649500000037,1.0760858191607554,1.0759861609818326,-569,-299759,-299482.4,0.010396445823354535,-202.86562433791633,0.048340615413226366
2023-06-12T20:00:00-04:00,1.07622,1.07669,1.0762,1.07666,1.0754374121983998,1.0762693333333333,1.0761733333333323,1.0759997777777752,1.0759760000000027,1.075698400000001,1.0755863000000012,1.0760566000000038,1.0762006553286043,1.0760525287854656,971,-298788,-299293.8,0.014582659337542445,-202.4686423082198,0.09017467857839297
2023-06-12T20:15:00-04:00,1.07666,1.07667,1.0764,1.07651,1.0755125674664958,1.0763366666666665,1.0762355555555547,1.0760791111111083,1.0760010000000029,1.0757030000000007,1.0756034000000012,1.0760477000000037,1.0762625242628834,1.0761168230283722,-946,-299734,-299440.4,0.019105125989331614,-202.60043878993167,0.05204702820764125
2023-06-12T20:30:00-04:00,1.07651,1.07654,1.07624,1.0763,1.0755832134185062,1.0763495555555556,1.0762755555555548,1.076151555555553,1.076004500000003,1.0756926000000007,1.0756174000000014,1.0760379000000038,1.0762700194103068,1.0761742584226972,-1004,-300738,-299641.8,0.021074228016290924,-202.79629391436157,0.033459114820541855
2023-06-12T20:45:00-04:00,1.0763,1.07634,1.07595,1.0760399999999999,1.0756496206133959,1.0763024444444442,1.076269999999999,1.0762039999999975,1.0760065000000028,1.0756844000000008,1.0756278000000012,1.0760261000000038,1.0762240155282454,1.0762086067381573,-1471,-302209,-300245.6,0.022844619853423464,-203.15164093656747,-0.004646451504995448
2023-06-12T21:00:00-04:00,1.0760399999999999,1.07636,1.07599,1.07632,1.075712043376592,1.0763124444444445,1.0763066666666659,1.07625222222222,1.0760290000000028,1.0756828000000007,1.0756446000000013,1.0760157000000037,1.0762432124225962,1.0762400853905256,1037,-301172,-300528.2,0.023565648586783214,-202.88179966672615,0.030669430013284645
2023-06-12T21:15:00-04:00,1.07632,1.07657,1.07591,1.07647,1.0757707207739966,1.076345111111111,1.0763333333333323,1.0762842222222198,1.076055500000003,1.0756800000000009,1.0756635000000012,1.0760067000000035,1.076288569938077,1.07625766831242,2288,-298884,-300547.4,0.025370568282532088,-202.5629353884444,0.022300065971030167
2023-06-12T21:30:00-04:00,1.07647,1.07683,1.07638,1.07651,1.0758258775275569,1.0763804444444447,1.0763733333333323,1.076311777777775,1.0760850000000026,1.0756742000000008,1.0756817000000012,1.0759968000000038,1.0763328559504617,1.0762717346499358,1965,-296919,-299984.4,0.025449582744057866,-202.489918955102,0.03345258560610863
2023-06-12T21:45:00-04:00,1.07651,1.07683,1.07651,1.07676,1.0759062073253522,1.076457777777778,1.0764211111111102,1.0763408888888863,1.076141000000003,1.0756764000000008,1.0757041000000012,1.0759896500000037,1.0764182847603694,1.0763013877199483,1411,-295508,-298938.4,0.027400097175156148,-202.1622396952718,0.039950572779717225
2023-06-12T22:00:00-04:00,1.07676,1.07689,1.07659,1.07664,1.075980110739324,1.0765015555555555,1.0764677777777767,1.0763804444444418,1.076199000000003,1.075695400000001,1.0757269000000012,1.0759808500000037,1.0764626278082956,1.0763491101759584,-1586,-297094,-297915.4,0.025854600066066342,-202.33899217493286,0.039025478062114344
2023-06-12T22:15:00-04:00,1.07664,1.0773,1.07661,1.07714,1.0760710996653917,1.0766360000000001,1.0765211111111102,1.0764233333333306,1.0762820000000028,1.075732400000001,1.0757561000000013,1.0759748500000037,1.0765981022466364,1.0764200881407664,1207,-295887,-296858.4,0.027056181286977614,-201.77845197579487,0.04458231939516988
2023-06-12T22:30:00-04:00,1.07714,1.07732,1.07697,1.07725,1.0762185677055447,1.0767817777777777,1.0766033333333322,1.0764773333333306,1.0763595000000028,1.0757610000000009,1.0757858000000011,1.0759696000000036,1.076728481797309,1.0765080705126127,882,-295005,-296082.6,0.024704805447830228,-201.68838011884029,0.06874065266462577
2023-06-12T22:45:00-04:00,1.07725,1.07756,1.07723,1.07744,1.0763727682267685,1.0769491111111111,1.0767299999999989,1.076548666666664,1.0764470000000028,1.0758080000000008,1.0758234000000013,1.0759659000000037,1.0768707854378472,1.07661565641009,1124,-293881,-295475,0.02564518861884284,-201.4901345862342,0.10591842423115477
2023-06-12T23:00:00-04:00,1.07744,1.07782,1.07741,1.07781,1.0765627253104855,1.0771651111111111,1.0769266666666657,1.0766497777777748,1.0765400000000027,1.075855000000001,1.0758652000000013,1.0759638500000035,1.0770586283502777,1.0767437251280714,1084,-292797,-294932.8,0.030291837615284038,-201.11788183898148,0.1644920263187288
2023-06-12T23:15:00-04:00,1.07781,1.0779,1.07771,1.0778,1.076789034754598,1.0773397777777778,1.07709111111111,1.0767744444444416,1.0766330000000028,1.075916800000001,1.075906900000001,1.0759618000000035,1.0772069026802222,1.076892580102457,-1089,-293886,-294291.2,0.03845439346129995,-201.12798566061963,0.13750557455033335
2023-06-12T23:30:00-04:00,1.0778,1.07799,1.07774,1.07791,1.0770112278036785,1.0775035555555554,1.07725111111111,1.0769204444444416,1.0767240000000027,1.0759648000000008,1.075951200000001,1.0759608500000035,1.0773475221441777,1.0770424640819651,1565,-292321,-293578,0.044505733380843446,-200.96826214976443,0.13377056490193742
2023-06-12T23:45:00-04:00,1.07791,1.07802,1.07785,1.07789,1.0772069822429429,1.0776313333333332,1.0774044444444433,1.077080666666664,1.0768190000000029,1.076013600000001,1.0759916000000012,1.0759599500000037,1.0774560177153423,1.0771879712655719,-1067,-293388,-293254.6,0.04972941801366384,-200.98805972099012,0.1281920279421405
2023-06-13T00:00:00-04:00,1.07789,1.0779,1.07767,1.07768,1.0773695857943544,1.0776864444444443,1.0775066666666655,1.0772359999999972,1.0768915000000028,1.076060200000001,1.0760298000000013,1.0759592000000036,1.0775008141722737,1.0773139770124573,-869,-294257,-293329.8,0.053117396876496095,-201.1573627110912,0.08544150971433113
2023-06-13T00:15:00-04:00,1.07768,1.07783,1.07759,1.07779,1.0774996686354834,1.077743111111111,1.0776344444444432,1.0773775555555527,1.0769735000000027,1.076124000000001,1.076070200000001,1.0759592500000037,1.077558651337819,1.0774139816099655,914,-293343,-293439,0.05578003167761326,-201.06406971131386,0.10681379105364693
2023-06-13T00:30:00-04:00,1.07779,1.07826,1.07779,1.07826,1.07759,1.0778682222222222,1.0777588888888878,1.0775111111111084,1.0770700000000029,1.0761938000000009,1.0761133000000012,1.0759620500000038,1.0776989210702552,1.077512385287972,880,-292463,-293154.4,0.06148716073666416,-200.6803214857783,0.10397905564736337
2023-06-13T00:45:00-04:00,1.07826,1.0783099999999999,1.0781,1.0782,1.07759,1.0779564444444445,1.0778644444444432,1.077633777777775,1.077169000000003,1.076269200000001,1.076154500000001,1.0759646500000037,1.077799136856204,1.0776027082303772,-706,-293169,-293324,0.06305593379234457,-200.7196070013311,0.088187514504526
2023-06-13T01:00:00-04:00,1.0782,1.07895,1.07812,1.07889,1.077734,1.0781615555555555,1.0780255555555545,1.077757999999997,1.0772805000000027,1.076349600000001,1.076201000000001,1.0759695000000038,1.0780173094849632,1.0777149665843013,1591,-291578,-292962,0.06646989890973269,-199.70143783049102,0.13457825957825506
2023-06-13T01:15:00-04:00,1.07889,1.07942,1.07883,1.07939,1.0779772,1.0784344444444445,1.07820111111111,1.0778968888888862,1.077424500000003,1.076440400000001,1.076252900000001,1.0759766500000039,1.0782918475879706,1.0778731732674407,2197,-289381,-291986.8,0.07249502762471191,-198.68326174210353,0.14659355545041677
2023-06-13T01:30:00-04:00,1.07939,1.0796,1.07918,1.07949,1.07812,1.0786922222222222,1.0783888888888877,1.0780477777777748,1.077584000000003,1.076529800000001,1.076307300000001,1.0759847000000038,1.0785314780703765,1.0780677386139523,2260,-287121,-290742.4,0.07490726083411656,-198.4738842233198,0.1568008907032816
2023-06-13T01:45:00-04:00,1.07949,1.07949,1.07824,1.07825,1.0796,1.0786644444444444,1.0784266666666658,1.0781813333333305,1.0776945000000029,1.0766008000000011,1.076348800000001,1.0759871000000039,1.0784751824563013,1.0782229908911616,-2620,-289741,-290198,0.07045978489588407,-201.48345355698694,0.03154252210295915
2023-06-13T02:00:00-04:00,1.07825,1.07952,1.07812,1.07941,1.0796,1.078861111111111,1.0785955555555544,1.078327555555553,1.077849000000003,1.0766920000000009,1.076399100000001,1.0759956000000037,1.078662145965041,1.0783955927129287,3830,-285911,-288746.4,0.06947727463557248,-197.36307331121816,0.14101624470029092
2023-06-13T02:15:00-04:00,1.07941,1.07973,1.07912,1.07941,1.07812,1.079024,1.0787877777777766,1.0784799999999972,1.077996000000003,1.076773200000001,1.076448900000001,1.0760045000000038,1.0788117167720328,1.0785544741703426,0,-285911,-287613,0.06991839246492319,-197.36307331121816,0.16053002746641018
2023-06-13T02:30:00-04:00,1.07941,1.07979,1.07929,1.07948,1.07812,1.0791624444444443,1.0789755555555542,1.0786348888888861,1.078144500000003,1.076854400000001,1.076498400000001,1.0760138500000038,1.0789453734176262,1.0786851793362737,3020,-282891,-286315,0.07331024673841037,-197.16722557958695,0.15680234554040853
2023-06-13T02:45:00-04:00,1.07948,1.07954,1.07912,1.0792599999999999,1.0781868,1.0792193333333333,1.0790866666666656,1.0787744444444418,1.078269500000003,1.076937800000001,1.0765418000000009,1.076022600000004,1.079008298734101,1.0787805434690185,-2532,-285423,-285975.4,0.07478971740797946,-197.68325181444104,0.09274201027580453
2023-06-13T03:00:00-04:00,1.0792599999999999,1.07982,1.07925,1.07943,1.0782509279999999,1.0792879999999998,1.079223333333332,1.078933777777775,1.078409000000003,1.0770130000000009,1.0765847000000008,1.0760304000000038,1.0790926389872808,1.0789040347752146,3792,-281631,-284353.4,0.07384028665315523,-197.0859536657095,0.11407902058985737
2023-06-13T03:15:00-04:00,1.07943,1.08041,1.07925,1.07965,1.0783450723199999,1.0793733333333333,1.0793077777777766,1.0790762222222194,1.078534500000003,1.077094200000001,1.0766284000000008,1.0760399500000037,1.0792041111898247,1.0790124278201714,3494,-278137,-282798.6,0.07398501313413215,-196.37383708566227,0.07044276988387083
2023-06-13T03:30:00-04:00,1.07965,1.08076,1.07957,1.08001,1.0785102665344,1.0795137777777777,1.0793766666666653,1.079193999999997,1.078672500000003,1.077178200000001,1.0766791000000009,1.0760490000000038,1.0793652889518597,1.0791231422561367,4084,-274053,-280427,0.07168873368191178,-195.01206243647073,0.05743985028579502
2023-06-13T03:45:00-04:00,1.08001,1.08032,1.07965,1.07996,1.07873523988096,1.0796304444444442,1.0794288888888874,1.0792846666666638,1.0787985000000029,1.077257200000001,1.076729700000001,1.0760598500000038,1.0794842311614878,1.0792309138049088,-3279,-277332,-279315.2,0.06500125146760602,-195.16386658643194,0.04353907863898419
2023-06-13T04:00:00-04:00,1.07996,1.08011,1.0794,1.0801,1.078937715892864,1.0797646666666667,1.079634444444443,1.0793942222222195,1.0789130000000031,1.077334600000001,1.076782200000001,1.076073200000004,1.0796073849291903,1.0793507310439268,3107,-274225,-277075.6,0.05890695076456876,-194.76109240961048,0.17157431022491346
2023-06-13T04:15:00-04:00,1.0801,1.0803099999999999,1.07969,1.0802,1.0791199443035775,1.0798777777777777,1.079722222222221,1.0794939999999973,1.079033000000003,1.077418600000001,1.076830900000001,1.0760859500000037,1.0797259079433523,1.079477384835141,2664,-271561,-275061.6,0.06642552053444384,-194.51444858033545,0.07318813055280833
2023-06-13T04:30:00-04:00,1.0802,1.08044,1.07989,1.08034,1.0792839498732198,1.0800013333333334,1.079825555555554,1.0795975555555526,1.079154500000003,1.077508000000001,1.076877700000001,1.0760981500000038,1.0798487263546819,1.0796063078681126,2612,-268949,-273224,0.06382772163668841,-194.17591867846537,0.08615817900520631
2023-06-13T04:45:00-04:00,1.08034,1.08082,1.0801,1.08074,1.079431554885898,1.0801842222222222,1.079965555555554,1.0797153333333305,1.0792970000000028,1.0776040000000011,1.076915500000001,1.0761125000000038,1.0800269810837455,1.0797386462944898,2592,-266357,-271684.8,0.06365649583537346,-193.2162208055736,0.11672286656538694
2023-06-13T05:00:00-04:00,1.08074,1.08105,1.08009,1.08074,1.07959816829959,1.0803391111111114,1.0801299999999987,1.0798555555555525,1.079450000000003,1.077700400000001,1.0769449000000009,1.0761296000000038,1.0801695848669963,1.0798757170355917,0,-266357,-269489.8,0.06274849250128786,-193.2162208055736,0.1371309971647377
2023-06-13T05:15:00-04:00,1.08074,1.08084,1.0803099999999999,1.0804,1.0798014247376475,1.0803931111111114,1.0802377777777765,1.0799762222222191,1.0795805000000027,1.077795600000001,1.076972100000001,1.0761451500000039,1.080215667893597,1.079997373628473,-2213,-268570,-268358.8,0.061302901709308494,-193.9124289592461,0.08986224210927411
2023-06-13T05:30:00-04:00,1.0804,1.08075,1.08015,1.08018,1.079976225274377,1.0803815555555556,1.0802966666666654,1.080091111111108,1.0796765000000028,1.0778896000000011,1.0769939000000008,1.0761613000000037,1.0802085343148775,1.0800938989027782,-2518,-271088,-268264.2,0.057701663609666325,-194.42516498294128,0.04908998286480984
2023-06-13T05:45:00-04:00,1.08018,1.08098,1.08005,1.08057,1.08105,1.0804362222222221,1.0803588888888875,1.080197777777775,1.079795000000003,1.077991400000001,1.077022600000001,1.0761764500000037,1.080280827451902,1.080180319122222,2246,-268842,-268242.8,0.05602868471113924,-193.61424458078585,0.05185137174656864
2023-06-13T06:00:00-04:00,1.08057,1.08069,1.08025,1.08034,1.0810300000000002,1.0804324444444442,1.08040111111111,1.080284888888886,1.0798675000000029,1.078084200000001,1.0770490000000008,1.0761949000000037,1.0802926619615216,1.0802334552977775,-2077,-270919,-269155.2,0.049642268736327835,-194.05633532918708,0.03518648838846318
2023-06-13T06:15:00-04:00,1.08034,1.08039,1.07975,1.07992,1.0810104000000003,1.0803362222222221,1.08038111111111,1.0803351111111081,1.0798940000000028,1.078168800000001,1.0770683000000008,1.0762123500000036,1.0802181295692173,1.0802431642382215,-3031,-273950,-270673.8,0.04472760610112607,-195.2346865889759,-0.016665123599673086
2023-06-13T06:30:00-04:00,1.07992,1.08017,1.07951,1.07973,1.0809599840000002,1.080206,1.0803288888888876,1.0803533333333304,1.079906000000003,1.078244400000001,1.0770795000000009,1.0762292000000035,1.0801205036553738,1.0802241313905772,-1871,-275821,-272124,0.039801372367234654,-195.56386838021956,-0.043510461025733235
2023-06-13T06:45:00-04:00,1.07973,1.07993,1.0796,1.07985,1.08087298496,1.0801102222222223,1.0802744444444432,1.080348888888886,1.079986000000003,1.078322600000001,1.0770927000000008,1.0762467500000037,1.080066402924299,1.0801957051124613,1861,-273960,-272698.4,0.03497226603658407,-195.35703889507067,-0.04535609160080173
2023-06-13T07:00:00-04:00,1.07985,1.07989,1.07941,1.0796,1.0807912058624,1.0799753333333335,1.0801477777777764,1.0803066666666639,1.079995500000003,1.0783928000000012,1.0771068000000008,1.0762632500000038,1.079973122339439,1.0801341640899689,-2281,-276241,-274178.2,0.02216556757471781,-195.88512149913623,-0.10548327997484509
2023-06-13T07:15:00-04:00,1.0796,1.07973,1.0793,1.07964,1.080680709393408,1.0798737777777778,1.080025555555554,1.0802315555555526,1.0800070000000028,1.0784658000000011,1.0771232000000008,1.0762799500000038,1.0799064978715514,1.0800569312719746,2019,-274222,-274838.8,0.010965826041918092,-195.81031601562375,-0.10178211225642624
2023-06-13T07:30:00-04:00,1.07964,1.07979,1.07943,1.07947,1.0805426384540673,1.0797626666666664,1.079922222222221,1.0801397777777748,1.0800065000000028,1.0785306000000012,1.0771416000000007,1.0762962000000038,1.0798191982972412,1.0799771450175795,-1884,-276106,-275270,-0.0010582192547004914,-196.10697045599278,-0.08607922991485537
2023-06-13T07:45:00-04:00,1.07947,1.07956,1.07918,1.07942,1.0804183746086606,1.0796622222222223,1.0798377777777766,1.0800415555555527,1.080014500000003,1.0785960000000012,1.0771632000000009,1.0763139500000036,1.079739358637793,1.0799009160140634,-2366,-278472,-275800.2,-0.009867920659418477,-196.21656127370863,-0.07035864392970356
2023-06-13T08:00:00-04:00,1.07942,1.0795299999999999,1.07906,1.07943,1.0802697696556214,1.0795806666666667,1.0797111111111097,1.0799288888888858,1.0800145000000028,1.078658000000001,1.0771843000000008,1.0763316000000038,1.0796774869102344,1.0798231328112504,2758,-275714,-276151,-0.017561945208797062,-196.19101051496824,-0.10549987506595046
2023-06-13T08:15:00-04:00,1.07943,1.07966,1.07895,1.07905,1.0801004019038343,1.0794484444444443,1.0795677777777763,1.0798128888888858,1.0799845000000028,1.078714600000001,1.0772068000000008,1.0763463500000037,1.0795519895281875,1.0797389062490002,-4138,-279852,-276873.2,-0.029961189346388785,-197.6477423085994,-0.11940685339800557
2023-06-13T08:30:00-04:00,1.07905,1.08235,1.07813,1.08144,1.07813,1.079822888888889,1.0797366666666652,1.0797551111111081,1.0800560000000028,1.078810200000001,1.0772543000000008,1.0763735000000039,1.07992959162255,1.0797435249991998,20811,-259041,-273837,-0.027666170071375996,-151.55322398229592,0.14075116675308966
2023-06-13T08:45:00-04:00,1.08144,1.08176,1.08068,1.08141,1.07813,1.0801575555555554,1.079923333333332,1.0797553333333303,1.0801285000000027,1.078908200000001,1.0773056000000008,1.0763999500000039,1.08022567329804,1.0798248199993596,-8208,-267249,-272065.6,-0.020041856000678402,-151.78092038708934,0.1555944541690889
2023-06-13T09:00:00-04:00,1.08141,1.0818,1.08006,1.08011,1.07813,1.0801948888888888,1.0799522222222206,1.0797782222222192,1.0801290000000026,1.078984400000001,1.0773385000000006,1.0764171500000037,1.080202538638432,1.0799174559994873,-7456,-274705,-271312.2,-0.017184918183880224,-160.7440333599679,0.024077418159922856
2023-06-13T09:15:00-04:00,1.08011,1.08061,1.07921,1.0803099999999999,1.0782144,1.0802664444444445,1.0800311111111098,1.0798422222222193,1.0801345000000027,1.079069800000001,1.0773771000000008,1.0764345500000039,1.0802240309107456,1.0800267647995896,6393,-268312,-269831.8,-0.013851850447203209,-159.56026504007468,0.06576509818451172
2023-06-13T09:30:00-04:00,1.0803099999999999,1.08151,1.07972,1.07985,1.078297112,1.0802302222222222,1.080054444444443,1.0799395555555527,1.0801100000000026,1.0791404000000009,1.0774116000000007,1.0764462500000038,1.0801492247285964,1.0801462118396714,-8191,-276503,-269162,-0.00999447151821271,-163.0480231835698,0.019450928087144187
2023-06-13T09:45:00-04:00,1.07985,1.07994,1.0793,1.07941,1.07837816976,1.0801013333333331,1.0800477777777764,1.0800017777777746,1.0800435000000026,1.079199200000001,1.0774396000000008,1.076456750000004,1.0800013797828771,1.0801605694717369,-6894,-283397,-274033.2,-0.008024121744044356,-165.8570799970161,-0.005558283231581145
2023-06-13T10:00:00-04:00,1.07941,1.07944,1.07781,1.07815,1.08235,1.0797217777777777,1.0799066666666652,1.0799984444444415,1.0799140000000025,1.0792320000000009,1.0774531000000007,1.076458250000004,1.0796311038263018,1.0800416555773893,-7342,-290739,-278731.2,-0.008827541930413225,-174.4274286133901,-0.117655778103065
2023-06-13T10:15:00-04:00,1.07815,1.07973,1.0781,1.07945,1.0822592,1.0796304444444442,1.0799088888888875,1.0799897777777747,1.0798665000000027,1.079285800000001,1.0774811000000009,1.076467750000004,1.0795948830610413,1.0799201244619112,6004,-284735,-280737.2,-0.002861838464035835,-167.18799068731258,0.0018528297342237131
2023-06-13T10:30:00-04:00,1.07945,1.07996,1.07904,1.07996,1.082170216,1.0796406666666665,1.0800099999999988,1.0799855555555524,1.0798555000000025,1.079352200000001,1.0775238000000007,1.076481300000004,1.079667906448833,1.0798088995695285,4630,-280105,-283095.8,0.003986366978122399,-165.00048779231972,0.08433344145312695
2023-06-13T10:45:00-04:00,1.07996,1.08078,1.07978,1.08018,1.08208301168,1.0796746666666668,1.0798699999999988,1.0799486666666636,1.0798360000000025,1.079413000000001,1.0775727000000006,1.0764987500000038,1.0797703251590665,1.0797331196556228,5406,-274699,-282735,0.014450580294619325,-163.89922478257918,-0.11651131824234714
2023-06-13T11:00:00-04:00,1.08018,1.08088,1.07985,1.08066,1.0819975514464,1.0798326666666667,1.0797866666666656,1.0798964444444414,1.0798520000000025,1.0794812000000011,1.0776211000000009,1.076517850000004,1.0799482601272532,1.0797224957244977,4640,-270059,-280067.4,0.006830595069136226,-161.8373462067861,-0.06935389907620869
2023-06-13T11:15:00-04:00,1.08066,1.08074,1.07924,1.07944,1.081913800417472,1.0797633333333332,1.0797122222222209,1.0798575555555525,1.0798280000000025,1.0795212000000012,1.0776646000000007,1.076530850000004,1.0798466081018026,1.079765596579598,-4293,-274352,-276790,-0.007443836079977465,-166.68388443342536,-0.0620307190934209
2023-06-13T11:30:00-04:00,1.07944,1.07948,1.07859,1.07879,1.0818317244091225,1.0795788888888886,1.079543333333332,1.0797844444444415,1.0797810000000025,1.079540800000001,1.0776979000000007,1.076538950000004,1.079635286481442,1.0797736772636781,-4542,-278894,-275621.8,-0.014685550608532631,-169.41891370786414,-0.14070035452786386
2023-06-13T11:45:00-04:00,1.07879,1.07948,1.07879,1.07912,1.08175128992094,1.0794942222222221,1.079462222222221,1.0796748888888859,1.0797445000000025,1.0795672000000012,1.0777420000000006,1.076549100000004,1.0795322291851537,1.0797465418109424,3101,-275793,-274759.4,-0.023016801956321543,-168.47032315733946,-0.06760198175671597
2023-06-13T12:00:00-04:00,1.07912,1.07973,1.07901,1.07956,1.0816724641225213,1.0795137777777777,1.0794788888888878,1.0795966666666637,1.0797425000000025,1.0796002000000013,1.0777825000000008,1.076562150000004,1.079537783348123,1.0797000334487534,3484,-272309,-274281.4,-0.024423966181807196,-167.0497582526023,0.013896480484717994
2023-06-13T12:15:00-04:00,1.07956,1.07986,1.07947,1.07964,1.081595214840071,1.0795460000000001,1.079644444444443,1.0795682222222192,1.0797425000000025,1.0796352000000011,1.0778244000000006,1.076575850000004,1.0795582266784984,1.0796220267590027,2191,-270118,-274293.2,-0.022470185657586177,-166.88739580864393,0.1381996939201402
2023-06-13T12:30:00-04:00,1.07964,1.08004,1.0795299999999999,1.07958,1.0815195105432696,1.079533111111111,1.0796588888888876,1.0795575555555526,1.0797480000000026,1.0796732000000013,1.0778667000000006,1.0765943000000042,1.0795625813427987,1.079565221407202,-2244,-272362,-273895.2,-0.008961636521445797,-167.01210404472252,0.012043170132934686
2023-06-13T12:45:00-04:00,1.07958,1.08035,1.0795,1.08023,1.0814453203324041,1.0796473333333334,1.0796888888888876,1.0795866666666636,1.0797885000000025,1.0797220000000012,1.0779230000000006,1.0766171500000041,1.0796960650742389,1.0795773771257613,2094,-270268,-272170,-0.0050892627577108366,-165.75133596824827,0.02500092596022005
2023-06-13T13:00:00-04:00,1.08023,1.08044,1.07972,1.07979,1.081372613925756,1.0796675555555557,1.0796455555555542,1.07962333333333,1.0798065000000023,1.0797526000000013,1.0779732000000006,1.0766372500000043,1.079714852059391,1.0796139017006088,-2529,-272797,-271570.8,-0.008295274735926575,-166.7814499254611,-0.036105093595501715
2023-06-13T13:15:00-04:00,1.07979,1.08,1.07962,1.07968,1.0813013616472409,1.0796744444444444,1.0795366666666655,1.0796348888888858,1.0798380000000025,1.0797822000000012,1.0780257000000006,1.0766587500000042,1.079707881647513,1.0796479213604866,-1730,-274527,-272014.4,-0.01402816481488891,-166.95768789765947,-0.0906853219328911
2023-06-13T13:30:00-04:00,1.07968,1.07969,1.0789199999999999,1.07893,1.081231534414296,1.0795531111111112,1.0794799999999987,1.0796019999999968,1.0797125000000025,1.0797830000000013,1.0780663000000006,1.0766785500000042,1.0795523053180103,1.0796467370883889,-1924,-276451,-273281,-0.029520601136761426,-168.29419501087824,-0.04724672052175299
2023-06-13T13:45:00-04:00,1.07893,1.07899,1.07867,1.07889,1.08116310372601,1.0794351111111111,1.0794911111111096,1.079568444444441,1.0795865000000024,1.0797730000000012,1.0781067000000009,1.0766990000000043,1.0794198442544083,1.0796181896707107,-2115,-278566,-274521.8,-0.02337126661730728,-168.37260602920202,0.00926964469451784
2023-06-13T14:00:00-04:00,1.07889,1.07907,1.07873,1.07879,1.0810960416514899,1.079294888888889,1.0794544444444432,1.0795215555555524,1.0795205000000023,1.079759000000001,1.0781444000000007,1.0767181500000043,1.0792938754035266,1.0795377517365685,-2082,-280648,-276597.8,-0.011817108738194656,-168.56558214354175,-0.03058047297799721
2023-06-13T14:15:00-04:00,1.07879,1.07898,1.07856,1.07859,1.0810303208184602,1.0791220000000001,1.0793466666666651,1.0794617777777744,1.0794345000000025,1.0797658000000012,1.0781833000000007,1.0767363000000043,1.0791531003228212,1.0794254013892544,-1861,-282509,-278540.2,-0.010022497683682116,-168.9105983190717,-0.08985142094928836
2023-06-13T14:30:00-04:00,1.07859,1.07862,1.07829,1.0784799999999999,1.0809659144020909,1.0789486666666666,1.0792177777777763,1.0793979999999965,1.0793660000000025,1.0797472000000012,1.0782196000000008,1.0767553500000042,1.079018480258257,1.0792875211114032,-2285,-284794,-280593.6,-0.011955616867530616,-169.14363404163555,-0.10744322181468359
2023-06-13T14:45:00-04:00,1.0784799999999999,1.07904,1.07834,1.079,1.0809027961140492,1.0789051111111112,1.0791533333333319,1.0793326666666634,1.0793455000000025,1.0797390000000013,1.0782561000000008,1.0767762500000042,1.0790147842066056,1.0791800168891226,2360,-282434,-281790.2,-0.014135510307420631,-168.00573625957173,-0.05372459660238472
2023-06-13T15:00:00-04:00,1.079,1.07904,1.07849,1.07866,1.0808409401917682,1.0788064444444445,1.0789788888888876,1.079230222222219,1.0793710000000025,1.079722600000001,1.0782885000000006,1.0767946500000043,1.0789438273652845,1.0790848135112976,-2146,-284580,-282993,-0.019350936243434258,-168.68195498060976,-0.145339418457187
2023-06-13T15:15:00-04:00,1.07866,1.07888,1.07846,1.07882,1.0807803213879328,1.0787746666666667,1.0788711111111098,1.0791135555555524,1.0793395000000026,1.0797138000000013,1.078325800000001,1.0768140000000042,1.0789190618922275,1.0790098508090378,1774,-282806,-283424.6,-0.03536978343082739,-168.41881367565742,-0.08983228220303369
2023-06-13T15:30:00-04:00,1.07882,1.07937,1.07881,1.07922,1.0807209149601742,1.0788444444444445,1.0788199999999986,1.079008222222219,1.0793025000000025,1.0797096000000013,1.0783613000000007,1.0768352000000043,1.078979249513782,1.0789750806472298,1645,-281161,-283155,-0.03963644240830585,-167.80888801614026,-0.04260521636039428
2023-06-13T15:45:00-04:00,1.07922,1.07957,1.07915,1.07915,1.0806626966609707,1.0789104444444444,1.0788444444444432,1.0789335555555524,1.0792510000000024,1.0796996000000012,1.0783969000000007,1.0768567500000044,1.0790133996110256,1.0789740645177834,-1711,-282872,-282770.6,-0.04097471012792545,-167.91986631528226,0.020390572140927495
2023-06-13T16:00:00-04:00,1.07915,1.07931,1.07906,1.0793,1.0806056427277513,1.0790015555555557,1.0788899999999986,1.0788808888888854,1.0791830000000024,1.0796854000000011,1.0784318000000006,1.0768781000000043,1.0790707196888205,1.0789852516142264,1058,-281814,-282646.6,-0.03366525004904079,-167.77280612902467,0.0380020205952434
2023-06-13T16:15:00-04:00,1.0793,1.07931,1.07914,1.07916,1.0805497298731963,1.0790555555555554,1.0789311111111097,1.0788713333333302,1.0791690000000025,1.0796694000000011,1.0784633000000006,1.0768999000000044,1.0790885757510564,1.0790142012913808,-425,-282239,-282178.4,-0.024546812796978817,-167.82793445293834,0.03429768536971806
2023-06-13T16:30:00-04:00,1.07916,1.07918,1.07903,1.07918,1.0804949352757325,1.0791053333333334,1.0789966666666653,1.078896444444441,1.0791885000000025,1.0796510000000012,1.0784928000000007,1.0769223500000042,1.0791068606008452,1.0790517610331043,403,-281836,-281984.4,-0.019785937687160384,-167.82046568093043,0.05470104488267928
2023-06-13T16:45:00-04:00,1.07918,1.07932,1.07917,1.07929,1.0804412365702178,1.079164,1.0790866666666654,1.0789497777777746,1.0791970000000024,1.0796328000000013,1.0785257000000008,1.0769439500000042,1.079143488480676,1.0790846088264832,588,-281248,-282001.8,-0.01550540836018162,-167.76053128629744,0.0751057043246235
2023-06-13T17:00:00-04:00,1.07929,1.07943,1.0790899999999999,1.0791,1.0803886118388135,1.0791666666666666,1.0790977777777764,1.0790004444444412,1.0791740000000025,1.0796080000000012,1.0785580000000006,1.0769645000000043,1.0791347907845408,1.0791088870611862,-194,-281442,-281715.8,-0.009672135776618577,-167.7946833677584,0.009267840593140777
2023-06-13T17:15:00-04:00,1.0791,1.07911,1.0788,1.07898,1.0803370396020373,1.0791431111111112,1.0791333333333322,1.0790491111111078,1.0791410000000026,1.0795728000000013,1.0785884000000006,1.0769857500000044,1.0791038326276325,1.0791155096489486,-209,-281651,-281683.2,-0.0072984133228142225,-167.81792495797245,0.02966643798788293
2023-06-13T17:30:00-04:00,1.07898,1.07913,1.07881,1.07895,1.0802864988099965,1.0791064444444443,1.0791477777777765,1.079092444444441,1.0791095000000026,1.0795370000000013,1.0786187000000007,1.0770076000000044,1.079073066102106,1.0791124077191587,-517,-282168,-281669,-0.001566514883484677,-167.83229964517702,0.012050202999590805
2023-06-13T17:45:00-04:00,1.07895,1.07915,1.07888,1.0789,1.0802369688337965,1.0790568888888887,1.079112222222221,1.079115555555552,1.0790430000000024,1.0795070000000013,1.0786513000000006,1.0770301000000044,1.0790384528816848,1.0790987261753267,-227,-282395,-281780.8,0.002175535246013767,-167.8428191317149,-0.029651044272724556
2023-06-13T18:00:00-04:00,1.0789,1.07921,1.07886,1.07899,1.0801884294571205,1.0790324444444446,1.0790944444444432,1.0791171111111078,1.0790030000000024,1.0794832000000012,1.0786864000000005,1.0770524000000044,1.0790287623053478,1.079075780940261,785,-281610,-281853.2,0.005516364848305701,-167.77733576903074,-0.014826483806714544
2023-06-13T18:15:00-04:00,1.07899,1.07912,1.0788,1.07891,1.0801408608679781,1.0789955555555555,1.07905111111111,1.0791077777777744,1.0789645000000025,1.0794500000000014,1.0787207000000005,1.0770726000000044,1.0790050098442783,1.0790498247522085,-986,-282596,-282084,0.007175966074742405,-167.85044117315854,-0.036134531640868196
2023-06-13T18:30:00-04:00,1.07891,1.0792,1.07891,1.07915,1.0800942436506185,1.0790153333333332,1.079049999999999,1.079091111111108,1.0789755000000025,1.0794262000000012,1.0787552000000005,1.0770945000000043,1.0790340078754226,1.0790358598017664,409,-282187,-282191.2,0.008125007723745059,-167.75946046114365,-0.000926646651084498
2023-06-13T18:45:00-04:00,1.07915,1.0792,1.07914,1.07914,1.080048558777606,1.0790333333333333,1.0790455555555545,1.0790706666666634,1.0789880000000023,1.0794106000000014,1.0787897000000006,1.0771161500000044,1.079055206300338,1.079032287841413,-290,-282477,-282253,0.007012774371298463,-167.76214776133364,-0.0037065179117515153
2023-06-13T19:00:00-04:00,1.07914,1.07921,1.07902,1.07907,1.080003787602054,1.0790382222222221,1.0790211111111099,1.0790524444444414,1.0790020000000022,1.0793974000000013,1.0788209000000004,1.0771376000000044,1.0790581650402704,1.07903623027313,-392,-282869,-282347.8,0.005198856251975029,-167.78757541668884,-0.020383770812303366
2023-06-13T19:15:00-04:00,1.07907,1.07907,1.07889,1.0789199999999999,1.079959911850013,1.0790179999999998,1.07900111111111,1.0790337777777748,1.0790185000000023,1.0793788000000013,1.0788507000000005,1.0771598500000044,1.0790305320322162,1.0790365842185037,-495,-283364,-282698.6,0.001195994873909388,-167.8563846691007,-0.01668056713928913
2023-06-13T19:30:00-04:00,1.0789199999999999,1.07893,1.07881,1.07883,1.0799169136130127,1.0789837777777778,1.0789844444444432,1.0790204444444413,1.0790360000000023,1.0793634000000012,1.0788781000000005,1.0771813500000045,1.078990425625773,1.0790336673748027,-470,-283834,-282946.2,-0.0023654851006348087,-167.89559054163988,-0.013902018573105572
2023-06-13T19:45:00-04:00,1.07883,1.07897,1.07882,1.07896,1.0798747753407525,1.0789788888888887,1.078985555555554,1.0790075555555523,1.0790340000000023,1.079349800000001,1.0789078000000005,1.0772036000000045,1.0789843405006183,1.0790237338998419,441,-283393,-283187.4,-0.00466908623563411,-167.84244963899536,0.0009268270077244976
2023-06-13T20:00:00-04:00,1.07896,1.07904,1.07856,1.0786499999999999,1.0798334798339375,1.0789117777777777,1.0789577777777764,1.0789899999999968,1.0790335000000024,1.0793334000000012,1.0789320000000004,1.0772234000000045,1.0789174724004946,1.078996187119873,-1375,-284768,-283645.6,-0.0059048524379166105,-168.2375059895552,-0.02317174900362253
2023-06-13T20:15:00-04:00,1.0786499999999999,1.07929,1.07864,1.07918,1.0797930102372588,1.0789562222222222,1.0789788888888878,1.0789815555555524,1.0790515000000025,1.079328600000001,1.0789623000000006,1.0772457500000043,1.0789699779203956,1.0789785496958981,1252,-283516,-283775,-0.0056046266851680765,-167.62232961167527,0.01760906032494597
2023-06-13T20:30:00-04:00,1.07918,1.07918,1.07893,1.07908,1.0797533500325136,1.0789764444444443,1.0789977777777766,1.0789808888888857,1.0790445000000024,1.079321600000001,1.0789898000000007,1.0772693500000043,1.0789919823363165,1.0789708397567181,-798,-284314,-283965,-0.00591788830645125,-167.69627464401464,0.015756643278865102
2023-06-13T20:45:00-04:00,1.07908,1.07924,1.07893,1.07901,1.0797144830318632,1.0789788888888887,1.078982222222221,1.0789804444444413,1.0790375000000023,1.079320800000001,1.0790177000000005,1.0772919500000042,1.0789955858690532,1.0789718718053742,-1662,-285976,-284393.4,-0.004064448651233685,-167.8040887078468,-0.012973173330864939
2023-06-13T21:00:00-04:00,1.07901,1.07912,1.07881,1.07896,1.079676393371226,1.0789744444444445,1.078962222222221,1.0789757777777746,1.0790205000000024,1.079271200000001,1.0790407000000004,1.0773135000000043,1.0789884686952425,1.078972697444299,-1324,-287300,-285174.8,-0.0049868246324547135,-167.865441243968,-0.01667994884816326
2023-06-13T21:15:00-04:00,1.07896,1.07933,1.07893,1.07907,1.0796390655038013,1.0789959999999998,1.078962222222221,1.0789766666666636,1.0790160000000024,1.079224400000001,1.0790663000000005,1.0773348500000044,1.079004774956194,1.0789901579554388,1275,-286025,-285426.2,-0.004620582643202149,-167.73545496088053,0
2023-06-13T21:30:00-04:00,1.07907,1.07949,1.079,1.07934,1.0796024841937253,1.0790715555555557,1.0790088888888878,1.0789826666666635,1.0790240000000022,1.079209000000001,1.0790967000000005,1.0773570500000043,1.0790718199649552,1.0790105263643508,1432,-284593,-285641.6,-0.0029126650616928614,-167.37714641741255,0.038927816705602546
2023-06-13T21:45:00-04:00,1.07934,1.0795,1.07923,1.07938,1.0795666345098507,1.0791457777777778,1.0790699999999989,1.0789971111111079,1.0790285000000022,1.079190400000001,1.0791301000000006,1.0773789500000042,1.079133455971964,1.0790388210914803,1637,-282956,-285370,0.0004677875330390144,-167.31647971368614,0.05098115551106759
2023-06-13T22:00:00-04:00,1.07938,1.07942,1.07903,1.07927,1.0795315018196536,1.0791857777777778,1.0791044444444435,1.0790215555555525,1.0790370000000022,1.0791788000000009,1.0791596000000003,1.0774021000000042,1.0791607647775712,1.079071856873184,-1116,-284072,-284989.2,0.00463374851756008,-167.4302116709209,0.028731370949806528
2023-06-13T22:15:00-04:00,1.07927,1.07956,1.07916,1.07952,1.07781,1.0792688888888888,1.0792011111111102,1.0790693333333303,1.0790640000000022,1.079181000000001,1.0791901000000004,1.0774268000000042,1.079232611822057,1.079120685498547,1019,-283053,-284139.8,0.007969899727893285,-167.19417249629353,0.08065637602560131
2023-06-13T22:30:00-04:00,1.07952,1.07961,1.07938,1.07943,1.077845,1.0793146666666666,1.079228888888888,1.0791226666666638,1.0790880000000023,1.079206600000001,1.0792193000000005,1.0774505000000043,1.0792720894576455,1.079174148398837,-1283,-284336,-283802,0.01321229564333789,-167.30113670260764,0.023165736948410964
2023-06-13T22:45:00-04:00,1.07943,1.0796,1.07936,1.07958,1.0779155999999999,1.0793848888888888,1.0792844444444434,1.079177777777775,1.0791220000000024,1.0792092000000009,1.0792475000000004,1.0774758000000044,1.0793336715661164,1.0792265187190693,953,-283383,-283560,0.014138616692905833,-167.16870569735477,0.04633576750564786
2023-06-13T23:00:00-04:00,1.07958,1.0796,1.07917,1.07921,1.077983376,1.07937,1.0793066666666657,1.0792251111111082,1.0791330000000023,1.0791942000000008,1.0792732000000005,1.0775000500000045,1.079308937252893,1.079261614975255,-1093,-284476,-283864,0.013975151853821914,-167.5433050785956,0.0185355094021351
2023-06-13T23:15:00-04:00,1.07921,1.07923,1.07911,1.07917,1.07804844096,1.0793426666666666,1.079329999999999,1.0792702222222192,1.0791460000000024,1.079174000000001,1.0792935000000006,1.0775248000000044,1.0792811498023145,1.0792856919802039,-791,-285267,-284103,0.014663423033703772,-167.57262282027705,0.019463186772451575
2023-06-13T23:30:00-04:00,1.07917,1.07919,1.07894,1.07897,1.0781109033215999,1.0792706666666665,1.0793188888888878,1.079293777777775,1.0791370000000025,1.0791402000000008,1.0793107000000006,1.0775482500000042,1.0792189198418516,1.0792829535841626,-856,-286123,-284717,0.014491289120548497,-167.73126325690887,-0.009267239382059457
2023-06-13T23:45:00-04:00,1.07897,1.079,1.07885,1.07898,1.0781708671887358,1.079202888888889,1.079278888888888,1.0793037777777748,1.0791290000000024,1.079131000000001,1.0793261000000005,1.0775747500000044,1.0791711358734812,1.07926276286733,799,-285324,-284914.6,0.014407556002286423,-167.72385804638398,-0.033353716159867694
2023-06-14T00:00:00-04:00,1.07898,1.07901,1.07853,1.07861,1.0782284325011864,1.0790691111111113,1.0791933333333323,1.0792855555555527,1.0791060000000026,1.0791274000000008,1.0793341000000005,1.0775996500000042,1.079058908698785,1.0792078102938638,-852,-286176,-285473.2,0.009981823549768138,-168.01602286871616,-0.0713372491615499
2023-06-14T00:15:00-04:00,1.07861,1.07871,1.07845,1.07867,1.078283695201139,1.0789644444444446,1.0791266666666657,1.0792495555555526,1.0790935000000026,1.079118400000001,1.0793428000000005,1.0776248500000043,1.078981126959028,1.0791422482350908,791,-285385,-285655,0.005167516225508533,-167.97202179325797,-0.05559313239503868
2023-06-14T00:30:00-04:00,1.07867,1.07899,1.07867,1.07888,1.0783367473930934,1.0789151111111113,1.0790555555555548,1.0791946666666639,1.0790960000000025,1.079104800000001,1.0793525000000006,1.0776518500000043,1.0789609015672224,1.0790781985880724,824,-284561,-285513.8,0.0017298633102322066,-167.81160201705205,-0.05928560841855398
2023-06-14T00:45:00-04:00,1.07888,1.07919,1.07888,1.07896,1.0783876774973697,1.078896,1.0790033333333324,1.0791315555555527,1.0790960000000025,1.0790912000000008,1.0793632000000004,1.0776774000000042,1.078960721253778,1.0790265588704575,999,-283562,-285001.6,-0.0040333826397059005,-167.73752519664583,-0.04354149875396927
2023-06-14T01:00:00-04:00,1.07896,1.07904,1.07882,1.07894,1.078436570397475,1.0788833333333334,1.0789322222222213,1.0790622222222193,1.0791105000000027,1.0790784000000009,1.0793758000000004,1.0777028000000044,1.0789565770030223,1.0789836470963656,-919,-284481,-284833,-0.008485997441955285,-167.75456011916373,-0.05928231349228162
2023-06-14T01:15:00-04:00,1.07894,1.07894,1.07815,1.07815,1.07961,1.078726888888889,1.0788144444444436,1.0789864444444415,1.0790590000000027,1.079036800000001,1.0793794000000003,1.0777248000000044,1.078795261602418,1.0789309176770923,-953,-285434,-284684.6,-0.01953190505324076,-168.452346835756,-0.09821999425506259
2023-06-14T01:30:00-04:00,1.07815,1.07854,1.07786,1.07854,1.0795808,1.0786719999999999,1.0787444444444436,1.0789099999999974,1.0790320000000027,1.0790118000000009,1.0793822000000004,1.0777477500000043,1.0787442092819344,1.0788835341416736,1650,-283784,-284364.4,-0.022917317601140578,-167.8554911106712,-0.058378198059611405
2023-06-14T01:45:00-04:00,1.07854,1.07873,1.07737,1.07762,1.079511968,1.0784471111111111,1.0785944444444437,1.078817777777775,1.0789625000000025,1.078970600000001,1.0793764000000003,1.0777654500000042,1.0785193674255475,1.0787952273133385,-3155,-286939,-284840,-0.030840850091429246,-170.5467218485206,-0.12511932676533752
2023-06-14T02:00:00-04:00,1.07762,1.07839,1.07762,1.07815,1.0793834499200001,1.078358222222222,1.0785022222222214,1.0787175555555526,1.0789220000000026,1.0789550000000008,1.0793690000000005,1.0777850000000044,1.078445493940438,1.0786921818506705,2295,-284644,-285056.4,-0.0346465172523099,-169.41798444572572,-0.07692450277114575
2023-06-14T02:15:00-04:00,1.07815,1.07857,1.07806,1.07856,1.0792626429248,1.0783697777777779,1.0784966666666655,1.0786304444444414,1.0788965000000024,1.078948400000001,1.0793607000000005,1.0778068000000043,1.0784683951523504,1.0785945454805361,1886,-282758,-284711.8,-0.0367745067746081,-168.70077441001638,-0.0046355958131396435
2023-06-14T02:30:00-04:00,1.07856,1.07876,1.07838,1.07863,1.0791490843493121,1.0783964444444445,1.0784922222222213,1.0785659999999968,1.0788610000000025,1.0789452000000008,1.0793521000000004,1.0778297000000046,1.0785007161218803,1.0785356363844287,1649,-281109,-283846.8,-0.034647801784228764,-168.59375208395198,-0.0037082703699963847
2023-06-14T02:45:00-04:00,1.07863,1.07872,1.07841,1.07853,1.0790423392883535,1.078404,1.0784533333333326,1.0785077777777747,1.0788185000000026,1.0789440000000008,1.0793549000000002,1.0778518500000045,1.0785065728975043,1.0784881091075427,-1890,-282999,-283689.8,-0.032371473025305596,-168.76897435664975,-0.03244104997776143
2023-06-14T03:00:00-04:00,1.07853,1.07907,1.07853,1.07897,1.07737,1.0785073333333333,1.0784544444444437,1.0784797777777748,1.0788035000000025,1.078953800000001,1.0793505000000003,1.0778748000000042,1.0785992583180035,1.0785040872860336,3095,-279904,-282282.8,-0.02972809059552502,-167.50632983123091,0.0009268184177416691
2023-06-14T03:15:00-04:00,1.07897,1.07948,1.07855,1.07937,1.077404,1.0786904444444445,1.0785022222222214,1.0784797777777748,1.0787960000000023,1.078961200000001,1.0793501000000005,1.0778995000000042,1.078753406654403,1.0785656698288268,3139,-276765,-280707,-0.02636894273482997,-166.34262741133057,0.03985393070976425
2023-06-14T03:30:00-04:00,1.07937,1.07968,1.07911,1.07918,1.07748704,1.078826,1.0786166666666657,1.0785037777777746,1.0787835000000023,1.078971600000001,1.0793471000000006,1.0779227500000044,1.0788387253235223,1.0786397358630608,-2940,-279705,-280096.4,-0.022643907993874952,-166.86015152261746,0.09553401660252159
2023-06-14T03:45:00-04:00,1.07918,1.07927,1.0789199999999999,1.07897,1.0776186176,1.0788966666666666,1.0786644444444435,1.078538222222219,1.0787530000000025,1.078974600000001,1.0793442000000004,1.0779430000000043,1.078864980258818,1.0787125886904485,-2450,-282155,-280305.6,-0.01301278678415163,-167.33690238901613,0.03986871140615373
2023-06-14T04:00:00-04:00,1.07897,1.07914,1.07858,1.07899,1.0777423005439999,1.0789617777777776,1.0788166666666656,1.078610888888886,1.0787420000000025,1.078970000000001,1.0793398000000005,1.0779622500000043,1.0788899842070543,1.0787892709523585,2464,-279691,-279644,-0.006237295317716078,-167.29122920069784,0.12713201314005598
2023-06-14T04:15:00-04:00,1.07899,1.07967,1.0789199999999999,1.07963,1.07785856251136,1.0791244444444446,1.07898111111111,1.0787162222222189,1.0787650000000024,1.078979600000001,1.0793396000000006,1.0779840000000043,1.0790379873656435,1.0788770167618866,2311,-277380,-279139.2,0.010540966087846352,-165.9204658015927,0.13727217919585846
2023-06-14T04:30:00-04:00,1.07963,1.07998,1.0795,1.07992,1.0779678487606783,1.0793122222222222,1.0791322222222213,1.078842222222219,1.0788125000000026,1.0789920000000008,1.0793387000000005,1.0780089000000044,1.0792143898925148,1.078969213409509,2018,-275362,-278858.6,0.02363693665334986,-165.37840972682653,0.12609405132769877
2023-06-14T04:45:00-04:00,1.07992,1.08046,1.07988,1.0802,1.078128820859824,1.0795257777777778,1.0793066666666655,1.078980222222219,1.0788735000000025,1.079012800000001,1.0793411000000004,1.0780354000000043,1.079411511914012,1.079083770727607,1710,-273652,-277648,0.03340770509096569,-164.9350435515542,0.145555009595512
2023-06-14T05:00:00-04:00,1.0802,1.08043,1.07961,1.0798,1.0783619387738417,1.0796244444444447,1.079447777777777,1.0791368888888855,1.0789330000000024,1.079025200000001,1.0793381000000004,1.0780601500000044,1.0794892095312096,1.0792086165820853,-2478,-276130,-276443,0.04063155005030656,-165.8526514019522,0.11775286732868853
2023-06-14T05:15:00-04:00,1.0798,1.08043,1.07972,1.08037,1.0785717448964576,1.079808888888889,1.0796033333333324,1.0792942222222188,1.0790180000000023,1.079046800000001,1.0793398000000005,1.0780853500000045,1.0796653676249677,1.0793636932656678,1915,-274215,-275347.8,0.04991387539574917,-164.84176975720322,0.12975337590480437
2023-06-14T05:30:00-04:00,1.08037,1.08099,1.08026,1.0804799999999999,1.0787605704068117,1.0799842222222222,1.0797266666666656,1.0794433333333298,1.0790980000000023,1.079074400000001,1.0793412000000004,1.0781094500000044,1.0798282940999742,1.0795217546125342,2069,-272146,-274301,0.055915844249738667,-164.63111044604162,0.10283776647488298
2023-06-14T05:45:00-04:00,1.0804799999999999,1.08063,1.08034,1.08043,1.0790281019579944,1.0801248888888888,1.0798655555555545,1.0795899999999965,1.0791715000000024,1.079103400000001,1.0793381000000004,1.0781268000000044,1.0799486352799794,1.0796686036900272,-2204,-274350,-274098.6,0.05889493561837789,-164.73310215343068,0.11582868474211655
2023-06-14T06:00:00-04:00,1.08043,1.08063,1.08021,1.0804799999999999,1.079263529723035,1.080247777777778,1.0800333333333323,1.0797353333333297,1.0792485000000023,1.0791340000000011,1.0793355000000004,1.0781402000000044,1.0800549082239834,1.0797972829520215,1833,-272517,-273871.6,0.06422987030957286,-164.648274816167,0.13994828401159443
2023-06-14T06:15:00-04:00,1.0804799999999999,1.08088,1.08028,1.08071,1.079470706156271,1.080383111111111,1.0802244444444433,1.0798906666666632,1.0793765000000024,1.079170200000001,1.0793386000000005,1.0781553500000045,1.0801859265791867,1.0799366263616168,1631,-270886,-272822.8,0.07253698102189977,-164.30108652947933,0.1594083355730976
2023-06-14T06:30:00-04:00,1.08071,1.08074,1.08034,1.08064,1.0796530214175184,1.0804662222222223,1.0803366666666656,1.08003733333333,1.0794815000000024,1.0792032000000011,1.0793432000000005,1.0781685500000044,1.0802767412633494,1.0800589010892931,-1852,-272738,-272527.4,0.07683019846807038,-164.42104470512314,0.09355056825022974
2023-06-14T06:45:00-04:00,1.08064,1.08098,1.08061,1.08066,1.0798134588474162,1.080530888888889,1.080418888888888,1.0801757777777743,1.0796335000000024,1.0792382000000011,1.0793441000000006,1.0781833500000044,1.0803533930106795,1.0801639208714342,1980,-270758,-272249.8,0.07701268929548294,-164.38439975398325,0.06852359434031807
2023-06-14T07:00:00-04:00,1.08066,1.08074,1.0804799999999999,1.08066,1.0799546437857261,1.0805791111111112,1.0804699999999992,1.0802966666666631,1.0797590000000024,1.079268400000001,1.0793473000000007,1.0781981500000044,1.0804147144085436,1.080257136697147,0,-270758,-271531.4,0.07044840788752128,-164.38439975398325,0.0425847065358179
2023-06-14T07:15:00-04:00,1.08066,1.08076,1.08044,1.08056,1.080078886531439,1.080597111111111,1.0805544444444435,1.0804008888888856,1.0798590000000021,1.079296800000001,1.0793537000000006,1.0782110000000045,1.080443771526835,1.0803349093577173,-1683,-272441,-271516.2,0.06314678153867388,-164.54013791399655,0.07038340433412409
2023-06-14T07:30:00-04:00,1.08056,1.08069,1.08016,1.08047,1.08099,1.0805802222222223,1.0805655555555547,1.0804691111111078,1.0799510000000023,1.079324800000001,1.0793611000000007,1.0782203000000046,1.080449017221468,1.0803875274861734,-1919,-274360,-272211,0.06092342019601378,-164.69997170388314,0.009256088192007274
2023-06-14T07:45:00-04:00,1.08047,1.08076,1.08021,1.08032,1.0809734,1.0805311111111113,1.0805477777777768,1.0805113333333298,1.0800405000000022,1.0793528000000012,1.0793658000000006,1.0782292500000046,1.0804232137771743,1.0804168219889383,-2405,-276765,-273016.4,0.05300418795293081,-165.0338541809535,-0.014808233377752293
2023-06-14T08:00:00-04:00,1.08032,1.08129,1.08032,1.08128,1.08016,1.0806775555555557,1.0806422222222214,1.0805559999999967,1.0801560000000023,1.0794018000000012,1.0793826000000006,1.0782447000000044,1.0805945710217395,1.0804650575911503,2399,-274366,-273738,0.048280383333648716,-162.90204138474482,0.07867238044112228
2023-06-14T08:15:00-04:00,1.08128,1.08196,1.08118,1.08171,1.0801826,1.0808911111111108,1.080778888888888,1.0806177777777746,1.0802730000000023,1.0794568000000013,1.0794033000000005,1.0782632500000044,1.0808176568173915,1.08054564607292,3919,-270447,-273675.8,0.048045323681473136,-161.34354589791465,0.11383829409152085
2023-06-14T08:30:00-04:00,1.08171,1.08287,1.08141,1.08276,1.0802536960000002,1.0812873333333333,1.081006666666666,1.080708222222219,1.0804520000000024,1.0795390000000011,1.0794362000000006,1.0782889000000047,1.0812061254539131,1.0806981168583358,7524,-262923,-271772.2,0.05419993282896657,-154.04010967193915,0.18969011113063497
2023-06-14T08:45:00-04:00,1.08276,1.08332,1.08234,1.0831,1.0804106742400001,1.081706,1.0812799999999991,1.080851111111108,1.0806585000000022,1.0796174000000012,1.0794730000000006,1.0783181000000046,1.0815849003631306,1.0809252934866682,4267,-258656,-268631.4,0.059033656588086875,-152.7002190221183,0.22764287829433544
2023-06-14T09:00:00-04:00,1.0831,1.08351,1.08269,1.08331,1.0806434203008002,1.0821120000000002,1.0815744444444437,1.0810564444444413,1.0808745000000022,1.0797020000000013,1.0795118000000006,1.0783480500000047,1.0819299202905044,1.0812266347893342,3977,-254679,-264214.2,0.06460473165921676,-151.92912678686747,0.24522051338996922
2023-06-14T09:15:00-04:00,1.08331,1.08395,1.08321,1.08365,1.08093007827072,1.0825271111111112,1.081906666666666,1.0813093333333303,1.081075500000002,1.0797948000000013,1.0795578000000006,1.0783823000000046,1.0822739362324034,1.081562507831467,3954,-250725,-259486,0.07172327028549647,-150.68815236587992,0.27668276793811636
2023-06-14T09:30:00-04:00,1.08365,1.08445,1.08351,1.08421,1.0812924688782337,1.0829877777777777,1.0823122222222217,1.081615999999997,1.0812900000000023,1.079899800000001,1.0795855000000005,1.0784199000000045,1.0826611489859228,1.0819312062651734,4832,-245893,-254575.2,0.08437081052746093,-148.1911099628905,0.3377878137262097
2023-06-14T09:45:00-04:00,1.08421,1.08451,1.08391,1.08447,1.081734523235281,1.083419333333333,1.082756666666666,1.0819659999999969,1.0815035000000024,1.080007800000001,1.0796161000000006,1.0784608500000048,1.0830229191887382,1.0822945650121383,4519,-241374,-250265.4,0.10047436688376933,-147.10742691255828,0.3702092607846588
2023-06-14T10:00:00-04:00,1.08447,1.08449,1.08413,1.08437,1.082178599517636,1.083742,1.0832066666666662,1.0823513333333303,1.0817320000000021,1.0801084000000012,1.0796587000000004,1.0784986000000047,1.0832923353509905,1.0826360520097102,-3378,-244752,-247484.6,0.1181539144266421,-147.41891547379092,0.374888921800958
2023-06-14T10:15:00-04:00,1.08437,1.08487,1.08435,1.08472,1.0825516235948143,1.0840446666666668,1.0835888888888883,1.0827542222222193,1.0819495000000021,1.0802152000000012,1.0797028000000006,1.0785399500000046,1.0835778682807924,1.082965641607768,3771,-240981,-244745,0.1371429476890544,-146.20175712378176,0.3181414619709869
2023-06-14T10:30:00-04:00,1.08472,1.08539,1.08465,1.08512,1.0829689313477477,1.0843508888888889,1.0839677777777772,1.0831664444444413,1.0821815000000021,1.0803322000000013,1.0797555000000005,1.0785835500000047,1.083886294624634,1.0832881132862142,2917,-238064,-242212.8,0.15169791028158,-145.12608782663548,0.3152416081944454
2023-06-14T10:45:00-04:00,1.08512,1.08563,1.085,1.08557,1.0834531450781981,1.0846713333333333,1.0842799999999995,1.083559999999997,1.082438500000002,1.0804532000000011,1.0798171000000005,1.0786283500000047,1.0842230356997071,1.0836004906289711,3660,-234404,-239915,0.16493321366389838,-143.60828334418247,0.25952196239240266
2023-06-14T11:00:00-04:00,1.08557,1.08557,1.08483,1.0849199999999999,1.0838885160625584,1.0847993333333332,1.0844822222222217,1.083905111111108,1.082660500000002,1.0805630000000013,1.0798848000000005,1.0786689500000046,1.0843624285597657,1.0838683925031767,-3418,-237822,-239204.6,0.1651029815225504,-145.65485795475584,0.16803619241066686
2023-06-14T11:15:00-04:00,1.0849199999999999,1.08535,1.08488,1.08503,1.0842368128500468,1.0849088888888891,1.084673333333333,1.0841984444444415,1.0828765000000022,1.0806720000000012,1.0799406000000007,1.0787108500000047,1.0844959428478125,1.084109114002541,2518,-235304,-237315,0.16288419860151754,-145.39955802480696,0.15877265048785147
2023-06-14T11:30:00-04:00,1.08503,1.08573,1.08482,1.08568,1.0845154502800374,1.0851102222222222,1.0848988888888884,1.0844604444444417,1.0831285000000022,1.0808014000000012,1.0799978000000006,1.0787608000000046,1.0847327542782499,1.0843400912020325,2499,-232805,-235679.8,0.16287938246226172,-143.90250264384966,0.18732985742628858
2023-06-14T11:45:00-04:00,1.08568,1.0858,1.0854,1.08578,1.0847583602240298,1.0852864444444443,1.085073333333333,1.0846815555555527,1.083384500000002,1.0809336000000012,1.0800538000000006,1.0788132500000047,1.0849422034226,1.0845512729616256,2176,-230629,-234192.8,0.15991049900362905,-143.70207526193235,0.14480589553684908
2023-06-14T12:00:00-04:00,1.08578,1.08593,1.08551,1.0859,1.08482,1.0854517777777777,1.0852322222222217,1.084871999999997,1.0836465000000022,1.081072200000001,1.0801062000000006,1.0788636500000046,1.08513376273808,1.0847334183693005,2042,-228587,-233029.4,0.15244187840288714,-143.47639418473418,0.13186164670300168
2023-06-14T12:15:00-04:00,1.0859,1.08625,1.08584,1.0862,1.0850419999999998,1.0856453333333334,1.0854355555555553,1.0850626666666638,1.083928500000002,1.081216600000001,1.0801738000000005,1.0789192000000047,1.0853470101904639,1.08493033469544,1757,-226830,-230831,0.14402571627339322,-142.99099037222848,0.16876158506782724
2023-06-14T12:30:00-04:00,1.0862,1.08629,1.08589,1.08603,1.0852836,1.0857642222222224,1.0855811111111109,1.0852442222222194,1.084206500000002,1.081365000000001,1.0802462000000006,1.0789720500000048,1.085483608152371,1.0851278677563516,-1857,-228687,-229507.6,0.13527582298873037,-143.28162745563853,0.12076849325172805
2023-06-14T12:45:00-04:00,1.08603,1.08641,1.08602,1.08623,1.0854848799999999,1.085894,1.0857044444444441,1.0854053333333304,1.084502000000002,1.0815162000000011,1.0803173000000006,1.0790296500000047,1.085632886521897,1.0853078942050811,2253,-226434,-228233.4,0.12387155934336713,-142.8667217900492,0.10229283397227443
2023-06-14T13:00:00-04:00,1.08623,1.08629,1.08603,1.08609,1.085669904,1.0859711111111112,1.0857622222222219,1.0855431111111085,1.0847425000000022,1.0816604000000012,1.0803826000000007,1.079082550000005,1.0857243092175175,1.0854643153640646,-1570,-228004,-227708.4,0.10745021213037857,-143.0690730416258,0.047901102646542924
2023-06-14T13:15:00-04:00,1.08609,1.08612,1.08564,1.08568,1.08641,1.0859546666666666,1.0858466666666662,1.0856659999999974,1.0849410000000022,1.081794800000001,1.0804430000000007,1.0791337000000047,1.085715447374014,1.0855806522912517,-1737,-229741,-227939.2,0.08912874283475225,-143.72479218092369,0.07005124801829572
2023-06-14T13:30:00-04:00,1.08568,1.08576,1.08533,1.08566,1.0863946,1.0859173333333334,1.0859166666666664,1.0857622222222194,1.0850860000000022,1.081929200000001,1.0805038000000007,1.0791852500000048,1.0857043578992112,1.0856521218330009,-2226,-231967,-228966.6,0.07859736101107308,-143.76579873902534,0.0580629107029419
2023-06-14T13:45:00-04:00,1.08566,1.08579,1.08519,1.08543,1.086352016,1.08582,1.0858888888888885,1.0858237777777748,1.0852025000000023,1.0820748000000011,1.0805558000000008,1.079239400000005,1.0856494863193689,1.0856852974664004,-2830,-234797,-230188.6,0.0705573097122446,-144.36534187407727,-0.023027042959259034
2023-06-14T14:00:00-04:00,1.08543,1.08543,1.08013,1.08163,1.08628229504,1.0849682222222223,1.0854277777777774,1.0857684444444415,1.0851185000000023,1.082136600000001,1.0805742000000007,1.079273700000005,1.084845589055495,1.0855278379731201,-20694,-255491,-236000,0.03968720705326453,-216.81331180304178,-0.38221370811765515
2023-06-14T14:15:00-04:00,1.08163,1.08203,1.08063,1.08107,1.0857901114368,1.0840966666666667,1.0848911111111108,1.0855942222222195,1.0849895000000023,1.082205600000001,1.0805881000000008,1.079306900000005,1.0840904712443962,1.085201070378496,-11347,-266838,-243766.8,0.006109700730410566,-222.68807489208453,-0.4447923381526947
2023-06-14T14:30:00-04:00,1.08107,1.08361,1.0807,1.08344,1.08543,1.0838064444444444,1.0845844444444441,1.085341777777775,1.0849510000000024,1.082311400000001,1.0806332000000005,1.0793497500000049,1.0839603769955168,1.0848500563027965,17182,-249656,-247749.8,-0.01564308484753906,-185.02044929892247,-0.2540968514085892
2023-06-14T14:45:00-04:00,1.08344,1.0845,1.08261,1.08341,1.085006,1.0835715555555556,1.0842933333333329,1.0850171111111084,1.0848980000000024,1.0824084000000012,1.0806784000000007,1.0793925500000048,1.0838503015964134,1.084479245042237,-13868,-263524,-254061.2,-0.03784934267286245,-185.40444841285554,-0.2412456377816512
2023-06-14T15:00:00-04:00,1.08341,1.0844,1.08323,1.08333,1.0846159199999998,1.083378888888889,1.0839711111111106,1.0846335555555529,1.0848460000000024,1.082502400000001,1.0807238000000006,1.0794341000000047,1.0837462412771306,1.0840985960337892,-8321,-271845,-261470.8,-0.05773597544258198,-186.01887877624583,-0.26697844839491863
2023-06-14T15:15:00-04:00,1.08333,1.08347,1.08235,1.08237,1.0845,1.0830586666666666,1.0835577777777772,1.0842595555555525,1.0847285000000024,1.0825792000000012,1.0807616000000007,1.0794724500000048,1.0834709930217046,1.083823676827031,-7573,-279418,-266256.2,-0.0845460942808236,-192.72974250197933,-0.3425130514045747
2023-06-14T15:30:00-04:00,1.08237,1.08295,1.08207,1.0826,1.0844,1.082867111111111,1.0832155555555552,1.0839244444444416,1.0846025000000026,1.0826518000000012,1.0808028000000005,1.0795112000000047,1.0832967944173637,1.0836649414616246,4108,-275310,-267950.6,-0.10742335417394805,-191.85680626021374,-0.28369316925797394
2023-06-14T15:45:00-04:00,1.0826,1.08294,1.0823,1.08268,1.0840584,1.08276,1.082884444444444,1.0835844444444418,1.0844580000000026,1.0827180000000012,1.0808396000000007,1.0795478500000046,1.083173435533891,1.0835075531692997,4337,-270973,-272214,-0.12438347238322275,-191.53631854545267,-0.2744874085809538
2023-06-14T16:00:00-04:00,1.08268,1.08325,1.0824799999999999,1.0831,1.083744128,1.0828031111111112,1.082625555555555,1.083250888888886,1.0843670000000025,1.0827964000000012,1.0808840000000006,1.0795862500000046,1.0831587484271128,1.0833692425354395,1555,-269418,-273392.8,-0.13715810376264256,-190.93309321571556,-0.21466147056926227
2023-06-14T16:15:00-04:00,1.0831,1.08349,1.08303,1.08345,1.08013,1.082968,1.0828277777777773,1.0830222222222194,1.0842880000000028,1.0828860000000011,1.0809303000000006,1.0796280500000046,1.0832169987416902,1.0832633940283514,1097,-268321,-272688,-0.14897155522448463,-190.57860147903375,0.16826456366779144
2023-06-14T16:30:00-04:00,1.08345,1.08355,1.08322,1.08326,1.0801972,1.0830544444444443,1.0830711111111107,1.0829248888888858,1.0841670000000028,1.082971400000001,1.0809707000000004,1.079666000000005,1.0832255989933521,1.083214315222681,-819,-269140,-270632.4,-0.12617583014070133,-190.72222601177648,0.20257707641502531
2023-06-14T16:45:00-04:00,1.08326,1.08327,1.08239,1.08239,1.080331312,1.0829182222222222,1.0829544444444439,1.0828726666666637,1.0839975000000026,1.083026600000001,1.0810031000000004,1.0797000000000048,1.0830584791946818,1.0831666521781442,-1248,-270388,-269648,-0.09956632183507241,-191.72453386030767,-0.0969135346673554
2023-06-14T17:00:00-04:00,1.08239,1.08319,1.08239,1.08276,1.08046005952,1.0828793333333333,1.0828822222222216,1.0828722222222191,1.0838405000000024,1.083083400000001,1.0810377000000004,1.0797347500000047,1.0829987833557455,1.0831317217425154,191,-270197,-269492.8,-0.09258563677131114,-191.65924316102183,-0.059995754146633266
2023-06-14T17:15:00-04:00,1.08276,1.0828,1.08241,1.08243,1.0805836571392,1.082788888888889,1.0827822222222219,1.0829035555555524,1.0836520000000025,1.083128000000001,1.0810704000000004,1.0797668500000048,1.0828850266845964,1.0830769773940123,-210,-270407,-269690.6,-0.08639567929293213,-191.72324626420257,-0.08307717869900223
2023-06-14T17:30:00-04:00,1.08243,1.08308,1.08243,1.08298,1.080702310853632,1.0828284444444445,1.0828499999999996,1.0829079999999969,1.0834995000000025,1.083191600000001,1.0811084000000004,1.0798006000000049,1.082904021347677,1.0830143819152096,136,-270271,-270080.6,-0.07548771709600842,-191.65414248843877,0.05635780740412238
2023-06-14T17:45:00-04:00,1.08298,1.0832,1.08284,1.0832,1.0808162184194867,1.0828984444444445,1.0829166666666665,1.0828771111111082,1.0833480000000026,1.0832482000000008,1.0811475000000004,1.0798366000000048,1.0829632170781416,1.0829619055321675,434,-269837,-270220,-0.05539882539508548,-191.56597834875018,0.055422131904667826
2023-06-14T18:00:00-04:00,1.0832,1.0833599999999999,1.0831,1.08324,1.0809255696827071,1.082963111111111,1.0829788888888887,1.0828819999999972,1.0832055000000027,1.083303400000001,1.0811889000000006,1.0798734500000047,1.0830185736625133,1.0829539244257336,385,-269452,-270032.8,-0.0363557243448985,-191.55176121433362,0.05172350094209682
2023-06-14T18:15:00-04:00,1.08324,1.08345,1.0832,1.08342,1.081030546895399,1.0830513333333334,1.0830144444444443,1.0829084444444417,1.0830925000000025,1.0833632000000009,1.0812333000000003,1.0799108500000048,1.0830988589300106,1.0829739395405866,359,-269093,-269812,-0.01779094257667626,-191.49210684411094,0.029544825039248268
2023-06-14T18:30:00-04:00,1.08342,1.08352,1.08328,1.0833599999999999,1.0811313250195829,1.0831204444444442,1.0830044444444442,1.0829528888888862,1.0829775000000026,1.0834208000000007,1.0812774000000005,1.0799480500000047,1.0831510871440084,1.0830271516324692,-344,-269437,-269618,-0.005192302027172365,-191.5111576277406,-0.008306797729488719
2023-06-14T18:45:00-04:00,1.0833599999999999,1.08337,1.08315,1.08322,1.0812280720187994,1.0831635555555557,1.0829999999999997,1.0829828888888862,1.0828670000000027,1.0834710000000007,1.0813206000000004,1.0799859500000046,1.0831648697152068,1.083079321305975,-415,-269852,-269534.2,0.0034120733758251313,-191.5647870768618,-0.003692557650039507
2023-06-14T19:00:00-04:00,1.08322,1.08345,1.08319,1.08332,1.0813209491380475,1.0832275555555555,1.083103333333333,1.0830202222222194,1.0829515000000027,1.083524600000001,1.0813639000000004,1.0800251500000047,1.0831958957721655,1.0831258570447801,567,-269285,-269423.8,0.013244998166649286,-191.51244313934217,0.0859209711841478
2023-06-14T19:15:00-04:00,1.08332,1.08383,1.08331,1.08383,1.0814101111725256,1.0833728888888887,1.0832222222222219,1.083068888888886,1.083089500000003,1.0835880000000009,1.0814131000000005,1.0800669000000047,1.0833227166177324,1.0831866856358239,630,-268655,-269264.4,0.016866832052274357,-191.21585487364044,0.09882153016366753
2023-06-14T19:30:00-04:00,1.08383,1.084,1.08381,1.08394,1.0815553045021742,1.0835164444444445,1.0833899999999999,1.0831439999999972,1.0831145000000029,1.0836536000000008,1.0814610000000004,1.0801081000000048,1.0834461732941858,1.0832561485086587,1023,-267632,-268972.2,0.01514130344502043,-191.11202862782713,0.1395009377049694
2023-06-14T19:45:00-04:00,1.08394,1.08429,1.0839,1.08428,1.0817508801420002,1.0836944444444443,1.0835344444444444,1.0832499999999972,1.0831580000000027,1.0837280000000007,1.0815124000000005,1.0801510500000047,1.0836129386353486,1.0833485188069267,539,-267093,-268503.4,0.0285273779742895,-190.94296022920727,0.12003915123084977
2023-06-14T20:00:00-04:00,1.08428,1.08445,1.084,1.08407,1.0820047921278002,1.0838015555555556,1.083631111111111,1.0833762222222194,1.0831950000000028,1.0838000000000008,1.0815624000000006,1.0801916500000046,1.0837043509082789,1.0834564150455415,-1103,-268196,-268172.2,0.03568786177517977,-191.15658586096274,0.08031757754801962
2023-06-14T20:15:00-04:00,1.08407,1.08417,1.08381,1.08398,1.0822982170724642,1.0838713333333332,1.083713333333333,1.0834982222222194,1.0832755000000027,1.0838732000000006,1.0816130000000006,1.0802318500000048,1.083759480726623,1.083569132036433,-771,-268967,-268108.6,0.040030103904559175,-191.22059464268358,0.0683135777851596
2023-06-14T20:30:00-04:00,1.08398,1.0841399999999999,1.08377,1.08385,1.0825564310237685,1.0838986666666668,1.083761111111111,1.0836059999999974,1.0833380000000028,1.083924600000001,1.0816632000000006,1.0802706500000048,1.0837775845812985,1.083660105629146,-965,-269932,-268364,0.03915274979202314,-191.33632556022815,0.03968913256169633
2023-06-14T20:45:00-04:00,1.08385,1.08408,1.08369,1.08381,1.0827836593009164,1.0839084444444442,1.083811111111111,1.0836902222222196,1.083394500000003,1.0839666000000008,1.0817117000000005,1.0803097500000047,1.0837840676650388,1.0837276845033166,-1463,-271395,-269116.6,0.03743202917589567,-191.39031827139672,0.04153743907842836
2023-06-14T21:00:00-04:00,1.08381,1.08381,1.08255,1.08261,1.08445,1.083668222222222,1.0837433333333333,1.0837319999999975,1.0833700000000028,1.0839636000000008,1.0817513000000005,1.0803416500000047,1.083549254132031,1.083714947602653,-2290,-273685,-270435,0.030816905123324915,-193.92581803611534,-0.05631358357489701
2023-06-14T21:15:00-04:00,1.08261,1.08281,1.08199,1.08221,1.084412,1.0833615555555556,1.0836199999999998,1.0837297777777752,1.0833080000000028,1.0839458000000008,1.0817816000000005,1.0803719500000046,1.0832814033056248,1.0836303580821223,-2400,-276085,-272012.8,0.025407028956041418,-194.81256395569898,-0.10246279954216357
2023-06-14T21:30:00-04:00,1.08221,1.08241,1.08147,1.08149,1.0843151199999999,1.0829355555555555,1.0833599999999999,1.0836591111111087,1.0832195000000027,1.083909400000001,1.0818057000000005,1.0803977500000048,1.0829231226445,1.0834630864656976,-3139,-279224,-274064.2,0.017131439951331585,-196.9009571511042,-0.21590101768727646
2023-06-14T21:45:00-04:00,1.08149,1.08173,1.08099,1.08108,1.0841444128,1.0824795555555555,1.0830422222222222,1.083515333333331,1.0831540000000026,1.083858000000001,1.0818264000000004,1.0804220500000048,1.0825544981156,1.083218469172558,-2057,-281281,-276334,0.0013277369079799767,-197.680779433326,-0.26385224274405067
2023-06-14T22:00:00-04:00,1.08108,1.08156,1.08081,1.08118,1.083892059776,1.0821071111111111,1.0826977777777778,1.0832926666666642,1.0830750000000027,1.083797400000001,1.0818486000000005,1.0804446500000047,1.08227959849248,1.0829175753380462,2347,-278934,-277841.8,-0.01883552157737098,-197.4636817162283,-0.2859040100342975
2023-06-14T22:15:00-04:00,1.08118,1.08138,1.08088,1.08119,1.0835838537984,1.0818055555555555,1.0823777777777777,1.083019555555553,1.0830130000000024,1.0837318000000011,1.0818698000000007,1.0804680500000048,1.082061678793984,1.0826200602704368,1843,-277091,-278523,-0.040465749653698854,-197.4466355259546,-0.26566550130526567
2023-06-14T22:30:00-04:00,1.08119,1.08138,1.08097,1.08122,1.08330646841856,1.0815740000000003,1.0820711111111112,1.0827097777777754,1.0829250000000026,1.0836688000000012,1.0818886000000005,1.080492650000005,1.0818933430351874,1.0823424482163495,1578,-275513,-278408.6,-0.061464777138149226,-197.40285043730233,-0.2546172438605762
2023-06-14T22:45:00-04:00,1.08122,1.0815,1.0812,1.08132,1.083056821576704,1.081423777777778,1.08179,1.0823957777777753,1.0828310000000028,1.083600800000001,1.0819080000000005,1.0805190500000048,1.08177867442815,1.0821135585730794,1187,-274326,-277429,-0.07873413245978193,-197.29306704446833,-0.23342713475111143
2023-06-14T23:00:00-04:00,1.08132,1.08158,1.0812,1.0815,1.0828321394190337,1.0813657777777776,1.0815333333333335,1.0820939999999974,1.0827440000000028,1.0835284000000012,1.0819303000000007,1.0805449500000046,1.0817229395425199,1.0819472468584634,1213,-273113,-275795.4,-0.09296722860076029,-197.09114716876104,-0.21313698895563193
2023-06-14T23:15:00-04:00,1.0815,1.08151,1.08108,1.08112,1.0826299254771303,1.0812831111111112,1.081367777777778,1.0818279999999976,1.0826290000000027,1.0834394000000012,1.0819463000000005,1.0805682000000048,1.0816023516340159,1.0818117974867705,-964,-274077,-274824,-0.10849753694543252,-197.42986191679603,-0.13763035626864625
2023-06-14T23:30:00-04:00,1.08112,1.08142,1.08107,1.08138,1.0824479329294172,1.0812855555555554,1.0812755555555558,1.081607555555553,1.0825300000000029,1.0833686000000013,1.0819658000000005,1.0805925500000046,1.0815578813072126,1.0817110379894161,938,-273139,-274033.6,-0.11089577002824041,-197.20428103770774,-0.07669491133882393
2023-06-14T23:45:00-04:00,1.08138,1.08139,1.08113,1.08133,1.0822841396364755,1.0812964444444444,1.0812577777777779,1.0814448888888866,1.082435500000003,1.0832946000000012,1.0819833000000005,1.0806154000000046,1.08151230504577,1.0816348303915326,-1039,-274178,-273766.6,-0.11010503727538622,-197.25232150451876,-0.014794404016695486
2023-06-15T00:00:00-04:00,1.08133,1.08134,1.081,1.08119,1.082136725672828,1.081282888888889,1.08127,1.0813408888888865,1.0823290000000028,1.0832048000000012,1.0820031000000006,1.0806381500000046,1.081447844036616,1.081568664313226,-1117,-275295,-273960.4,-0.10395558273426128,-197.39693970617762,0.010175010175015216
2023-06-15T00:15:00-04:00,1.08119,1.08143,1.08118,1.08123,1.0820040531055453,1.0812748888888888,1.0812755555555558,1.081289333333331,1.0821990000000028,1.0831138000000011,1.0820237000000004,1.0806586000000047,1.0814042752292927,1.0815049314505805,882,-274413,-274220.4,-0.09338339241619743,-197.36430899372203,0.0046245768512073356
2023-06-15T00:30:00-04:00,1.08123,1.08151,1.08122,1.08133,1.0818846477949908,1.0812857777777778,1.0812911111111112,1.0812739999999976,1.082068500000003,1.0830224000000013,1.0820473000000004,1.0806790000000046,1.0813894201834342,1.0814623451604641,925,-273488,-274102.6,-0.08100659572921691,-197.2787582783331,0.012948695418918686
2023-06-15T00:45:00-04:00,1.08133,1.08146,1.08114,1.08115,1.0817771830154919,1.0812575555555557,1.0812833333333334,1.0812755555555533,1.0819120000000029,1.0829214000000014,1.0820690000000004,1.0806975500000047,1.0813415361467473,1.0814190761283708,-1011,-274499,-274374.6,-0.06910765179172074,-197.44705102892712,-0.006474168069404422
2023-06-15T01:00:00-04:00,1.08115,1.08115,1.08057,1.08075,1.0816804647139426,1.081150888888889,1.0812200000000003,1.081267999999998,1.081746000000003,1.0828158000000012,1.0820904000000005,1.0807122500000046,1.081223228917398,1.0813612609026966,-1683,-276182,-274775.4,-0.05792511022675023,-198.06972133369513,-0.05271335034956899
2023-06-15T01:15:00-04:00,1.08075,1.0815299999999999,1.08075,1.0814,1.0815472089482696,1.081186888888889,1.0812088888888889,1.0812557777777756,1.0816170000000027,1.0827192000000012,1.0821177000000004,1.0807302500000047,1.0812585831339183,1.081323408722157,1566,-274616,-274639.6,-0.045438697816838375,-197.12787539337617,-0.009246417013406286
2023-06-15T01:30:00-04:00,1.0814,1.082,1.0814,1.08188,1.08057,1.081321111111111,1.0812933333333337,1.0812593333333311,1.0815185000000027,1.0826350000000011,1.0821477000000004,1.0807501000000046,1.0813828665071346,1.0813191269777254,2324,-272292,-274215.4,-0.03268437128770707,-196.0963237011253,0.07029746929109366
2023-06-15T01:45:00-04:00,1.08188,1.08235,1.08183,1.08183,1.0805986,1.0814284444444446,1.0813433333333335,1.0812697777777756,1.081419500000003,1.0825580000000012,1.0821764000000003,1.0807698000000046,1.0814722932057077,1.08133570158218,-2501,-274793,-274476.4,-0.017228626024375134,-196.21190953319513,0.04161349386895092
2023-06-15T02:00:00-04:00,1.08183,1.08206,1.08142,1.08174,1.080668656,1.0815077777777777,1.0813888888888892,1.0812908888888866,1.0813760000000028,1.0824796000000012,1.0822044000000002,1.0807901000000046,1.0815258345645662,1.0813725612657439,-3187,-277980,-275172.6,-0.004786410293131175,-196.47704361156278,0.0379162697788854
2023-06-15T02:15:00-04:00,1.08174,1.08197,1.08129,1.08132,1.08073590976,1.0814940000000002,1.0814033333333335,1.0813275555555533,1.0813315000000028,1.0823974000000012,1.0822361000000003,1.0808077500000046,1.081484667651653,1.0814248490125948,-2640,-280620,-276060.2,0.0008014500084550625,-197.50205886476562,0.012023788603294838
2023-06-15T02:30:00-04:00,1.08132,1.08136,1.08088,1.0809,1.0808004733696,1.0813933333333334,1.0813666666666668,1.081359111111109,1.0813020000000029,1.0823828000000013,1.0822597000000003,1.0808209500000046,1.0813677341213224,1.0814466792100756,-2388,-283008,-277738.6,0.0038885779303140557,-198.42959187996945,-0.030520795760378593
2023-06-15T02:45:00-04:00,1.0809,1.08106,1.08036,1.08103,1.08235,1.081326,1.0813333333333337,1.081367111111109,1.081299500000003,1.0823820000000013,1.0822938000000004,1.0808351000000047,1.0813001872970578,1.0814301433680602,2265,-280743,-279428.8,0.004064813294281049,-198.1571800009798,-0.027743612033326273
2023-06-15T03:00:00-04:00,1.08103,1.08134,1.08058,1.08087,1.0823102,1.0812333333333335,1.0813022222222226,1.0813588888888865,1.081284000000003,1.0823306000000015,1.0823210000000003,1.0808450000000047,1.0812141498376462,1.0813785146944481,-3392,-284135,-281297.2,0.0007354605616919999,-198.65921972235643,-0.02589834898025787
2023-06-15T03:15:00-04:00,1.08087,1.08138,1.08083,1.0813,1.082271196,1.081232888888889,1.0813633333333337,1.0813537777777757,1.081289500000003,1.0822884000000013,1.0823484000000003,1.0808545500000049,1.081231319870117,1.0813196117555584,2922,-281213,-281943.8,0.0015942234506683029,-197.49676725351208,0.0508905852417144
2023-06-15T03:30:00-04:00,1.0813,1.08189,1.08112,1.08177,1.08223297208,1.081314222222222,1.0814044444444448,1.081353999999998,1.081317000000003,1.0822572000000015,1.0823798000000004,1.0808659500000046,1.0813390558960936,1.0812904894044464,3337,-277876,-281395,0.008472949097576904,-196.04630022308584,0.034214906602550534
2023-06-15T03:45:00-04:00,1.08177,1.08287,1.08171,1.08269,1.08036,1.0815713333333332,1.0814944444444448,1.0813795555555534,1.0813855000000028,1.0822636000000014,1.0824214000000003,1.0808881500000047,1.0816092447168748,1.081338791523557,2720,-275156,-279824.6,0.0139283800325145,-193.7330543390254,0.07486967131289768
2023-06-15T04:00:00-04:00,1.08269,1.08303,1.08257,1.0829199999999999,1.0804102,1.0818564444444443,1.0816155555555558,1.0814359999999978,1.081456500000003,1.0822700000000014,1.0824609000000003,1.0809057000000049,1.0818713957734998,1.0814530332188454,2345,-272811,-278238.2,0.0164988818016178,-193.23489697172738,0.10075520183391229
2023-06-15T04:15:00-04:00,1.0829199999999999,1.08301,1.08245,1.08256,1.080514992,1.0820453333333333,1.081706666666667,1.0815168888888869,1.0815285000000028,1.0822676000000013,1.0824928000000003,1.0809214500000046,1.0820091166187997,1.081612026575076,-2218,-275029,-276417,0.01858073969881115,-193.9722367567529,0.07580379758537568
2023-06-15T04:30:00-04:00,1.08256,1.08357,1.08256,1.08345,1.0806155923199998,1.0823939999999999,1.0819433333333337,1.0816328888888869,1.081632000000003,1.0822746000000014,1.0825355,1.0809413000000048,1.0822972932950399,1.0818252212600605,1930,-273099,-274794.2,0.024130470960663612,-192.38553486494078,0.1969814670957686
2023-06-15T04:45:00-04:00,1.08345,1.08372,1.08312,1.08329,1.0807928567807998,1.082663333333333,1.0822088888888892,1.0817937777777755,1.081730000000003,1.0822714000000015,1.0825787,1.0809614500000047,1.0824958346360318,1.0820565770080481,-2065,-275164,-274251.8,0.03393213485033127,-192.69048663936496,0.22111203626608514
2023-06-15T05:00:00-04:00,1.08329,1.08424,1.08312,1.0842,1.0810270282383359,1.0830615555555556,1.0825611111111115,1.0820071111111091,1.081880500000003,1.0822902000000014,1.0826308000000002,1.0809853000000047,1.0828366677088255,1.0823020616064383,1999,-273165,-273853.6,0.05179851048515244,-191.01125947027825,0.29323885553593493
2023-06-15T05:15:00-04:00,1.0842,1.08449,1.0839699999999999,1.08437,1.0813483254145022,1.0834233333333334,1.0829500000000003,1.0822739999999977,1.0820375000000029,1.0823298000000015,1.0826782000000001,1.0810089000000047,1.0831433341670604,1.0825564492851503,3191,-269974,-273286.2,0.06866479065689617,-190.51091820482907,0.3238132245320953
2023-06-15T05:30:00-04:00,1.08437,1.08472,1.08426,1.0843099999999999,1.081725326364762,1.0836953333333332,1.0832844444444447,1.0825895555555534,1.0821865000000028,1.0823608000000013,1.0827221000000002,1.0810304000000048,1.0833766673336482,1.0828299594281199,-2240,-272214,-272723.2,0.08689085969457294,-190.63486113943662,0.2783686303523497
2023-06-15T05:45:00-04:00,1.0843099999999999,1.08476,1.08396,1.08476,1.0821445806736953,1.0839904444444444,1.083616666666667,1.08292422222222,1.082367000000003,1.0824074000000015,1.0827677000000002,1.0810544000000049,1.0836533338669185,1.0831011675424957,2240,-269974,-272098.2,0.10375524286964424,-189.70523769226733,0.27639886482339576
2023-06-15T06:00:00-04:00,1.08476,1.08487,1.08391,1.08402,1.082563047765904,1.0840711111111112,1.0837644444444448,1.0832353333333313,1.082530500000003,1.0824282000000014,1.0828099000000002,1.0810740000000048,1.0837266670935348,1.0833473340339963,-2427,-272401,-271545.6,0.11190267542329614,-191.36088502439603,0.12284218012543327
2023-06-15T06:15:00-04:00,1.08402,1.0841399999999999,1.08343,1.08392,1.0829782991680412,1.084102222222222,1.0838755555555557,1.08349822222222,1.082656500000003,1.0824426000000014,1.0828454000000003,1.0810926000000047,1.0837653336748279,1.0835330672271968,-2495,-274896,-271891.8,0.10930509669699286,-191.59104682952875,0.09234292468512097
2023-06-15T06:30:00-04:00,1.08392,1.08449,1.08383,1.0841399999999999,1.0833188053177938,1.0841551111111112,1.0840511111111113,1.083718444444442,1.082769500000003,1.0824606000000014,1.0828820000000001,1.0811116000000047,1.0838402669398624,1.0836724537817573,2271,-272625,-272422,0.1085090690311866,-191.13010875291818,0.1459503399349611
2023-06-15T06:45:00-04:00,1.0841399999999999,1.08453,1.08412,1.08422,1.08343,1.0841888888888889,1.0841366666666667,1.0838888888888865,1.082889000000003,1.0824766000000015,1.0829199,1.0811290000000047,1.0839162135518898,1.0837803630254055,1815,-270810,-272141.2,0.11353756726744918,-190.9961777108017,0.07106926946328279
2023-06-15T07:00:00-04:00,1.08422,1.08433,1.08339,1.08344,1.08487,1.0840495555555556,1.0841533333333335,1.0839962222222197,1.0829740000000032,1.0824782000000015,1.0829495000000002,1.0811425000000048,1.0838209708415119,1.083813890420324,-2121,-272931,-272732.6,0.10635753051114276,-192.52204884396656,0.01384670771445065
2023-06-15T07:15:00-04:00,1.08344,1.0835299999999999,1.0832,1.08338,1.0848404,1.0838948888888889,1.0840622222222223,1.0840557777777753,1.0830770000000032,1.0824814000000016,1.0829762,1.0811574000000048,1.0837327766732094,1.0838151123362592,-2078,-275009,-273254.2,0.09996983668764817,-192.6371267439886,-0.07563180225051123
2023-06-15T07:30:00-04:00,1.08338,1.08339,1.0825,1.08253,1.084774784,1.0835884444444444,1.0838577777777778,1.0840522222222198,1.0831585000000032,1.0824656000000017,1.0829951000000002,1.0811691500000047,1.0834922213385676,1.0837604898690072,-2618,-277627,-273800.4,0.0792250463531927,-194.69116133942146,-0.16968377952175584
2023-06-15T07:45:00-04:00,1.08253,1.08289,1.08177,1.08177,1.08463829696,1.083170888888889,1.0835755555555557,1.0839571111111088,1.0831955000000033,1.0824244000000014,1.0830062000000003,1.0811751500000049,1.083147777070854,1.0836219918952055,-3882,-281509,-275577.2,0.05139165018727282,-197.41655463106267,-0.23425035275889616
2023-06-15T08:00:00-04:00,1.08177,1.08301,1.08144,1.0829199999999999,1.0844088332031998,1.0830397777777776,1.0833711111111113,1.0838039999999975,1.0832980000000032,1.0824040000000015,1.0830288000000001,1.0811880500000048,1.0831022216566832,1.0834591935161642,4653,-276856,-276786.4,0.030245972736000402,-192.47007802328105,-0.16962277370110107
2023-06-15T08:15:00-04:00,1.0829199999999999,1.08517,1.08262,1.0849199999999999,1.08144,1.0833495555555552,1.0834711111111115,1.0836675555555533,1.0834790000000032,1.0824168000000014,1.0830724000000003,1.081213050000005,1.0834657773253467,1.0833881548129312,8311,-268545,-275909.2,0.013915945229834954,-177.12083708212194,0.083024298444669
2023-06-15T08:30:00-04:00,1.0849199999999999,1.0879,1.08429,1.08774,1.08144,1.0842033333333332,1.083895555555556,1.08363422222222,1.0837775000000032,1.0824902000000014,1.0831451,1.0812531000000047,1.0843206218602772,1.0835057238503447,13295,-255250,-271957.4,0.01994083661916872,-142.563542535058,0.3524245331758741
2023-06-15T08:45:00-04:00,1.08774,1.08812,1.08517,1.08639,1.0816984,1.0847022222222222,1.084145555555556,1.0836917777777757,1.0839625000000033,1.0825384000000013,1.0832058000000002,1.0812858000000047,1.0847344974882218,1.0837541790802756,-9872,-265122,-269456.4,0.022427789547382126,-154.81573515461747,0.20753777187448905
2023-06-15T09:00:00-04:00,1.08639,1.08798,1.08584,1.08744,1.082083696,1.085361111111111,1.0845033333333338,1.0838773333333314,1.0841885000000033,1.0826102000000015,1.0832674000000002,1.081325000000005,1.0852755979905775,1.0841797432642202,8591,-256531,-264460.8,0.03199850307664846,-146.51250150924153,0.29698769622401366
2023-06-15T09:15:00-04:00,1.08744,1.08939,1.08737,1.08864,1.08244587424,1.0861884444444443,1.0850811111111116,1.0842193333333312,1.0844925000000034,1.0827068000000013,1.0833367000000003,1.0813700000000048,1.085948478392462,1.0847489946113762,6849,-249682,-259026,0.047632200544872674,-138.95456727838686,0.47995274311453273
2023-06-15T09:30:00-04:00,1.08864,1.08922,1.08765,1.08907,1.0830014043008,1.0869862222222222,1.0857133333333338,1.0846677777777758,1.0847735000000034,1.0828360000000012,1.0833998000000002,1.0814180000000049,1.0865727827139695,1.0853703956891008,7121,-242561,-253829.2,0.0709427839428144,-136.1418560056066,0.5252081448799104
2023-06-15T09:45:00-04:00,1.08907,1.09007,1.08885,1.0899,1.083512491956736,1.0878235555555555,1.0865322222222227,1.0851951111111091,1.0851040000000034,1.0829898000000013,1.0834678000000002,1.0814704000000048,1.0872382261711757,1.0859539165512804,5541,-237020,-250183.2,0.10270625405733719,-131.9189594057548,0.6808125409919447
2023-06-15T10:00:00-04:00,1.0899,1.0911899999999999,1.0899,1.09045,1.0841682427610624,1.0886071111111113,1.0874966666666672,1.0858653333333315,1.0854165000000033,1.0831690000000014,1.0835392000000004,1.0815255000000048,1.0878805809369405,1.086583133241024,6261,-230759,-243310.6,0.1442314653095027,-128.7594493589625,0.8023886778150644
2023-06-15T10:15:00-04:00,1.09045,1.092,1.09045,1.09178,1.085010853629735,1.0894637777777778,1.0884811111111117,1.086660888888887,1.0857870000000034,1.0833830000000013,1.0836205000000003,1.0815891500000048,1.0886604647495524,1.0872601065928191,4588,-226171,-237238.6,0.2031349848755215,-123.16355775457878,0.8181583127100885
2023-06-15T10:30:00-04:00,1.09178,1.0921399999999999,1.09115,1.09145,1.085989334121572,1.0900575555555556,1.0892066666666669,1.087485999999998,1.0861440000000033,1.0835884000000013,1.0836929000000002,1.0816392000000048,1.089218371799642,1.0879140852742548,-5670,-231841,-233670.4,0.25057010530496315,-124.87736456547444,0.6018876967887169
2023-06-15T10:45:00-04:00,1.09145,1.09175,1.09077,1.09106,1.0869734406621205,1.0904282222222224,1.089575555555556,1.0882584444444423,1.0864590000000034,1.0837858000000014,1.0837588000000002,1.0816874500000047,1.0895866974397135,1.0885168682194037,-6032,-237873,-232732.8,0.2774268714658896,-127.03273586054125,0.3052199974258545
2023-06-15T11:00:00-04:00,1.09106,1.09206,1.09098,1.09194,1.0878000901561813,1.0909011111111109,1.0901922222222225,1.0889904444444425,1.0868550000000035,1.0840002000000013,1.0838345000000003,1.0817466000000047,1.0900573579517707,1.0890806945755227,4316,-233557,-232040.2,0.28452591283909207,-123.55164407823783,0.5108662634965292
2023-06-15T11:15:00-04:00,1.09194,1.09282,1.09169,1.09279,1.0884944757311923,1.0914206666666666,1.090786666666667,1.0896484444444425,1.0872985000000033,1.0842296000000013,1.0839152,1.0818090000000047,1.0906038863614165,1.0896253556604178,3617,-229940,-231876.4,0.3048722529986079,-120.73605897282904,0.4919811667770145
2023-06-15T11:30:00-04:00,1.09279,1.09342,1.09264,1.09342,1.0892730700995776,1.0919473333333334,1.0913177777777783,1.090215777777776,1.0877625000000033,1.0844680000000015,1.0839982000000001,1.0818768500000047,1.0911671090891333,1.0901266845283342,2638,-227302,-232102.6,0.31813459116074316,-119.21523612488905,0.43907995296884245
2023-06-15T11:45:00-04:00,1.09342,1.09357,1.09287,1.09327,1.0901024560796622,1.0923377777777779,1.091784444444445,1.0907313333333313,1.088215000000003,1.0847110000000015,1.0840752000000002,1.0819461500000047,1.0915876872713066,1.090600547622667,-2278,-229580,-231650.4,0.32060282241522847,-119.52774184089957,0.38565014186415764
2023-06-15T12:00:00-04:00,1.09327,1.09399,1.0931899999999999,1.09392,1.0907959648637298,1.0927648888888888,1.0922311111111116,1.0912624444444423,1.0887390000000032,1.0849618000000014,1.0841652000000002,1.082025000000005,1.0920541498170453,1.0910940380981335,2344,-227236,-229523,0.3225885480151318,-118.13412452770146,0.36884117808972494
2023-06-15T12:15:00-04:00,1.09392,1.0945,1.09387,1.09427,1.0914347718909838,1.0931726666666668,1.092655555555556,1.0917551111111092,1.0892835000000032,1.0852206000000018,1.0842576000000002,1.0820991000000049,1.0924973198536363,1.0915820304785067,2711,-224525,-227716.6,0.31520767150409496,-117.26673934414124,0.3503140905131053
2023-06-15T12:30:00-04:00,1.09427,1.09438,1.09378,1.09405,1.092047817512787,1.0934515555555555,1.0929077777777783,1.0921793333333314,1.0898595000000033,1.0854778000000016,1.0843413000000002,1.0821695500000048,1.092807855882909,1.0920228243828052,-2155,-226680,-227064.6,0.30146785013150296,-117.69999621858743,0.20791734598545442
2023-06-15T12:45:00-04:00,1.09405,1.09451,1.09391,1.09437,1.0925382540102295,1.093744,1.0932322222222224,1.0925622222222204,1.0904895000000032,1.0857406000000016,1.0844272000000001,1.0822405000000048,1.0931202847063273,1.092413459506244,2256,-224424,-226489,0.2733496537592926,-117.04013606594339,0.2675340143845374
2023-06-15T13:00:00-04:00,1.09437,1.09451,1.09393,1.09421,1.0929326032081836,1.0939395555555556,1.0935822222222227,1.092921777777776,1.0910540000000033,1.0859982000000017,1.0845103000000003,1.082308250000005,1.0933382277650618,1.0927635676049952,-2171,-226595,-225892,0.24419315403466918,-117.3575424275947,0.2887100617747866
2023-06-15T13:15:00-04:00,1.09421,1.09448,1.0942,1.09443,1.093248082566547,1.0941091111111112,1.0938588888888894,1.0932473333333315,1.0915295000000032,1.0862638000000018,1.0845926000000004,1.082383200000005,1.0935565822120494,1.0930640540839958,1365,-225230,-225490.8,0.22472552432872972,-117.08309785114214,0.22803450739052544
2023-06-15T13:30:00-04:00,1.09443,1.09465,1.09435,1.09462,1.0935004660532375,1.0942613333333333,1.0940622222222227,1.0935286666666648,1.0918735000000033,1.0865412000000017,1.0846785000000003,1.082462350000005,1.0937692657696396,1.0933184432671965,1518,-223712,-225328.2,0.2068683340309883,-116.81956340855571,0.16746126886226984
2023-06-15T13:45:00-04:00,1.09462,1.095,1.0942399999999999,1.09429,1.09373037284259,1.094306888888889,1.0941588888888891,1.093778888888887,1.0922685000000034,1.0867990000000016,1.0847591000000003,1.0825382000000048,1.0938734126157117,1.093531554613757,-1611,-225323,-225056.8,0.19198264764719283,-117.30523880275635,0.0795668636022687
2023-06-15T14:00:00-04:00,1.09429,1.09463,1.09414,1.09435,1.093984298274072,1.094345111111111,1.0942788888888895,1.0939882222222206,1.0926140000000033,1.0870484000000016,1.0848417000000001,1.082612150000005,1.0939687300925693,1.0937012436910054,1934,-223389,-224849.8,0.1657300089107463,-117.19919744260511,0.09878621017680626
2023-06-15T14:15:00-04:00,1.09435,1.09456,1.09425,1.09447,1.09414,1.0943833333333333,1.0943400000000003,1.0941397777777762,1.0929055000000034,1.0873012000000015,1.0849296000000002,1.082686300000005,1.0940689840740554,1.0938473949528043,1206,-222183,-223967.4,0.14602503622561228,-117.0669545587013,0.05027789966359975
2023-06-15T14:30:00-04:00,1.09447,1.09474,1.0944,1.0947,1.09414,1.0944553333333333,1.0943877777777784,1.0942455555555537,1.0931870000000035,1.0875604000000016,1.0850200000000003,1.082761900000005,1.0941951872592444,1.093975115962243,1505,-220678,-223057,0.12672086772857916,-116.75068275591097,0.03929560346166215
2023-06-15T14:45:00-04:00,1.0947,1.09511,1.09467,1.0950199999999999,1.09425,1.0945817777777775,1.094495555555556,1.0943322222222203,1.0934430000000033,1.0878344000000015,1.0851159000000004,1.082835850000005,1.0943601498073954,1.0940932927697942,1655,-219023,-222119.2,0.10763211950511008,-116.26689724389874,0.08866139573144878
2023-06-15T15:00:00-04:00,1.0950199999999999,1.09513,1.09472,1.09507,1.0944,1.0946966666666667,1.0945733333333338,1.0944151111111093,1.0936740000000031,1.0881178000000016,1.0852503000000002,1.082912250000005,1.0945021198459164,1.094219034215835,2157,-216866,-220427.8,0.0944219913581451,-116.1684058921424,0.06396374169612863
2023-06-15T15:15:00-04:00,1.09507,1.09526,1.09477,1.09488,1.094546,1.0947580000000001,1.094647777777778,1.094488888888887,1.0938290000000033,1.0883948000000014,1.0853884000000003,1.082988250000005,1.094577695876733,1.0943408273726678,-1724,-218590,-219468,0.07977931380425624,-116.46752832267182,0.061231390683705186
2023-06-15T15:30:00-04:00,1.09488,1.09493,1.09453,1.09454,1.09526,1.0947364444444445,1.0946600000000004,1.094552888888887,1.0939835000000033,1.0886682000000014,1.0854994000000004,1.083066300000005,1.0945701567013864,1.094441061898134,-1906,-220496,-219130.6,0.07077147305006219,-117.05941053807445,0.01005089407271863
2023-06-15T15:45:00-04:00,1.09454,1.09491,1.09453,1.09477,1.09526,1.0947584444444445,1.0946766666666672,1.0946106666666648,1.0941690000000033,1.0889376000000015,1.0856130000000004,1.083145700000005,1.0946101253611091,1.094524049518507,2379,-218117,-218618.4,0.059418205623699906,-116.55950190065609,0.013703385649823182
2023-06-15T16:00:00-04:00,1.09477,1.09492,1.09471,1.09475,1.0952453999999998,1.0947731111111112,1.0947277777777782,1.0946571111111094,1.0943095000000034,1.0891972000000016,1.0857272000000002,1.0832255000000048,1.0946381002888872,1.094579639614805,-952,-219069,-218627.6,0.044538002004916095,-116.57689368157823,0.042036388891418634
2023-06-15T16:15:00-04:00,1.09475,1.0948499999999999,1.09473,1.09477,1.095231092,1.0947815555555556,1.094774444444445,1.0946973333333316,1.0944085000000032,1.0894388000000015,1.0858512000000002,1.0833064000000048,1.0946644802311098,1.094612111691844,420,-218649,-218984.2,0.036604214967935825,-116.56922069687847,0.038378946406550644
2023-06-15T16:30:00-04:00,1.09477,1.09479,1.09462,1.09464,1.09521707016,1.0947546666666665,1.094793333333334,1.094726444444443,1.0944695000000033,1.0896732000000016,1.0859716000000004,1.0833872000000049,1.0946595841848878,1.0946284893534748,-514,-219163,-219098.8,0.03120158066002842,-116.63025634820248,0.015532632232953253
2023-06-15T16:45:00-04:00,1.09464,1.09472,1.09447,1.09447,1.0952033287568,1.09469,1.0947677777777782,1.0947479999999983,1.0945295000000033,1.0899114000000016,1.0860895000000004,1.0834645500000049,1.0946216673479103,1.0946387914827795,-817,-219980,-218995.6,0.02663173200710786,-116.75713824544724,-0.021010322462770847
2023-06-15T17:00:00-04:00,1.09447,1.09447,1.0942,1.09439,1.0951739956065278,1.0946144444444446,1.0946977777777782,1.0947522222222206,1.0945530000000032,1.0901302000000015,1.0862024000000003,1.083543200000005,1.0945753338783282,1.0946318331862233,-107,-220087,-219389.6,0.018925402589400175,-116.76495938261866,-0.057533195740708705
2023-06-15T17:15:00-04:00,1.09439,1.0944099999999999,1.09415,1.09425,1.0951155558701362,1.094524888888889,1.0946066666666672,1.0947279999999984,1.0945520000000033,1.0903494000000016,1.0863104000000003,1.0836203500000048,1.0945102671026625,1.0946062665489786,-75,-220162,-219608.2,0.010454503333201703,-116.77455376853227,-0.07488105783192334
2023-06-15T17:30:00-04:00,1.09425,1.0943,1.09414,1.09428,1.0950383114005253,1.0944595555555556,1.0945400000000005,1.0946811111111094,1.0945635000000034,1.0905510000000016,1.0864206000000003,1.0836956500000048,1.09446421368213,1.0945662132391827,151,-220011,-219880.6,0.00319334253383725,-116.77041394673653,-0.05480052608506466
2023-06-15T17:45:00-04:00,1.09428,1.09428,1.09404,1.0942399999999999,1.0949484802604728,1.0943995555555557,1.0945066666666672,1.094623777777776,1.094557000000003,1.0907484000000016,1.0865391000000002,1.0837711000000048,1.094419370945704,1.0945181705913458,-102,-220113,-220070.6,-0.003480453554872866,-116.77414242573641,-0.027408774462348472
2023-06-15T18:00:00-04:00,1.0942399999999999,1.09478,1.09423,1.09472,1.094839462629216,1.0944422222222223,1.0945011111111116,1.0945704444444426,1.0945825000000033,1.0909566000000013,1.0866587000000003,1.0838482000000047,1.0944794967565632,1.0944897364730763,614,-219499,-219974.4,-0.0033585865392959297,-116.50480480327697,-0.0045671693597838375
2023-06-15T18:15:00-04:00,1.09472,1.09479,1.0946,1.09461,1.09404,1.0944639999999999,1.0944855555555562,1.0945279999999982,1.094591500000003,1.0911536000000013,1.0867805000000004,1.0839254500000048,1.0945055974052507,1.094475789178461,-538,-220037,-219964.4,-0.006560440889039945,-116.55886428880743,-0.012788307832820915
2023-06-15T18:30:00-04:00,1.09461,1.09469,1.09454,1.09464,1.094055,1.0944948888888888,1.0944711111111116,1.0945008888888872,1.0945925000000032,1.0913660000000014,1.0868971000000003,1.0840027500000047,1.0945324779242005,1.0944802313427684,602,-219435,-219819,-0.008478900848658886,-116.54236526175671,-0.01187464033540958
2023-06-15T18:45:00-04:00,1.09464,1.09494,1.09459,1.09489,1.0940697,1.0945786666666666,1.0944988888888894,1.094492666666665,1.0946225000000032,1.0915854000000014,1.0870140000000001,1.0840807500000047,1.0946039823393603,1.0945081850742144,1038,-218397,-219496.2,-0.008557107270982786,-116.30530102145866,0.022838558795573106
2023-06-15T19:00:00-04:00,1.09489,1.09513,1.0948499999999999,1.0949,1.094104512,1.0946588888888888,1.094546666666667,1.094500666666665,1.0946500000000032,1.0918006000000013,1.0871306,1.0841597500000046,1.0946631858714881,1.0945569480593715,885,-217512,-218976,-0.008835294193984355,-116.29721801768653,0.0392884227068746
2023-06-15T19:15:00-04:00,1.0949,1.09513,1.09473,1.09475,1.0941660412799998,1.0946995555555554,1.0945866666666673,1.0945177777777761,1.0946640000000032,1.0920112000000015,1.0872439,1.0842386000000048,1.0946805486971904,1.0945971584474967,-470,-217982,-218672.6,-0.00801731356875682,-116.36160745964474,0.032895037418097385
2023-06-15T19:30:00-04:00,1.09475,1.09489,1.09469,1.0947,1.0942238788032,1.0947222222222224,1.0946366666666671,1.0945479999999983,1.0946640000000032,1.0922364000000016,1.0873573,1.0843173500000047,1.0946844389577524,1.094632926757997,-524,-218506,-218366.4,-0.006185841469757982,-116.38553986430328,0.04112405757368622
2023-06-15T19:45:00-04:00,1.0947,1.09471,1.0945,1.09454,1.094278246075008,1.0947028888888888,1.094665555555556,1.0945868888888872,1.0946400000000032,1.0924596000000013,1.0874705000000002,1.0843955500000046,1.094655551166202,1.0946575414063973,-555,-219061,-218291.6,-0.002840634735714067,-116.46665797885518,0.02375991519539323
2023-06-15T20:00:00-04:00,1.09454,1.09508,1.0945,1.09503,1.0943293513105075,1.0947757777777778,1.094753333333334,1.094637777777776,1.094638000000003,1.0927096000000014,1.0875876000000002,1.0844757500000046,1.0947304409329615,1.0946828331251175,1428,-217633,-218138.8,0.003967316619699066,-115.82737572329593,0.07219622751864933
2023-06-15T20:15:00-04:00,1.09503,1.09507,1.09461,1.09464,1.094377390231877,1.094753111111111,1.094744444444445,1.0946773333333317,1.0946260000000032,1.0929670000000014,1.0876957000000003,1.0845544000000047,1.0947123527463691,1.094692666500094,-853,-218486,-218333.6,0.00949215657313064,-116.13117561918911,-0.007307804735444495
2023-06-15T20:30:00-04:00,1.09464,1.09467,1.09438,1.0946,1.09513,1.0947242222222222,1.0947433333333338,1.094708666666665,1.0946290000000032,1.0932006000000012,1.0878023000000003,1.0846316500000046,1.0946898821970954,1.0946945332000748,-1148,-219634,-218664,0.009614079537110713,-116.17312548398488,-0.0009135673893044565
2023-06-15T20:45:00-04:00,1.0946,1.0946,1.09396,1.0942,1.0951149999999998,1.0946155555555555,1.094694444444445,1.0947202222222205,1.0946005000000032,1.0933862000000014,1.0879015000000003,1.0847069500000048,1.0945919057576763,1.09467602656006,-1714,-221348,-219232.4,0.0073477015923712015,-116.79947300819457,-0.04019586348023057
2023-06-15T21:00:00-04:00,1.0942,1.09463,1.0942,1.0944,1.0950688,1.0945566666666668,1.0946400000000005,1.0947151111111095,1.0945830000000032,1.0935194000000013,1.0880048000000004,1.0847836000000048,1.094553524606141,1.0946556212480476,1391,-219957,-219411.6,0.006764866719469414,-116.54522332806299,-0.04475335421822096
2023-06-15T21:15:00-04:00,1.0944,1.09443,1.09398,1.0942,1.095024448,1.0944686666666665,1.0945622222222229,1.0946768888888871,1.0945545000000032,1.0936756000000012,1.0881070000000002,1.0848600000000048,1.0944828196849128,1.094606096998438,-1459,-221416,-220168.2,0.002853928459031016,-116.81185344502202,-0.06393277924923947
2023-06-15T21:30:00-04:00,1.0942,1.09448,1.09399,1.09447,1.09498187008,1.094450222222222,1.0945311111111116,1.0946342222222207,1.0945460000000033,1.0938162000000013,1.0882132000000002,1.0849382000000047,1.0944802557479303,1.09455967759875,2047,-219369,-220344.8,0.00023057954686916263,-116.30674468976706,-0.025576615665662113
2023-06-15T21:45:00-04:00,1.09447,1.09487,1.09433,1.09433,1.0949409952768,1.09441,1.0944900000000006,1.094583555555554,1.0945390000000033,1.0939300000000012,1.0883184000000004,1.0850150500000049,1.0944502045983442,1.0945117420789998,-1241,-220610,-220540,-0.002257969784553194,-116.46548819118787,-0.033799214396636655
2023-06-15T22:00:00-04:00,1.09433,1.09456,1.0942399999999999,1.09446,1.094901755465728,1.0944040000000002,1.0944811111111117,1.0945408888888872,1.0945425000000033,1.094037800000001,1.0884369000000005,1.0850941000000047,1.0944521636786753,1.0944837936631997,1562,-219048,-220080,-0.004407176083021615,-116.27993173198458,-0.0073090065232956315
2023-06-15T22:15:00-04:00,1.09446,1.09453,1.09422,1.09429,1.09487,1.0943657777777778,1.0943988888888896,1.0944926666666652,1.0945445000000036,1.094125600000001,1.0885577000000004,1.0851696500000048,1.0944197309429402,1.0944570349305596,-1139,-220187,-220126,-0.006256215972168268,-116.45685002959253,-0.06757805722217318
2023-06-15T22:30:00-04:00,1.09429,1.09437,1.09402,1.09416,1.0948336,1.0943180000000001,1.0943455555555561,1.0944493333333318,1.0945385000000034,1.094199800000001,1.0886844000000002,1.0852450500000048,1.0943677847543523,1.0944340279444476,-1766,-221953,-220233.4,-0.013813326487890578,-116.66664816354233,-0.04385003288752795
2023-06-15T22:45:00-04:00,1.09416,1.09423,1.09354,1.09362,1.094798656,1.0941728888888889,1.0942366666666672,1.0943904444444428,1.0945075000000035,1.0942366000000012,1.0888098000000002,1.085318100000005,1.0942182278034818,1.0943816223555578,-3542,-225495,-221458.6,-0.020261577531133987,-118.4147288829983,-0.08953042207198803
2023-06-15T23:00:00-04:00,1.09362,1.09411,1.09361,1.09388,1.09472313664,1.0941015555555558,1.0942011111111116,1.094332666666665,1.0944655000000034,1.094285200000001,1.0889368000000001,1.0853927000000048,1.0941505822427855,1.094321697884446,1479,-224016,-222139.8,-0.025274070734801625,-118.06310766173324,-0.029245110583083347
2023-06-15T23:15:00-04:00,1.09388,1.0942399999999999,1.09377,1.09418,1.0946521484416,1.0940973333333333,1.0941766666666672,1.0942717777777762,1.0944440000000033,1.0943476000000012,1.0890667000000003,1.0854682500000048,1.0941564657942284,1.0942625583075567,1323,-222693,-222868.8,-0.023107891794955267,-117.70027078748748,-0.02010233918129651
2023-06-15T23:30:00-04:00,1.09418,1.09425,1.09406,1.0942,1.0945854195351041,1.094102,1.0941766666666672,1.0942273333333317,1.0944220000000033,1.0943928000000012,1.0891965000000001,1.0855425500000049,1.0941651726353827,1.0942116466460452,1265,-221428,-223117,-0.02315181429081057,-117.677148449298,0
2023-06-15T23:45:00-04:00,1.0942,1.0942,1.0937999999999999,1.09382,1.094522694362998,1.0940306666666666,1.094104444444445,1.0941791111111094,1.0943685000000034,1.0944134000000012,1.0893215000000003,1.0856147500000048,1.094096138108306,1.094157317316836,-1074,-222502,-223226.8,-0.023056914332646214,-118.05013327839693,-0.05938947618482365
2023-06-16T00:00:00-04:00,1.09382,1.09413,1.09365,1.09406,1.094463732701218,1.0940217777777779,1.094074444444445,1.0941466666666648,1.0943265000000033,1.0944262000000011,1.0894471000000001,1.0856887000000048,1.094088910486645,1.0941314538534688,900,-221602,-222448.2,-0.02319263857779239,-117.85266020238807,-0.024672630742097214
2023-06-16T00:15:00-04:00,1.09406,1.0942399999999999,1.09404,1.09422,1.094408308739145,1.094050888888889,1.0940477777777784,1.0941159999999983,1.0943000000000034,1.0944452000000011,1.0895781,1.085762200000005,1.094115128389316,1.0941243630827748,756,-220846,-221814.2,-0.021239515681218145,-117.74209953843915,-0.02192862233430349
2023-06-16T00:30:00-04:00,1.09422,1.0943,1.09406,1.09413,1.0943562102147963,1.0940673333333333,1.0940300000000005,1.094086666666665,1.0942715000000034,1.0944494000000011,1.0897056,1.0858357000000047,1.0941181027114528,1.0941166904662196,-724,-221570,-221589.6,-0.021557754459658927,-117.80164880641081,-0.014621352657882095
2023-06-16T00:45:00-04:00,1.09413,1.0942399999999999,1.09385,1.09387,1.0943072376019085,1.0940353333333332,1.0939977777777783,1.0940508888888874,1.0942380000000034,1.0944414000000011,1.089831,1.0859071500000048,1.0940684821691622,1.0940973523729756,-1017,-222587,-221821.4,-0.021784823732276554,-118.04332027141054,-0.026504350369244305
2023-06-16T01:00:00-04:00,1.09387,1.09404,1.09374,1.09389,1.0943,1.0940137777777779,1.0940277777777783,1.0940355555555539,1.0941810000000034,1.0944382000000012,1.0899580000000002,1.0859805500000048,1.0940327857353298,1.0940846818983805,1075,-221512,-221623.4,-0.02142423510481576,-118.02366528498607,0.024688648707960028
2023-06-16T01:15:00-04:00,1.09389,1.09425,1.09384,1.09411,1.0942544,1.0940302222222222,1.0940533333333338,1.0940313333333316,1.0941545000000032,1.094433000000001,1.0900868,1.086055250000005,1.0940482285882638,1.094076545518704,1035,-220477,-221398.4,-0.012942966950684124,-117.8155090718386,0.02102607232968447
2023-06-16T01:30:00-04:00,1.09411,1.09434,1.09393,1.09432,1.09354,1.0940835555555555,1.0940688888888892,1.0940355555555539,1.0941405000000033,1.094435200000001,1.0902167,1.0861320000000048,1.094102582870611,1.094074036414963,1348,-219129,-221055,-0.0075291340490946605,-117.55677823124665,0.012794969749038458
2023-06-16T01:45:00-04:00,1.09432,1.0945,1.09392,1.0939699999999999,1.093556,1.094063777777778,1.0940433333333337,1.0940382222222205,1.0941290000000035,1.094426000000001,1.0903449,1.0862069500000047,1.0940760662964888,1.0940656291319701,-1789,-220918,-220924.6,-0.006706770922259954,-118.12896004278271,-0.021019923231600665
2023-06-16T02:00:00-04:00,1.0939699999999999,1.0948499999999999,1.09391,1.09473,1.09359376,1.0942011111111112,1.0941444444444448,1.0940675555555537,1.0941455000000033,1.094428200000001,1.0904847000000002,1.0862875500000047,1.0942068530371911,1.094093303305576,2751,-218167,-220040.6,-0.004169330526117951,-116.21779246049046,0.08319467554076232
2023-06-16T02:15:00-04:00,1.09473,1.09578,1.09472,1.09561,1.0936691344,1.0944942222222223,1.0943166666666668,1.0941253333333314,1.0942160000000034,1.094454600000001,1.0906268000000001,1.0863722500000046,1.0944874824297528,1.0941842426444606,3797,-214370,-218612.2,0.006923857585651696,-113.16556953794337,0.14167413121766084
2023-06-16T02:30:00-04:00,1.09561,1.09623,1.09466,1.09487,1.093838003648,1.0946048888888888,1.094388888888889,1.0941924444444422,1.0942360000000035,1.094465000000001,1.0907567000000002,1.0864522000000048,1.0945639859438023,1.0942873941155682,-3200,-217570,-218030.8,0.011410323862976546,-115.3269225741514,0.059403045091484294
2023-06-16T02:45:00-04:00,1.09487,1.09531,1.09456,1.0947,1.0940772032832,1.094667111111111,1.0944522222222226,1.094269111111109,1.0942545000000032,1.094469600000001,1.0908854000000003,1.0865309000000047,1.094591188755042,1.0943851152924544,-2914,-220484,-218301.8,0.014795847763301048,-115.77937811681858,0.05209618601079939
2023-06-16T03:00:00-04:00,1.0947,1.09521,1.09436,1.09451,1.09429248295488,1.0946786666666666,1.094523333333334,1.094365111111109,1.0942570000000034,1.0944658000000012,1.0910131,1.0866087500000048,1.0945749510040335,1.0944848922339634,-3763,-224247,-218967.6,0.01748507371797305,-116.43249769295785,0.05850786656551474
2023-06-16T03:15:00-04:00,1.09451,1.0945799999999999,1.09339,1.0941,1.09623,1.094594,1.0945466666666672,1.0944455555555535,1.0942475000000034,1.094447400000001,1.0911409,1.0866885000000046,1.0944799608032267,1.0945395137871705,-3590,-227837,-220901.6,0.021153876281765332,-117.77730039005526,0.019197542714536515
2023-06-16T03:30:00-04:00,1.0941,1.09467,1.09386,1.09401,1.0961732,1.0944866666666668,1.094535555555556,1.0944893333333314,1.0942400000000034,1.0944262000000011,1.0912720000000002,1.0867658500000048,1.0943859686425814,1.0945192110297364,-3226,-231063,-224240.2,0.023469295390608137,-118.04266918632659,-0.009139848826899397
2023-06-16T03:45:00-04:00,1.09401,1.09443,1.0936299999999999,1.09426,1.096117536,1.0944315555555555,1.0945288888888893,1.0945173333333313,1.0942720000000032,1.094413800000001,1.0914043,1.0868490500000048,1.0943607749140651,1.094478568823789,2933,-228130,-226352.2,0.02440482770005864,-117.3724285121095,-0.00548285693398174
2023-06-16T04:00:00-04:00,1.09426,1.09467,1.09381,1.09463,1.09606298528,1.0944517777777776,1.0946022222222225,1.0945473333333313,1.0943095000000036,1.0944156000000012,1.0915419000000002,1.0869314500000047,1.094414619931252,1.0944432550590308,3124,-225006,-227256.6,0.022841531814722666,-116.31611648388956,0.06033072204906031
2023-06-16T04:15:00-04:00,1.09463,1.09527,1.09443,1.09486,1.0960095255744,1.0945033333333334,1.094616666666667,1.094565999999998,1.0943435000000035,1.094417400000001,1.0916775,1.0870129500000048,1.0945036959450016,1.0944290040472244,2857,-222149,-226837,0.026708962384633873,-115.71581318505811,0.011875074219210534
2023-06-16T04:30:00-04:00,1.09486,1.09535,1.09459,1.09464,1.095957135062912,1.094508,1.0945088888888894,1.0945584444444423,1.0943655000000034,1.0944152000000011,1.0918062,1.0870930000000047,1.0945309567560013,1.0944392032377794,-3198,-225347,-226339,0.023884418387195242,-116.35841589225322,-0.08853515393250476
2023-06-16T04:45:00-04:00,1.09464,1.09535,1.09451,1.09503,1.0959057923616538,1.0946122222222223,1.094526666666667,1.0945566666666646,1.0944260000000035,1.094420400000001,1.0919296,1.087175500000005,1.094630765404801,1.0944881625902234,2747,-222600,-224646.4,0.014972365738632148,-115.3797105644745,0.01461360709490058
2023-06-16T05:00:00-04:00,1.09503,1.09511,1.09423,1.09423,1.0958554765144206,1.0945528888888891,1.0944744444444447,1.0945457777777758,1.0944345000000038,1.0944122000000012,1.0920427000000001,1.0872518000000049,1.0945506123238409,1.0945261300721785,-2688,-225288,-224078,0.007340287824981423,-117.34349237867114,-0.0429341372065379
2023-06-16T05:15:00-04:00,1.09423,1.09467,1.09395,1.09465,1.0958061669841321,1.0945880000000001,1.0944900000000002,1.0945233333333313,1.0944560000000036,1.094415800000001,1.0921636000000001,1.0873282000000046,1.0945704898590727,1.0945573040577428,2397,-222891,-223655,0.004316169886941423,-116.42344814665441,0.012791112004440977
2023-06-16T05:30:00-04:00,1.09465,1.0948499999999999,1.09446,1.09479,1.0957578436444495,1.094648,1.094566666666667,1.0945133333333312,1.0944890000000034,1.094423800000001,1.0922770000000002,1.0874062500000046,1.0946143918872582,1.0945794432461942,1767,-221124,-223450,0.004394378502583827,-116.19745810417503,0.06306553331504043
2023-06-16T05:45:00-04:00,1.09479,1.09495,1.09452,1.09493,1.0957104867715606,1.0947206666666665,1.0946688888888891,1.0945453333333313,1.0945420000000035,1.0944374000000012,1.0923934000000002,1.0874860500000048,1.0946775135098066,1.0946087545969552,1864,-219260,-222232.6,0.008496952974807145,-115.95909275556932,0.084094295298949
2023-06-16T06:00:00-04:00,1.09493,1.09494,1.09461,1.09467,1.0956640770361294,1.0947208888888889,1.0947144444444445,1.0945828888888867,1.0945810000000034,1.0944452000000013,1.0924981,1.0875644500000048,1.0946760108078453,1.094617803677564,-1943,-221203,-221953.2,0.011046089471542904,-116.42047384842444,0.037468243379089196
2023-06-16T06:15:00-04:00,1.09467,1.09473,1.09434,1.09442,1.095618595495407,1.0946619999999998,1.0946911111111115,1.0946262222222198,1.0945965000000033,1.0944488000000012,1.0925986,1.0876384000000048,1.0946248086462762,1.094632642942051,-1629,-222832,-221462,0.010201844250205646,-116.79250377525182,-0.01918456464741908
2023-06-16T06:30:00-04:00,1.09442,1.09498,1.09429,1.09483,1.095574023585499,1.0946897777777778,1.0946877777777781,1.0946657777777755,1.0946220000000033,1.0944510000000014,1.0927038000000002,1.0877129500000047,1.094665846917021,1.0946517143536407,1924,-220908,-221065.4,0.00889642559496858,-116.07172016384116,-0.0027400763567921463
2023-06-16T06:45:00-04:00,1.09483,1.09495,1.0944099999999999,1.09444,1.095530343113789,1.0946402222222222,1.0946655555555558,1.0946855555555532,1.0946455000000033,1.0944476000000014,1.0928006000000001,1.0877841500000047,1.0946206775336167,1.0946529714829123,-1534,-222442,-221329,0.004537370883259639,-116.61816116381361,-0.018270847036466597
2023-06-16T07:00:00-04:00,1.09444,1.09585,1.09443,1.09579,1.09339,1.094865111111111,1.0947500000000003,1.0947017777777757,1.0946985000000033,1.0944706000000013,1.0929183,1.0878641000000047,1.0948545420268934,1.0946883771863296,3952,-218490,-221175,0.007125239792111205,-111.74333933712613,0.06940449120116289
2023-06-16T07:15:00-04:00,1.09579,1.0957999999999999,1.09505,1.09574,1.0934392000000002,1.0950631111111113,1.0949177777777779,1.0947424444444422,1.0947050000000034,1.0944876000000014,1.0930365,1.0879409500000046,1.0950316336215147,1.0947595017490637,-1791,-220281,-220990.6,0.00921716715912039,-111.82506119989198,0.13799658207140184
2023-06-16T07:30:00-04:00,1.09574,1.09609,1.09556,1.09579,1.093487416,1.0952375555555556,1.0950444444444447,1.094813111111109,1.0947510000000034,1.0945054000000014,1.093153,1.0880175000000045,1.0951833068972117,1.0948712013992508,2157,-218124,-220049,0.022683884090331813,-111.72663456583625,0.10414287671859873
2023-06-16T07:45:00-04:00,1.09579,1.09659,1.09579,1.09601,1.09359151936,1.0954306666666667,1.0951800000000003,1.0949115555555533,1.0948165000000034,1.0945306000000015,1.0932709,1.0880954000000047,1.0953486455177692,1.0950077611194005,2452,-215672,-219001.8,0.03014653975959974,-111.23435046030534,0.11143689657377204
2023-06-16T08:00:00-04:00,1.09601,1.09684,1.09592,1.09668,1.0937714281984001,1.0957306666666666,1.0953744444444449,1.0950533333333312,1.0949250000000033,1.0945702000000015,1.0934033,1.0881764000000047,1.0956149164142155,1.0952066088955204,3030,-212642,-217041.8,0.038794398819875016,-109.38208633862715,0.15982756888569502
2023-06-16T08:15:00-04:00,1.09668,1.09705,1.09633,1.0965,1.0940169139425282,1.0959557777777778,1.0955777777777782,1.0952188888888865,1.0950450000000034,1.0946094000000015,1.0935345,1.0882553500000045,1.0957919331313724,1.095394087116416,-3616,-216258,-216595.4,0.04447488584516596,-109.97558672160145,0.1671736687768915
2023-06-16T08:30:00-04:00,1.0965,1.09667,1.09527,1.09536,1.0943202225482753,1.0959122222222224,1.0956822222222227,1.0953717777777756,1.0951125000000033,1.0946160000000016,1.0936628000000002,1.0883289500000046,1.0957055465050978,1.0955288696931327,-3846,-220104,-216560,0.04529432177273327,-113.97416401298361,0.08589024323385364
2023-06-16T08:45:00-04:00,1.09536,1.09549,1.09474,1.09509,1.0945932002934478,1.0957937777777778,1.0957111111111115,1.095505111111109,1.0951540000000033,1.0946250000000015,1.0937960000000002,1.0884011000000047,1.095582437204078,1.095608695754506,-3529,-223633,-217661.8,0.04671409823957945,-114.84404240912731,0.02374797913830704
2023-06-16T09:00:00-04:00,1.09509,1.0954,1.09423,1.09442,1.09705,1.0955355555555555,1.095708888888889,1.0956108888888867,1.0951435000000032,1.0946214000000014,1.093911,1.0884699000000047,1.0953499497632624,1.0956089566036045,-4036,-227669,-220061.2,0.04227416023522528,-117.3133554336274,-0.001827418588513854
2023-06-16T09:15:00-04:00,1.09442,1.09561,1.09436,1.09532,1.0969936,1.0954577777777779,1.095656666666667,1.0956673333333309,1.0951665000000033,1.0946438000000014,1.094015,1.0885437000000047,1.0953439598106098,1.0955547652828834,3687,-223982,-222329.2,0.04730807076595128,-114.28133847487257,-0.042891429927264385
2023-06-16T09:30:00-04:00,1.09532,1.09582,1.09472,1.09542,1.096938328,1.0954104444444446,1.0956211111111114,1.0956759999999979,1.0952055000000032,1.0946642000000013,1.0940918000000002,1.0886184500000047,1.095359167848488,1.0954682122263066,5961,-218021,-222681.8,0.04149355943299916,-113.73711395601056,-0.02920400825012101
2023-06-16T09:45:00-04:00,1.09542,1.09549,1.09469,1.09534,1.09688416144,1.0953542222222221,1.0955711111111113,1.0956537777777755,1.0952210000000033,1.0946870000000013,1.0941813,1.0886935500000048,1.0953553342787903,1.095398169781045,-5264,-223285,-223318,0.034796484264131546,-114.12155097560161,-0.041066262696325156
2023-06-16T10:00:00-04:00,1.09534,1.09671,1.09416,1.09418,1.0968310782112,1.095076,1.095367777777778,1.0955851111111088,1.0952185000000032,1.0946812000000015,1.0942487,1.0887580500000047,1.0951202674230323,1.095305735824836,-11575,-234860,-225563.4,0.023792752602723958,-126.37984520387829,-0.1669692794773769
2023-06-16T10:15:00-04:00,1.09418,1.09449,1.09314,1.0936,1.096724235082752,1.0947224444444443,1.095025555555556,1.0954484444444421,1.0951660000000032,1.0946666000000014,1.0942983000000002,1.0888175000000047,1.0948162139384259,1.0951989886598685,-6679,-241539,-228337.4,0.004526486468568961,-129.92023161196485,-0.2808476492687195
2023-06-16T10:30:00-04:00,1.0936,1.09392,1.09326,1.09326,1.09671,1.0943693333333333,1.0946655555555558,1.0952502222222198,1.0950895000000032,1.0946426000000014,1.0943402000000002,1.0888700000000044,1.0945049711507406,1.0950311909278947,-6201,-247740,-233089,-0.020659593730462084,-131.84812115110168,-0.29548563611492307
2023-06-16T10:45:00-04:00,1.09326,1.09334,1.09176,1.09251,1.0964958,1.0939382222222223,1.094348888888889,1.0949957777777755,1.0949685000000031,1.0946070000000014,1.0943663000000001,1.0889170500000045,1.0941059769205925,1.0947805527423156,-8946,-256686,-240822,-0.047185606867388354,-137.98527059405055,-0.26018843120068263
2023-06-16T11:00:00-04:00,1.09251,1.09307,1.09229,1.09296,1.096116936,1.0936604444444444,1.0941122222222226,1.0947039999999977,1.0948830000000032,1.0945830000000014,1.0943914000000001,1.0889653000000046,1.093876781536474,1.0944848421938524,5244,-251442,-246453.4,-0.06054192854706479,-135.8252903650374,-0.19450456126893365
2023-06-16T11:15:00-04:00,1.09296,1.09316,1.09234,1.09284,1.09576838112,1.0934059999999999,1.093936666666667,1.0944177777777755,1.094804000000003,1.0945674000000016,1.0944020000000003,1.0890112500000044,1.0936694252291792,1.0941946737550818,-4726,-256168,-250715,-0.07313890519958671,-136.34417486218234,-0.14436870671222335
2023-06-16T11:30:00-04:00,1.09284,1.0931,1.09234,1.09236,1.0954477106304001,1.0930906666666667,1.0936077777777782,1.09413422222222,1.094680500000003,1.0945370000000014,1.0944111000000003,1.0890520000000046,1.0934075401833434,1.0939129390040654,-4122,-260290,-254465.2,-0.08300258738699673,-138.15465032062104,-0.27024066026367394
2023-06-16T11:45:00-04:00,1.09236,1.09249,1.09216,1.09239,1.095152693779968,1.092847111111111,1.0932711111111117,1.0938553333333312,1.0945780000000032,1.0945012000000014,1.0944244000000003,1.0890916000000046,1.0932040321466747,1.0936527512032521,2636,-257654,-256448,-0.0991647089528701,-138.08225660426385,-0.2766062332256201
2023-06-16T12:00:00-04:00,1.09239,1.09276,1.09239,1.0926,1.0948812782775705,1.0927128888888888,1.092966666666667,1.0935788888888867,1.0944185000000028,1.0944692000000016,1.0944310000000004,1.0891327500000045,1.0930832257173397,1.0934482009626014,2470,-255184,-256147.6,-0.11693270495812373,-137.60742618655578,-0.25015063815801164
2023-06-16T12:15:00-04:00,1.0926,1.09292,1.09257,1.09287,1.0946315760153649,1.0926935555555557,1.0928211111111115,1.0933206666666646,1.094275000000003,1.0944502000000014,1.0944318000000004,1.0891735000000045,1.0930405805738719,1.093280960770081,2398,-252786,-256416.4,-0.1268121302414646,-137.01483969561676,-0.11972435979454225
2023-06-16T12:30:00-04:00,1.09287,1.09326,1.09272,1.09317,1.0944018499341357,1.0927633333333333,1.0927733333333338,1.0930879999999978,1.0941440000000031,1.0944324000000014,1.0944293000000003,1.0892137500000043,1.0930664644590975,1.0931603686160647,1926,-250860,-255354.8,-0.12487232724914926,-136.48614003325991,-0.03931967812727967
2023-06-16T12:45:00-04:00,1.09317,1.09338,1.09299,1.09337,1.094190501939405,1.0928826666666667,1.0927855555555561,1.0929235555555536,1.094012000000003,1.0944154000000015,1.0944303000000004,1.0892527500000044,1.093127171567278,1.0931042948928515,1683,-249177,-253132.2,-0.11645503509016969,-136.17822818057465,0.01006165047656134
2023-06-16T13:00:00-04:00,1.09337,1.09349,1.0931899999999999,1.09343,1.0939960617842526,1.0930115555555555,1.0928877777777783,1.092846888888887,1.093849500000003,1.0944014000000015,1.0944254000000002,1.0892953000000043,1.0931877372538223,1.093101035914281,1611,-247566,-251114.6,-0.10368391293120743,-136.08982260881035,0.08420975551709456
2023-06-16T13:15:00-04:00,1.09343,1.09394,1.09338,1.09377,1.09176,1.0931879999999998,1.0929777777777783,1.0928491111111092,1.093713000000003,1.0943994000000015,1.0944204000000004,1.0893390000000043,1.0933041898030578,1.0931452287314247,1612,-245954,-249268.6,-0.07950977677668634,-135.58857424357433,0.07411067193675683
2023-06-16T13:30:00-04:00,1.09377,1.09389,1.0935,1.09359,1.0918036,1.0933104444444446,1.0930611111111115,1.092897111111109,1.0936245000000029,1.0943934000000015,1.0944158000000004,1.0893785500000044,1.0933613518424463,1.0932093829851397,-1193,-247147,-248140.8,-0.061089740658823256,-135.78490436782332,0.06862852750631643
2023-06-16T13:45:00-04:00,1.09359,1.09398,1.09351,1.09393,1.091846328,1.0934842222222223,1.0932355555555562,1.0929895555555535,1.093566500000003,1.0943898000000016,1.0944114000000003,1.0894193000000043,1.0934750814739571,1.0932911063881117,1547,-245600,-247088.8,-0.044900337100436026,-135.303938009316,0.14372551173606424
2023-06-16T14:00:00-04:00,1.09393,1.09415,1.09385,1.09414,1.0919316748799999,1.093665111111111,1.0934300000000006,1.0931184444444426,1.093552500000003,1.0943862000000015,1.0944107000000003,1.0894605000000044,1.0936080651791658,1.0933872851104893,1826,-243774,-246008.2,-0.02448893926361106,-134.9534036972488,0.1601991962577393
2023-06-16T14:15:00-04:00,1.09414,1.09425,1.09398,1.09409,1.0920647743871998,1.093797111111111,1.093595555555556,1.093259999999998,1.0934910000000029,1.0943886000000014,1.0944073000000003,1.0894999500000044,1.0937044521433326,1.0934906280883914,-1473,-245247,-245544.4,-0.007507030220168107,-135.02071683816297,0.13637195680029207
2023-06-16T14:30:00-04:00,1.09409,1.09414,1.09372,1.09411,1.0922395924362238,1.0939,1.0937333333333337,1.093411111111109,1.093425500000003,1.0943762000000015,1.0944022000000002,1.0895403500000043,1.0937855617146661,1.093586902470713,1669,-243578,-245069.2,0.011570319192288136,-134.9902074650768,0.11346271743207406
2023-06-16T14:45:00-04:00,1.09411,1.09455,1.09404,1.09444,1.092400425041326,1.0940413333333334,1.093874444444445,1.0935737777777759,1.093380500000003,1.0943528000000016,1.0944037000000002,1.0895814000000044,1.0939164493717328,1.0936979219765703,2148,-241430,-243925.8,0.03019646865970874,-134.34233842083046,0.11617589213023632
2023-06-16T15:00:00-04:00,1.09444,1.09444,1.09384,1.09396,1.0926153825371934,1.0940584444444446,1.0939400000000008,1.0937146666666648,1.093369500000003,1.0943346000000014,1.0943998000000004,1.0896207500000044,1.0939251594973862,1.093787937581256,-1713,-243143,-243434.4,0.043433441180609086,-135.0936267509354,0.053961604946183864
2023-06-16T15:15:00-04:00,1.09396,1.09435,1.0939,1.09413,1.092808844283474,1.0940964444444443,1.0940177777777782,1.09383222222222,1.093396000000003,1.0943232000000014,1.0943964000000002,1.0896630000000043,1.093966127597909,1.0938595500650046,1430,-241713,-243022.2,0.05060205073571194,-134.8714065600692,0.06401873005131971
2023-06-16T15:30:00-04:00,1.09413,1.09433,1.09412,1.09418,1.0929829598551266,1.094128888888889,1.0940633333333338,1.0939257777777758,1.093442000000003,1.0943166000000015,1.0943912000000002,1.0897056000000043,1.094008902078327,1.0939204400520035,1404,-240309,-242034.6,0.05493399993945892,-134.80724599414026,0.0374850288451888
2023-06-16T15:45:00-04:00,1.09418,1.0942399999999999,1.09345,1.0935,1.093139663869614,1.094016222222222,1.094053333333334,1.0939897777777756,1.093491500000003,1.0943046000000014,1.0943760000000002,1.0897459500000044,1.0939071216626617,1.0939447520416026,-2344,-242653,-241849.6,0.05141897559261937,-136.26397157859623,-0.008229775327146875
2023-06-16T16:00:00-04:00,1.0935,1.09387,1.09346,1.09371,1.0932806974826526,1.0939475555555556,1.0940288888888894,1.0940206666666645,1.0935290000000029,1.0942986000000015,1.0943624000000003,1.0898063500000044,1.0938676973301293,1.093935001633282,1631,-241022,-241768,0.04728800524698859,-135.95074798463182,-0.020110976022241732
2023-06-16T16:15:00-04:00,1.09371,1.09394,1.09358,1.0936299999999999,1.0934076277343874,1.0938677777777777,1.0939722222222228,1.0940271111111088,1.093568500000003,1.0942860000000014,1.0943499000000003,1.0898691500000046,1.0938201578641034,1.0939140013066253,-640,-241662,-241471.8,0.041625642685282,-135.99756112522672,-0.046611950938637695
2023-06-16T16:30:00-04:00,1.0936299999999999,1.09386,1.09358,1.09375,1.09346,1.0938233333333331,1.093934444444445,1.0940104444444425,1.093638000000003,1.0942684000000014,1.0943420000000004,1.0899207000000044,1.0938061262912826,1.0938820010453,434,-241228,-241374.8,0.03409518434956401,-135.949939900498,-0.031076054072334724
2023-06-16T16:45:00-04:00,1.09375,1.09421,1.09373,1.09406,1.093569,1.0938484444444445,1.0939288888888896,1.0939835555555537,1.093721500000003,1.0942524000000013,1.0943349000000004,1.0899739500000043,1.0938569010330261,1.0938516008362398,1341,-239887,-241290.4,0.026416369354111586,-135.56986218621225,-0.004569924413439551
2023-06-18T17:15:00-04:00,1.09406,1.09406,1.09355,1.09377,1.09455,1.0938166666666667,1.0938544444444451,1.0939437777777756,1.0937800000000029,1.0942350000000014,1.0943251000000003,1.0900261500000044,1.0938395208264209,1.0938380806689918,-23,-239910,-240741.8,0.01729782917292477,-135.57595874398788,-0.061218522714828624
2023-06-18T17:30:00-04:00,1.09377,1.09409,1.09294,1.09374,1.09453,1.0937937777777778,1.0938300000000007,1.093903999999998,1.0938235000000032,1.0942092000000014,1.0943148000000005,1.0900830000000044,1.0938196166611367,1.0938284645351932,-586,-240496,-240636.6,0.0059339972332419135,-135.59203159294148,-0.020110424512789223
2023-06-18T17:45:00-04:00,1.09374,1.09406,1.09349,1.09395,1.0944664,1.0938177777777778,1.0938100000000006,1.0938715555555534,1.093862500000003,1.0942036000000015,1.0943079000000004,1.0901397500000045,1.0938456933289094,1.0938335716281546,412,-240084,-240321,0.0011405973425616148,-135.51292686969828,-0.016451427161312548
2023-06-18T18:00:00-04:00,1.09395,1.09433,1.09384,1.09389,1.094405344,1.0938337777777778,1.0937777777777784,1.09384022222222,1.0938885000000031,1.0941884000000015,1.0943021000000004,1.0901958000000045,1.0938545546631275,1.0938432573025234,-655,-240739,-240223.2,-0.004187863553609648,-135.54885172915252,-0.026503865908708023
2023-06-18T18:15:00-04:00,1.09389,1.09408,1.0937,1.09401,1.0943467302399998,1.0938802222222221,1.0938344444444452,1.0938213333333313,1.093917500000003,1.0941728000000015,1.0942983000000006,1.0902503500000045,1.093885643730502,1.0938490058420185,944,-239795,-240204.8,-0.008527854610791077,-135.44529469873822,0.04663923182441797
2023-06-18T18:30:00-04:00,1.09401,1.0941,1.09392,1.09401,1.09433,1.0939153333333334,1.0938677777777785,1.0938239999999981,1.0939295000000029,1.0941544000000014,1.0942959000000005,1.0903031500000044,1.0939105149844015,1.0938632046736145,0,-239795,-240181.8,-0.006390288154582719,-135.44529469873822,0.02742957456729544
2023-06-18T18:45:00-04:00,1.09401,1.09431,1.094,1.09429,1.09294,1.0939997777777777,1.0939411111111117,1.0938462222222203,1.093964500000003,1.0941468000000014,1.0942960000000006,1.0903583000000046,1.0939864119875211,1.0938965637388915,397,-239398,-239962.2,-0.003351778270321888,-135.34368685237482,0.060349478342776354
2023-06-18T19:00:00-04:00,1.09429,1.0943,1.09415,1.09418,1.0929674,1.0940475555555553,1.0939888888888893,1.093881999999998,1.0939770000000029,1.0941420000000013,1.0942954000000005,1.0904172500000044,1.094025129590017,1.093932450991113,-651,-240049,-239955.2,-0.0008923336348873236,-135.40912654386432,0.039314285714279355
2023-06-18T19:15:00-04:00,1.09418,1.09428,1.09398,1.09398,1.092994252,1.0940457777777775,1.0939800000000004,1.0939224444444424,1.0939690000000029,1.0941250000000016,1.0942880000000006,1.0904733500000043,1.0940161036720135,1.0939647607928902,-661,-240710,-239949.4,0.0009924469567331694,-135.52994761535163,-0.007312213224144929
2023-06-18T19:30:00-04:00,1.09398,1.09405,1.09386,1.09405,1.09302056696,1.0940597777777776,1.0940111111111115,1.0939577777777756,1.0939670000000028,1.0941172000000012,1.0942824000000007,1.0905314500000045,1.0940228829376109,1.093992208634312,822,-239888,-239968,0.0012927978107556033,-135.47735067573663,0.025599531894279236
2023-06-18T19:45:00-04:00,1.09405,1.0941,1.09391,1.09396,1.0930463556207999,1.0940495555555556,1.094035555555556,1.093991333333331,1.0939595000000029,1.0940806000000014,1.0942756000000005,1.0905863500000044,1.0940103063500888,1.0940121669074494,-735,-240623,-240133.6,0.003595478229496003,-135.53781409148542,0.020114469618017904
2023-06-18T20:00:00-04:00,1.09396,1.09463,1.09396,1.0942,1.093071628508384,1.0940824444444444,1.0940633333333336,1.0940157777777755,1.0939475000000027,1.0940498000000014,1.0942687000000006,1.0906413500000045,1.094048245080071,1.0940245335259593,1665,-238958,-240045.6,0.007408571395415951,-135.17253565351692,0.02285296402944225
2023-06-18T20:15:00-04:00,1.0942,1.09438,1.09407,1.09418,1.0931339633680486,1.0941057777777778,1.0940955555555558,1.0940371111111087,1.093958500000003,1.0940176000000015,1.0942615000000007,1.0906960500000045,1.0940745960640568,1.0940344268207673,-943,-239901,-240016,0.010642868429761,-135.18977199056692,0.026510892320059737
2023-06-18T20:30:00-04:00,1.09418,1.09421,1.09369,1.09372,1.0931938048333267,1.0940306666666666,1.0940633333333336,1.0940537777777755,1.0939380000000027,1.0939718000000014,1.0942512000000009,1.0907475500000043,1.0940036768512453,1.0940319414566138,-1348,-241249,-240123.8,0.010133683659735099,-135.75647947927982,-0.026507984387702258
2023-06-18T20:45:00-04:00,1.09372,1.0939699999999999,1.09345,1.09365,1.0932512526399936,1.093948,1.0940233333333336,1.0940562222222199,1.093911500000003,1.0939112000000015,1.0942407000000007,1.0907990000000043,1.0939329414809962,1.094013953165291,-1322,-242571,-240660.4,0.00893245419220264,-135.84108980002006,-0.03290646337784078
2023-06-18T21:00:00-04:00,1.09365,1.09405,1.09334,1.09346,1.093306402534394,1.0938353333333335,1.0939311111111114,1.094035333333331,1.0939095000000028,1.0938504000000013,1.0942299000000006,1.0908502000000042,1.093838353184797,1.0939795625322326,-1555,-244126,-241361,0.00703909899576445,-136.11124021377205,-0.07584826691278239
2023-06-18T21:15:00-04:00,1.09346,1.09381,1.09346,1.09361,1.09334,1.0937711111111112,1.093867777777778,1.0939962222222197,1.093904500000003,1.0938154000000013,1.0942157000000006,1.0909016500000044,1.0937926825478377,1.093928450025786,1285,-242841,-242137.6,0.00034389991251433915,-135.9349649042044,-0.05209380540678494
2023-06-18T21:30:00-04:00,1.09361,1.09392,1.09346,1.09348,1.09334,1.0936935555555556,1.0938122222222224,1.093939555555553,1.0938970000000028,1.0937832000000014,1.0942041000000007,1.0909499000000045,1.0937301460382702,1.0938595600206287,-1659,-244500,-243057.4,-0.005054073360667823,-136.13217414698744,-0.045704674674120635
2023-06-18T21:45:00-04:00,1.09348,1.09379,1.09347,1.09368,1.0933916,1.093667111111111,1.0937711111111115,1.0938811111111086,1.093893500000003,1.0937684000000014,1.0941949000000006,1.0909986000000045,1.093720116830616,1.093802848016503,1590,-242910,-243389.6,-0.008014236696858771,-135.8413595001718,-0.03381929527900749
2023-06-18T22:00:00-04:00,1.09368,1.0939,1.0936299999999999,1.09373,1.0934411359999998,1.093658888888889,1.0937455555555557,1.093825555555553,1.0938770000000029,1.0937366000000013,1.0941902000000008,1.0910458500000044,1.093722093464493,1.0937606784132021,1209,-241701,-243215.6,-0.01085253095082693,-135.78608739132812,-0.021024534717901243
2023-06-18T22:15:00-04:00,1.09373,1.09403,1.09364,1.09401,1.09347,1.093711777777778,1.0937244444444447,1.0937842222222198,1.093889000000003,1.0937084000000012,1.0941863000000007,1.0910955500000044,1.0937796747715942,1.0937489427305616,1191,-240510,-242492.4,-0.010177806895517007,-135.4811858159852,-0.017364284408712714
2023-06-18T22:30:00-04:00,1.09401,1.09407,1.09386,1.09386,1.0935164,1.0937388888888888,1.0936888888888892,1.093748444444442,1.093895000000003,1.0936788000000013,1.0941829000000007,1.0911449500000046,1.0937957398172753,1.093749554184449,-1134,-241644,-242253,-0.013677734806519145,-135.6366688554454,-0.02924564514064194
2023-06-18T22:45:00-04:00,1.09386,1.09393,1.09361,1.0936299999999999,1.093560944,1.093727111111111,1.0936788888888893,1.0937217777777755,1.093879000000003,1.0936678000000013,1.0941745000000005,1.0911938500000042,1.0937625918538203,1.0937560433475593,-1097,-242741,-241901.2,-0.018226909569818803,-135.86732908618808,-0.00822879713273466
2023-06-18T23:00:00-04:00,1.0936299999999999,1.09367,1.09347,1.09355,1.09463,1.0937013333333334,1.093667777777778,1.0937011111111086,1.0938620000000028,1.0936668000000014,1.0941667000000006,1.0912425500000045,1.0937200734830563,1.0937560346780473,-1211,-243952,-242109.6,-0.018040035470208816,-135.95591480530683,-0.009143693137657293
2023-06-18T23:15:00-04:00,1.09355,1.0936299999999999,1.09337,1.0936,1.0946068,1.0936877777777778,1.0936833333333336,1.093688666666664,1.0938415000000028,1.0936736000000014,1.0941581000000007,1.0912975000000045,1.093696058786445,1.0937508277424377,1130,-242822,-242333.8,-0.017234894326450003,-135.9042482148447,0.012803394728641828
2023-06-18T23:30:00-04:00,1.0936,1.09379,1.09355,1.0937,1.094557328,1.093691111111111,1.0936933333333334,1.093682444444442,1.0938260000000029,1.0936974000000013,1.0941522000000008,1.0913549500000044,1.093696847029156,1.09373426219395,1330,-241492,-242530.2,-0.013691455965108481,-135.7826315359859,0.00822962482054146
2023-06-18T23:45:00-04:00,1.0937,1.09377,1.09341,1.09369,1.09450983488,1.0936904444444444,1.0937166666666667,1.0936879999999976,1.0937960000000027,1.0937120000000013,1.094147500000001,1.0914159500000045,1.0936954776233248,1.09371420975516,-1402,-242894,-242780.2,-0.011567155894121542,-135.79545040770554,0.019204740827453954
2023-06-19T00:00:00-04:00,1.09369,1.0937,1.09343,1.09352,1.0944642414848,1.093651111111111,1.093698888888889,1.0936919999999977,1.0937630000000027,1.0937256000000013,1.0941465000000008,1.0914781500000046,1.09366038209866,1.093693767804128,-1043,-243937,-243019.4,-0.007849560110757159,-135.95757130119455,-0.01462950771705965
2023-06-19T00:15:00-04:00,1.09352,1.09366,1.09332,1.09353,1.094420471825408,1.0936173333333332,1.0936766666666669,1.0936937777777753,1.0937405000000024,1.0937490000000012,1.0941430000000008,1.0915399000000046,1.093634305678928,1.0936766142433023,1152,-242785,-242786,-0.006391281386191594,-135.94703651445099,-0.018286048659193768
2023-06-19T00:30:00-04:00,1.09353,1.09355,1.09329,1.0933,1.0943544435158836,1.093542,1.093597777777778,1.0936766666666642,1.0937030000000025,1.0937672000000012,1.0941342000000007,1.0916004500000045,1.0935674445431423,1.0936508913946417,-931,-243716,-242964.8,-0.007362382015336188,-136.14285190131733,-0.06489885832853343
2023-06-19T00:45:00-04:00,1.0933,1.09347,1.09321,1.09346,1.094269288034613,1.0935144444444445,1.0935533333333334,1.0936486666666643,1.0936780000000026,1.0937844000000012,1.0941268000000008,1.0916616500000045,1.0935459556345137,1.0936207131157132,1189,-242527,-243171.8,-0.009822566824383606,-135.96884659627736,-0.036567750900476835
2023-06-19T01:00:00-04:00,1.09346,1.09352,1.09318,1.09349,1.0941633592311517,1.0935017777777776,1.093537777777778,1.0936128888888867,1.0936425000000025,1.0937968000000011,1.0941235000000007,1.0917225000000044,1.093534764507611,1.0935885704925705,1304,-241223,-242837.6,-0.011159465407619256,-135.93307025329273,-0.012801404496932872
2023-06-19T01:15:00-04:00,1.09349,1.0937,1.09344,1.09364,1.0940453561234136,1.0935222222222223,1.0935477777777782,1.0935826666666644,1.0936155000000025,1.0938062000000013,1.0941193000000007,1.0917832000000045,1.0935558116060888,1.0935676563940562,1136,-240087,-242067.6,-0.008629964787386655,-135.7772389242455,0.008230076356812535
2023-06-19T01:30:00-04:00,1.09364,1.09405,1.09357,1.09403,1.09318,1.0936186666666667,1.0935955555555559,1.0935664444444422,1.0936310000000025,1.0938194000000012,1.0941174000000007,1.0918477500000043,1.093650649284871,1.093570925115245,1471,-238616,-241233.8,-0.003587859449533599,-135.25266959613006,0.03931967812729997
2023-06-19T01:45:00-04:00,1.09403,1.09413,1.09365,1.09402,1.0931974,1.0937035555555557,1.0936311111111114,1.0935731111111089,1.0936495000000026,1.0938312000000012,1.0941163000000007,1.0919109500000044,1.0937245194278968,1.093602340092196,-1790,-240406,-240571.8,-0.0010537022389892456,-135.26903112186528,0.029258480387683826
2023-06-19T02:00:00-04:00,1.09402,1.09403,1.09331,1.09355,1.093234704,1.0936873333333332,1.093615555555556,1.0935855555555534,1.0936540000000026,1.0938268000000013,1.0941131000000006,1.0919720500000043,1.0936896155423175,1.0936310720737565,-2296,-242702,-240606.8,-0.001989851322399211,-136.255411626792,-0.012800702209952454
2023-06-19T02:15:00-04:00,1.09355,1.09367,1.09274,1.09284,1.09413,1.0935322222222223,1.0935400000000004,1.093585999999998,1.0936155000000027,1.0938118000000012,1.0941026000000007,1.0920303000000045,1.093519692433854,1.0936280576590054,-2102,-244804,-241323,-0.007062638901039659,-137.62015946639696,-0.06218450508449904
2023-06-19T02:30:00-04:00,1.09284,1.09326,1.09283,1.09304,1.0941022,1.0934322222222221,1.093485555555556,1.0935735555555537,1.0935935000000028,1.0937940000000013,1.094091900000001,1.0920893500000044,1.0934237539470832,1.0936016461272042,2009,-242795,-241864.6,-0.008970035291861819,-137.25249356836983,-0.04480901301289215
2023-06-19T02:45:00-04:00,1.09304,1.0933599999999999,1.09285,1.09294,1.094074956,1.0933231111111112,1.093445555555556,1.0935435555555535,1.093556500000003,1.0937700000000015,1.094078100000001,1.0921474000000044,1.0933270031576665,1.0935369169017632,-2062,-244857,-243112.8,-0.012014033644955208,-137.44114174227013,-0.032927833165637604
2023-06-19T03:00:00-04:00,1.09294,1.0932,1.09259,1.09299,1.09404825688,1.0932320000000002,1.0933933333333339,1.093495999999998,1.0935195000000029,1.0937480000000013,1.0940683000000009,1.0922066000000044,1.0932596025261332,1.0934439335214106,3103,-241754,-243382.4,-0.011844564476658591,-137.29918518472843,-0.042982825160517296
2023-06-19T03:15:00-04:00,1.09299,1.09314,1.09264,1.09279,1.0939899266048,1.0931113333333333,1.093315555555556,1.0934359999999983,1.0934585000000028,1.0937216000000012,1.0940489000000009,1.0922668000000044,1.0931656820209066,1.0933391468171285,-2767,-244521,-243746.2,-0.013878739790803868,-137.8055027173682,-0.06401521733167609
2023-06-19T03:30:00-04:00,1.09279,1.09375,1.0925,1.09318,1.093933929540608,1.0930842222222221,1.093264444444445,1.0933808888888872,1.093424500000003,1.0936964000000013,1.0940246000000011,1.0923257000000044,1.0931685456167253,1.0932689174537027,3677,-240844,-242954.2,-0.01309970451586853,-136.49323778082925,-0.04206137302950742
2023-06-19T03:45:00-04:00,1.09318,1.0931899999999999,1.09252,1.09293,1.0938478937681717,1.0930173333333333,1.0931422222222227,1.0933122222222207,1.093389500000003,1.0936758000000013,1.094005200000001,1.0923809500000043,1.0931208364933802,1.0932083339629621,-2950,-243794,-243154,-0.015543463774859545,-137.16787507752352,-0.10054568887508578
2023-06-19T04:00:00-04:00,1.09293,1.09357,1.09289,1.09333,1.0937670201420815,1.093054888888889,1.093065555555556,1.0932362222222207,1.093378500000003,1.0936598000000013,1.0939915000000011,1.0924384500000044,1.093162669194704,1.0931754671703695,2953,-240841,-242350.8,-0.020639237109939274,-136.08711052718647,-0.06307014496993468
2023-06-19T04:15:00-04:00,1.09333,1.09385,1.09316,1.0937,1.0925,1.0931817777777777,1.0930822222222227,1.0931739999999983,1.093383500000003,1.0936502000000015,1.093983400000001,1.0924982500000044,1.0932701353557632,1.0931775737362954,2392,-238449,-241689.8,-0.024219043632577885,-135.27762025435032,0.01371679392802089
2023-06-19T04:30:00-04:00,1.0937,1.0937,1.09269,1.09327,1.092527,1.0932193333333333,1.0931300000000004,1.0931368888888873,1.0933620000000028,1.0936456000000014,1.0939751000000009,1.0925580000000046,1.0932701082846106,1.0931984589890362,-2145,-240594,-240904.4,-0.025343039091161347,-136.1209502351493,0.03934702243694689
2023-06-19T04:45:00-04:00,1.09327,1.09332,1.09269,1.09294,1.09255346,1.0931813333333333,1.0931188888888892,1.093107777777776,1.0933245000000027,1.0936302000000016,1.093964400000001,1.0926182000000046,1.0932040866276884,1.093205567191229,-2350,-242944,-241324.4,-0.021119172410215187,-136.83029010544655,-0.009148796018442965
2023-06-19T05:00:00-04:00,1.09294,1.09296,1.09266,1.09268,1.0925793907999999,1.0930935555555552,1.0930900000000006,1.0930973333333316,1.0932825000000028,1.0936112000000016,1.0939486000000012,1.0926764500000046,1.0930992693021508,1.0932012537529832,-2057,-245001,-241565.8,-0.020013789696640662,-137.31963078288524,-0.02378904605924634
2023-06-19T05:15:00-04:00,1.09268,1.09285,1.09239,1.09266,1.09385,1.0930075555555554,1.0930533333333337,1.0930948888888872,1.0932390000000027,1.0935894000000015,1.093928900000001,1.0927354000000045,1.0930114154417208,1.0931710030023867,-2167,-247168,-242831.2,-0.018829783202236987,-137.35929472841391,-0.03019240798176941
2023-06-19T05:30:00-04:00,1.09266,1.09266,1.09169,1.09184,1.0938208,1.0927648888888888,1.092947777777778,1.0930679999999982,1.0931660000000027,1.0935450000000015,1.0938987000000011,1.0927881000000044,1.0927771323533766,1.0930724024019092,-1911,-249079,-244957.2,-0.021989299818104362,-138.793427944602,-0.0869334455842391
2023-06-19T05:45:00-04:00,1.09184,1.09215,1.09097,1.09108,1.093735568,1.0923913333333335,1.092714444444445,1.0929848888888871,1.0930470000000028,1.0934912000000014,1.093863100000001,1.0928346500000046,1.0924377058827013,1.0929059219215274,-2910,-251989,-247236.2,-0.02796413759409686,-140.81899945691114,-0.19210011160101637
2023-06-19T06:00:00-04:00,1.09108,1.0916299999999999,1.09071,1.09162,1.09356963392,1.0921724444444443,1.0925688888888896,1.0928748888888873,1.0929535000000028,1.0934488000000016,1.0938290000000008,1.0928793000000043,1.0922741647061611,1.0927199375372219,2533,-249456,-248538.6,-0.03422276207927821,-139.56536086029132,-0.11986129029305832
2023-06-19T06:15:00-04:00,1.09162,1.09168,1.09125,1.0916,1.0933408632064001,1.0919786666666667,1.0923766666666674,1.0927322222222204,1.0928515000000025,1.0934018000000014,1.0938027000000008,1.0929227000000044,1.0921393317649288,1.0925279500297775,-1754,-251210,-249780.4,-0.03816010600084399,-139.59749658517748,-0.15823218973228664
2023-06-19T06:30:00-04:00,1.0916,1.09184,1.0915,1.0917999999999999,1.0931303941498882,1.0918633333333332,1.092165555555556,1.092554666666665,1.0927400000000027,1.0933600000000012,1.0937742000000008,1.0929689000000042,1.092071465411943,1.092339960023822,1404,-249806,-250308,-0.044146041431759146,-139.34025950199685,-0.1737222273018207
2023-06-19T06:45:00-04:00,1.0917999999999999,1.0919699999999999,1.0915,1.0919699999999999,1.0929367626178972,1.0918242222222223,1.0920211111111118,1.0923693333333317,1.0926375000000026,1.0933192000000012,1.0937460000000008,1.0930115000000042,1.0920511723295543,1.0921947680190578,1584,-248222,-250136.6,-0.051004999831810824,-139.0936209235026,-0.11890932706468474
2023-06-19T07:00:00-04:00,1.0919699999999999,1.09215,1.09169,1.09204,1.0927586216084655,1.091828,1.0919211111111116,1.092210666666665,1.0925620000000025,1.0932798000000012,1.0937171000000008,1.0930552500000044,1.0920489378636433,1.0921170144152461,1563,-246659,-249070.6,-0.05363744884961266,-138.99342586319872,-0.08234669789742556
2023-06-19T07:15:00-04:00,1.09204,1.09221,1.09177,1.09211,1.0925947318797882,1.0918657777777776,1.0918577777777783,1.0920684444444428,1.0925255000000025,1.0932362000000013,1.0936915000000007,1.0930948000000043,1.0920611502909146,1.0920744115321965,1446,-245213,-248222,-0.05496145942028848,-138.90073695070467,-0.05216531829997634
2023-06-19T07:30:00-04:00,1.09211,1.09259,1.09204,1.0924,1.09071,1.0919742222222222,1.0918288888888894,1.0919588888888874,1.0924935000000024,1.0932006000000014,1.0936713000000007,1.0931349500000043,1.0921289202327316,1.0920723292257573,1407,-243806,-246741.2,-0.05560759293350959,-138.52712073988326,-0.023795142130207655
2023-06-19T07:45:00-04:00,1.0924,1.09273,1.09201,1.09212,1.0907476,1.0920324444444445,1.0918600000000005,1.0918977777777763,1.0924525000000025,1.0931634000000015,1.0936442000000006,1.0931740000000043,1.0921271361861853,1.0920834633806056,-2272,-246078,-245995.6,-0.05654261029623296,-139.10947152714078,0.025644783118410938
2023-06-19T08:00:00-04:00,1.09212,1.09251,1.09195,1.0925,1.090826896,1.0921604444444442,1.0920177777777782,1.0918971111111095,1.0924280000000024,1.0931324000000016,1.0936248000000008,1.0932127000000045,1.0922017089489482,1.0921135707044844,2031,-244047,-245160.6,-0.04858433715204926,-138.40279094258955,0.13014627708325482
2023-06-19T08:15:00-04:00,1.0925,1.09294,1.09222,1.09254,1.09090302016,1.092264888888889,1.0921200000000004,1.0919368888888872,1.0924155000000026,1.0931040000000014,1.0935923000000007,1.0932553000000045,1.0922693671591586,1.0921576565635873,1833,-242214,-244271.6,-0.03325908522217957,-138.335678814443,0.08427841190158039
2023-06-19T08:30:00-04:00,1.09254,1.09254,1.09204,1.09236,1.0910252389504,1.0923128888888889,1.0922044444444452,1.0920062222222207,1.0923745000000025,1.0930672000000015,1.093558500000001,1.0932975000000043,1.0922874937273268,1.0922029252508698,-2005,-244219,-244072.8,-0.024611312572410605,-138.66600996936654,0.06962257237084042
2023-06-19T08:45:00-04:00,1.09236,1.09261,1.09225,1.0926,1.091140124613376,1.092392,1.092293333333334,1.0920991111111094,1.0923580000000024,1.0930356000000014,1.0935266000000008,1.0933398000000043,1.0923499949818614,1.092247140200696,1452,-242767,-243865,-0.012929330268136063,-138.34699426025963,0.073273493313806
2023-06-19T09:00:00-04:00,1.0926,1.09261,1.09224,1.09234,1.0912481171365735,1.0924013333333333,1.0923344444444452,1.0921939999999986,1.0923085000000023,1.0930080000000013,1.0934899000000007,1.0933804000000042,1.0923479959854892,1.0922913121605566,-2094,-244861,-243621.6,-0.005414241809567858,-138.84529189891958,0.033883714754086976
2023-06-19T09:15:00-04:00,1.09234,1.09234,1.09168,1.09225,1.0913496301083792,1.0923844444444444,1.0923577777777784,1.0922619999999985,1.0922360000000024,1.0929800000000014,1.0934456000000008,1.0934244500000043,1.0923283967883912,1.092316649728445,-1888,-246749,-244162,0.0018571462205890913,-139.00084786134911,0.01923006483279399
2023-06-19T09:30:00-04:00,1.09225,1.09236,1.09201,1.09219,1.0914450523018764,1.0923508888888889,1.0923666666666674,1.0923113333333319,1.0921820000000024,1.0929546000000014,1.0934025000000007,1.0934685000000044,1.0923007174307129,1.092322919782756,-2437,-249186,-245556.4,0.009813876411830617,-139.13471831225309,0.007325269432573643
2023-06-19T09:45:00-04:00,1.09219,1.09229,1.0917,1.09183,1.0915347491637637,1.0922435555555554,1.092303333333334,1.0923311111111098,1.0921265000000024,1.0929190000000013,1.0933672000000008,1.0935150000000042,1.0922065739445703,1.0923067358262046,-1772,-250958,-246904.2,0.013529262753662088,-139.71879251179698,-0.05217868912485897
2023-06-19T10:00:00-04:00,1.09183,1.09198,1.09126,1.09128,1.09294,1.092038888888889,1.0922100000000006,1.092314444444443,1.0920565000000024,1.0928750000000014,1.093329100000001,1.0935625500000044,1.0920212591556562,1.0922409886609636,-2445,-253403,-249031.4,0.010512862887119645,-140.95044029579276,-0.07691462476650478
2023-06-19T10:15:00-04:00,1.09128,1.09199,1.09121,1.09192,1.0929064,1.091980888888889,1.0921455555555564,1.0922766666666652,1.0920195000000024,1.0928398000000015,1.0933041000000008,1.0936075500000042,1.092001007324525,1.0921715909287708,1797,-251606,-250380.4,0.011995787739052436,-139.8965586155641,-0.05308924485126086
2023-06-19T10:30:00-04:00,1.09192,1.09222,1.0917,1.09195,1.092838544,1.091941777777778,1.0920800000000006,1.0922211111111095,1.0920250000000027,1.0928042000000013,1.0932704000000006,1.0936427000000044,1.09199080585962,1.0921040727430167,2489,-249117,-250854,0.010055668109321476,-139.8281744848586,-0.054002599447168106
2023-06-19T10:45:00-04:00,1.09195,1.09262,1.0917,1.09228,1.09277340224,1.0919817777777776,1.0920711111111117,1.0921619999999985,1.0920850000000024,1.0927696000000013,1.0932390000000007,1.0936654000000043,1.092048644687696,1.0920536581944131,2993,-246124,-250241.6,0.0057559528330098225,-138.92365504715556,-0.007323592954710902
2023-06-19T11:00:00-04:00,1.09228,1.09264,1.09219,1.09242,1.0927108661504,1.0920515555555557,1.0920511111111117,1.092111555555554,1.0921250000000025,1.0927408000000012,1.0932098000000008,1.0936955500000043,1.0921229157501569,1.0920369265555305,2149,-243975,-248845,0.0004621934484227879,-138.64821285284634,-0.016474464579907467
2023-06-19T11:15:00-04:00,1.09242,1.09289,1.09242,1.09272,1.09121,1.0921853333333333,1.0920933333333338,1.0920882222222208,1.0921810000000023,1.0927226000000012,1.093195200000001,1.0937219500000044,1.0922423326001254,1.0920811412444245,1572,-242403,-246645,-0.0032351989643549742,-138.21651076024463,0.03478770346227593
2023-06-19T11:30:00-04:00,1.09272,1.09282,1.09238,1.09257,1.0912436,1.0922806666666667,1.0921288888888894,1.0920848888888872,1.0922195000000026,1.0927030000000013,1.093184900000001,1.0937416000000042,1.0923078660801002,1.0921425129955393,-943,-243346,-244993,-0.005358344170992049,-138.34595837720036,0.029297322041666102
2023-06-19T11:45:00-04:00,1.09257,1.09269,1.09212,1.09218,1.091276528,1.092290888888889,1.0921277777777783,1.0920944444444427,1.0922300000000025,1.0926746000000014,1.0931741000000008,1.0937571500000045,1.09228229286408,1.0922008103964314,-997,-244343,-244038.2,-0.0076558962386720645,-138.7018440412769,-0.0009155916095244886
2023-06-19T12:00:00-04:00,1.09218,1.09263,1.09192,1.09194,1.09130879744,1.0922533333333333,1.0921400000000003,1.0921082222222205,1.0922250000000024,1.0926394000000013,1.0931684000000006,1.0937673500000045,1.092213834291264,1.0922338483171452,-1115,-245458,-243905,-0.009814034723244932,-138.9468585993168,0.010074828498926797
2023-06-19T12:15:00-04:00,1.09194,1.09216,1.09181,1.09212,1.0913404214912,1.0922493333333332,1.0922333333333336,1.0921446666666648,1.0922255000000023,1.0926080000000011,1.0931600000000006,1.0937757000000046,1.0921950674330112,1.092248278653716,810,-244648,-244039.6,-0.007507644979575422,-138.81333477932665,0.07697382889817021
2023-06-19T12:30:00-04:00,1.09212,1.09215,1.09161,1.09187,1.0913714130613759,1.0921766666666666,1.0922277777777782,1.0921715555555536,1.0921990000000024,1.0925750000000012,1.0931503000000007,1.0937761500000043,1.092130053946409,1.0922258229229727,-864,-245512,-244661.4,-0.001059452275878155,-139.01111524301203,-0.004579090043236273
2023-06-19T12:45:00-04:00,1.09187,1.09189,1.09156,1.0916,1.0914017848001483,1.092051111111111,1.0921888888888893,1.0921835555555535,1.0921730000000023,1.092536400000001,1.0931427000000007,1.0937769000000044,1.092024043157127,1.092169058338378,-867,-246379,-245268,-0.000501404367869286,-139.2255088979343,-0.03205274966803173
2023-06-19T13:00:00-04:00,1.0916,1.09172,1.09157,1.0917,1.0914315491041453,1.091953333333333,1.092124444444445,1.092182888888887,1.0921330000000022,1.0925044000000013,1.0931358000000007,1.0937801000000043,1.0919592345257016,1.0921044466707024,442,-245937,-245586.8,-0.0009592259217587419,-139.1850178755818,-0.05309993774490286
2023-06-19T13:15:00-04:00,1.0917,1.09182,1.09168,1.0917999999999999,1.0914607181220624,1.0918884444444443,1.092055555555556,1.0921659999999982,1.0920960000000022,1.0924712000000012,1.0931278000000006,1.0937794000000043,1.0919273876205613,1.092047157336562,306,-245631,-245621.4,-0.0023022124781570063,-139.15698819709868,-0.0567547280350108
2023-06-19T13:30:00-04:00,1.0917999999999999,1.09189,1.09178,1.09186,1.0914893037596212,1.0918493333333334,1.0919600000000005,1.0921113333333314,1.0920710000000022,1.0924386000000013,1.0931177000000007,1.0937747500000043,1.091913910096449,1.0919909258692495,252,-245379,-245767.6,-0.004465029314458045,-139.14313950686233,-0.07870268687311122
2023-06-19T13:45:00-04:00,1.09186,1.09189,1.09171,1.09173,1.0915173176844288,1.0918033333333332,1.0918666666666672,1.0920391111111094,1.0920275000000024,1.0924004000000012,1.0931033000000006,1.0937663000000044,1.0918771280771593,1.0919403406953996,-242,-245621,-245789.4,-0.010783516437625656,-139.17195272467413,-0.07688294571514429
2023-06-19T14:00:00-04:00,1.09173,1.0921,1.09171,1.09194,1.0915447713307402,1.091818,1.0918400000000004,1.0919693333333313,1.0920075000000022,1.0923586000000014,1.0930890000000006,1.0937596500000044,1.0918897024617273,1.0919134725563198,413,-245208,-245555.2,-0.013674921475650626,-139.09251000532052,-0.021974399824206448
2023-06-19T14:15:00-04:00,1.09194,1.09198,1.0917999999999999,1.09182,1.0915716759041254,1.091814,1.091826666666667,1.091909777777776,1.0919860000000021,1.0923146000000012,1.0930729000000006,1.0937491500000045,1.091875761969382,1.0918967780450557,-170,-245378,-245443.4,-0.014704362511869287,-139.1111923505043,-0.010989614813991426
2023-06-19T14:30:00-04:00,1.09182,1.09182,1.09164,1.09166,1.091598042386043,1.0917806666666665,1.0917755555555562,1.091853777777776,1.0919595000000022,1.0922768000000014,1.0930518000000005,1.0937361000000043,1.0918326095755055,1.0918778224360444,-248,-245626,-245442.4,-0.014696019166374478,-139.14753533744351,-0.042119913562603466
2023-06-19T14:45:00-04:00,1.09166,1.0919699999999999,1.0916,1.09191,1.09289,1.0918075555555555,1.0917800000000004,1.0918177777777758,1.091963500000002,1.0922582000000014,1.0930350000000006,1.0937254000000045,1.0918480876604044,1.0918646579488356,219,-245407,-245448,-0.0153983018691356,-139.0973823594101,0.0036634397867914685
2023-06-19T15:00:00-04:00,1.09191,1.09199,1.09187,1.09194,1.0928642,1.0918395555555556,1.091817777777778,1.0918079999999981,1.091996500000002,1.0922362000000014,1.0930151000000006,1.0937132500000046,1.0918664701283236,1.0918625263590684,304,-245103,-245344.4,-0.015236875855718809,-139.08903002267905,0.03114694027116224
2023-06-19T15:15:00-04:00,1.09194,1.0919699999999999,1.09191,1.0919699999999999,1.092838916,1.09187,1.0918477777777782,1.0918095555555536,1.0919990000000022,1.0922168000000014,1.0929934000000006,1.0937020500000045,1.091887176102659,1.0918620210872547,192,-244911,-245285,-0.014857033215360875,-139.08375500756833,0.024732069249793213
2023-06-19T15:30:00-04:00,1.0919699999999999,1.09207,1.09189,1.09206,1.09281413768,1.0919124444444444,1.0918766666666668,1.0918195555555537,1.0920045000000023,1.0921982000000012,1.0929731000000005,1.0936902000000044,1.0919217408821271,1.0918712168698037,234,-244677,-245144.8,-0.012170744512529936,-139.06446876344071,0.023813885326996614
2023-06-19T15:45:00-04:00,1.09206,1.09207,1.09181,1.09182,1.0927898549264001,1.091901111111111,1.0918722222222226,1.0918388888888868,1.0919815000000024,1.0921788000000012,1.0929502000000004,1.0936762000000044,1.0919013927057017,1.091884973495843,-543,-245220,-245063.6,-0.011420766957084886,-139.18380286596258,-0.0036634733390764384
2023-06-19T16:00:00-04:00,1.09182,1.0919,1.09173,1.09188,1.0927660578278722,1.0919026666666665,1.0918888888888894,1.0918606666666648,1.0919545000000022,1.0921528000000011,1.0929246000000006,1.0936641500000044,1.0918971141645615,1.0918947787966744,290,-244930,-244968.2,-0.009493487345176776,-139.16786617310112,0.013739660905157177
2023-06-19T16:15:00-04:00,1.09188,1.09206,1.09179,1.09199,1.0927427366713147,1.0919228888888888,1.0918944444444447,1.091875999999998,1.0919180000000022,1.0921340000000013,1.0929049000000006,1.0936523500000044,1.0919156913316492,1.0919046230373395,324,-244606,-244868.8,-0.005237433212536916,-139.1352252235462,0.004579006172509984
2023-06-19T16:30:00-04:00,1.09199,1.0921399999999999,1.09199,1.09211,1.0927198819378885,1.091966,1.0919266666666667,1.0918917777777757,1.0918950000000023,1.0921096000000012,1.0928847000000006,1.0936405500000044,1.0919545530653194,1.0919180984298715,192,-244414,-244769.4,-0.0010204762480408654,-139.11412612923218,0.026561154769092106
2023-06-19T16:45:00-04:00,1.09211,1.09224,1.09201,1.09212,1.0926974842991308,1.0920046666666667,1.091977777777778,1.091911999999998,1.0918920000000025,1.0920780000000012,1.0928641000000006,1.0936276500000046,1.0919876424522554,1.0919312787438973,409,-244005,-244635,0.003689486533750419,-139.11038108523476,0.042137661909377
2023-06-19T17:00:00-04:00,1.09212,1.09224,1.09182,1.09201,1.0926755346131483,1.0920111111111113,1.091988888888889,1.0919353333333313,1.0918955000000026,1.0920528000000012,1.0928492000000005,1.0936126000000046,1.0919921139618043,1.0919494229951177,-218,-244223,-244435.6,0.0076363342982424445,-139.13233837930503,0.009158263959482832
2023-06-19T17:15:00-04:00,1.09201,1.09223,1.09192,1.09221,1.0926540239208853,1.0920553333333334,1.0920188888888889,1.0919613333333311,1.0919000000000025,1.0920382000000013,1.0928342000000004,1.0935983000000045,1.0920356911694433,1.0919771383960941,137,-244086,-244266.8,0.009206231803769777,-139.10724703398768,0.024726633331501043
2023-06-19T17:30:00-04:00,1.09221,1.09227,1.09191,1.09209,1.0926329434424675,1.0920695555555555,1.0920322222222225,1.0919888888888867,1.0919110000000025,1.092026400000001,1.0928188000000005,1.0935843500000046,1.0920465529355547,1.0920033107168752,-362,-244448,-244235.2,0.01071081709700299,-139.14701960519648,0.010989312893222343
2023-06-19T17:45:00-04:00,1.09209,1.09222,1.09205,1.09222,1.0926122845736181,1.092107111111111,1.09205,1.0920135555555532,1.0919420000000024,1.0920176000000013,1.0928035000000005,1.0935727500000048,1.0920812423484438,1.0920286485735002,135,-244313,-244215,0.011473831291851878,-139.1309495010842,0.014651209640490263
2023-06-19T18:00:00-04:00,1.09222,1.09253,1.09215,1.09244,1.0925920388821457,1.0921851111111112,1.092118888888889,1.0920417777777756,1.0919790000000025,1.0920296000000014,1.0927873000000006,1.0935611000000047,1.092152993878755,1.0920617188588,431,-243882,-244190.4,0.01129025505806092,-139.04413548925504,0.056785917092566994
2023-06-19T18:15:00-04:00,1.09244,1.0926,1.09237,1.09252,1.0916,1.0922653333333332,1.09219,1.0920819999999978,1.0920150000000024,1.0920584000000013,1.0927748000000006,1.0935499500000045,1.092226395103004,1.09210857508704,542,-243340,-244013.8,0.014124306104004319,-139.00444452224548,0.05861449976187621
2023-06-19T18:30:00-04:00,1.09252,1.09263,1.09231,1.09239,1.0916199999999998,1.0923053333333335,1.0922344444444445,1.092125111111109,1.0920415000000023,1.0920738000000014,1.0927613000000007,1.0935380500000045,1.0922591160824031,1.092153260069632,-569,-243909,-243978.4,0.01622138528048676,-139.07215037660052,0.036630372073000295
2023-06-19T18:45:00-04:00,1.09239,1.09245,1.09226,1.09228,1.0916603999999999,1.0923144444444444,1.0922533333333333,1.092169333333331,1.0920690000000024,1.0920874000000014,1.0927446000000005,1.0935262500000045,1.0922632928659224,1.0921966080557055,-340,-244249,-243938.6,0.017045224132610445,-139.10638723340077,0.015566197544203743
2023-06-19T19:00:00-04:00,1.09228,1.09239,1.09215,1.0922,1.0916991839999999,1.0923037777777775,1.092262222222222,1.0922117777777756,1.0920820000000022,1.0920954000000014,1.0927277000000006,1.0935149000000046,1.0922506342927378,1.0922304864445642,-475,-244724,-244020.8,0.015819597289550045,-139.1411768477853,0.007325202358722485
2023-06-19T19:15:00-04:00,1.0922,1.09227,1.09191,1.09192,1.0917364166399999,1.0922353333333334,1.0922522222222222,1.092238444444442,1.0920870000000025,1.0920944000000015,1.0927068000000006,1.0935025500000046,1.0921845074341903,1.0922367891556513,-690,-245414,-244327.2,0.01407544227796367,-139.3180675271481,-0.008241682768465809
2023-06-19T19:30:00-04:00,1.09192,1.09231,1.09189,1.09219,1.0917721599744,1.092222888888889,1.09225,1.0922504444444419,1.0921135000000022,1.0920974000000014,1.0926886000000007,1.0934922500000048,1.0921856059473523,1.0922286313245209,442,-244972,-244653.6,0.014110098007984751,-139.20877380599634,-0.0018311496873228575
2023-06-19T19:45:00-04:00,1.09219,1.09248,1.09219,1.09235,1.0918064735754238,1.0922428888888889,1.092278888888889,1.0922593333333308,1.0921355000000024,1.0921022000000014,1.0926692000000007,1.0934826000000046,1.0922184847578817,1.0922205050596165,447,-244525,-244776.8,0.012383026185242594,-139.14329069408362,0.023807561647842847
2023-06-19T20:00:00-04:00,1.09235,1.0926,1.09208,1.09226,1.0918394146324069,1.0922391111111112,1.0922833333333335,1.092265333333331,1.0921515000000024,1.0920994000000015,1.0926500000000008,1.0934727000000046,1.0922267878063054,1.092213204047693,-1934,-246459,-245218.8,0.01241335829123327,-139.30263522651356,0.0036622658438812696
2023-06-19T20:15:00-04:00,1.09226,1.09229,1.09169,1.09188,1.09263,1.0921584444444445,1.092221111111111,1.0922571111111088,1.0921470000000024,1.0920946000000014,1.0926290000000007,1.0934585000000046,1.0921574302450443,1.0921945632381547,-1595,-248054,-245884.8,0.009561842623674474,-139.85753973642886,-0.05126139650691259
2023-06-19T20:30:00-04:00,1.09188,1.09198,1.0917,1.09191,1.0926112,1.0920962222222221,1.0921533333333333,1.092237333333331,1.0921395000000023,1.0920828000000014,1.0926076000000007,1.0934450000000047,1.0921079441960355,1.0921792505905237,1549,-246505,-246103,0.004970601508537195,-139.8149801144924,-0.05583421813788301
2023-06-19T20:45:00-04:00,1.09191,1.09203,1.09167,1.092,1.0925927759999998,1.0920655555555556,1.09211,1.092209333333331,1.0921485000000022,1.0920720000000015,1.0925880000000006,1.0934318000000045,1.0920863553568285,1.0921594004724189,1634,-244871,-246082.8,0.000470900322536381,-139.680298684704,-0.03570153516600211
2023-06-19T21:00:00-04:00,1.092,1.09223,1.09185,1.09192,1.0925558649599998,1.0920275555555554,1.0920699999999999,1.092167555555553,1.0921505000000022,1.0920632000000012,1.0925652000000008,1.0934169500000046,1.0920530842854628,1.092126320377935,-1439,-246310,-246439.8,-0.00426860560446704,-139.78571993012537,-0.03295858204855128
2023-06-19T21:15:00-04:00,1.09192,1.09207,1.09157,1.09171,1.0925204303615998,1.0919555555555556,1.0920155555555555,1.0921139999999974,1.0921365000000023,1.0920454000000013,1.0925405000000008,1.0934010000000045,1.0919844674283703,1.092077856302348,-1541,-247851,-246718.2,-0.008746564160882209,-140.08208779590313,-0.04486357809925851
2023-06-19T21:30:00-04:00,1.09171,1.09187,1.0911899999999999,1.09126,1.0924634045399038,1.0918044444444444,1.0919422222222221,1.0920582222222197,1.0920940000000021,1.0920238000000013,1.0925159000000009,1.0933835500000044,1.0918395739426963,1.0920142850418784,-2275,-250126,-247132.6,-0.014171105856053428,-141.0198368318194,-0.06044398857060086
2023-06-19T21:45:00-04:00,1.09126,1.09146,1.09109,1.09131,1.0923615321767115,1.091678,1.0918444444444446,1.0919964444444419,1.0920535000000022,1.0920050000000012,1.0924925000000008,1.0933666000000044,1.091733659154157,1.0919394280335026,2230,-247896,-247410.8,-0.016268997029719772,-140.91766136492768,-0.08057206163762641
2023-06-19T22:00:00-04:00,1.09131,1.09142,1.09105,1.09116,1.0922343789590403,1.0915411111111113,1.0917122222222224,1.0919168888888866,1.0920110000000023,1.0919844000000014,1.0924695000000006,1.0933497000000045,1.0916189273233257,1.091845942426802,-2463,-250359,-248508.4,-0.02151557000741585,-141.25619945218082,-0.1089394424863848
2023-06-19T22:15:00-04:00,1.09116,1.0917999999999999,1.09113,1.09176,1.0920922534839554,1.0915506666666666,1.0916566666666665,1.09183422222222,1.0919885000000022,1.0919830000000013,1.0924510000000007,1.0933333500000046,1.0916471418586606,1.0917647539414417,2186,-248173,-248881,-0.025828559068680347,-140.05417591759345,-0.045776646585972657
2023-06-19T22:30:00-04:00,1.09176,1.09199,1.09171,1.09194,1.09105,1.0916073333333332,1.0916633333333334,1.0917637777777753,1.0919810000000023,1.0919962000000012,1.0924356000000006,1.0933198500000045,1.0917057134869286,1.0917090031531533,1763,-246410,-248592.8,-0.027581894241276387,-139.7635076388511,0.005495109352671446
2023-06-19T22:45:00-04:00,1.09194,1.09238,1.09188,1.09224,1.0910688000000002,1.0917226666666666,1.0917000000000001,1.091715333333331,1.0919820000000022,1.0920026000000014,1.0924212000000006,1.0933080500000045,1.091812570789543,1.0917036025225226,1935,-244475,-247462.6,-0.0249391021919639,-139.23188502222348,0.03022227106631165
2023-06-19T23:00:00-04:00,1.09224,1.09238,1.09212,1.09223,1.091121248,1.0918286666666666,1.0917255555555554,1.091691555555553,1.0919715000000023,1.0920082000000013,1.0924062000000005,1.0932982000000044,1.0918960566316345,1.0917360820180182,-1625,-246100,-247103.4,-0.022052279207589627,-139.24676270478417,0.021062271062266706
2023-06-19T23:15:00-04:00,1.09223,1.09224,1.09195,1.09206,1.09117159808,1.0918955555555556,1.091741111111111,1.0916973333333309,1.0919485000000022,1.0920038000000012,1.0923867000000005,1.0932865000000045,1.0919288453053075,1.0917980656144146,-1342,-247442,-246520,-0.019846071929589815,-139.45563812479645,0.012821452121037163
2023-06-19T23:30:00-04:00,1.09206,1.09232,1.09195,1.09226,1.0912199341568,1.0919993333333333,1.0918022222222221,1.0917264444444421,1.0919420000000024,1.0920006000000013,1.0923707000000005,1.0932768000000046,1.091995076244246,1.0918676524915314,870,-246572,-246199.8,-0.015598814367683036,-139.29630621995608,0.05037967958524246
2023-06-19T23:45:00-04:00,1.09226,1.09227,1.09188,1.09198,1.091266336790528,1.0920348888888889,1.091882222222222,1.0917702222222196,1.0919270000000023,1.0919858000000011,1.0923542000000006,1.0932643500000045,1.0919920609953968,1.091924921993225,-946,-247518,-246421.4,-0.011338451917194608,-139.53881258291,0.06597877682679233
2023-06-20T00:00:00-04:00,1.09198,1.09204,1.09165,1.09171,1.091310883318907,1.0920004444444444,1.0919266666666667,1.0918155555555529,1.0919025000000024,1.0919686000000013,1.0923358000000005,1.0932512500000044,1.0919356487963174,1.09194953759458,-1120,-248638,-247254,-0.004731740822397652,-139.8157407317772,0.036653196616905914
2023-06-20T00:15:00-04:00,1.09171,1.09195,1.09161,1.0919,1.0913536479861505,1.0919951111111112,1.0920088888888888,1.0918722222222197,1.0919015000000025,1.0919630000000013,1.0923188000000006,1.0932384500000045,1.091928519037054,1.0919560300756639,903,-247735,-247581,0.0019799432622986577,-139.65858361129636,0.06781773525424181
2023-06-20T00:30:00-04:00,1.0919,1.09191,1.09145,1.0915,1.0913947020667045,1.0918933333333334,1.09198,1.0919199999999973,1.0918670000000026,1.0919542000000013,1.0922968000000006,1.0932245000000045,1.091842815229643,1.0919388240605312,-1320,-249055,-247903.6,0.006925567161967206,-140.14214437693445,-0.02381475782224564
2023-06-20T00:45:00-04:00,1.0915,1.09157,1.09126,1.09137,1.09238,1.0917713333333332,1.0919166666666666,1.0919428888888862,1.0918180000000026,1.0919392000000012,1.0922736000000006,1.0932105500000047,1.0917482521837145,1.0918894592484247,-1369,-250424,-248674,0.006930176185545949,-140.30519522439204,-0.052200670366499946
2023-06-20T01:00:00-04:00,1.09137,1.0916,1.09127,1.09152,1.0923576,1.0916919999999999,1.0918366666666666,1.0919337777777751,1.0917810000000026,1.0919322000000014,1.0922536000000005,1.0932000500000045,1.0917026017469715,1.0918315673987398,1854,-248570,-248884.4,0.006703628944660163,-140.05037788471788,-0.065919578114705
2023-06-20T01:15:00-04:00,1.09152,1.09177,1.09117,1.09176,1.092335648,1.0916766666666666,1.0917844444444444,1.0919053333333308,1.0917750000000026,1.0919354000000012,1.0922359000000006,1.0931894500000043,1.0917140813975772,1.0917872539189917,1954,-246616,-248480,0.004488083680164171,-139.62073848278294,-0.04303122968605243
2023-06-20T01:30:00-04:00,1.09176,1.09223,1.0916299999999999,1.09207,1.09228902208,1.091733777777778,1.0917855555555556,1.0918606666666641,1.0917830000000026,1.091942800000001,1.0922236000000005,1.0931789000000045,1.0917852651180617,1.0917586031351931,1717,-244899,-247912.8,0.002193865290002273,-139.1332045925506,0.0009157006025369954
2023-06-20T01:45:00-04:00,1.09207,1.09261,1.09195,1.09261,1.09117,1.0918986666666668,1.0918244444444443,1.091829555555553,1.0918135000000027,1.091959000000001,1.0922151000000004,1.0931709500000044,1.0919502120944493,1.0917800825081545,1924,-242975,-246696.8,0.004178248075733385,-138.18183700622376,0.03204365261019102
2023-06-20T02:00:00-04:00,1.09261,1.09272,1.09205,1.09217,1.0911988,1.0919677777777779,1.0918455555555555,1.091815333333331,1.0918260000000026,1.091965200000001,1.0922019000000005,1.0931627000000044,1.0919941696755595,1.0918292660065234,-3030,-246005,-245813,0.0026124760344434094,-139.40203451494142,0.01739958607301732
2023-06-20T02:15:00-04:00,1.09217,1.09322,1.09216,1.09321,1.0912596479999999,1.0922406666666666,1.0920122222222222,1.091850444444442,1.0919010000000027,1.091994800000001,1.0921976000000004,1.0931584500000044,1.0922373357404476,1.0919362128052186,2584,-243421,-244783.2,0.008251296461283872,-136.9414651896534,0.13739912614156294
2023-06-20T02:30:00-04:00,1.09321,1.09322,1.09257,1.09281,1.0913772691199999,1.0924002222222222,1.092113333333333,1.0919162222222198,1.0919785000000028,1.092012200000001,1.0921854000000004,1.0931514000000044,1.092351868592358,1.092063770244175,-2656,-246077,-244675.4,0.01352763942724218,-137.91328213241817,0.08334096528985863
2023-06-20T02:45:00-04:00,1.09281,1.09283,1.09196,1.09215,1.0914878329728,1.0924075555555557,1.092185555555555,1.0919962222222197,1.0920205000000027,1.092018800000001,1.0921667000000006,1.0931415000000044,1.0923114948738866,1.0921690161953397,-2493,-248570,-245409.6,0.011935432667391796,-139.41892355224437,0.05955107650023266
2023-06-20T03:00:00-04:00,1.09215,1.09294,1.0915,1.09278,1.09322,1.0925264444444445,1.092342222222222,1.0920997777777752,1.0921015000000027,1.0920412000000013,1.0921590000000005,1.0931360500000045,1.0924051958991092,1.0922600129562716,4624,-243946,-245603.8,0.017245747321141112,-136.75159763547413,0.12919541493720127
2023-06-20T03:15:00-04:00,1.09278,1.0935,1.09256,1.0933,1.0915,1.092718,1.0925399999999996,1.0922386666666641,1.0921785000000026,1.092069000000001,1.0921636000000006,1.0931331000000044,1.0925841567192873,1.0923780103650174,3643,-240303,-244463.4,0.02558498177298,-135.0180739619081,0.16307534447375152
2023-06-20T03:30:00-04:00,1.0933,1.0946,1.09325,1.09391,1.0915,1.092992,1.0927788888888885,1.0923919999999974,1.0922770000000028,1.092108400000001,1.0921723000000005,1.0931321000000045,1.09284932537543,1.0925004082920138,4212,-236091,-242997.4,0.0380904964280012,-132.66801450887598,0.1969297281453684
2023-06-20T03:45:00-04:00,1.09391,1.09462,1.0935,1.09438,1.091624,1.0933122222222222,1.093035555555555,1.092576444444442,1.0923840000000027,1.0921566000000011,1.0921867000000007,1.0931324000000044,1.093155460300344,1.092661126633611,3700,-232391,-240260.2,0.05143435548195096,-131.07830420364073,0.21152490224983855
2023-06-20T04:00:00-04:00,1.09438,1.09447,1.0936,1.0939,1.09180376,1.0934851111111112,1.0931788888888885,1.0927751111111088,1.0924675000000026,1.092193400000001,1.0921958000000007,1.0931320500000044,1.0933043682402752,1.0928597013068886,-3080,-235471,-237640.4,0.06094610746107524,-132.42920608415702,0.1180659155599906
2023-06-20T04:15:00-04:00,1.0939,1.09413,1.09364,1.09402,1.0919727343999999,1.0936533333333334,1.093384444444444,1.0929835555555532,1.0925655000000025,1.092237400000001,1.0922081000000006,1.0931285000000044,1.0934474945922201,1.0930681610455109,2795,-232676,-235386.4,0.06604522352238441,-132.12259670487214,0.16938754955729485
2023-06-20T04:30:00-04:00,1.09402,1.09405,1.09322,1.09387,1.092131570336,1.0937504444444446,1.0934577777777774,1.0931671111111085,1.0926460000000024,1.092277200000001,1.0922150000000006,1.0931198000000044,1.0935319956737761,1.0932577288364087,-3245,-235921,-234510,0.07371046991164981,-132.567515444932,0.06037266398952469
2023-06-20T04:45:00-04:00,1.09387,1.09404,1.09316,1.09379,1.09228087611584,1.093816888888889,1.0935666666666664,1.0933246666666643,1.0927365000000024,1.092313200000001,1.0922236000000005,1.0931144000000044,1.0935835965390208,1.0934045830691268,-3186,-239107,-235113.2,0.0723458831356227,-132.80052302352868,0.08967707103704951
2023-06-20T05:00:00-04:00,1.09379,1.094,1.0932,1.09321,1.0924212235488897,1.0937455555555555,1.093684444444444,1.093454444444442,1.0928115000000025,1.092335200000001,1.0922224000000005,1.0931069500000044,1.0935088772312167,1.0934752664553014,-3144,-242251,-237085.2,0.07064250647365454,-134.46768033891837,0.097056265165047
2023-06-20T05:15:00-04:00,1.09321,1.09324,1.0926,1.09297,1.0925531501359562,1.0936026666666667,1.093705555555555,1.0935597777777752,1.0928650000000026,1.092352200000001,1.0922151000000004,1.0930992500000043,1.0934011017849734,1.093494613164241,-3077,-245328,-239056.6,0.07265176999664326,-135.14319556472134,0.017386848221957983
2023-06-20T05:30:00-04:00,1.09297,1.09327,1.09255,1.09265,1.09462,1.0933915555555556,1.0936333333333328,1.093609555555553,1.0929225000000025,1.0923650000000011,1.0922089000000004,1.0930920000000044,1.0932508814279787,1.0934552905313928,-2396,-247724,-242066.2,0.0681918696993554,-135.84469697830107,-0.059453032104640945
2023-06-20T05:45:00-04:00,1.09265,1.09276,1.09227,1.09252,1.0945786,1.0931688888888889,1.0934788888888884,1.0936137777777752,1.0929800000000025,1.092371200000001,1.0922047000000004,1.0930845500000044,1.093104705142383,1.0933698324251142,-2451,-250175,-244917,0.05660762922034255,-136.13630911393454,-0.12706712618039898
2023-06-20T06:00:00-04:00,1.09252,1.09328,1.09246,1.09307,1.094486256,1.0930871111111111,1.0933333333333328,1.0935671111111085,1.0930575000000027,1.0923908000000009,1.0922086000000002,1.0930786000000043,1.0930977641139064,1.0932726659400913,2087,-248088,-246713.2,0.041511510425878466,-135.08566473213824,-0.11970247994297432
2023-06-20T06:15:00-04:00,1.09307,1.09337,1.09286,1.09303,1.09439760576,1.0930264444444444,1.0932366666666664,1.093477555555553,1.0931210000000025,1.0924070000000008,1.0922123000000004,1.0930706000000043,1.093084211291125,1.0931877327520731,-2181,-250269,-248316.8,0.022579765428627788,-135.16547663805468,-0.07953194990402673
2023-06-20T06:30:00-04:00,1.09303,1.09343,1.09294,1.09322,1.0943125015296,1.093023111111111,1.0931477777777774,1.0933659999999974,1.0931785000000025,1.0924226000000008,1.0922261000000004,1.0930624000000044,1.0931113690329,1.0931297862016582,2641,-247628,-248776.8,0.009997543087753845,-134.70639500260063,-0.07312480576222664
2023-06-20T06:45:00-04:00,1.09322,1.09328,1.09272,1.09281,1.0942308014684161,1.0929555555555555,1.0930299999999997,1.0932453333333307,1.0931885000000026,1.0924284000000009,1.0922434000000003,1.0930532500000043,1.09305109522632,1.0930898289613267,-2144,-249772,-249186.4,-0.0042951022763082864,-135.51047835270404,-0.09690365399908937
2023-06-20T07:00:00-04:00,1.09281,1.09321,1.09269,1.0927,1.0941523694096795,1.0928895555555556,1.0929088888888883,1.0931313333333308,1.0932150000000027,1.092434600000001,1.0922542000000002,1.0930416000000045,1.092980876181056,1.093065063169061,-2435,-252207,-249592.8,-0.01538999680674022,-135.7555804290029,-0.09965349838634796
2023-06-20T07:15:00-04:00,1.0927,1.0930199999999999,1.09254,1.0927,1.0940770746332924,1.0928477777777776,1.092852222222222,1.0930351111111085,1.0931895000000025,1.092443000000001,1.0922652000000002,1.0930339500000044,1.0929247009448448,1.0930304505352488,0,-252207,-250416.6,-0.02766912052940118,-135.7555804290029,-0.046651603991914675
2023-06-20T07:30:00-04:00,1.0927,1.0931,1.09219,1.09294,1.0940047916479607,1.0928653333333334,1.0928488888888885,1.092957555555553,1.0931960000000027,1.092457800000001,1.0922766000000004,1.0930254000000044,1.0929277607558758,1.092999160428199,2420,-249787,-250320.2,-0.028963184216292306,-135.2240530198329,-0.002744814587772262
2023-06-20T07:45:00-04:00,1.09294,1.09307,1.09236,1.09287,1.093895904149083,1.0928695555555556,1.092873333333333,1.0929026666666641,1.0932320000000026,1.092476800000001,1.0922856000000003,1.0930158000000043,1.0929162086047006,1.092960128342559,-2441,-252228,-251240.2,-0.030139231137886767,-135.38039280060772,0.02013453530408722
2023-06-20T08:00:00-04:00,1.09287,1.09342,1.09282,1.09342,1.093793549900138,1.092978888888889,1.092973333333333,1.0928913333333308,1.0932640000000027,1.0925014000000008,1.0922994000000004,1.0930082500000045,1.0930169668837606,1.0929533026740472,3070,-249158,-251117.4,-0.0286261121363713,-133.83537829751023,0.08237835462967479
2023-06-20T08:15:00-04:00,1.09342,1.09359,1.09274,1.09277,1.0936973369061298,1.0929382222222221,1.0929399999999996,1.092897555555553,1.0932375000000025,1.092509800000001,1.0923060000000002,1.0929987500000045,1.0929675735070086,1.0929506421392379,-3229,-252387,-251153.4,-0.026295787316158073,-135.75490601787396,-0.027445634771786524
2023-06-20T08:30:00-04:00,1.09277,1.09277,1.09171,1.09186,1.093606896691762,1.0927222222222222,1.0928099999999996,1.0928891111111085,1.0931350000000024,1.0925018000000009,1.0923006000000002,1.0929859500000043,1.0927460588056068,1.09291491371139,-4950,-257337,-252179.4,-0.031093441060922822,-139.87699941355635,-0.10704189272022666
2023-06-20T08:45:00-04:00,1.09186,1.09209,1.0911899999999999,1.09192,1.09359,1.0925442222222221,1.0926655555555553,1.092852444444442,1.0930120000000025,1.0925026000000009,1.0922986000000003,1.0929714000000041,1.0925808470444855,1.092845530969112,4167,-253170,-252856,-0.03258167636814846,-139.6480140124978,-0.11891476555497327
2023-06-20T09:00:00-04:00,1.09192,1.09201,1.09063,1.09078,1.09335,1.092167111111111,1.0924399999999999,1.0927657777777753,1.0928560000000025,1.092480000000001,1.0922814000000003,1.0929531000000043,1.0922206776355885,1.0927064247752898,-4538,-257708,-253952,-0.03922701474678745,-144.3858336329825,-0.18575964714817544
2023-06-20T09:15:00-04:00,1.09078,1.0914,1.09064,1.09139,1.0930236,1.0919571111111113,1.0922944444444445,1.0926299999999975,1.0927245000000025,1.092467800000001,1.0922699000000005,1.0929311000000042,1.0920545421084709,1.0925139398202315,3592,-254116,-254943.6,-0.041288083626940635,-142.377069262532,-0.11988651963026653
2023-06-20T09:30:00-04:00,1.09139,1.09245,1.09107,1.09134,1.092736368,1.0917662222222222,1.0921433333333335,1.0924706666666644,1.0925980000000026,1.092456200000001,1.0922597000000003,1.0929091000000044,1.0919116336867767,1.0923027518561852,-7173,-261289,-256724,-0.04205992984316886,-142.70568689692553,-0.1244623409902103
2023-06-20T09:45:00-04:00,1.09134,1.0919,1.09114,1.09164,1.0924836038399999,1.0916655555555554,1.091998888888889,1.0923084444444424,1.0924905000000027,1.092454800000001,1.0922501000000004,1.0928883500000044,1.0918573069494213,1.0921250014849482,5724,-255565,-256369.6,-0.04204658379652522,-141.13220842092372,-0.11894523029627234
2023-06-20T10:00:00-04:00,1.09164,1.09209,1.0913,1.09182,1.09245,1.0916297777777777,1.0918822222222222,1.0921517777777758,1.0924210000000028,1.092466000000001,1.0922449000000005,1.0928674000000043,1.0918498455595371,1.0919788011879585,6005,-249560,-255647.6,-0.04371528962823913,-140.1420468291898,-0.09607730105135975
2023-06-20T10:15:00-04:00,1.09182,1.09186,1.08998,1.09019,1.0922315999999999,1.0912913333333334,1.0915233333333334,1.0919684444444424,1.0922820000000029,1.092443600000001,1.0922243000000005,1.0928349500000043,1.0915178764476297,1.0918382409503669,-5505,-255065,-255119,-0.05509052204968752,-148.36057186078853,-0.2954034131440861
2023-06-20T10:30:00-04:00,1.09019,1.09055,1.08966,1.08988,1.09209,1.0909626666666665,1.0912022222222222,1.091749999999998,1.0921435000000028,1.092418000000001,1.0922012000000003,1.0928018500000043,1.0911903011581037,1.0916653927602933,-5209,-260274,-256350.6,-0.07403799870218844,-149.84177238546786,-0.2644655325457378
2023-06-20T10:45:00-04:00,1.08988,1.09029,1.0891899999999999,1.09013,1.09186,1.0907482222222222,1.0910099999999998,1.0915233333333312,1.0920240000000028,1.092385400000001,1.0921842000000004,1.0927757000000042,1.090978240926483,1.0914787142082347,6917,-253357,-254764.2,-0.087232372563307,-148.25512981931325,-0.15844522191489835
2023-06-20T11:00:00-04:00,1.09013,1.09096,1.09003,1.09086,1.0913794,1.0907182222222223,1.0908922222222222,1.0913019999999978,1.0919135000000026,1.092363800000001,1.0921800000000004,1.0927545500000042,1.0909545927411863,1.091298171366588,5370,-247987,-253248.6,-0.08915745874397257,-144.65913668088072,-0.09707670891640971
2023-06-20T11:15:00-04:00,1.09086,1.09095,1.09033,1.09047,1.090985308,1.090633777777778,1.0908577777777775,1.0910971111111087,1.0917855000000027,1.092328400000001,1.0921655000000003,1.0927348000000041,1.090857674192949,1.0910997370932702,-3454,-251441,-253624.8,-0.0911083644367011,-145.89399724960597,-0.02842002970351789
2023-06-20T11:30:00-04:00,1.09047,1.0908,1.0901,1.09017,1.0891899999999999,1.0904962222222223,1.0907222222222221,1.0909368888888866,1.091633000000003,1.092287200000001,1.0921477000000004,1.092709050000004,1.0907201393543593,1.090940189674616,-3572,-255013,-253614.4,-0.08423231736336742,-146.87669278455868,-0.1117840551956678
2023-06-20T11:45:00-04:00,1.09017,1.09047,1.08994,1.0899699999999999,1.0892221999999998,1.0903457777777779,1.0905699999999998,1.0908104444444422,1.0914910000000029,1.0922454000000013,1.0921246000000004,1.092681800000004,1.0905701114834874,1.0908161517396928,-2558,-257571,-253073.8,-0.08307510961851215,-147.34597739154705,-0.1255337475030782
2023-06-20T12:00:00-04:00,1.0899699999999999,1.09022,1.0895299999999999,1.0902,1.0892537559999997,1.0902717777777775,1.0904099999999997,1.090690444444442,1.091366000000003,1.092204200000001,1.0921024000000004,1.0926561000000041,1.0904960891867899,1.090719721391754,3206,-254365,-253275.4,-0.08214216217940647,-146.66946335905024,-0.1319116192151154
2023-06-20T12:15:00-04:00,1.0902,1.09081,1.09018,1.0908,1.0892846808799996,1.0903497777777778,1.0902966666666665,1.090571333333331,1.091271000000003,1.0921806000000012,1.0920832000000005,1.092639200000004,1.0905568713494318,1.090640177113403,2718,-251647,-254007.4,-0.08155555516748048,-145.17359104204436,-0.09342199263615072
2023-06-20T12:30:00-04:00,1.0908,1.0913599999999999,1.09079,1.09129,1.0893456936447996,1.0905484444444442,1.0904188888888886,1.0904835555555532,1.0911885000000028,1.0921722000000011,1.0920704000000003,1.092627650000004,1.0907034970795455,1.0906093416907228,2284,-249363,-253591.8,-0.0802645754994609,-144.14759177545082,0.10089984314661672
2023-06-20T12:45:00-04:00,1.09129,1.09162,1.09112,1.0915,1.0894665520261115,1.0907646666666668,1.0905988888888887,1.0904588888888866,1.091120000000003,1.092164200000001,1.0920636000000004,1.092618850000004,1.0908627976636365,1.0906378733525781,2113,-247250,-252039.2,-0.061980504702510125,-143.74098125029286,0.1486402172716221
2023-06-20T13:00:00-04:00,1.0915,1.09167,1.0913,1.09131,1.0896388278640226,1.0909068888888889,1.0907299999999998,1.0904908888888865,1.0910145000000029,1.0921604000000011,1.0920573000000005,1.092612850000004,1.0909522381309091,1.0907142986820624,-1974,-249224,-250369.8,-0.042070882453968575,-144.0846001234031,0.10824397090254913
2023-06-20T13:15:00-04:00,1.09131,1.09169,1.0912,1.09156,1.0898419450776202,1.091072888888889,1.0908077777777776,1.0905704444444422,1.0909540000000029,1.0921642000000011,1.0920517000000003,1.092605850000004,1.0910737905047274,1.0908298389456499,2391,-246833,-248863.4,-0.020849473089004,-143.53686391645897,0.0641695542966233
2023-06-20T13:30:00-04:00,1.09156,1.09168,1.09132,1.09142,1.0900637116683058,1.0911953333333335,1.0909133333333332,1.0906937777777757,1.0909320000000027,1.092162200000001,1.0920472000000006,1.092598750000004,1.0911430324037819,1.0909470711565201,-1352,-248185,-248171,-0.009825189323426386,-143.7102671192147,0.08711839848872563
2023-06-20T13:45:00-04:00,1.09142,1.09157,1.09121,1.09155,1.0902588662681092,1.0913226666666667,1.0910666666666664,1.090823333333331,1.0909135000000025,1.092158000000001,1.0920467000000005,1.092594700000004,1.0912244259230255,1.091051256925216,1368,-246817,-247661.8,0.0014273124756117924,-143.54732343117533,0.12658576185365006
2023-06-20T14:00:00-04:00,1.09155,1.09165,1.09114,1.09122,1.090430602315936,1.0913533333333334,1.0912055555555553,1.0909446666666645,1.0909355000000025,1.092141000000001,1.0920419000000003,1.092588850000004,1.0912235407384203,1.0911234055401728,-1707,-248524,-247916.6,0.014107690743274538,-144.06338774339181,0.11468205546943452
2023-06-20T14:15:00-04:00,1.09122,1.0916299999999999,1.09122,1.09157,1.0905817300380236,1.0914262222222224,1.0913577777777776,1.0910702222222202,1.0909445000000024,1.092120200000001,1.0920396000000003,1.092583700000004,1.0912928325907363,1.0911915244321382,1921,-246603,-247392.4,0.025324875994797633,-143.44724251144984,0.12566501559345727
2023-06-20T14:30:00-04:00,1.09157,1.09173,1.09138,1.0914,1.0907147224334608,1.0914346666666668,1.0914244444444443,1.0911935555555536,1.0909475000000026,1.092104800000001,1.0920350000000003,1.092576350000004,1.091314266072589,1.0912396195457106,-1678,-248281,-247682,0.03628064070799357,-143.70857252235157,0.05500550055004895
2023-06-20T14:45:00-04:00,1.0914,1.09175,1.09123,1.0917,1.0908568612927763,1.0914897777777777,1.0914699999999997,1.091304888888887,1.0909505000000026,1.092074600000001,1.0920347000000004,1.092569000000004,1.091391412858071,1.0912892956365683,1839,-246442,-247333.4,0.04295818756805565,-143.20307499623837,0.037570215066554204
2023-06-20T15:00:00-04:00,1.0917,1.09175,1.09123,1.09129,1.090999763485932,1.0914537777777775,1.0914466666666662,1.0913808888888867,1.0909240000000024,1.092044200000001,1.0920282000000003,1.092558600000004,1.0913711302864568,1.0913186365092546,-1454,-247896,-247549.2,0.044486540988369294,-143.74914076522225,-0.019239578561596103
2023-06-20T15:15:00-04:00,1.09129,1.0913,1.09096,1.09113,1.09175,1.0913904444444444,1.0914266666666663,1.0914251111111093,1.0909710000000026,1.092023800000001,1.0920213000000003,1.0925471000000042,1.0913229042291654,1.0913385092074035,-1107,-249003,-247645,0.04410812755023851,-143.91144409431,-0.0164939384776158
2023-06-20T15:30:00-04:00,1.09113,1.09152,1.09108,1.09152,1.09175,1.091409111111111,1.0914222222222218,1.091437999999998,1.0910530000000027,1.091998600000001,1.0920199000000004,1.0925358500000042,1.0913623233833323,1.0913524073659229,1133,-247870,-247898.4,0.040225324670481316,-143.50647859982254,-0.003664480193488219
2023-06-20T15:45:00-04:00,1.09152,1.09161,1.09121,1.09125,1.0917342,1.0913746666666666,1.091403333333333,1.0914337777777754,1.0911090000000025,1.091957600000001,1.0920133000000005,1.092524150000004,1.0913398587066658,1.0913575258927382,-1884,-249754,-248193,0.03140233350569972,-143.97250762356924,-0.01557603855527693
2023-06-20T16:00:00-04:00,1.09125,1.09144,1.0912,1.09143,1.0917187160000001,1.09138,1.0913899999999996,1.0914177777777756,1.0911375000000025,1.091908000000001,1.0920082000000004,1.092511650000004,1.0913578869653326,1.0913508207141907,1075,-248679,-248640.4,0.02581871647488779,-143.79518803594053,-0.010993541294500482
2023-06-20T16:15:00-04:00,1.09143,1.09173,1.09138,1.0917,1.09096,1.0914419999999998,1.0914433333333329,1.0914171111111088,1.0911990000000025,1.0918544000000012,1.0920055000000004,1.092499450000004,1.091426309572266,1.0913618565713523,774,-247905,-248642.2,0.02352663930429384,-143.60371446457086,0.04398746357286467
2023-06-20T16:30:00-04:00,1.0917,1.09175,1.09164,1.0917,1.0909754,1.0914933333333332,1.0914577777777774,1.091423333333331,1.0912755000000023,1.091810400000001,1.0920019000000003,1.092487500000004,1.0914810476578127,1.091393485257082,0,-247905,-248422.6,0.022556607528375218,-143.60371446457086,0.011909451523948395
2023-06-20T16:45:00-04:00,1.0917,1.09185,1.09157,1.09179,1.091006384,1.0915597777777777,1.0915011111111106,1.0914391111111086,1.0913665000000026,1.0917658000000012,1.0920016000000003,1.092475900000004,1.0915428381262502,1.0914295882056653,618,-247287,-248306,0.01750206176147152,-143.5527664019162,0.035733919736129056
2023-06-20T17:00:00-04:00,1.09179,1.09179,1.09141,1.09172,1.09105700096,1.0916035555555554,1.0915033333333328,1.0914591111111087,1.0914425000000025,1.091722800000001,1.0920000000000003,1.092462300000004,1.0915782705010002,1.0914772705645324,-104,-247391,-247833.4,0.012797214544475376,-143.55943435088074,0.001832005129626365
2023-06-20T17:15:00-04:00,1.09172,1.09191,1.09171,1.09191,1.0911045809024,1.091684888888889,1.0915722222222217,1.091495555555553,1.0914980000000025,1.091685200000001,1.0919992000000005,1.092452050000004,1.0916446164008002,1.0915346164516257,155,-247236,-247544.8,0.007259794178081648,-143.53245856954487,0.05681349595431488
2023-06-20T17:30:00-04:00,1.09191,1.09218,1.09167,1.09195,1.091169014430208,1.0917604444444444,1.091663333333333,1.091539555555553,1.0915310000000022,1.091660000000001,1.0919976000000005,1.092441150000004,1.0917056931206401,1.0915904931613007,359,-246877,-247339.2,0.008289012565068733,-143.51930730249904,0.07515144849834969
2023-06-20T17:45:00-04:00,1.09195,1.09203,1.0917,1.09179,1.0912701129871871,1.0917857777777777,1.0916933333333327,1.091586666666664,1.0915455000000025,1.091636400000001,1.0919943000000005,1.092429200000004,1.0917225544965121,1.0916387945290402,-139,-247016,-247161.4,0.012154044884714789,-143.53967453543095,0.024736147757255245
2023-06-20T18:00:00-04:00,1.09179,1.09204,1.09174,1.09191,1.0913611016884683,1.0918291111111111,1.091766666666666,1.0916397777777749,1.0915755000000025,1.091621600000001,1.0919933000000004,1.092421250000004,1.0917600435972097,1.0916822356232323,447,-246569,-247017.8,0.013938075682059318,-143.49054420817026,0.060481099656346654
2023-06-20T18:15:00-04:00,1.09191,1.09195,1.09184,1.09188,1.0914429915196215,1.0918517777777779,1.091816666666666,1.0917024444444416,1.0915915000000025,1.091608800000001,1.0919900000000005,1.092412100000004,1.0917840348777677,1.0917233884985857,-484,-247053,-246950.2,0.017222583571005725,-143.50384200743943,0.04123031252577458
2023-06-20T18:30:00-04:00,1.09188,1.0919699999999999,1.09182,1.09192,1.0915166923676594,1.0918724444444443,1.0918411111111106,1.0917562222222195,1.0916165000000024,1.091585800000001,1.0919883000000006,1.092403550000004,1.091811227902214,1.0917567107988684,539,-246514,-246805.8,0.0201406837889081,-143.48409624783213,0.020152056425767978
2023-06-20T18:45:00-04:00,1.09192,1.09205,1.09179,1.09196,1.0915830231308934,1.0918962222222224,1.0918699999999995,1.0917975555555528,1.0916370000000024,1.091564400000001,1.0919857000000006,1.092394600000004,1.0918409823217712,1.0917837686390945,590,-245924,-246615.2,0.020166382470564303,-143.46248294282807,0.02381606668500037
2023-06-20T19:00:00-04:00,1.09196,1.0922,1.09193,1.09216,1.0916427208178041,1.0919542222222223,1.0919111111111106,1.0918411111111084,1.0916840000000023,1.091543200000001,1.0919829000000008,1.092385100000004,1.091904785857417,1.0918202149112755,620,-245304,-246272.8,0.02171874250297765,-143.3489256696679,0.03388930105606219
2023-06-20T19:15:00-04:00,1.09216,1.09224,1.09209,1.09212,1.0917095943196675,1.0919959999999997,1.0919555555555551,1.0918788888888862,1.0917115000000022,1.091529400000001,1.0919789000000006,1.092376850000004,1.0919478286859334,1.0918577719290203,-360,-245664,-246091.8,0.020814977013068982,-143.36211055100398,0.03663943135602132
2023-06-20T19:30:00-04:00,1.09212,1.0921399999999999,1.09196,1.09203,1.091783851114914,1.0920108888888889,1.0919688888888885,1.0919093333333307,1.0917430000000024,1.0915160000000008,1.0919753000000005,1.092368300000004,1.0919642629487467,1.0918938175432162,-508,-246172,-245915.6,0.021647665166754433,-143.403974082484,0.0109899167513916
2023-06-20T19:45:00-04:00,1.09203,1.09213,1.09182,1.092,1.09224,1.0920171111111114,1.0919744444444441,1.0919359999999974,1.0917580000000022,1.091502000000001,1.0919725000000005,1.092358550000004,1.0919714103589975,1.0919258540345729,-1256,-247428,-246098.4,0.01985444147197389,-143.4384786290624,0.004578964238298962
2023-06-20T20:00:00-04:00,1.092,1.092,1.09164,1.09169,1.0922316,1.0919602222222222,1.0919633333333332,1.0919546666666642,1.0917780000000024,1.091477000000001,1.0919674000000006,1.092347550000004,1.091915128287198,1.0919406832276581,-1553,-248981,-246709.8,0.01751657990549833,-143.8793485924324,-0.009159270555691936
2023-06-20T20:15:00-04:00,1.09169,1.09193,1.09152,1.09162,1.092207936,1.0918915555555555,1.091931111111111,1.0919586666666643,1.0918025000000025,1.091452000000001,1.0919644000000006,1.092335600000004,1.0918561026297584,1.0919309465821265,-1250,-250231,-247695.2,0.014519884259911782,-143.95949955103788,-0.02655896548249411
2023-06-20T20:30:00-04:00,1.09162,1.09181,1.09144,1.09173,1.0921666598400002,1.0918513333333333,1.091914444444444,1.091950444444442,1.0918130000000024,1.091418200000001,1.0919598000000006,1.092324200000004,1.0918308821038067,1.0919075572657013,1330,-248901,-248342.6,0.01025393649131385,-143.8254785547204,-0.013737773381678616
2023-06-20T20:45:00-04:00,1.09173,1.09193,1.09149,1.09159,1.0921085270528001,1.0917864444444445,1.0918777777777775,1.0919322222222196,1.0918300000000023,1.091394600000001,1.0919522000000006,1.092310700000004,1.0917827056830454,1.0918712458125608,-2289,-251190,-249346.2,0.007292441288961553,-144.1190126702985,-0.030221994285290266
2023-06-20T21:00:00-04:00,1.09159,1.09168,1.09117,1.09155,1.0920550448885762,1.091720888888889,1.0918322222222219,1.0919037777777754,1.0918360000000022,1.091388400000001,1.0919451000000007,1.0922975500000038,1.0917361645464363,1.0918241966500486,-2059,-253249,-250510.4,0.002595063274050365,-144.1944622438564,-0.03754716289974188
2023-06-20T21:15:00-04:00,1.09155,1.09156,1.09118,1.09133,1.0919665403997185,1.0916204444444444,1.0917399999999997,1.0918591111111087,1.0918175000000023,1.091376600000001,1.0919396000000006,1.0922843000000038,1.091654931637149,1.091772157320039,-1771,-255020,-251718.2,-0.002739003098541897,-144.55140420711984,-0.07599619103429062
2023-06-20T21:30:00-04:00,1.09133,1.09166,1.09118,1.09143,1.0918868863597466,1.0915584444444446,1.091663333333333,1.091805555555553,1.0918040000000022,1.091389600000001,1.0919348000000006,1.0922712000000039,1.0916099453097192,1.0917229258560313,1941,-253079,-252287.8,-0.008247636709409216,-144.3735478300387,-0.06317987034392553
2023-06-20T21:45:00-04:00,1.09143,1.09168,1.09125,1.0914,1.091815197723772,1.0915057777777777,1.091593333333333,1.0917413333333308,1.0917845000000024,1.091389800000001,1.0919288000000007,1.092258400000004,1.0915679562477754,1.091670340684825,-1943,-255022,-253512,-0.01353397756724011,-144.426954828197,-0.057690722782353085
2023-06-20T22:00:00-04:00,1.0914,1.0915,1.09122,1.09143,1.0917506779513948,1.091473111111111,1.0915299999999997,1.0916717777777751,1.0917700000000026,1.091391600000001,1.0919239000000005,1.092244550000004,1.0915403649982203,1.09162187254786,1892,-253130,-253900,-0.017459672213236382,-144.37494823116572,-0.05219780219781881
2023-06-20T22:15:00-04:00,1.09143,1.0921,1.09142,1.09184,1.09117,1.0915351111111111,1.0915466666666664,1.091614666666664,1.0917665000000025,1.0913956000000011,1.0919252000000006,1.092232850000004,1.0916002919985761,1.0915946980382878,1754,-251376,-253525.4,-0.019448481369488065,-143.7160511878372,0.013740164332353732
2023-06-20T22:30:00-04:00,1.09184,1.09185,1.09123,1.09128,1.0911886,1.0914817777777777,1.0915088888888884,1.0915684444444416,1.0917330000000025,1.091384800000001,1.0919254000000005,1.092220650000004,1.091536233598861,1.0915709584306303,-1915,-253291,-253179.6,-0.02045657862166627,-144.69824638127196,-0.031146369615801008
2023-06-20T22:45:00-04:00,1.09128,1.09151,1.09117,1.09123,1.0921,1.0914259999999998,1.091453333333333,1.0915264444444417,1.0917050000000024,1.091405600000001,1.0919246000000005,1.092208550000004,1.0914749868790887,1.0915439667445042,-1758,-255049,-253573.6,-0.02088904727333152,-144.77879399508342,-0.045798869683911496
2023-06-20T23:00:00-04:00,1.09123,1.09162,1.09123,1.09143,1.0920814,1.0914213333333331,1.091435555555555,1.0914948888888862,1.0916810000000026,1.0914366000000009,1.0919273000000005,1.092198400000004,1.091465989503271,1.0915235733956032,1632,-253417,-253252.6,-0.02206710161086682,-144.47968198386675,-0.014657517932571754
2023-06-20T23:15:00-04:00,1.09143,1.09153,1.09133,1.09137,1.092063172,1.0914082222222221,1.0914155555555551,1.0914719999999971,1.0916555000000026,1.091461400000001,1.0919234000000002,1.0921872000000041,1.0914467916026167,1.0915048587164826,-1361,-254778,-253582.2,-0.021727381342079136,-144.55450125766345,-0.01649031194174055
2023-06-20T23:30:00-04:00,1.09137,1.09152,1.0913,1.09146,1.09204530856,1.091417111111111,1.0914299999999995,1.0914486666666636,1.0916325000000024,1.091473400000001,1.0919186000000003,1.092177100000004,1.0914494332820934,1.0914746869731862,1400,-253378,-253982.6,-0.020720126920303672,-144.43905003580448,0.011912070592779959
2023-06-20T23:45:00-04:00,1.09146,1.09159,1.09144,1.09151,1.0920278023888,1.0914331111111109,1.0914388888888884,1.0914346666666637,1.0916100000000024,1.091494200000001,1.0919113000000003,1.092166250000004,1.0914615466256747,1.091459749578549,1043,-252335,-253791.4,-0.017283076020836924,-144.391269998057,0.00732983333792181
2023-06-21T00:00:00-04:00,1.09151,1.09161,1.0914,1.09149,1.092010646341024,1.0914433333333333,1.0914488888888885,1.0914337777777745,1.0915765000000026,1.0915206000000008,1.0919039000000001,1.0921550500000041,1.0914672373005398,1.091458199662839,-1236,-253571,-253495.8,-0.014683499907453462,-144.41391752304523,0.008246289169886891
2023-06-21T00:15:00-04:00,1.09149,1.09188,1.09143,1.09185,1.0919938334142034,1.0915235555555556,1.0914955555555552,1.0914457777777749,1.0915630000000027,1.091558200000001,1.0919018000000003,1.092144250000004,1.0915437898404319,1.0914737597302713,917,-252654,-253343.2,-0.00920893864662785,-144.111468577109,0.03848162502405899
2023-06-21T00:30:00-04:00,1.09185,1.09195,1.09173,1.09179,1.0919773567459194,1.0915824444444444,1.0914899999999996,1.0914606666666635,1.0915510000000028,1.091590000000001,1.0918971000000002,1.092133900000004,1.0915930318723455,1.091503007784217,-1039,-253693,-253126.2,-0.004471481761508357,-144.16856433202034,-0.004579425556847475
2023-06-21T00:45:00-04:00,1.09179,1.0917999999999999,1.09152,1.0916,1.091961209611001,1.0916044444444444,1.0915255555555552,1.0914797777777747,1.0915310000000027,1.0916060000000012,1.0918933000000002,1.0921237500000038,1.0915944254978764,1.0915320062273737,-1108,-254801,-253410.8,-0.004794390867773654,-144.36138529575894,0.029323363389769437
2023-06-21T01:00:00-04:00,1.0916,1.09174,1.09138,1.09156,1.09195,1.0916113333333335,1.091562222222222,1.0915044444444415,1.0915245000000027,1.0916114000000012,1.0918918000000002,1.092113800000004,1.091587540398301,1.0915572049818987,-1544,-256345,-254212.8,-0.00030974366283944665,-144.41796279667477,0.03024110407523286
2023-06-21T01:15:00-04:00,1.09156,1.09167,1.09125,1.09142,1.0919344,1.091582888888889,1.091561111111111,1.091526888888886,1.0915145000000026,1.0916098000000012,1.0918870000000003,1.0921029000000038,1.0915540323186408,1.0915745639855188,-1263,-257608,-255020.2,0.002608857639121695,-144.5799511436278,-0.000916229167224968
2023-06-21T01:30:00-04:00,1.09142,1.09142,1.09106,1.09107,1.091919112,1.0914846666666667,1.0915277777777777,1.0915333333333306,1.0914815000000027,1.091605000000001,1.0918827000000002,1.092089750000004,1.0914572258549127,1.091557251188415,-1542,-259150,-256319.4,0.0017101952068468824,-145.07444455587984,-0.027488386156845707
2023-06-21T01:45:00-04:00,1.09107,1.09138,1.09101,1.0912,1.09188474752,1.0914191111111111,1.0914988888888886,1.0915351111111085,1.0914620000000026,1.091597800000001,1.091881,1.092077300000004,1.0914057806839301,1.091519800950732,2034,-257116,-257004,0.0024650067212501365,-144.8320953023948,-0.023821303575041593
2023-06-21T02:00:00-04:00,1.0912,1.09158,1.09056,1.09125,1.0918322626688,1.0913693333333334,1.09147,1.0915239999999973,1.0914470000000027,1.091594400000001,1.0918783000000003,1.0920659500000038,1.091374624547144,1.0914758407605856,7349,-249767,-255997.2,0.0020243895312164984,-144.49535593289264,-0.023820212366348174
2023-06-21T02:15:00-04:00,1.09125,1.0915,1.091,1.09137,1.091730481655296,1.0913493333333333,1.0914566666666665,1.0915028888888862,1.0914490000000026,1.091590800000001,1.0918744000000005,1.092055150000004,1.0913736996377152,1.0914330726084684,3021,-246746,-254077.4,0.001527029957548178,-144.16314974732592,-0.010994145617469697
2023-06-21T02:30:00-04:00,1.09137,1.09167,1.09082,1.09099,1.09056,1.091256,1.091361111111111,1.0914628888888862,1.0914270000000026,1.091586200000001,1.0918636000000004,1.092043600000004,1.0912969597101723,1.0913816580867748,-3626,-250372,-252630.2,-0.0015706826838621992,-145.42567299791938,-0.07876539817741292
2023-06-21T02:45:00-04:00,1.09099,1.0912,1.09073,1.09101,1.0905822,1.0911857777777778,1.0912744444444442,1.0914122222222196,1.0914075000000025,1.091575000000001,1.0918476000000004,1.092031350000004,1.091239567768138,1.0913381264694197,2869,-247503,-250300.8,-0.007434700942809758,-145.37307856533945,-0.07144231033440523
2023-06-21T03:00:00-04:00,1.09101,1.0916,1.0909,1.09133,1.090603956,1.0911968888888888,1.0912444444444445,1.0913613333333307,1.0914025000000025,1.0915736000000011,1.0918392000000003,1.092020550000004,1.0912576542145103,1.0913085011755357,4515,-242988,-247475.2,-0.011344061906889228,-144.04880106100913,-0.024734334921215875
2023-06-21T03:15:00-04:00,1.09133,1.09157,1.09112,1.09157,1.09062527688,1.0912620000000002,1.0912455555555554,1.0913164444444419,1.0913890000000026,1.0915710000000012,1.0918228000000003,1.092010200000004,1.091320123371608,1.0912976009404285,3352,-239636,-245449,-0.012229696652638622,-143.311645480204,0.0009161200483567983
2023-06-21T03:30:00-04:00,1.09157,1.09194,1.09146,1.0919,1.0906461713424,1.0913928888888889,1.0912988888888888,1.0912848888888864,1.0914200000000025,1.091583200000001,1.0918137000000003,1.091999550000004,1.0914360986972864,1.0913100807523428,3394,-236242,-243348.2,-0.009376221657288998,-142.28558210359915,0.04397940297960785
2023-06-21T03:45:00-04:00,1.0919,1.09198,1.09126,1.09127,1.090697924488704,1.091387111111111,1.091321111111111,1.0912768888888862,1.0914220000000026,1.091586000000001,1.0918049000000003,1.091985800000004,1.0914028789578292,1.0913312646018742,-3135,-239377,-241149.2,-0.010706960440265222,-144.0944015925637,0.018330629565470408
2023-06-21T04:00:00-04:00,1.09127,1.0924,1.09093,1.09227,1.0907748490193818,1.091576888888889,1.0914399999999997,1.0913099999999976,1.0914640000000024,1.0916010000000012,1.0917998000000002,1.091979400000004,1.0915763031662633,1.0913986116814993,4494,-234883,-238625.2,-0.004249432063577583,-139.9762640097469,0.09805718475074472
2023-06-21T04:15:00-04:00,1.09227,1.09298,1.09227,1.09273,1.0909048610978314,1.091834888888889,1.0916044444444444,1.0913819999999974,1.0915320000000024,1.0916306000000011,1.0917941000000004,1.091978850000004,1.0918070425330106,1.0915084893451996,3918,-230965,-236220.6,0.004096499391024786,-138.32623242415028,0.13562428407788552
2023-06-21T04:30:00-04:00,1.09273,1.09338,1.09227,1.09229,1.09093,1.0919720000000002,1.0917066666666666,1.0914742222222196,1.0915735000000022,1.0916478000000012,1.0917779000000003,1.091975100000004,1.0919036340264086,1.0916251914761594,-3478,-234443,-235182,0.009610464282085505,-139.72668816344543,0.08429771754767237
2023-06-21T04:45:00-04:00,1.09229,1.09274,1.09222,1.09249,1.091224,1.0921286666666667,1.0918733333333335,1.0915891111111087,1.0916225000000024,1.091663600000001,1.0917590000000004,1.091972850000004,1.0920209072211269,1.0917421531809275,3017,-231426,-234218.8,0.01537692440601765,-139.17427076513553,0.13748980283962794
2023-06-21T05:00:00-04:00,1.09249,1.09273,1.09166,1.09183,1.09148272,1.09212,1.0919644444444445,1.0917177777777751,1.0916395000000025,1.0916662000000013,1.0917383000000003,1.091967050000004,1.0919827257769015,1.091858122544742,-2791,-234217,-233186.8,0.021675708026865224,-140.86038230849033,0.07515971439308924
2023-06-21T05:15:00-04:00,1.09183,1.09277,1.09181,1.09276,1.09166,1.092279111111111,1.0921233333333333,1.091854444444442,1.0916850000000025,1.0916856000000013,1.0917257000000005,1.091966900000004,1.0921381806215211,1.0919704980357934,2881,-231336,-232477.4,0.03216498622739329,-138.40640137739334,0.13103277652039644
2023-06-21T05:30:00-04:00,1.09276,1.09297,1.0923,1.0924099999999999,1.09166,1.0923364444444446,1.0922166666666666,1.0919768888888863,1.0917160000000026,1.0916994000000013,1.0917111000000004,1.0919630500000042,1.092192544497217,1.0920475984286349,-2685,-234021,-233088.6,0.0396142215144876,-139.26637978070258,0.0769533790778376
2023-06-21T05:45:00-04:00,1.0924099999999999,1.09246,1.0916299999999999,1.09166,1.09338,1.0922251111111112,1.09219,1.0920735555555532,1.0917190000000025,1.0916944000000013,1.0916898000000004,1.091956700000004,1.0920860355977735,1.0920840787429076,-2442,-236463,-233492.6,0.041005880664903814,-140.94294810211994,-0.021980034801723412
2023-06-21T06:00:00-04:00,1.09166,1.09207,1.09134,1.092,1.093345,1.0921871111111112,1.0922711111111112,1.0921531111111087,1.0917410000000025,1.0916954000000012,1.0916777000000002,1.0919500500000041,1.0920688284782187,1.092093662994326,2592,-233871,-233981.6,0.04017642558509952,-140.13566378282638,0.06689453572444211
2023-06-21T06:15:00-04:00,1.092,1.09249,1.09199,1.09223,1.0932648,1.0921788888888888,1.0922666666666667,1.0922135555555532,1.0917815000000026,1.0917042000000012,1.0916703000000003,1.0919427000000042,1.092101062782575,1.0921173303954608,2478,-231393,-233416.8,0.046046046046276184,-139.6137407059034,-0.0036620981991668726
2023-06-21T06:30:00-04:00,1.09223,1.09259,1.09183,1.09192,1.093187808,1.0921095555555556,1.0921766666666666,1.0922242222222198,1.0918240000000026,1.0917044000000011,1.0916630000000003,1.091935950000004,1.09206485022606,1.0921026643163685,-2455,-233848,-233919.2,0.040658509086468765,-140.31052618149013,-0.0741262708994882
2023-06-21T06:45:00-04:00,1.09192,1.09217,1.09171,1.09184,1.09311389568,1.0920422222222224,1.0921266666666665,1.0922062222222197,1.0918560000000026,1.091703600000001,1.0916562000000003,1.091930450000004,1.0920198801808478,1.0920681314530947,-2336,-236184,-234351.8,0.029147360120800405,-140.48167425094593,-0.041197850387723174
2023-06-21T07:00:00-04:00,1.09184,1.09212,1.09161,1.09171,1.0930429398527999,1.0919588888888887,1.09204,1.0921762222222198,1.0918790000000027,1.091699400000001,1.0916426000000004,1.0919256000000042,1.0919579041446783,1.0920425051624758,-2537,-238721,-234803.4,0.0216103481950443,-140.78374231952733,-0.0713965345220554
2023-06-21T07:15:00-04:00,1.09171,1.09211,1.09169,1.09183,1.092974822258688,1.0919168888888888,1.09204,1.0921299999999976,1.0919020000000026,1.091696800000001,1.0916306000000002,1.0919214500000043,1.0919323233157427,1.0920152041299804,2037,-236684,-235366,0.0130356603159614,-140.55983670356682,0
2023-06-21T07:30:00-04:00,1.09183,1.09217,1.09179,1.09203,1.0929094293683403,1.091914888888889,1.0919588888888887,1.092068444444442,1.0919540000000028,1.091694200000001,1.0916187000000002,1.0919224000000043,1.0919518586525943,1.0919853633039844,2496,-234188,-235925,0.011988624544320396,-140.10262266841488,-0.0668033236941229
2023-06-21T07:45:00-04:00,1.09203,1.09268,1.09176,1.09243,1.0928466521936067,1.0920091111111112,1.091961111111111,1.0920253333333307,1.0920250000000027,1.091700400000001,1.0916149000000004,1.0919291500000043,1.0920474869220753,1.0919818906431875,2807,-231381,-235431.6,0.0026862600851352532,-139.07444578682748,0.0018308144378146507
2023-06-21T08:00:00-04:00,1.09243,1.09248,1.09189,1.09196,1.0927863861058624,1.092008888888889,1.0919944444444445,1.0919988888888863,1.0920565000000029,1.091699000000001,1.0916075000000003,1.0919308500000042,1.0920299895376602,1.09198391251455,-2857,-234238,-235042.4,-0.005577247272848008,-140.30362294234308,0.027481083853944172
2023-06-21T08:15:00-04:00,1.09196,1.09221,1.09112,1.09143,1.092728530661628,1.0918959999999998,1.0919311111111112,1.0919771111111085,1.0920495000000028,1.091687600000001,1.0915948000000002,1.0919300000000043,1.091909991630128,1.09197433001164,-4159,-238397,-234977.6,-0.008119459842043415,-142.32225915612435,-0.05219780219781881
2023-06-21T08:30:00-04:00,1.09143,1.09235,1.09081,1.09148,1.0926320188219303,1.0918057777777779,1.0918477777777778,1.0919386666666642,1.0920285000000027,1.091683400000001,1.0915802000000003,1.0919284000000042,1.0918239933041025,1.091952664009312,6896,-231501,-233941,-0.012488842239616361,-142.00634333925956,-0.06866685588200548
2023-06-21T08:45:00-04:00,1.09148,1.09257,1.09142,1.09251,1.09081,1.0919382222222223,1.0919133333333333,1.091929555555553,1.0920905000000027,1.091701200000001,1.0915766000000005,1.0919311000000043,1.0919611946432821,1.0919545312074495,4163,-227338,-232571,-0.012584441339539912,-138.07783342611378,0.05403326251008228
2023-06-21T09:00:00-04:00,1.09251,1.09255,1.09152,1.09189,1.09081,1.0919335555555556,1.0919188888888889,1.0919211111111085,1.0920715000000027,1.0917044000000011,1.0915613000000004,1.0919303500000042,1.0919469557146257,1.0919344249659597,-3859,-231197,-232534.2,-0.015562251184716394,-140.26781795714805,0.004579425556867812
2023-06-21T09:15:00-04:00,1.09189,1.09239,1.09176,1.09205,1.0908452,1.0919597777777779,1.0919566666666667,1.091913555555553,1.0920375000000027,1.0917136000000012,1.0915541000000004,1.0919300500000042,1.0919675645717006,1.0919219399727678,3902,-227295,-231145.6,-0.012680151463918715,-139.69603874861994,0.031143801925420392
2023-06-21T09:30:00-04:00,1.09205,1.09205,1.09116,1.09142,1.090879696,1.0918524444444446,1.091911111111111,1.091909555555553,1.0919940000000028,1.091711000000001,1.0915497000000005,1.0919251500000042,1.0918580516573606,1.0919115519782143,-6742,-234037,-230273.6,-0.009624034707348279,-143.58547604544646,-0.03755163349605904
2023-06-21T09:45:00-04:00,1.09142,1.0931,1.09104,1.09266,1.09091350208,1.092002222222222,1.091981111111111,1.0919362222222195,1.0920025000000027,1.0917376000000012,1.0915571000000004,1.0919278500000043,1.0920184413258884,1.0919504415825716,6626,-227411,-229455.6,-0.003636753713035623,-136.05744833842314,0.057690722782332754
2023-06-21T10:00:00-04:00,1.09266,1.093,1.09228,1.09281,1.0910009619968,1.092168,1.0920233333333331,1.0919582222222197,1.0920515000000026,1.0917652000000013,1.0915774000000005,1.0919294000000042,1.0921767530607107,1.0919935532660574,4904,-222507,-228489.4,0.0021105086764276115,-135.3842288556925,0.03478483747242816
2023-06-21T10:15:00-04:00,1.09281,1.09446,1.09276,1.09446,1.09104,1.0926553333333333,1.092301111111111,1.0920346666666638,1.0921365000000027,1.0918264000000013,1.0916081000000004,1.0919390000000042,1.0926334024485687,1.0921308426128458,6057,-216450,-225540,0.009230236633494366,-126.23895200061287,0.22894611524231168
2023-06-21T10:30:00-04:00,1.09446,1.0964,1.0944099999999999,1.09591,1.0912452,1.0933771111111112,1.0927988888888887,1.0922031111111083,1.0923115000000025,1.0919160000000012,1.0916538000000005,1.0919567500000043,1.093288721958855,1.0923950740902768,9066,-207384,-221557.8,0.03165837207461803,-114.22782322477862,0.4104706669232145
2023-06-21T10:45:00-04:00,1.09591,1.0959699999999999,1.0952,1.09545,1.091657584,1.0939073333333333,1.0932399999999998,1.092468888888886,1.0925010000000026,1.0919882000000012,1.0916919000000005,1.0919710000000042,1.093720977567084,1.0927676592722215,-7885,-215269,-217804.2,0.055200839694623555,-117.53749281443402,0.3637263165610024
2023-06-21T11:00:00-04:00,1.09545,1.09552,1.09431,1.09459,1.09203697728,1.0941773333333333,1.0934711111111108,1.092766888888886,1.0926305000000027,1.0920544000000012,1.0917196000000005,1.0919822500000043,1.093894782053667,1.093142927417777,-6293,-221562,-216634.4,0.07088810836207683,-122.47790999458877,0.1903872733430229
2023-06-21T11:15:00-04:00,1.09459,1.09525,1.09459,1.09501,1.0923860190976,1.0944851111111111,1.0938177777777773,1.0931257777777748,1.0927695000000026,1.0921300000000012,1.0917678000000004,1.0919960500000043,1.0941178256429336,1.0935311419342217,4123,-217439,-215620.8,0.08064017096346927,-120.89589298365284,0.2857430693568044
2023-06-21T11:30:00-04:00,1.09501,1.09562,1.09501,1.09509,1.092707137569792,1.0947395555555557,1.094155555555555,1.0934966666666637,1.0929280000000028,1.0922032000000013,1.0918199000000006,1.0920105500000044,1.094312260514347,1.0938669135473775,3854,-213585,-215047.8,0.09744894224457719,-120.61432477879677,0.27837553225584283
2023-06-21T11:45:00-04:00,1.09509,1.09531,1.09483,1.09503,1.0930025665642087,1.0949144444444445,1.0945566666666662,1.0938482222222192,1.0930875000000027,1.0922764000000011,1.0918689000000006,1.0920265500000044,1.0944558084114775,1.094100330837902,-3289,-216874,-216945.8,0.11115036907103251,-120.79452914556099,0.33076175990909923
2023-06-21T12:00:00-04:00,1.09503,1.09567,1.09495,1.0954,1.093274361239072,1.095083111111111,1.0948611111111104,1.0941724444444412,1.0932720000000027,1.0923552000000012,1.0919143000000004,1.0920471500000042,1.094644646729182,1.0942850646703215,3091,-213783,-216648.6,0.1320329396290428,-119.7501102711923,0.2507641901414864
2023-06-21T12:15:00-04:00,1.0954,1.0964,1.09536,1.09626,1.0935244123399464,1.0953628888888889,1.0952444444444438,1.0945271111111077,1.0934935000000028,1.0924502000000011,1.0919722000000005,1.0920688500000042,1.0949677173833456,1.0944996517362573,2965,-210818,-214499.8,0.1451155620012885,-117.42228481930235,0.31569989293655376
2023-06-21T12:30:00-04:00,1.09626,1.09697,1.0962,1.09687,1.0937544593527506,1.095688,1.0955122222222213,1.0948659999999966,1.0937355000000026,1.0925578000000011,1.0920392000000005,1.0920934500000044,1.0953481739066766,1.0947457213890057,2497,-208321,-212676.2,0.16026218784227764,-116.03286077756043,0.22019991594028318
2023-06-21T12:45:00-04:00,1.09687,1.09736,1.0968,1.09705,1.0940760134174756,1.0959955555555554,1.095638888888888,1.0951626666666632,1.0939665000000027,1.0926618000000012,1.0921100000000006,1.0921173000000044,1.0956885391253413,1.0950209771112047,2521,-205800,-211119.2,0.1620511445359467,-115.61915632762546,0.10402314058637488
2023-06-21T13:00:00-04:00,1.09705,1.09734,1.09671,1.09722,1.0944700918073786,1.0963117777777778,1.0958355555555548,1.095418444444441,1.0942295000000029,1.0927704000000014,1.0921802000000005,1.0921413000000042,1.095994831300273,1.0953287816889639,3452,-202348,-208214,0.153143095895802,-115.08423084565106,0.1615774339312656
2023-06-21T13:15:00-04:00,1.09722,1.09752,1.09707,1.09734,1.0948168807904932,1.0966126666666667,1.0961411111111101,1.095674444444441,1.0945250000000029,1.0928852000000013,1.0922456000000005,1.0921644000000041,1.0962638650402183,1.0956526253511711,2492,-199856,-205428.6,0.1469676393586099,-114.81168750885466,0.25123562247051684
2023-06-21T13:30:00-04:00,1.09734,1.09759,1.09727,1.09757,1.0951953174798241,1.0968984444444443,1.0964255555555547,1.0959106666666631,1.0948295000000028,1.0930054000000013,1.0923084000000005,1.092189400000004,1.0965250920321747,1.095964100280937,2049,-197807,-202826.4,0.1474416947575475,-114.38222170974053,0.23378781928931203
2023-06-21T13:45:00-04:00,1.09757,1.09793,1.09755,1.09773,1.0955784666830524,1.0971593333333334,1.096718888888888,1.0961519999999965,1.0950905000000029,1.0931316000000013,1.0923707000000007,1.0922171500000042,1.0967660736257399,1.0962476802247496,2245,-195562,-200274.6,0.1450619109417228,-114.05495328950278,0.241076075938982
2023-06-21T14:00:00-04:00,1.09773,1.09837,1.09762,1.09836,1.096001742680103,1.0974875555555554,1.0970888888888881,1.0964419999999964,1.0954140000000028,1.0932774000000012,1.0924412000000006,1.0922492500000043,1.097084858900592,1.0965269441797996,2135,-193427,-197800,0.14944672148099641,-112.82965198590371,0.30410125749979955
2023-06-21T14:15:00-04:00,1.09836,1.09893,1.09829,1.09892,1.0964753941440823,1.0978537777777777,1.0974799999999991,1.0967708888888852,1.0957575000000028,1.0934318000000012,1.0925148000000005,1.0922832500000041,1.0974518871204735,1.0968183553438398,2282,-191145,-195559.4,0.15435168121304793,-111.66617188830386,0.3213438013511017
2023-06-21T14:30:00-04:00,1.09892,1.099,1.09852,1.09866,1.0969663153152658,1.0980897777777778,1.0977466666666658,1.0970919999999964,1.0961195000000028,1.0935800000000013,1.0925872000000005,1.092317200000004,1.0976935096963787,1.097104284275072,-2220,-193365,-194261.2,0.15533281972891366,-112.1914148541247,0.21892616715012475
2023-06-21T14:45:00-04:00,1.09866,1.0986799999999999,1.09833,1.09846,1.0973730522522127,1.0982324444444445,1.0979233333333325,1.0973915555555518,1.0964095000000027,1.0937218000000013,1.0926563000000005,1.092351500000004,1.0978468077571029,1.0973686274200574,-2407,-195772,-193854.2,0.14477310785677408,-112.62958498865217,0.1449579257341326
2023-06-21T15:00:00-04:00,1.09846,1.09863,1.09815,1.09862,1.0976984418017701,1.0983717777777775,1.098097777777777,1.0976673333333296,1.0967000000000027,1.0938744000000014,1.0927303000000004,1.0923861000000041,1.0980014462056822,1.097615701936046,2004,-193768,-193495.4,0.13481242082620443,-112.33768542016549,0.1431110705984093
2023-06-21T15:15:00-04:00,1.09862,1.09895,1.09855,1.09856,1.0979587534414161,1.0984642222222223,1.0982466666666657,1.097898888888885,1.0969050000000027,1.0940254000000011,1.0928002000000006,1.0924199000000039,1.0981131569645457,1.0978213615488368,-1377,-195145,-193839,0.12358157321657293,-112.41288885720462,0.12212682962394932
2023-06-21T15:30:00-04:00,1.09856,1.0987,1.0984099999999999,1.09847,1.09815,1.0985088888888888,1.0983722222222214,1.0980773333333294,1.0970330000000026,1.0941682000000013,1.0928709000000005,1.0924529500000042,1.0981845255716365,1.0979678892390694,-1739,-196884,-194986.8,0.11754788147737565,-112.5553571793717,0.10297628811490289
2023-06-21T15:45:00-04:00,1.09847,1.09881,1.09838,1.09879,1.09832,1.0985924444444446,1.098507777777777,1.098229555555552,1.0972000000000026,1.0943126000000012,1.0929418000000004,1.0924882500000042,1.0983056204573092,1.0980903113912555,1541,-195343,-195382.4,0.11824935057065057,-112.10644186989596,0.11115464161739105
2023-06-21T16:00:00-04:00,1.09879,1.09888,1.0985,1.09879,1.09838,1.0986488888888888,1.0986255555555546,1.0983699999999963,1.0974100000000029,1.0944504000000013,1.0930168000000002,1.092522500000004,1.0984024963658474,1.0982014491130045,0,-195343,-195296.6,0.11485588333725616,-112.10644186989596,0.09656290709007122
2023-06-21T16:15:00-04:00,1.09879,1.09908,1.09878,1.09896,1.09838,1.0987157777777776,1.0986922222222215,1.0984888888888853,1.0976075000000027,1.0946042000000014,1.0930951000000002,1.092558200000004,1.0985139970926778,1.0983039592904036,785,-194558,-195454.6,0.1070804385444784,-111.98499009112112,0.054626898284709374
2023-06-21T16:30:00-04:00,1.09896,1.09898,1.09866,1.09871,1.0985,1.0987193333333332,1.0986688888888883,1.0985733333333296,1.0977885000000027,1.0947330000000013,1.0931670000000002,1.092593450000004,1.0985531976741423,1.0983919674323228,-514,-195072,-195440,0.09420038992057639,-112.10191882374099,-0.01910967131363716
2023-06-21T16:45:00-04:00,1.09871,1.09875,1.09856,1.09859,1.09908,1.0987035555555555,1.0986611111111104,1.0986311111111076,1.0979665000000027,1.0948502000000013,1.0932404000000002,1.092626850000004,1.0985605581393139,1.0984671739458585,-877,-195949,-195253,0.07599863973687822,-112.1977038807625,-0.006371397884697222
2023-06-21T17:00:00-04:00,1.09859,1.09865,1.09836,1.09859,1.0990696,1.0986893333333334,1.098675555555555,1.098664666666663,1.0981260000000028,1.0949762000000014,1.0933120000000003,1.092660100000004,1.098566446511451,1.0985193391566868,0,-195949,-195374.2,0.05991000055531918,-112.1977038807625,0.011834750468834867
2023-06-21T17:15:00-04:00,1.09859,1.09862,1.09816,1.09825,1.099041216,1.0986042222222223,1.0986344444444438,1.0986664444444407,1.0982255000000027,1.0950914000000014,1.0933775000000003,1.092691500000004,1.0985031572091608,1.0985394713253496,-1408,-197357,-195777,0.04563160727088766,-112.63346244401177,-0.03367861498971268
2023-06-21T17:30:00-04:00,1.09825,1.09843,1.09818,1.09842,1.09898834304,1.0985613333333333,1.0986188888888886,1.0986517777777742,1.0983030000000027,1.0952232000000013,1.0934447000000003,1.0927233000000038,1.0984865257673286,1.0985339770602796,187,-197170,-196299.4,0.03444055026852082,-112.60451639347683,-0.012743955723859324
2023-06-21T17:45:00-04:00,1.09842,1.09852,1.09836,1.09849,1.0989386424576,1.0985355555555556,1.0986211111111106,1.0986422222222187,1.0983750000000028,1.0953378000000014,1.0935117000000003,1.092756650000004,1.098487220613863,1.0985207816482236,201,-196969,-196678.8,0.026777023614360202,-112.59170708556182,0.0018207142661983468
2023-06-21T18:00:00-04:00,1.09849,1.09889,1.09846,1.09881,1.098891923910144,1.0985733333333334,1.0986233333333328,1.0986346666666633,1.0984545000000028,1.0954658000000013,1.0935826000000004,1.092791300000004,1.0985517764910904,1.0985190253185793,405,-196564,-196801.8,0.022240228281186974,-112.47372694919277,0.0018201840206164075
2023-06-21T18:15:00-04:00,1.09881,1.09893,1.09869,1.09886,1.09816,1.098620666666667,1.0986311111111104,1.0986257777777744,1.098530500000003,1.0956098000000012,1.0936521000000001,1.0928256500000042,1.0986134211928722,1.0985284202548633,486,-196078,-196827.6,0.015766463860221968,-112.45161211587313,0.00637064407211701
2023-06-21T18:30:00-04:00,1.09886,1.09901,1.09884,1.0989,1.0981754000000001,1.0986744444444443,1.098624444444444,1.098623777777774,1.0985970000000027,1.0957478000000014,1.0937216000000003,1.0928596000000041,1.0986707369542978,1.0985619362038908,573,-195505,-196457.2,0.01000454712754697,-112.43075413578465,-0.005459707359680879
2023-06-21T18:45:00-04:00,1.0989,1.09908,1.09882,1.09906,1.098208784,1.0987615555555554,1.0986633333333327,1.098632666666663,1.0986635000000027,1.0958844000000014,1.0937943000000003,1.0928943000000042,1.0987485895634383,1.0986143489631128,386,-195119,-196047,0.004455810324810841,-112.37455247958302,0.03185553967833645
2023-06-21T19:00:00-04:00,1.09906,1.09923,1.09897,1.09913,1.0982610569600002,1.098854888888889,1.0987233333333328,1.0986531111111077,1.0987020000000027,1.0960286000000012,1.0938665,1.0929299000000041,1.0988248716507507,1.0986818791704904,678,-194441,-195541.4,0.0022104332450863877,-112.33137012375165,0.04915391547346917
2023-06-21T19:15:00-04:00,1.09913,1.09923,1.09908,1.09913,1.0983385724032002,1.098936222222222,1.0987833333333326,1.0986851111111076,1.0987125000000026,1.096174400000001,1.0939390000000002,1.0929645000000043,1.0988858973206006,1.0987487033363923,0,-194441,-195116.8,0.003787949380336114,-112.33137012375165,0.04915391547346917
2023-06-21T19:30:00-04:00,1.09913,1.0992,1.09908,1.09916,1.0984098866109442,1.0990115555555555,1.0988844444444437,1.098735777777774,1.0987375000000028,1.096323400000001,1.0940114,1.0929998500000044,1.0989407178564805,1.098814162669114,440,-194001,-194701.4,0.007935541387418555,-112.31936062533019,0.08285909401319977
2023-06-21T19:45:00-04:00,1.09916,1.09922,1.09912,1.09916,1.0984754956820686,1.0990666666666666,1.098966666666666,1.0988042222222185,1.0987725000000028,1.0964700000000012,1.0940834,1.0930345500000043,1.0989845742851845,1.0988769301352914,0,-194001,-194400.6,0.014050501193955215,-112.31936062533019,0.06736949436462947
2023-06-21T20:00:00-04:00,1.09916,1.09921,1.09876,1.099,1.0985358560275031,1.0990733333333333,1.0990233333333326,1.0988762222222186,1.0987915000000028,1.096609400000001,1.0941518000000001,1.0930673500000043,1.0989876594281476,1.0989247441082333,-1710,-195711,-194519,0.016988487266390597,-112.56827798040123,0.046427368478548774
2023-06-21T20:15:00-04:00,1.099,1.09911,1.09871,1.09886,1.0985913875453028,1.0990406666666666,1.0990288888888882,1.0989373333333297,1.0988065000000027,1.096738000000001,1.0942192,1.0930990500000042,1.098962127542518,1.0989521952865866,-1093,-196804,-194991.6,0.019315535766857326,-112.70751364919107,0.004550377226261453
2023-06-21T20:30:00-04:00,1.09886,1.09891,1.0987,1.09881,1.0986424765416787,1.098996888888889,1.0990233333333324,1.0989853333333295,1.0988235000000028,1.0968750000000012,1.094287,1.0931311500000043,1.0989317020340146,1.0989613562292693,-1110,-197914,-195686.2,0.018231900061462684,-112.7580205381486,-0.004550170176353991
2023-06-21T20:45:00-04:00,1.09881,1.09905,1.09864,1.09883,1.09923,1.0989582222222223,1.0990155555555545,1.0990115555555517,1.098825500000003,1.097023000000001,1.0943553,1.0931639000000042,1.0989113616272117,1.0989554849834158,1371,-196543,-196194.6,0.01639848669374312,-112.73306626943983,-0.0063700063700076895
2023-06-21T21:00:00-04:00,1.09883,1.09926,1.0987,1.09926,1.09864,1.099007111111111,1.0990377777777767,1.0990257777777739,1.0988490000000029,1.097178600000001,1.094431,1.0931992000000041,1.0989810893017693,1.0989547879867325,1198,-195345,-196463.4,0.01763754795631947,-112.26425853757965,0.01819736866048969
2023-06-21T21:15:00-04:00,1.09926,1.09935,1.09915,1.09927,1.09864,1.0990535555555554,1.0990533333333323,1.099031777777774,1.0988645000000028,1.0973138000000011,1.0945074999999997,1.0932359500000044,1.0990388714414154,1.098965030389386,1233,-194112,-196143.6,0.01746817615531925,-112.2530419009331,0.012737346810661979
2023-06-21T21:30:00-04:00,1.09927,1.09949,1.09923,1.09944,1.0986684,1.0991308888888889,1.0990877777777768,1.0990435555555518,1.0989010000000028,1.0974648000000011,1.0945846,1.0932722000000044,1.0991190971531324,1.098996424311509,1348,-192764,-195335.6,0.01820881901396102,-112.04457628284109,0.028204125080748637
2023-06-21T21:45:00-04:00,1.09944,1.09947,1.09921,1.09934,1.098717696,1.0991813333333333,1.099107777777777,1.0990604444444407,1.0989385000000027,1.097610600000001,1.0946620999999999,1.0933071500000044,1.099163277722506,1.099042739449207,-995,-193759,-194504.6,0.01738933742872671,-112.13507690133777,0.016376141781002676
2023-06-21T22:00:00-04:00,1.09934,1.09936,1.0988,1.0989,1.09876403424,1.0991397777777776,1.0990788888888878,1.0990731111111074,1.0989540000000029,1.097760200000001,1.0947356,1.0933403500000043,1.0991106221780047,1.0990825915593656,-1358,-195117,-194219.4,0.013679890561049983,-112.67860301700716,-0.023654427016988153
2023-06-21T22:15:00-04:00,1.0989,1.09918,1.09886,1.09917,1.0988,1.099158,1.0990977777777768,1.0990851111111075,1.0990000000000026,1.097890400000001,1.0948139999999997,1.0933768000000044,1.0991224977424037,1.0991108732474928,1182,-193935,-193937.4,0.011257352702416323,-112.38818532658948,0.01546860782529604
2023-06-21T22:30:00-04:00,1.09917,1.09934,1.09906,1.09924,1.0988,1.0991864444444444,1.0991399999999991,1.0991024444444408,1.0990410000000028,1.098019000000001,1.0948920999999998,1.0934134500000043,1.099145998193923,1.099132298597994,1096,-192839,-193682.8,0.009151081231618025,-112.31838720618953,0.034581293340375206
2023-06-21T22:45:00-04:00,1.09924,1.09934,1.09914,1.09933,1.0988414,1.0992244444444443,1.0991977777777768,1.0991244444444408,1.0990830000000027,1.098116400000001,1.0949714,1.0934501000000045,1.0991827985551383,1.0991450388783952,1107,-191732,-193476.4,0.00948434043990839,-112.22775185813094,0.0473239231532161
2023-06-21T23:00:00-04:00,1.09933,1.09944,1.09924,1.09925,1.098880316,1.099234888888889,1.0992444444444436,1.0991517777777742,1.0991050000000029,1.098183200000001,1.0950495999999998,1.0934867500000045,1.0991962388441108,1.0991516311027163,-919,-192651,-193254.8,0.010194572051271493,-112.29462895599953,0.03822247299401063
2023-06-21T23:15:00-04:00,1.09925,1.09931,1.09909,1.09918,1.09891689704,1.099222,1.0992355555555546,1.0991831111111074,1.0991210000000027,1.0982578000000012,1.0951229999999998,1.0935241000000044,1.0991929910752887,1.0991681048821729,-909,-193560,-192943.4,0.011775776733518187,-112.35251387753695,-0.007277623128273381
2023-06-21T23:30:00-04:00,1.09918,1.09941,1.09914,1.0992899999999999,1.0989512832176,1.099232888888889,1.0992377777777766,1.0992111111111074,1.0991405000000027,1.098351800000001,1.0952030999999998,1.0935642500000045,1.0992123928602309,1.0991860839057384,1004,-192556,-192667.6,0.010185553843455182,-112.2520389780666,0.0018193892310268615
2023-06-21T23:45:00-04:00,1.0992899999999999,1.09931,1.09917,1.0993,1.098983606224544,1.0992453333333332,1.0992222222222212,1.0992275555555517,1.0991525000000029,1.0984376000000011,1.0952837999999998,1.0936042000000044,1.0992299142881847,1.0992028671245906,733,-191823,-192464.4,0.008725372160672084,-112.24537103785059,-0.01273375536637097
2023-06-22T00:00:00-04:00,1.0993,1.09938,1.09909,1.09916,1.0990139898510713,1.099232888888889,1.0992022222222213,1.0992284444444407,1.0991540000000026,1.0985190000000014,1.0953610999999999,1.0936442000000044,1.0992159314305479,1.0992094936996726,-1141,-192964,-192710.8,0.005744683893108405,-112.39068169008385,-0.01637346043990658
2023-06-22T00:15:00-04:00,1.09916,1.09925,1.09886,1.0989,1.09949,1.0991724444444446,1.0992022222222215,1.099219999999996,1.0991425000000026,1.0985964000000012,1.0954363999999999,1.0936799000000044,1.0991527451444383,1.099200794959738,-1239,-194203,-193021.2,0.0027380666651664084,-112.68376004082434,0
2023-06-22T00:30:00-04:00,1.0989,1.09892,1.09865,1.09889,1.0994774,1.09911,1.0991711111111102,1.0992071111111072,1.0991290000000027,1.0986662000000011,1.0955106999999997,1.0937146500000043,1.0991001961155507,1.0991822359677905,-1137,-195340,-193377.2,0.003686897088508127,-112.69410675117112,-0.025473766569325762
2023-06-22T00:45:00-04:00,1.09889,1.09892,1.09863,1.0987,1.0994443040000001,1.0990157777777776,1.0991111111111103,1.099181777777774,1.0991060000000026,1.0987150000000012,1.0955826,1.0937469500000043,1.0990201568924405,1.0991437887742321,-1393,-196733,-194212.6,0.0014037349749867838,-112.93495888377755,-0.049124849896290616
2023-06-22T01:00:00-04:00,1.0987,1.09883,1.09855,1.09864,1.0993954457600001,1.0989215555555556,1.0990344444444435,1.0991442222222185,1.0990880000000025,1.0987504000000012,1.0956541,1.0937790000000043,1.0989441255139525,1.0990866310193859,-1567,-198300,-195508,-0.0018023669929336259,-113.02053274379386,-0.06276550262431276
2023-06-22T01:15:00-04:00,1.09864,1.09883,1.09848,1.09882,1.0993278100992,1.0988786666666666,1.098986666666666,1.0991011111111073,1.0990860000000027,1.0987858000000013,1.0957237999999998,1.0938128000000042,1.098919300411162,1.0990273048155088,1473,-196827,-196280.6,-0.005662769306318123,-112.77919800265957,-0.039117580168310434
2023-06-22T01:30:00-04:00,1.09882,1.09888,1.09858,1.09873,1.09924302908928,1.0988273333333334,1.098936666666666,1.0990479999999963,1.0990820000000026,1.0988160000000013,1.0957932,1.0938451500000044,1.0988814403289295,1.098973043852407,-1137,-197964,-197032.8,-0.009830830854540387,-112.87232517544484,-0.04093960952710761
2023-06-22T01:45:00-04:00,1.09873,1.09905,1.09847,1.09858,1.0991667261803522,1.098756,1.098857777777777,1.0989853333333295,1.0990695000000026,1.0988408000000012,1.095863,1.093878150000004,1.0988211522631437,1.0989172350819256,-1956,-199920,-197948.8,-0.014293624583998148,-113.13936075288441,-0.06458714261022919
2023-06-22T02:00:00-04:00,1.09858,1.09904,1.09831,1.09845,1.0990831190387098,1.0986744444444443,1.0987633333333326,1.098915777777774,1.0990290000000025,1.0988584000000012,1.0959318999999998,1.0939118500000042,1.098746921810515,1.0988625880655405,-2444,-202364,-199075,-0.020290435288825483,-113.42857045996074,-0.07732193213863527
2023-06-22T02:15:00-04:00,1.09845,1.09861,1.09814,1.09843,1.09905,1.0986077777777776,1.0986822222222214,1.0988453333333297,1.0989870000000024,1.0988724000000012,1.096002,1.0939445000000043,1.098683537448412,1.0988104704524324,-2005,-204369,-200288.8,-0.02461110766868507,-113.4650764456677,-0.06641435277847606
2023-06-22T02:30:00-04:00,1.09843,1.09877,1.09821,1.09826,1.09904,1.0985233333333335,1.0986111111111105,1.0987702222222187,1.0989280000000026,1.0988704000000014,1.0960739,1.0939783000000043,1.0985988299587297,1.098746376361946,-2514,-206883,-202300,-0.02842534015064143,-113.85415904537821,-0.05824005824005587
2023-06-22T02:45:00-04:00,1.09826,1.09836,1.09806,1.09827,1.098896,1.0984551111111112,1.0985422222222216,1.09869133333333,1.0988745000000026,1.098857400000001,1.0961446,1.0940128000000042,1.0985330639669837,1.0986767010895568,1935,-204948,-203696.8,-0.02908978399532531,-113.83654026658255,-0.05642056984774117
2023-06-22T03:00:00-04:00,1.09827,1.09919,1.09796,1.09872,1.09796,1.0984906666666667,1.0985444444444437,1.0986286666666631,1.0988655000000027,1.0988586000000011,1.0962193,1.0940488000000042,1.098570451173587,1.0986265608716457,3465,-201483,-204009.4,-0.027950863681544643,-112.41680741400582,0.0018203331209528514
2023-06-22T03:15:00-04:00,1.09872,1.09927,1.0984099999999999,1.0991,1.09796,1.0986017777777777,1.0985955555555549,1.0985951111111074,1.0988620000000027,1.098871400000001,1.0962966,1.094085500000004,1.0986763609388697,1.0986124486973166,3575,-197908,-203118.2,-0.02517722644017613,-111.18036864889717,0.04186994829970735
2023-06-22T03:30:00-04:00,1.0991,1.10002,1.09857,1.09984,1.09796,1.0988506666666666,1.098708888888888,1.0986004444444408,1.0988920000000026,1.098895800000001,1.0963851,1.0941243500000042,1.0989090887510957,1.098657558957853,5438,-192470,-200738.4,-0.01715988331263165,-107.51908214175515,0.09282685062157778
2023-06-22T03:45:00-04:00,1.09984,1.09988,1.09912,1.09943,1.0980836,1.0989948888888887,1.098786666666666,1.098635555555552,1.0988970000000025,1.098913200000001,1.0964692999999999,1.0941584500000041,1.0990132710008766,1.0987404471662827,-4100,-196570,-198675.8,-0.01243214643657317,-109.04748627326526,0.06370991963448007
2023-06-22T04:00:00-04:00,1.09943,1.0999,1.09922,1.09977,1.098199784,1.0991915555555556,1.0989188888888881,1.0987108888888852,1.0989230000000025,1.0989392000000011,1.0965536999999999,1.094196450000004,1.0991646168007012,1.0988667577330262,4456,-192114,-196109,-0.004874833767986836,-107.66946311581091,0.10832165158659583
2023-06-22T04:15:00-04:00,1.09977,1.10037,1.0993,1.09931,1.09830899696,1.0992697777777776,1.0990144444444434,1.098804888888885,1.0989295000000026,1.098949600000001,1.0966311,1.0942269500000041,1.099193693440561,1.098991406186421,-3037,-195151,-194842.6,0.0015079446586071736,-108.93974690242058,0.07829213892303545
2023-06-22T04:30:00-04:00,1.09931,1.0994,1.09871,1.09906,1.0984738772031999,1.0992788888888887,1.0990844444444434,1.0989026666666628,1.0989180000000025,1.098955000000001,1.0967026999999998,1.094258200000004,1.0991669547524487,1.0990895249491366,-2891,-198042,-194869.4,0.007578761269213415,-109.59720476235113,0.057354587911829465
2023-06-22T04:45:00-04:00,1.09906,1.09937,1.09893,1.09928,1.0986255670269438,1.099318,1.0991977777777768,1.0990004444444406,1.0989170000000024,1.098961400000001,1.0967827999999997,1.0942938500000041,1.099189563801959,1.0991456199593095,2742,-195300,-195435.4,0.015356856247180094,-109.0483357288131,0.0928741827982464
2023-06-22T05:00:00-04:00,1.09928,1.10025,1.0992,1.1002,1.09871,1.0995184444444444,1.0994122222222211,1.0991255555555515,1.0989690000000025,1.098991200000001,1.0968620999999998,1.094330950000004,1.0993916510415673,1.0992212959674474,2474,-192826,-194686.6,0.02910929374232688,-106.97781684372461,0.17573092226865772
2023-06-22T05:15:00-04:00,1.1002,1.1002,1.09941,1.09975,1.0988428000000001,1.0995860000000002,1.0995266666666657,1.099247111111107,1.0990115000000025,1.0990144000000008,1.0969322999999997,1.094363200000004,1.0994633208332538,1.099281036773958,-2140,-194966,-195257,0.04001883953185688,-107.85311224456095,0.09374544925004427
2023-06-22T05:30:00-04:00,1.09975,1.1004,1.09973,1.10005,1.0989649760000002,1.0996906666666666,1.0996322222222212,1.0993706666666625,1.0990695000000024,1.099043600000001,1.0970098999999998,1.094393900000004,1.099580656666603,1.0993584294191663,2046,-192920,-194810.8,0.04713547669285849,-107.29498539755032,0.0864343553816765
2023-06-22T05:45:00-04:00,1.10005,1.10034,1.09988,1.10018,1.0991084784000003,1.0998002222222225,1.0996699999999988,1.0994877777777738,1.0991435000000025,1.099082200000001,1.0970867999999998,1.094422900000004,1.0997005253332826,1.0994651435353333,2455,-190465,-193295.4,0.0513699891300691,-107.00486222133114,0.030913587430899676
2023-06-22T06:00:00-04:00,1.10018,1.10064,1.10001,1.10032,1.0992376305600002,1.0999302222222223,1.099768888888888,1.099601999999996,1.0992275000000025,1.0991202000000009,1.0971716999999999,1.0944550000000042,1.099824420266626,1.0995921148282666,2555,-187910,-191817.4,0.04871510393515661,-106.67973360601357,0.08095103826528814
2023-06-22T06:15:00-04:00,1.10032,1.10082,1.10026,1.1007,1.0994059148928002,1.1001164444444445,1.0998722222222213,1.099693999999996,1.0993215000000025,1.0991644000000012,1.0972510999999998,1.094488400000004,1.0999995362133008,1.0997136918626134,2476,-185434,-190339,0.051340141432504545,-105.82463690687139,0.08456313592843026
2023-06-22T06:30:00-04:00,1.1007,1.10073,1.10005,1.10036,1.0996038868078082,1.100214,1.0999888888888878,1.0997864444444403,1.0994030000000026,1.099195400000001,1.0973306,1.094520850000004,1.1000716289706407,1.0998353534900907,-1773,-187207,-188787.2,0.050032940915786965,-106.37230657163019,0.09551445906977972
2023-06-22T06:45:00-04:00,1.10036,1.10072,1.10015,1.10046,1.099774142654715,1.1003082222222222,1.1001444444444433,1.0998888888888847,1.0994970000000024,1.099227400000001,1.0974186,1.0945542000000041,1.1001493031765126,1.0999490827920728,2659,-184548,-187112.8,0.052996034393067666,-106.13065838376443,0.12738158062344804
2023-06-22T07:00:00-04:00,1.10046,1.10122,1.10004,1.10035,1.0999205626830548,1.1003493333333334,1.1002633333333323,1.1000075555555515,1.0995920000000026,1.0992564000000011,1.0975020999999998,1.0945899000000041,1.10018944254121,1.1000468662336582,-11342,-195890,-188197.8,0.0570586164143239,-107.26438428020829,0.09733643839603234
2023-06-22T07:15:00-04:00,1.10035,1.10108,1.10002,1.10005,1.10122,1.1003066666666665,1.1002466666666657,1.100103111111107,1.0996730000000023,1.0992762000000011,1.0975803,1.0946253000000041,1.100161554032968,1.1001142929869263,-4523,-200413,-190698.4,0.05712828183423144,-108.49753736786208,-0.013633884748236184
2023-06-22T07:30:00-04:00,1.10005,1.10011,1.09891,1.09925,1.10122,1.1001073333333333,1.10019111111111,1.1001668888888847,1.0997225000000024,1.0992786000000012,1.0976536,1.094658300000004,1.0999792432263744,1.100110234389541,-4439,-204852,-194582,0.04493625910540129,-111.72575426709358,-0.04546487838144532
2023-06-22T07:45:00-04:00,1.09925,1.09941,1.09879,1.09891,1.1011276,1.0998511111111111,1.1000644444444434,1.100181999999996,1.0997545000000026,1.0992742000000013,1.0977242999999999,1.094690250000004,1.0997653945810995,1.100048987511633,-2992,-207844,-198709.4,0.034481773115960145,-112.65118524275883,-0.1036316531066696
2023-06-22T08:00:00-04:00,1.09891,1.09926,1.09844,1.0988,1.100987344,1.0995982222222223,1.0999111111111102,1.1001353333333292,1.0997585000000023,1.0992670000000013,1.0977952,1.094718900000004,1.0995723156648796,1.0999335900093064,-4298,-212142,-204228.2,0.02081935957977286,-113.08141155792589,-0.12543401988764902
2023-06-22T08:15:00-04:00,1.0988,1.0994,1.09852,1.09913,1.10078355648,1.099442,1.0997788888888878,1.1000384444444404,1.0997600000000025,1.0992664000000014,1.0978682,1.094749400000004,1.0994838525319037,1.099792472007445,3078,-209064,-206863,0.009495849625443236,-112.15700311234906,-0.10815035625999932
2023-06-22T08:30:00-04:00,1.09913,1.10016,1.09828,1.09833,1.1005960719616,1.0991522222222223,1.0995155555555547,1.099892222222218,1.0996845000000026,1.0992530000000016,1.0979311999999999,1.0947749500000041,1.099253082025523,1.0996107776059563,-7287,-216351,-210050.6,-0.005265544072053157,-117.46083432430703,-0.21531752521122768
2023-06-22T08:45:00-04:00,1.09833,1.09866,1.09802,1.0982399999999999,1.1003644647654398,1.098897111111111,1.099279999999999,1.099709999999996,1.0996250000000025,1.0992406000000015,1.0979892999999998,1.0948021000000039,1.0990504656204185,1.099425022084765,-5144,-221495,-213379.2,-0.020708533240615466,-117.88234698443718,-0.1926642189828894
2023-06-22T09:00:00-04:00,1.0982399999999999,1.09839,1.09683,1.09695,1.10016,1.0984311111111111,1.0988899999999988,1.099475111111107,1.0994840000000026,1.0992034000000015,1.0980391999999997,1.094823350000004,1.0986303724963349,1.099198017667812,-7025,-228520,-217514.4,-0.04098408580519591,-126.13395865401627,-0.31895752685239825
2023-06-22T09:15:00-04:00,1.09695,1.09781,1.0968,1.09775,1.0996938,1.0982031111111112,1.09860111111111,1.099213111111107,1.0994060000000028,1.0991818000000015,1.0981023999999997,1.0948486000000042,1.098454297997068,1.0989744141342495,4375,-224145,-219915,-0.05688809884838058,-122.94329362826339,-0.23628845367382523
2023-06-22T09:30:00-04:00,1.09775,1.09805,1.09735,1.0977999999999999,1.099230792,1.098042888888889,1.0983511111111097,1.098927555555551,1.0993430000000026,1.0991526000000016,1.0981655999999997,1.0948729000000041,1.0983234383976543,1.0987423313073996,6234,-217911,-221684.4,-0.07354699314535103,-122.65934919647175,-0.2045361574473965
2023-06-22T09:45:00-04:00,1.0977999999999999,1.0985,1.0977999999999999,1.0981,1.09884186528,1.0979926666666666,1.0982233333333322,1.0986691111111067,1.0992840000000026,1.0991292000000017,1.0982214999999997,1.0948990500000042,1.0982787507181235,1.0985474650459197,5306,-212605,-220935.2,-0.0871303220795781,-121.20935830559819,-0.10461678417102427
2023-06-22T10:00:00-04:00,1.0981,1.09891,1.0976299999999999,1.09872,1.0968,1.098092,1.0982022222222207,1.0984535555555512,1.0992100000000027,1.0991148000000015,1.0982897999999999,1.0949255500000041,1.0983670005744988,1.0984107720367358,5727,-206878,-218011.8,-0.08952799293007019,-117.97582766175965,-0.017289859952146627
2023-06-22T10:15:00-04:00,1.09872,1.09884,1.09767,1.09774,1.0968422,1.0979995555555557,1.098084444444443,1.09829244444444,1.0991095000000026,1.0990828000000017,1.0983466999999998,1.094950400000004,1.098241600459599,1.0983330176293886,-4743,-211621,-214632,-0.08952453736536314,-122.20633224891553,-0.0964688751365181
2023-06-22T10:30:00-04:00,1.09774,1.09784,1.09648,1.09684,1.09891,1.0977506666666668,1.0978299999999985,1.0981382222222178,1.0989490000000026,1.0990416000000016,1.0984009,1.0949753000000042,1.0979612803676793,1.098234414103511,-4996,-216617,-213126.4,-0.09476134828868489,-126.30238413734038,-0.20834660140291897
2023-06-22T10:45:00-04:00,1.09684,1.09716,1.09581,1.0959,1.0988614,1.0973646666666668,1.0975599999999985,1.0979799999999957,1.0987350000000027,1.0989762000000016,1.0984333,1.094995200000004,1.0975490242941435,1.0980795312828087,-5905,-222522,-214048.6,-0.10618906793857393,-131.3630128525583,-0.22124498101662818
2023-06-22T11:00:00-04:00,1.0959,1.09662,1.09557,1.0966,1.0987393440000002,1.0971726666666668,1.0973777777777765,1.0978108888888845,1.0985490000000027,1.0989234000000017,1.0984712,1.0950243000000042,1.0973592194353148,1.097895625026247,4962,-217560,-215039.6,-0.10643526806009697,-128.19356308524414,-0.14932983682982445
2023-06-22T11:15:00-04:00,1.0966,1.09666,1.09521,1.09528,1.09854918336,1.096753111111111,1.0971922222222208,1.0976088888888846,1.0982780000000028,1.0988424000000017,1.0984794,1.0950437500000043,1.0969433755482518,1.0976109000209977,-4683,-222243,-218112.6,-0.11155688004880575,-133.8305866125102,-0.15224030265737365
2023-06-22T11:30:00-04:00,1.09528,1.09618,1.0952,1.09611,1.0982820486912002,1.0965366666666667,1.0970099999999985,1.0973939999999955,1.0980655000000028,1.0987796000000016,1.0984814,1.0950676000000044,1.0967767004386015,1.0973179200167982,3777,-218466,-219481.6,-0.09932498383656088,-130.96838699232214,-0.1493964928262433
2023-06-22T11:45:00-04:00,1.09611,1.09643,1.09523,1.09525,1.09797384382208,1.0961846666666666,1.0967266666666653,1.0971733333333291,1.0978050000000028,1.0987010000000015,1.0984794,1.0950856500000044,1.0964713603508813,1.0970199360134387,-3321,-221787,-220515.6,-0.099954199585503,-133.5740196386802,-0.232282747312792
2023-06-22T12:00:00-04:00,1.09525,1.0956299999999999,1.09483,1.09538,1.0976964594398722,1.0959153333333336,1.096424444444443,1.096946222222218,1.0975565000000027,1.0986228000000016,1.0984873,1.0951034500000043,1.0962530882807051,1.096760748810751,2882,-218905,-219792.2,-0.09998490335523011,-133.23194248734498,-0.24770057371824566
2023-06-22T12:15:00-04:00,1.09538,1.09566,1.09504,1.0954,1.0973524843070874,1.0957104444444443,1.0960555555555542,1.0966817777777735,1.0973240000000026,1.0985448000000018,1.0984912000000002,1.0951295000000043,1.096082470624564,1.0965053990486007,2497,-216408,-219561.8,-0.10313049296336115,-133.1863510031114,-0.3021697975826407
2023-06-22T12:30:00-04:00,1.0954,1.09566,1.0951,1.0955,1.0970497861902369,1.0955993333333331,1.0958066666666655,1.0964046666666625,1.0971365000000026,1.0984716000000017,1.0984953000000002,1.0951576000000043,1.0959659764996512,1.0963099192388805,2181,-214227,-217958.6,-0.11275072715083666,-132.98724565346745,-0.20405560515240584
2023-06-22T12:45:00-04:00,1.0955,1.09568,1.09533,1.09544,1.0967834118474085,1.095526,1.0956511111111098,1.0961328888888846,1.0969630000000028,1.0984024000000017,1.0984994000000001,1.0951841500000044,1.095860781199721,1.0961267353911044,-1690,-215917,-217448.8,-0.1171968086004648,-133.07980612813648,-0.12763940045950803
2023-06-22T13:00:00-04:00,1.09544,1.0955,1.09499,1.09531,1.0965490024257194,1.0954577777777779,1.0955855555555543,1.0959046666666623,1.0967885000000028,1.0983308000000016,1.0984985000000003,1.0952064000000044,1.0957506249597768,1.0959825883128835,-2427,-218344,-216760.2,-0.11553504146136974,-133.36782737987087,-0.05383702892600515
2023-06-22T13:15:00-04:00,1.09531,1.09545,1.0951,1.09525,1.0963427221346331,1.0953906666666666,1.0954355555555544,1.0957068888888846,1.0965945000000026,1.0982618000000017,1.0984884000000001,1.0952303000000043,1.0956504999678214,1.0958620706503066,-2388,-220732,-217125.6,-0.10606564537717644,-133.49863966132534,-0.12310778770745598
2023-06-22T13:30:00-04:00,1.09525,1.09554,1.09514,1.09554,1.0961611954784771,1.0954115555555555,1.0954644444444432,1.0955886666666623,1.0964550000000026,1.0981998000000017,1.0984751000000001,1.0952571500000043,1.095628399974257,1.0957712565202453,1422,-219310,-217706,-0.10015881060084332,-133.12212288433392,0.023738222189753026
2023-06-22T13:45:00-04:00,1.09554,1.0957999999999999,1.09543,1.09572,1.09600145202106,1.0954626666666667,1.09542111111111,1.0955115555555512,1.0963290000000028,1.0981378000000017,1.0984618,1.0952859000000044,1.0956467199794058,1.0957074052161961,2203,-217107,-218282,-0.08482151000503549,-132.7601643981078,-0.03558037058323439
2023-06-22T14:00:00-04:00,1.09572,1.09603,1.09536,1.09561,1.09483,1.0955004444444445,1.09546111111111,1.0954735555555515,1.0962620000000027,1.0980754000000017,1.0984457,1.0953129500000043,1.0956393759835246,1.0956631241729569,-1938,-219045,-218907.6,-0.07796825584337422,-132.95472140172197,0.03286920794338424
2023-06-22T14:15:00-04:00,1.09561,1.09576,1.09547,1.09562,1.094854,1.0955322222222221,1.0954877777777767,1.095453999999996,1.0961555000000027,1.0980162000000018,1.0984285,1.0953370500000044,1.0956355007868197,1.0956400993383655,1859,-217186,-218676,-0.06882019177366513,-132.93775368510737,0.02191020467783034
2023-06-22T14:30:00-04:00,1.09562,1.09572,1.09536,1.09542,1.09487752,1.0955186666666668,1.095489999999999,1.0954648888888847,1.0960365000000027,1.0979556000000017,1.098407,1.0953577000000043,1.0955924006294557,1.0956284794706923,-1422,-218608,-218251.2,-0.05833995481007959,-133.1973327362382,0.0018258170531432376
2023-06-22T14:45:00-04:00,1.09542,1.09591,1.09511,1.09591,1.0949005696,1.0956026666666667,1.0955355555555544,1.095479111111107,1.0959270000000028,1.0979052000000016,1.0983888,1.0953797500000044,1.0956559205035645,1.0956339835765538,2129,-216479,-217685,-0.04548013958571309,-132.24499482018797,0.03742583295299146
2023-06-22T15:00:00-04:00,1.09591,1.09616,1.0957999999999999,1.09591,1.0949231582080001,1.0956775555555558,1.0955877777777767,1.0955124444444404,1.0957865000000029,1.0978582000000017,1.0983642999999998,1.0954027500000045,1.0957067364028517,1.0956459868612431,0,-216479,-217559.4,-0.032227578760052646,-132.24499482018797,0.042905134010075445
2023-06-22T15:15:00-04:00,1.09591,1.09595,1.09554,1.09561,1.0949726318796802,1.095682,1.09562111111111,1.0955444444444402,1.0956800000000029,1.0978050000000015,1.0983311999999998,1.0954230000000045,1.0956873891222814,1.0956555894889946,-1665,-218144,-217379.2,-0.01716544973021679,-132.70078042302026,0.02738950616720079
2023-06-22T15:30:00-04:00,1.09561,1.09593,1.09542,1.09572,1.095020126604493,1.0957017777777778,1.0956733333333324,1.0955815555555515,1.0956240000000028,1.0977450000000015,1.0983017999999998,1.0954445000000046,1.095693911297825,1.0956672715911955,1624,-216520,-217246,-0.004645943469627025,-132.53772970241704,0.042912577037203414
2023-06-22T15:45:00-04:00,1.09572,1.09581,1.09557,1.0957999999999999,1.0950657215403132,1.095727111111111,1.0957022222222212,1.095623999999996,1.0956190000000028,1.0976790000000016,1.0982752,1.0954657500000045,1.09571512903826,1.0956918172729564,1654,-214866,-216497.6,0.004893890373619717,-132.41696892411622,0.023732588495164665
2023-06-22T16:00:00-04:00,1.0957999999999999,1.09586,1.0954599999999999,1.09559,1.0951094926787006,1.0957046666666665,1.0956877777777767,1.0956544444444405,1.0955685000000028,1.0975940000000015,1.0982449,1.0954876000000047,1.0956901032306081,1.0956986538183648,-1062,-215928,-216387.4,0.0066976791088516445,-132.62049146472566,-0.011864344905629492
2023-06-22T16:15:00-04:00,1.09559,1.09568,1.0953,1.09536,1.0951515129715526,1.095639111111111,1.095659999999999,1.095668888888885,1.0955725000000027,1.0975126000000015,1.0982128999999998,1.0955065500000045,1.0956240825844865,1.0956821230546923,-732,-216660,-216423.6,0.00880177235123183,-132.77416208968583,-0.022818338642407746
2023-06-22T16:30:00-04:00,1.09536,1.09548,1.09536,1.09541,1.0951918524526905,1.095589111111111,1.0956366666666655,1.095671999999996,1.095537500000003,1.0974254000000017,1.0981823,1.0955266000000046,1.0955812660675892,1.0956608984437537,498,-216162,-216027.2,0.006411131288900905,-132.75142983727562,-0.019167229513886518
2023-06-22T16:45:00-04:00,1.09541,1.09561,1.09531,1.09557,1.0952305783545828,1.0955757777777777,1.0956533333333323,1.0956679999999959,1.0955535000000027,1.0973506000000017,1.0981500999999998,1.0955459500000044,1.0955790128540714,1.0956379187550032,922,-215240,-215771.2,0.008302066562830598,-132.61675880086008,0.0136933778824444
2023-06-22T17:00:00-04:00,1.09557,1.09557,1.0954,1.09556,1.0952677552203995,1.0955571111111113,1.0956144444444433,1.0956504444444406,1.0955625000000029,1.0972806000000017,1.0981177999999998,1.0955673000000044,1.0955752102832572,1.0956099350040023,-210,-215450,-215888,0.008232409527393804,-132.6186756112875,-0.0319369291273782
2023-06-22T17:15:00-04:00,1.09556,1.09557,1.09543,1.09557,1.0953034450115835,1.0955482222222221,1.0955766666666655,1.0956282222222182,1.0955710000000027,1.0972064000000017,1.0980838999999998,1.0955895000000044,1.0955741682266058,1.095586748003202,579,-214871,-215676.6,0.004303071871980184,-132.6133906428696,-0.031024445438038433
2023-06-22T17:30:00-04:00,1.09557,1.09572,1.09543,1.09557,1.0953377072111201,1.0955468888888888,1.095572222222221,1.0956106666666625,1.0955745000000028,1.0971138000000018,1.0980524999999999,1.0956097500000046,1.0955733345812846,1.0955765984025616,0,-214871,-215318.8,0.0004607295437232499,-132.6133906428696,-0.003650934182787671
2023-06-22T17:45:00-04:00,1.09557,1.0956,1.09549,1.09555,1.0953705989226754,1.0955424444444444,1.0955533333333323,1.095593999999996,1.0955800000000027,1.0970298000000016,1.0980220999999997,1.0956312500000045,1.0955686676650276,1.0955740787220494,-127,-214998,-215086,-0.00030425469745131616,-132.61570907071993,-0.015514912568904781
2023-06-22T18:00:00-04:00,1.09555,1.09557,1.09542,1.09544,1.0954021749657683,1.0955197777777776,1.0955133333333325,1.0955659999999958,1.0955865000000027,1.0969376000000015,1.0979905999999997,1.0956513000000045,1.095542934132022,1.0955668629776394,-240,-215238,-215085.6,-0.0028599941580812758,-132.6398065560013,-0.03285271034859609
2023-06-22T18:15:00-04:00,1.09544,1.09549,1.09533,1.09541,1.09616,1.0954991111111112,1.0954933333333325,1.095541777777774,1.0955945000000027,1.0968422000000015,1.0979621999999996,1.0956698500000046,1.0955163473056175,1.0955550903821114,-427,-215665,-215128.6,-0.006854393896607676,-132.65150048720702,-0.0164295037377184
2023-06-22T18:30:00-04:00,1.09541,1.09549,1.09528,1.09537,1.0961434,1.0954744444444446,1.0954944444444437,1.0955253333333297,1.0955860000000026,1.0967432000000017,1.0979316999999997,1.0956882000000048,1.095487077844494,1.095537672305689,-485,-216150,-215384.4,-0.009383994443255725,-132.6692107509439,0.0009129418638680902
2023-06-22T18:45:00-04:00,1.09537,1.09542,1.0953,1.09534,1.096108864,1.0954435555555557,1.0954866666666658,1.0955082222222186,1.0955670000000026,1.0966360000000015,1.0979001999999998,1.0957059500000046,1.0954576622755952,1.0955145378445512,-321,-216471,-215704.4,-0.008697330297522987,-132.67800230083114,-0.0063903013483549076
2023-06-22T19:00:00-04:00,1.09534,1.09557,1.09531,1.09553,1.09607570944,1.0954522222222223,1.0954822222222214,1.0954939999999964,1.0955630000000027,1.0965394000000015,1.0978673999999997,1.0957250000000047,1.0954721298204761,1.0954952302756409,733,-215738,-215852.4,-0.006776236836861314,-132.5508545658813,-0.0036510674808583666
2023-06-22T19:15:00-04:00,1.09553,1.09564,1.0954,1.09545,1.0960438810624,1.095445777777778,1.0954699999999993,1.0954853333333299,1.0955545000000027,1.0964392000000016,1.0978332999999996,1.0957427000000046,1.095467703856381,1.0954801842205126,-639,-216377,-216080.2,-0.00717616730052667,-132.5975169119603,-0.010040527218961488
2023-06-22T19:30:00-04:00,1.09545,1.09568,1.09542,1.09565,1.096013325819904,1.0954817777777777,1.095478888888888,1.0954824444444409,1.095566000000003,1.0963452000000016,1.0978007999999997,1.0957612000000048,1.0955041630851048,1.09547774737641,907,-215470,-216041.2,-0.006485056118106073,-132.43192286385224,0.007302134961716733
2023-06-22T19:45:00-04:00,1.09565,1.09577,1.0955,1.09553,1.095983992787108,1.095492,1.0954744444444438,1.0954784444444408,1.0955470000000027,1.0962548000000014,1.0977654999999997,1.0957799000000046,1.0955093304680839,1.0954821979011278,-959,-216429,-216097,-0.007328252237691072,-132.53695640558556,-0.0036510674808583666
2023-06-22T20:00:00-04:00,1.09553,1.09568,1.09539,1.09556,1.0959558330756236,1.095509111111111,1.0954755555555549,1.0954762222222185,1.0955295000000027,1.0961810000000016,1.0977297999999998,1.0957981500000047,1.095519464374467,1.0954945583209024,1468,-214961,-215795,-0.005898333079555217,-132.49675668490215,0.0009127835333910375
2023-06-22T20:15:00-04:00,1.09556,1.09579,1.09539,1.09544,1.0959287997525986,1.095502,1.0954755555555549,1.0954748888888854,1.0955210000000029,1.0961116000000017,1.0976928999999997,1.0958159500000049,1.0955035714995736,1.0955008466567218,-1401,-216362,-215919.8,-0.004859595505820739,-132.65021245181603,0
2023-06-22T20:30:00-04:00,1.09544,1.09548,1.09525,1.09536,1.0959028477624946,1.095478888888889,1.0954699999999993,1.0954748888888852,1.0955030000000028,1.0960428000000018,1.0976548999999998,1.0958331500000047,1.0954748571996589,1.0955022773253773,-1142,-217504,-216145.2,-0.004503216148047591,-132.73361272933016,-0.004564500963119336
2023-06-22T20:45:00-04:00,1.09536,1.09592,1.0953,1.09551,1.09525,1.095486888888889,1.0954855555555547,1.0954762222222185,1.0954885000000028,1.0959704000000017,1.0976183999999995,1.0958509000000047,1.095481885759727,1.095497821860302,2181,-215323,-216115.8,-0.002677612421453651,-132.43494379856747,0.01278106941033888
2023-06-22T21:00:00-04:00,1.09551,1.09562,1.09532,1.0955,1.09525,1.0954897777777777,1.0955033333333324,1.0954819999999963,1.0954840000000028,1.0959138000000017,1.0975833999999995,1.0958676000000047,1.0954855086077817,1.0954930574882416,-2056,-217379,-216305.8,-0.00018691369388286296,-132.45371131324112,0.014607336534768927
2023-06-22T21:15:00-04:00,1.0955,1.09552,1.09526,1.09533,1.09592,1.0954551111111113,1.0954811111111102,1.0954831111111074,1.0954825000000028,1.0958556000000017,1.0975480999999996,1.0958836500000046,1.0954544068862253,1.0954800459905931,-1547,-218926,-217098.8,0.0008519883279803442,-132.6937752110047,-0.01825600394329484
2023-06-22T21:30:00-04:00,1.09533,1.09534,1.0945799999999999,1.09473,1.0959068,1.0953048888888888,1.0954011111111102,1.0954682222222185,1.095448500000003,1.0958112000000018,1.0975072999999995,1.0958971500000048,1.0953095255089802,1.0954412367924744,-3546,-222472,-218320.8,-0.003712336520031582,-134.63620352028113,-0.06572641380255181
2023-06-22T21:45:00-04:00,1.09473,1.09497,1.09461,1.09466,1.095853728,1.0951566666666666,1.0952911111111103,1.0954324444444405,1.0954030000000028,1.0957494000000016,1.0974655999999996,1.0959104500000045,1.0951796204071842,1.0953821894339795,-2404,-224876,-219795.2,-0.0076640078107179845,-134.78992178871263,-0.09035732213754816
2023-06-22T22:00:00-04:00,1.09466,1.09466,1.09379,1.094,1.09580277888,1.0948984444444445,1.0951211111111103,1.0953595555555515,1.0953250000000028,1.0956734000000017,1.0974129999999997,1.0959220000000045,1.0949436963257473,1.0952745515471833,-2621,-227497,-222230,-0.01590292347706722,-136.3701932885388,-0.13965843016620352
2023-06-22T22:15:00-04:00,1.094,1.09409,1.09376,1.0939,1.0956820121472,1.0946542222222222,1.094936666666666,1.0952462222222183,1.0952415000000029,1.0955894000000017,1.0973592999999997,1.0959334000000047,1.0947349570605978,1.0951244412377468,-1927,-229424,-224639,-0.023569155318816395,-136.54633588451682,-0.15152068348607056
2023-06-22T22:30:00-04:00,1.0939,1.09391,1.0932,1.09378,1.095528251175424,1.094422888888889,1.0947522222222217,1.0951004444444408,1.0951520000000028,1.0954906000000015,1.0973026999999995,1.0959436500000046,1.0945439656484781,1.0949423529901972,-1853,-231277,-227109.2,-0.032041066829451376,-136.74960857854757,-0.15153728182282872
2023-06-22T22:45:00-04:00,1.09378,1.09408,1.09373,1.09385,1.0952954260578815,1.0942424444444445,1.094584444444444,1.0949371111111075,1.095067000000003,1.0954128000000016,1.0972477999999997,1.0959549500000045,1.0944051725187824,1.0947614823921576,1302,-229975,-228609.8,-0.03908354564441554,-136.66628286405287,-0.13785422144316942
2023-06-22T23:00:00-04:00,1.09385,1.09403,1.09379,1.09396,1.0950858834520933,1.0941175555555558,1.0944122222222215,1.0947613333333297,1.0949930000000028,1.0953552000000015,1.0971983999999997,1.0959670000000046,1.094316138015026,1.0945887859137262,1350,-228625,-229359.6,-0.04495701295457863,-136.5305238477343,-0.14148661354071987
2023-06-22T23:15:00-04:00,1.09396,1.09404,1.09386,1.09392,1.094897295106884,1.0940191111111113,1.094236666666666,1.0945844444444408,1.0949185000000028,1.0953156000000015,1.0971458999999997,1.0959799500000045,1.0942369104120206,1.0944474287309807,-1049,-229674,-229795,-0.0528708198475733,-136.56887991194142,-0.14422638064809812
2023-06-22T23:30:00-04:00,1.09392,1.09394,1.09351,1.09376,1.0947275655961957,1.093923777777778,1.0940622222222214,1.094409555555552,1.0948380000000029,1.0952588000000014,1.0970910999999997,1.0959916000000047,1.0941415283296165,1.0943287429847846,-1780,-231454,-230201,-0.06159063992742885,-136.82922801783573,-0.14333579834386434
2023-06-22T23:45:00-04:00,1.09376,1.09392,1.09347,1.09355,1.0945748090365761,1.0938213333333333,1.0939311111111105,1.0942453333333297,1.0947485000000028,1.0952242000000014,1.0970332999999997,1.0960023500000047,1.0940232226636932,1.0942245943878277,-1084,-232538,-230453.2,-0.06993816090321815,-137.0373541149686,-0.10778913522055292
2023-06-23T00:00:00-04:00,1.09355,1.09369,1.09314,1.09328,1.0944373281329185,1.0936911111111112,1.093777777777777,1.0940839999999965,1.094636000000003,1.0951676000000015,1.0969735999999997,1.0960116000000049,1.0938745781309547,1.0941184755102622,-1662,-234200,-231298.2,-0.07422922579990986,-137.4477057221196,-0.1260665412091368
2023-06-23T00:15:00-04:00,1.09328,1.09335,1.09313,1.09329,1.0942816487569682,1.0935935555555556,1.0936988888888883,1.0939413333333297,1.094528000000003,1.0951284000000014,1.0969146999999997,1.0960188500000045,1.0937576625047638,1.0940067804082099,1386,-232814,-232136,-0.07700771034184803,-137.43502827443913,-0.06489945155392947
2023-06-23T00:30:00-04:00,1.09329,1.09341,1.09287,1.09339,1.0941204179309927,1.0935317777777778,1.0936422222222215,1.0938224444444409,1.0944150000000028,1.0950886000000013,1.0968556999999997,1.0960294000000048,1.0936841300038112,1.0938962243265677,1828,-230986,-232398.4,-0.07362529069175626,-137.26782652558936,-0.046622177529939704
2023-06-23T00:45:00-04:00,1.09339,1.09343,1.0929,1.09329,1.093920351062034,1.0934613333333334,1.093587777777777,1.093727555555552,1.094303000000003,1.0950464000000013,1.0967955999999996,1.0960397000000048,1.093605304003049,1.0937889794612543,-1561,-232547,-232617,-0.0689377888995132,-137.41059351632458,-0.04479877123369228
2023-06-23T01:00:00-04:00,1.09329,1.0934,1.09301,1.09306,1.0937522948921086,1.0933557777777778,1.0934999999999995,1.09364133333333,1.0941780000000028,1.0949976000000015,1.0967345999999996,1.0960478500000048,1.093496243202439,1.0936835835690033,-1993,-234540,-233017.4,-0.06477619682543234,-137.82986928030334,-0.07222196827719234
2023-06-23T01:15:00-04:00,1.09306,1.09323,1.09272,1.09274,1.0936111277093712,1.0932037777777777,1.093364444444444,1.093558666666663,1.0940430000000028,1.0949436000000012,1.0966729999999996,1.0960547000000047,1.0933449945619513,1.0935776668552029,-1703,-236243,-233426,-0.06265586713245044,-138.3284329456097,-0.11152144502541216
2023-06-23T01:30:00-04:00,1.09274,1.09322,1.09273,1.09305,1.0934507247216843,1.0931408888888887,1.093267777777777,1.0934724444444408,1.0939275000000026,1.0948984000000013,1.0966145999999997,1.0960626500000048,1.093285995649561,1.0934833334841623,1710,-234533,-233769.8,-0.06057741150702488,-137.84332212327314,-0.07953049583149832
2023-06-23T01:45:00-04:00,1.09305,1.09333,1.0929,1.09326,1.09272,1.0931393333333335,1.0932122222222214,1.0933864444444408,1.0938150000000029,1.0948586000000013,1.0965601999999997,1.0960714000000047,1.093280796519649,1.0934026667873298,2092,-232441,-234060.8,-0.05747479192955044,-137.44140089368653,-0.04571386775893861
2023-06-23T02:00:00-04:00,1.09326,1.09333,1.09271,1.09294,1.09333,1.0930848888888889,1.0931444444444436,1.0932977777777741,1.093687000000003,1.0948066000000012,1.0965031999999995,1.0960786500000048,1.0932126372157192,1.0933241334298638,-3321,-235762,-234703.8,-0.05378932868460181,-138.41346609318126,-0.055781628640665666
2023-06-23T02:15:00-04:00,1.09294,1.09312,1.09234,1.09263,1.09333,1.0929820000000001,1.0930722222222213,1.0932122222222187,1.093552000000003,1.094744800000001,1.0964412999999995,1.0960825500000047,1.0930961097725753,1.093244106743891,-2038,-237800,-235355.8,-0.04971181775770026,-138.99152161315496,-0.05945411971316034
2023-06-23T02:30:00-04:00,1.09263,1.09263,1.09207,1.09211,1.09333,1.0927895555555553,1.0929411111111103,1.093127555555552,1.0934210000000026,1.0946748000000013,1.0963750999999995,1.0960841500000047,1.0928988878180603,1.0931548853951127,-2594,-240394,-236186,-0.04639607370920402,-140.2260474819305,-0.10793110702559987
2023-06-23T02:45:00-04:00,1.09211,1.09264,1.09201,1.09231,1.0932544,1.0926633333333333,1.0928211111111104,1.0930382222222188,1.0933035000000026,1.094608600000001,1.0963123999999995,1.0960877000000047,1.0927811102544482,1.0930539083160902,2672,-237722,-236823.8,-0.044824358807208836,-139.73671948383512,-0.09877536834982868
2023-06-23T03:00:00-04:00,1.09231,1.09259,1.0919699999999999,1.09221,1.093154848,1.0925411111111112,1.0927011111111105,1.0929359999999966,1.0932140000000028,1.094544400000001,1.0962499999999995,1.0960909500000047,1.0926668882035586,1.0929311266528718,-3566,-241288,-238593.2,-0.04495110260855061,-140.06318358285458,-0.09878440304038195
2023-06-23T03:15:00-04:00,1.09221,1.09221,1.08761,1.08795,1.0930363632,1.0915908888888888,1.0921333333333325,1.0927337777777741,1.0929165000000027,1.0943852000000012,1.0961451999999996,1.0960736000000046,1.0917235105628469,1.0926333013222975,-13538,-254826,-242406,-0.06746185446886312,-192.8661060977547,-0.46749492251111086
2023-06-23T03:30:00-04:00,1.08795,1.08795,1.0853,1.08671,1.09259,1.0905062222222222,1.0914633333333326,1.0924119999999964,1.0925630000000028,1.094201200000001,1.0960296999999997,1.0960518000000046,1.0907208084502775,1.092158241057838,-12302,-267128,-248271.6,-0.0942643813214346,-206.88741222395433,-0.5518238556289675
2023-06-23T03:45:00-04:00,1.08671,1.08743,1.08649,1.08685,1.09221,1.0895835555555555,1.0907744444444436,1.091978666666663,1.0922130000000028,1.094026000000001,1.0959154999999996,1.0960300500000046,1.0899466467602221,1.0915677928462704,6338,-260790,-252350.8,-0.11800449121551813,-206.0708926373119,-0.567220163761949
2023-06-23T04:00:00-04:00,1.08685,1.08744,1.08639,1.08664,1.0912426,1.0887566666666666,1.0900388888888883,1.0914222222222187,1.0918470000000027,1.0938444000000012,1.0957946999999997,1.0960070000000046,1.0892853174081778,1.0908686342770164,-6192,-266982,-258202.8,-0.14530175440108178,-207.2673042856537,-0.605528419589105
2023-06-23T04:15:00-04:00,1.08664,1.0873,1.08602,1.08695,1.0904106359999999,1.088138888888889,1.0893733333333326,1.0907566666666633,1.0914985000000028,1.093667400000001,1.0956731999999996,1.0959849000000046,1.0888182539265423,1.0900989074216132,4162,-262820,-262509.2,-0.1725710601471015,-206.0799561298706,-0.5480630226727853
2023-06-23T04:30:00-04:00,1.08695,1.08698,1.08588,1.08592,1.0896951469599998,1.0874482222222221,1.088627777777777,1.0900555555555522,1.0911065000000026,1.0934740000000012,1.0955339999999996,1.0959595500000048,1.0882386031412339,1.0894019259372905,-5713,-268533,-265250.6,-0.20205193863275886,-211.49362741189873,-0.6141145676029391
2023-06-23T04:45:00-04:00,1.08592,1.08645,1.08485,1.08491,1.0890798263855999,1.0867046666666667,1.087827777777777,1.089328444444441,1.0906745000000029,1.093265000000001,1.0953887999999996,1.0959290500000047,1.0875728825129871,1.0887723407498324,-4012,-272545,-266334,-0.2342685916642004,-215.22513617865854,-0.659274248930957
2023-06-23T05:00:00-04:00,1.08491,1.08538,1.08441,1.08529,1.0884030541639038,1.0861971111111113,1.087047777777777,1.0885831111111077,1.090275000000003,1.093062600000001,1.0952439999999997,1.0958988500000046,1.0871163060103897,1.088206272599866,3939,-268606,-267897.2,-0.26082612261417015,-213.84546413212917,-0.6426746985745626
2023-06-23T05:15:00-04:00,1.08529,1.08545,1.08493,1.08529,1.0876843044144011,1.0858455555555555,1.0862788888888881,1.0878311111111079,1.0898750000000028,1.092857000000001,1.0951037999999995,1.0958674500000047,1.0867510448083118,1.0876994180798927,0,-268606,-268222,-0.29041374281952514,-213.84546413212917,-0.6335777918165751
2023-06-23T05:30:00-04:00,1.08529,1.0855,1.08499,1.0853599999999999,1.087094929619809,1.0856617777777777,1.0859911111111105,1.0871546666666634,1.0894735000000029,1.0926530000000012,1.0949667999999995,1.0958347500000047,1.0864728358466493,1.087230334463914,2946,-265660,-268790,-0.31872327147897844,-213.65545040308035,-0.23806241095639435
2023-06-23T05:45:00-04:00,1.0853599999999999,1.08622,1.08515,1.08607,1.0866116422882433,1.0856775555555556,1.085919999999999,1.0866131111111077,1.0891125000000028,1.0924630000000013,1.0948346999999996,1.0958087500000047,1.0863922686773195,1.0868610675711312,3025,-262635,-267610.4,-0.30408462488735793,-211.67661388800641,-0.05889335701336823
2023-06-23T06:00:00-04:00,1.08607,1.08645,1.08606,1.08624,1.08441,1.0857415555555556,1.0858522222222213,1.0862179999999966,1.088771500000003,1.0922764000000011,1.0946950999999996,1.0957786000000047,1.0863618149418557,1.086618854056905,2615,-260020,-265105.4,-0.27766590623149745,-211.26729404674387,-0.05612550029902925
2023-06-23T06:15:00-04:00,1.08624,1.08676,1.08622,1.0865799999999999,1.0844508000000002,1.085887111111111,1.0858455555555546,1.0859775555555522,1.0884635000000027,1.0920970000000012,1.0945633999999995,1.0957478500000049,1.0864054519534845,1.086476683245524,1976,-258044,-262993,-0.25188074014470685,-210.6487935312044,-0.005521607892233953
2023-06-23T06:30:00-04:00,1.0865799999999999,1.0869199999999999,1.08627,1.0865,1.0845431680000002,1.086018,1.0857955555555547,1.0858808888888856,1.0881360000000029,1.0919182000000012,1.0944278999999997,1.0957189000000047,1.0864243615627875,1.0864113465964191,-2072,-260116,-261295,-0.22593419517241276,-210.80134557523218,-0.04140024840149606
2023-06-23T06:45:00-04:00,1.0865,1.08721,1.08648,1.08681,1.08468577792,1.086220888888889,1.0858944444444436,1.0858615555555522,1.0878135000000029,1.091746200000001,1.0942941999999996,1.0956905000000046,1.08650148925023,1.0864170772771353,2633,-257483,-259659.6,-0.19997347866655746,-210.0500984514401,0.0819581552968964
2023-06-23T07:00:00-04:00,1.08681,1.08735,1.08662,1.08731,1.0848877156864,1.086504,1.08616111111111,1.0859097777777742,1.0875320000000028,1.0915850000000011,1.0941640999999998,1.0956679000000047,1.086663191400184,1.086471261821708,2418,-255065,-258145.6,-0.16120065243694134,-208.9376684958822,0.22121650643831817
2023-06-23T07:15:00-04:00,1.08731,1.08732,1.08672,1.08702,1.08513394411776,1.0866757777777776,1.0863533333333324,1.0860099999999966,1.087251500000003,1.091418600000001,1.0940272999999996,1.0956392000000046,1.0867345531201473,1.0865458094573666,-2324,-257389,-257619.4,-0.11591818075911452,-209.55751012338473,0.15940439882427823
2023-06-23T07:30:00-04:00,1.08702,1.08771,1.08702,1.08745,1.0853555497059841,1.0868951111111111,1.0865933333333322,1.086159555555552,1.087018500000003,1.091257000000001,1.0938981999999995,1.0956144000000048,1.086877642496118,1.0866402475658932,2512,-254877,-256986,-0.07339106395781575,-208.56382095483232,0.19902514535284943
2023-06-23T07:45:00-04:00,1.08745,1.08792,1.08718,1.0876,1.085638083741266,1.0870964444444442,1.0868422222222212,1.0863688888888856,1.086783000000003,1.091100000000001,1.0937695999999995,1.0955941000000047,1.0870221139968943,1.0867597980527146,2464,-252413,-255445.4,-0.032398851058390174,-208.2239432593064,0.20638313554949694
2023-06-23T08:00:00-04:00,1.0876,1.08861,1.0876,1.0885,1.085957552017489,1.087428,1.0871122222222214,1.0866124444444412,1.086597500000003,1.090957000000001,1.0936510999999995,1.0955766000000047,1.0873176911975155,1.0869230384421715,3914,-248499,-253648.6,0.01317901732220922,-204.98506867306102,0.22374248437024613
2023-06-23T08:15:00-04:00,1.0885,1.08957,1.0885,1.08938,1.0863819436946907,1.0878815555555557,1.08746111111111,1.0868724444444413,1.086669000000003,1.0908340000000012,1.0935443999999996,1.0955623500000047,1.0877301529580123,1.0871364307537372,4339,-244160,-251467.6,0.05603967866926688,-201.4771954530335,0.28907055531005305
2023-06-23T08:30:00-04:00,1.08938,1.08955,1.08847,1.08854,1.0869557938296464,1.0880973333333335,1.087678888888888,1.0871375555555522,1.0867605000000031,1.0906936000000012,1.0934372999999995,1.0955454500000048,1.08789212236641,1.0873679446029898,-4635,-248795,-249748.8,0.0746168595808334,-205.0511549529323,0.18038248449264518
2023-06-23T08:45:00-04:00,1.08854,1.08925,1.08809,1.08873,1.08742635094031,1.0883075555555555,1.0879266666666656,1.087404222222219,1.0868545000000032,1.0905594000000012,1.0933354999999993,1.0955299000000047,1.088059697893128,1.087604355682392,4300,-244495,-247672.4,0.08554176009949127,-204.30060834922494,0.20524620340542607
2023-06-23T09:00:00-04:00,1.08873,1.08927,1.0885799999999999,1.08917,1.0878122077710541,1.088556222222222,1.088188888888888,1.0876735555555523,1.086981000000003,1.090435600000001,1.0932391999999995,1.0955172000000049,1.0882817583145024,1.0878562845459134,4752,-239743,-245138.4,0.09993314717370101,-202.3801321981131,0.21714927172182052
2023-06-23T09:15:00-04:00,1.08917,1.09002,1.0891,1.08971,1.08809,1.0888604444444445,1.0884555555555548,1.087942222222219,1.087119000000003,1.090319600000001,1.0931449999999996,1.0955066000000049,1.0885674066516018,1.0881062276367306,4108,-235635,-242565.6,0.11314830527245776,-200.34342534794285,0.22072821918311777
2023-06-23T09:30:00-04:00,1.08971,1.0899,1.08913,1.0893,1.088476,1.0890293333333332,1.088708888888888,1.0881917777777748,1.0872880000000031,1.090195600000001,1.0930546999999995,1.0954929500000048,1.0887139253212814,1.0883029821093844,-4565,-240200,-241773.6,0.12114745826872998,-202.06099240706877,0.20974775073134233
2023-06-23T09:45:00-04:00,1.0893,1.09025,1.0883,1.08832,1.09025,1.0889515555555556,1.088805555555555,1.088417111111108,1.0874585000000032,1.0900554000000011,1.0929554999999993,1.095472400000005,1.0886351402570251,1.0884515856875077,-11268,-251468,-242308.2,0.12257993315276464,-212.1983650316899,0.08000367833003139
2023-06-23T10:00:00-04:00,1.08832,1.08985,1.08806,1.0891899999999999,1.09025,1.0890284444444445,1.0889822222222214,1.0886282222222194,1.0876535000000032,1.089944600000001,1.0928778999999995,1.095458550000005,1.0887461122056201,1.088588868550006,6854,-244614,-242332,0.11981595876434165,-206.7192963754128,0.1461934534755407
2023-06-23T10:15:00-04:00,1.0891899999999999,1.08963,1.08859,1.08928,1.09025,1.0890879999999998,1.089068888888888,1.0888042222222194,1.087853000000003,1.089837000000001,1.0927931999999994,1.095447800000005,1.088852889764496,1.0887030948400047,6096,-238518,-242087,0.11777247087118123,-206.2155826064644,0.07165824529168607
2023-06-23T10:30:00-04:00,1.08928,1.08946,1.08833,1.08839,1.0901623999999999,1.0889522222222223,1.0889588888888881,1.088904888888886,1.0880045000000031,1.089724800000001,1.0926990999999993,1.095432350000005,1.0887603118115967,1.0887416758720039,-5160,-243678,-243695.6,0.10317590592456395,-210.43157849365622,-0.09087737979401553
2023-06-23T10:45:00-04:00,1.08839,1.08851,1.08787,1.08825,1.090078304,1.0888104444444444,1.088926666666666,1.0889484444444417,1.0881135000000033,1.089611800000001,1.0926005999999993,1.095411050000005,1.0886582494492774,1.0887305406976029,-5100,-248778,-245411.2,0.08012835943461856,-211.08759334127532,-0.026641189115707595
2023-06-23T11:00:00-04:00,1.08825,1.08865,1.088,1.08813,1.08994580576,1.088651111111111,1.0888599999999993,1.0889593333333303,1.0882080000000032,1.089498800000001,1.0924946999999994,1.0953922500000048,1.0885525995594219,1.0887140325580824,-4006,-252784,-245674.4,0.0673379897071493,-211.52933007456232,-0.055110082389567105
2023-06-23T11:15:00-04:00,1.08813,1.08865,1.08788,1.08813,1.0898212574144,1.0885051111111113,1.0887444444444436,1.0889117777777748,1.0882855000000033,1.089384400000001,1.0923985999999994,1.095372650000005,1.0884680796475374,1.0886584260464658,0,-252784,-247308.4,0.05354824396172313,-211.52933007456232,-0.09548555321941753
2023-06-23T11:30:00-04:00,1.08813,1.08918,1.08804,1.08918,1.089704181969536,1.0885922222222222,1.088685555555555,1.088835111111108,1.0884195000000034,1.0892888000000012,1.0923219999999993,1.0953614500000048,1.08861046371803,1.0886099408371726,3150,-249634,-249531.6,0.04225791504593116,-208.48971164661714,-0.04863679327526768
2023-06-23T11:45:00-04:00,1.08918,1.08924,1.08859,1.08862,1.0895941310513637,1.088579111111111,1.0886099999999994,1.0887653333333303,1.0885100000000034,1.089182800000001,1.0922491999999995,1.0953412500000048,1.088612370974424,1.088580352669738,-2879,-252513,-251298.6,0.02296450848137871,-209.9699444823287,-0.06242541081428569
2023-06-23T12:00:00-04:00,1.08862,1.08872,1.08828,1.08861,1.0894906831882818,1.088579111111111,1.0886422222222218,1.0887084444444415,1.0885750000000034,1.089079800000001,1.0921692999999992,1.095320250000005,1.0886118967795393,1.0885710821357903,-2461,-254974,-252537.8,0.008749361843608994,-209.99255108518335,0.02664657453691226
2023-06-23T12:15:00-04:00,1.08861,1.08894,1.08855,1.08881,1.0893934421969849,1.0886126666666667,1.0885999999999996,1.0886564444444413,1.0886645000000033,1.0889850000000012,1.0921045999999994,1.095292000000005,1.0886515174236315,1.0885908657086323,2099,-252875,-252556,0.0066884482320837095,-209.60692170459714,-0.034888311497518795
2023-06-23T12:30:00-04:00,1.08881,1.08887,1.08865,1.08878,1.0893020356651657,1.0886486666666666,1.088544444444444,1.0886164444444415,1.0887310000000032,1.088895000000001,1.0920312999999995,1.095256350000005,1.0886772139389052,1.0886326925669059,-1661,-254536,-252906.4,-0.00477647037193682,-209.65268726516322,-0.04590188014100552
2023-06-23T12:45:00-04:00,1.08878,1.08898,1.08854,1.08857,1.0892161135252558,1.0886537777777778,1.0885644444444442,1.0885922222222193,1.0887795000000033,1.0888006000000012,1.0919644999999993,1.095221950000005,1.0886557711511242,1.0886417540535247,-2108,-256644,-254308.4,-0.016196340055620873,-210.05927078065773,0.016538189435778443
2023-06-23T13:00:00-04:00,1.08857,1.08939,1.08857,1.08939,1.08787,1.088818888888889,1.0886911111111108,1.0886084444444415,1.0888240000000033,1.0887206000000011,1.0919045999999997,1.095195950000005,1.0888026169208993,1.0886798032428195,1923,-254721,-254750,-0.01483928697929327,-208.61070982454092,0.10475534114405155
2023-06-23T13:15:00-04:00,1.08939,1.08944,1.08905,1.0892,1.0879003999999999,1.0889206666666666,1.0888099999999996,1.0886419999999972,1.0888150000000034,1.0886388000000011,1.0918425999999994,1.095166900000005,1.0888820935367194,1.0887338425942557,-1809,-256530,-255061.2,-0.009175323016673257,-208.9262166678204,0.09833383878763606
2023-06-23T13:30:00-04:00,1.0892,1.08962,1.0892,1.08946,1.0879619839999999,1.0890506666666666,1.0889577777777775,1.0887135555555527,1.0888610000000034,1.088566800000001,1.0917821999999995,1.0951387500000052,1.0889976748293755,1.0888030740754044,1388,-255142,-255514.6,0.0026896110168216567,-208.59489092415512,0.12222804260520832
2023-06-23T13:45:00-04:00,1.08946,1.0896,1.0893599999999999,1.08945,1.08806146496,1.0891491111111111,1.0889877777777774,1.0888022222222193,1.0888970000000033,1.088501000000001,1.0917222999999996,1.095110850000005,1.0890881398635004,1.0888852592603233,-1872,-257014,-256010.2,0.010832359937144938,-208.6120737486738,0.024789291026275955
2023-06-23T14:00:00-04:00,1.08945,1.08949,1.08907,1.08928,1.0881549770624,1.0892075555555556,1.0890611111111108,1.0889015555555526,1.0889025000000032,1.0884256000000012,1.0916619999999995,1.0950802500000052,1.0891265118908002,1.0889794074082588,-1925,-258939,-256469.2,0.009345254910920128,-208.9124546748292,0.060627216108477246
2023-06-23T14:15:00-04:00,1.08928,1.08933,1.08917,1.0892,1.088242878438656,1.0892353333333333,1.0891266666666664,1.0889886666666637,1.0888770000000032,1.088344400000001,1.0916014999999994,1.0950449500000052,1.0891412095126403,1.089047125926607,-1534,-260473,-257619.6,0.014540445396998307,-209.02511624944742,0.05419755467980896
2023-06-23T14:30:00-04:00,1.0892,1.08928,1.08904,1.08908,1.0883255057323367,1.089226,1.0891566666666666,1.0890579999999972,1.0888660000000032,1.088267200000001,1.0915368999999995,1.0950060000000053,1.0891289676101121,1.0890965007412854,-1148,-261621,-258637.8,0.021612289004837474,-209.15159439854756,0.024797714936489603
2023-06-23T14:45:00-04:00,1.08908,1.0892,1.08885,1.0891899999999999,1.0884031753883965,1.0892326666666667,1.089202222222222,1.089106888888886,1.088909500000003,1.0881984000000011,1.0914715999999993,1.094966700000005,1.0891411740880896,1.089125200593028,2334,-259287,-259466.8,0.025583265658118873,-208.91585414071562,0.037656826907162086
2023-06-23T15:00:00-04:00,1.0891899999999999,1.08939,1.08891,1.08938,1.0884761848650928,1.089268222222222,1.089292222222222,1.0891677777777748,1.0889190000000033,1.0881438000000012,1.0914092999999996,1.0949275000000052,1.0891889392704717,1.0891453604744226,2140,-257147,-259493.4,0.026456680793095336,-208.54254920769174,0.074409546469219
2023-06-23T15:15:00-04:00,1.08938,1.08943,1.08903,1.08907,1.0885448137731872,1.089223777777778,1.0892566666666665,1.0892068888888862,1.0889085000000034,1.0880790000000011,1.0913437999999995,1.094886150000005,1.0891651514163774,1.089153088379538,-1313,-258460,-259397.6,0.03157326243213521,-208.91618375211152,-0.029374236958306755
2023-06-23T15:30:00-04:00,1.08907,1.08922,1.0887,1.08893,1.088609324946796,1.0891584444444444,1.0892266666666666,1.089226888888886,1.0889355000000034,1.0880134000000012,1.0912788999999996,1.094842950000005,1.0891181211331018,1.08914847070363,-1680,-260140,-259331,0.02887991918539937,-209.1321478315555,-0.02478883584281973
2023-06-23T15:45:00-04:00,1.08893,1.08931,1.08881,1.08911,1.0886699654499883,1.089135111111111,1.0891877777777776,1.0892331111111084,1.0889785000000034,1.0880366000000012,1.0912108999999994,1.0947998500000051,1.0891164969064815,1.0891459765629041,2123,-258017,-258610.2,0.024903991723052896,-208.7812161830564,-0.03212600737980949
2023-06-23T16:00:00-04:00,1.08911,1.08932,1.08903,1.08924,1.0887,1.0891455555555556,1.0891644444444442,1.089225555555553,1.0890340000000034,1.0880872000000013,1.0911441999999996,1.094754250000005,1.0891411975251852,1.089145981250323,1025,-256992,-258151.2,0.018553654519155926,-208.6588685781313,-0.019275781357569736
2023-06-23T16:15:00-04:00,1.08924,1.0894,1.08924,1.08931,1.0887552,1.0891746666666668,1.0891677777777775,1.089200666666664,1.0890930000000032,1.0881364000000011,1.0910811999999996,1.094706200000005,1.0891749580201482,1.0891431850002582,487,-256505,-258022.8,0.012107569789227375,-208.62757152697634,0.002754112808458293
2023-06-23T16:30:00-04:00,1.08931,1.08941,1.08928,1.08937,1.088807088,1.089215111111111,1.0891866666666663,1.089186666666664,1.0891025000000034,1.0881910000000012,1.0910176999999996,1.094659750000005,1.0892139664161185,1.0891529480002065,303,-256202,-257571.2,0.007511620494558591,-208.61088206300374,0.015607785530665028
2023-06-23T16:45:00-04:00,1.08937,1.08959,1.08898,1.08915,1.08885586272,1.089207777777778,1.0891944444444441,1.0891802222222196,1.0891290000000036,1.0882350000000012,1.0909511999999997,1.094613200000005,1.0892011731328948,1.089169558400165,-1053,-257255,-256994.2,0.007183707020356633,-208.82353708379546,0.0064274433466792605
2023-06-25T17:00:00-04:00,1.09045,1.09045,1.08946,1.08993,1.0889017109568,1.089354888888889,1.0892766666666664,1.0891979999999972,1.0891950000000032,1.0883152000000011,1.0908945999999997,1.094569750000005,1.089346938506316,1.0892156467201322,285,-256970,-256784.8,0.009260024370027263,-208.61943296590536,0.06794039607416383
2023-06-25T17:15:00-04:00,1.08993,1.09026,1.08984,1.09003,1.08898,1.0895055555555557,1.0893488888888887,1.089234888888886,1.0892560000000033,1.0884176000000012,1.0908412999999997,1.094527100000005,1.0894835508050527,1.0892841173761054,288,-256682,-256722.8,0.010763344995974504,-208.5930092506209,0.05966696653142516
2023-06-25T17:30:00-04:00,1.09003,1.09019,1.0899,1.08999,1.0890976,1.0896337777777778,1.089451111111111,1.0892915555555527,1.0893165000000034,1.0885116000000012,1.0907870999999998,1.094484700000005,1.089584840644042,1.089366093900884,-67,-256749,-256771.6,0.011204317706169895,-208.595467898548,0.08447574536072354
2023-06-25T17:45:00-04:00,1.08999,1.09001,1.08984,1.09,1.089205792,1.0897435555555557,1.0895699999999997,1.0893682222222192,1.0893880000000036,1.0886058000000012,1.0907313999999997,1.0944407500000048,1.0896678725152336,1.0894568751207072,83,-256666,-256864.4,0.014407905464019122,-208.59470642367208,0.09826159624586764
2023-06-25T18:00:00-04:00,1.09,1.09064,1.08933,1.09038,1.08930532864,1.0899055555555555,1.0897111111111109,1.0894715555555528,1.0894375000000036,1.0887062000000012,1.0906795999999996,1.0943987000000048,1.0898102980121869,1.0895787000965655,1090,-255576,-256528.6,0.019804931694775638,-208.21470642367225,0.1166089743001058
2023-06-25T18:15:00-04:00,1.09038,1.09054,1.09032,1.09038,1.08933,1.0900393333333334,1.0898377777777777,1.089583777777775,1.0894965000000036,1.0887924000000013,1.0906276999999998,1.0943558000000049,1.0899242384097494,1.089694160077252,0,-255576,-256249.8,0.027133898885329404,-208.21470642367225,0.10466012999889086
2023-06-25T18:30:00-04:00,1.09038,1.09073,1.0902,1.09036,1.08933,1.0901437777777778,1.0899544444444442,1.089704888888886,1.0895415000000037,1.0888748000000013,1.0905755999999998,1.0943140500000048,1.0900113907277995,1.0897997280618015,-1243,-256819,-256277.2,0.03234224741052297,-208.23750581471015,0.0963912935711593
2023-06-25T18:45:00-04:00,1.09036,1.09069,1.09034,1.09064,1.0894979999999999,1.0902808888888889,1.0900955555555554,1.0898337777777751,1.0896010000000036,1.0889560000000014,1.0905265,1.0942743000000048,1.0901371125822397,1.089910182449441,989,-255830,-256093.4,0.03938995178213981,-207.98353464922346,0.11658114322958264
2023-06-25T19:00:00-04:00,1.09064,1.09065,1.0903,1.0904,1.08964584,1.0903417777777777,1.090234444444444,1.089966666666664,1.0896570000000037,1.0890340000000012,1.0904760999999998,1.094233350000005,1.0901896900657917,1.0900145459595527,-776,-256606,-256081.4,0.0446893291882814,-208.15429677054672,0.11476839737409661
2023-06-25T19:15:00-04:00,1.0904,1.09059,1.09036,1.09046,1.0897759392,1.090386888888889,1.090293333333333,1.0900831111111084,1.0897200000000038,1.0891070000000012,1.0904265999999998,1.094194400000005,1.0902437520526334,1.090101236767642,567,-256039,-256174,0.051552203324821744,-208.12309721075218,0.048626976044325726
2023-06-25T19:30:00-04:00,1.09046,1.09061,1.09043,1.09057,1.0898904264959999,1.0904422222222223,1.0903533333333328,1.0901862222222196,1.0897945000000038,1.0891722000000013,1.0903785999999998,1.094155150000005,1.0903090016421066,1.0901781894141134,1053,-254986,-256056,0.05143550548695762,-208.01687598301336,0.04953992091960633
2023-06-25T19:45:00-04:00,1.09057,1.09064,1.09047,1.09062,1.08999117531648,1.0904955555555556,1.0904233333333329,1.090279999999997,1.0898660000000038,1.0892442000000013,1.0903313999999997,1.0941158000000049,1.0903712013136853,1.0902501515312906,853,-254133,-255518.8,0.05011685923298555,-207.9777679936134,0.05779869540086684
2023-06-25T20:00:00-04:00,1.09062,1.09086,1.08987,1.0902,1.09086,1.0904508888888889,1.0904455555555552,1.0903499999999973,1.0899070000000037,1.0892992000000015,1.0902780999999997,1.094072750000005,1.0903369610509481,1.0902901212250322,-3002,-257135,-255779.8,0.04762857662186305,-209.1338443538485,0.018348623853208988
2023-06-25T20:15:00-04:00,1.0902,1.09066,1.09016,1.09053,1.09086,1.0904677777777778,1.090462222222222,1.0903955555555527,1.0899800000000037,1.0893578000000013,1.0902288999999998,1.094031100000005,1.0903755688407586,1.0903272969800255,1794,-255341,-255526.8,0.04746453157846389,-208.59080637916506,0.013756671985921835
2023-06-25T20:30:00-04:00,1.09053,1.09093,1.09034,1.09072,1.08987,1.0905193333333332,1.0904999999999998,1.090436888888886,1.0900695000000036,1.0894022000000014,1.0901795999999997,1.0939902000000048,1.090444455072607,1.0903674375840202,1581,-253760,-255071,0.043372045476161046,-208.31535315917125,0.031181789834737156
2023-06-25T20:45:00-04:00,1.09072,1.09082,1.09033,1.09052,1.0898911999999998,1.0905233333333333,1.0905177777777775,1.0904697777777752,1.0901400000000037,1.0894250000000014,1.0901294999999998,1.093947500000005,1.0904595640580854,1.090397550067216,-2084,-255844,-255242.6,0.037707644316442614,-208.69748606220773,0.014674052606472905
2023-06-25T21:00:00-04:00,1.09052,1.0906,1.09016,1.09034,1.0899119759999998,1.0904877777777777,1.0904844444444444,1.0904819999999975,1.0901950000000036,1.0894610000000013,1.0900773,1.093903550000005,1.0904356512464684,1.0904104400537729,-2591,-258435,-256103,0.0321493687630569,-209.12515359696144,-0.027506785006965354
2023-06-25T21:15:00-04:00,1.09034,1.09071,1.09032,1.0905799999999999,1.0899323364799998,1.090506888888889,1.0905044444444443,1.090493777777775,1.0902585000000038,1.0894980000000012,1.0900287,1.093860800000005,1.0904645209971746,1.090435952043018,2224,-256211,-255918.2,0.025744196854615056,-208.63561822267494,0.016507703594996967
2023-06-25T21:30:00-04:00,1.0905799999999999,1.09097,1.09055,1.09063,1.0899522897503997,1.090532,1.090523333333333,1.0905059999999973,1.0903215000000037,1.0895272000000014,1.0899813999999999,1.0938181500000048,1.0904976167977396,1.0904603616344144,2230,-253981,-255646.2,0.022087020327038385,-208.53337904719012,0.015589751114209002
2023-06-25T21:45:00-04:00,1.09063,1.09072,1.09033,1.09038,1.0899929981603838,1.0905033333333334,1.090502222222222,1.090506444444442,1.0903830000000037,1.0895406000000014,1.0899301,1.093774250000005,1.0904740934381916,1.0904662893075312,-1853,-255834,-256061,0.01694122456376208,-208.9581335468831,-0.017422082030510145
2023-06-25T22:00:00-04:00,1.09038,1.09068,1.09032,1.09059,1.0900320782339683,1.0905208888888887,1.0904988888888887,1.090502666666664,1.0904160000000036,1.0895664000000014,1.0898809999999997,1.093732200000005,1.0904972747505532,1.0904738314460247,1910,-253924,-255677,0.01083488912926402,-208.5902801379797,-0.0027507289431676013
2023-06-25T22:15:00-04:00,1.09059,1.0909,1.09046,1.0909,1.0900695951046095,1.0906011111111111,1.0905766666666663,1.0905211111111082,1.0904595000000037,1.0896180000000013,1.0898367,1.0936924000000048,1.0905778198004425,1.0905022651568195,1804,-252120,-254414,0.009166251077752532,-208.07749348121587,0.06420840212804282
2023-06-25T22:30:00-04:00,1.0909,1.09092,1.0906,1.09083,1.0901056113004253,1.0906517777777778,1.0906099999999996,1.0905422222222194,1.0905015000000038,1.0896508000000014,1.0897976999999999,1.0936525000000048,1.090628255840354,1.0905350121254556,-1539,-253659,-253903.6,0.011449771659771865,-208.17624680416026,0.027509559571948224
2023-06-25T22:45:00-04:00,1.09083,1.09084,1.09044,1.09047,1.0901401868484082,1.0906237777777779,1.0905822222222217,1.090553999999997,1.0905250000000037,1.0896746000000015,1.0897557999999998,1.0936107000000048,1.0905966046722833,1.0905548097003641,-1317,-254976,-254102.6,0.008803301238135927,-208.61088831566974,-0.02292063957751407
2023-06-25T23:00:00-04:00,1.09047,1.09074,1.09038,1.09064,1.090173379374472,1.0906353333333334,1.0905955555555553,1.0905726666666637,1.0905380000000038,1.0897196000000016,1.0897222,1.0935676000000047,1.0906052837378266,1.0905810477602913,1212,-253764,-253688.6,0.0052748465798658365,-208.4219422648843,0.01100392473316583
2023-06-25T23:15:00-04:00,1.09064,1.09094,1.09059,1.0909,1.090205244199493,1.090696222222222,1.0906577777777775,1.0906044444444416,1.0905640000000039,1.0897726000000014,1.0896922,1.0935257500000046,1.0906642269902613,1.090614438208233,1228,-252536,-253411,0.006488612616022204,-208.12919672098357,0.0513601261991575
2023-06-25T23:30:00-04:00,1.0909,1.0909,1.09048,1.09053,1.0902358344315133,1.0906706666666666,1.090652222222222,1.0906195555555527,1.090572500000004,1.0898206000000015,1.0896597,1.0934812000000047,1.090637381592209,1.0906263505665863,-1064,-253600,-253707,0.007575820426566054,-208.49007306161974,-0.004584716389433465
2023-06-25T23:45:00-04:00,1.09053,1.09066,1.09049,1.0906,1.0902652010542528,1.0906602222222224,1.0906488888888886,1.0906273333333307,1.090570500000004,1.0898700000000014,1.0896271999999998,1.0934375000000045,1.0906299052737671,1.0906266804532687,936,-252664,-253508,0.006711189609857228,-208.4299921835146,-0.0027507037216997965
2023-06-26T00:00:00-04:00,1.0906,1.09083,1.0905,1.0907,1.0902933930120828,1.0906704444444446,1.0906844444444443,1.0906477777777752,1.090585500000004,1.0899004000000014,1.0895945999999999,1.0933965000000045,1.0906439242190138,1.0906361443626147,760,-251904,-252893.6,0.007091049689464497,-208.36030577236477,0.029347566903290413
2023-06-26T00:15:00-04:00,1.0907,1.0908,1.09027,1.09038,1.09097,1.0906095555555555,1.090661111111111,1.0906608888888862,1.0905815000000039,1.0899356000000016,1.0895591999999998,1.0933525500000045,1.090591139375211,1.0906333154900918,-897,-252801,-252701,0.007178384156377342,-208.62347621336605,-0.019255632272443677
2023-06-26T00:30:00-04:00,1.09038,1.09039,1.08996,1.09008,1.090956,1.0904933333333333,1.0905699999999998,1.0906433333333307,1.090557000000004,1.0899650000000016,1.0895224,1.0933067500000047,1.0904889115001688,1.0905982523920732,-1020,-253821,-252958,0.0041612613208327365,-208.90411232187864,-0.07516729306077945
2023-06-26T00:45:00-04:00,1.09008,1.0903,1.09005,1.09025,1.0909161600000001,1.0904293333333333,1.0905055555555554,1.0906139999999975,1.090538500000004,1.0899938000000018,1.0894894,1.0932613500000046,1.090441129200135,1.0905590019136582,826,-252995,-252837,-0.0004017223406799245,-208.7752960882077,-0.05317052152947984
2023-06-26T01:00:00-04:00,1.09025,1.09056,1.09022,1.09054,1.0908779136000002,1.0904362222222221,1.090513333333333,1.0905868888888866,1.0905555000000042,1.0900290000000017,1.089462,1.0932178000000046,1.090460903360108,1.0905252015309266,1232,-251763,-252656.8,-0.002711635273080762,-208.4475914333119,0.0064192504149600165
2023-06-26T01:15:00-04:00,1.09054,1.0908,1.09053,1.09064,1.0908411970560001,1.0904615555555555,1.090513333333333,1.090552666666664,1.090561000000004,1.0900704000000017,1.0894354999999998,1.0931751000000047,1.0904967226880864,1.0904957612247412,939,-250824,-252440.8,-0.003074000894955685,-208.36148730141397,0
2023-06-26T01:30:00-04:00,1.09064,1.09098,1.0905799999999999,1.09091,1.08996,1.090540888888889,1.0905144444444443,1.0905233333333306,1.090570500000004,1.0901008000000016,1.0894107,1.0931332000000047,1.0905793781504691,1.0904934089797926,1253,-249571,-251794.8,-0.002257431950482425,-208.0512932868904,0.0009166743056252188
2023-06-26T01:45:00-04:00,1.09091,1.09098,1.09054,1.09067,1.0899804,1.0905719999999999,1.0905299999999998,1.0905153333333308,1.0905780000000043,1.0901302000000017,1.0893845,1.0930900500000045,1.0905975025203754,1.090515127183834,-2333,-251904,-251411.4,-0.004148094845365977,-208.5645528591741,0.012837794466913244
2023-06-26T02:00:00-04:00,1.09067,1.0911,1.09044,1.09073,1.0900003919999999,1.090612,1.0905444444444443,1.0905231111111084,1.0905975000000043,1.090155600000002,1.0893612,1.0930479000000046,1.0906240020163003,1.0905517017470672,2554,-249350,-250682.4,-0.0032311179360676005,-208.42405206608376,0.011920044012466852
2023-06-26T02:15:00-04:00,1.09073,1.09074,1.09017,1.09021,1.0900443763199998,1.090545111111111,1.09049,1.090518444444442,1.0905790000000042,1.0901708000000019,1.0893359,1.0930044500000045,1.0905412016130402,1.0905677613976534,-2425,-251775,-250684.8,-0.0062395861349581385,-209.5801585268946,-0.04492527734483373
2023-06-26T02:30:00-04:00,1.09021,1.09037,1.08976,1.09005,1.0911,1.0904571111111112,1.0904533333333333,1.0905064444444421,1.0905500000000043,1.0901862000000018,1.0893059,1.0929602500000046,1.0904429612904323,1.0905570091181225,-2317,-254092,-251338.4,-0.00988575922307746,-209.9202031054619,-0.0302646783690036
2023-06-26T02:45:00-04:00,1.09005,1.09063,1.08999,1.09031,1.0910731999999999,1.0904284444444445,1.0904788888888888,1.0904993333333308,1.0905465000000043,1.0902084000000019,1.0892764,1.0929183000000047,1.0904163690323458,1.0905244072944977,2268,-251824,-251789,-0.009130482055229759,-209.37923709472858,0.021099368853657756
2023-06-26T03:00:00-04:00,1.09031,1.09061,1.09018,1.09025,1.091046936,1.0903826666666667,1.0904788888888888,1.0904891111111088,1.0905295000000041,1.0902318000000017,1.0892495,1.0928763500000045,1.0903830952258766,1.0904815258355982,-3797,-255621,-252532.4,-0.007004005906934706,-209.58818684296514,0
2023-06-26T03:15:00-04:00,1.09025,1.09084,1.08977,1.09034,1.09102119728,1.0903548888888888,1.0904566666666666,1.090471555555553,1.0905015000000042,1.0902548000000016,1.0892265999999997,1.0928339500000044,1.0903744761807013,1.0904316206684783,4047,-251574,-252977.2,-0.00508712964912636,-209.2541075033636,-0.01833953821042584
2023-06-26T03:30:00-04:00,1.09034,1.09043,1.08955,1.08985,1.0909959733344,1.0902335555555556,1.0903688888888885,1.0904473333333309,1.0904525000000043,1.0902642000000018,1.0892039999999998,1.0927895500000044,1.090269580944561,1.0903772965347824,-4601,-256175,-253857.2,-0.006829730111948849,-211.32180198398476,-0.07243453385168969
2023-06-26T03:45:00-04:00,1.08985,1.09059,1.08969,1.09023,1.0909381344010238,1.0902057777777776,1.0902933333333331,1.0904153333333308,1.0904405000000041,1.0902874000000018,1.0891832,1.0927478000000044,1.090261664755649,1.0903410372278257,3443,-252732,-253585.2,-0.007969682889409614,-210.12132485410436,-0.06233328138893345
2023-06-26T04:00:00-04:00,1.09023,1.09033,1.08871,1.08926,1.0908826090249828,1.089999111111111,1.0901366666666665,1.0903468888888863,1.090371500000004,1.0902940000000017,1.0891536999999998,1.0927018500000043,1.0900613318045191,1.0902700297822605,-6061,-258793,-254979,-0.01781809558602734,-215.5139209118177,-0.12927833350143794
2023-06-26T04:15:00-04:00,1.08926,1.08945,1.08885,1.08931,1.0907522524834838,1.0898337777777778,1.0899788888888888,1.0902468888888863,1.090292000000004,1.0902980000000015,1.0891672999999997,1.0926562500000043,1.0899110654436153,1.090175623825808,2820,-255973,-255049.4,-0.02448383481648007,-215.38447523309978,-0.13018803920310038
2023-06-26T04:30:00-04:00,1.08931,1.08931,1.08874,1.08882,1.0906297173344748,1.089602,1.0898244444444443,1.0901204444444417,1.090206500000004,1.0902896000000015,1.0891883999999998,1.0926090500000043,1.089692852354892,1.0900392990606462,-2994,-258967,-256528,-0.03292034037613594,-216.7312543868763,-0.12749837187330904
2023-06-26T04:45:00-04:00,1.08882,1.08933,1.08877,1.08918,1.0905145342944063,1.0894731111111111,1.0897277777777776,1.0899922222222196,1.090135500000004,1.0902870000000016,1.0892116999999997,1.0925636000000045,1.0895902818839136,1.0899034392485167,2481,-256486,-256590.2,-0.03647353746555411,-215.91095351069808,-0.07981285262143263
2023-06-26T05:00:00-04:00,1.08918,1.08957,1.08906,1.08945,1.0904062622367419,1.0894175555555554,1.0896322222222221,1.0898599999999974,1.090073000000004,1.0902886000000016,1.0892397999999996,1.0925172500000044,1.0895622255071309,1.0897635513988133,2196,-254290,-256901.8,-0.03695588358616296,-215.36658067976106,-0.0788766497601472
2023-06-26T05:15:00-04:00,1.08945,1.08972,1.08921,1.08954,1.0903044865025373,1.089399111111111,1.0895533333333334,1.0897433333333306,1.0900310000000037,1.0902964000000015,1.0892656999999997,1.0924694500000043,1.0895577804057046,1.0896628411190503,1938,-252352,-255613.6,-0.03895417412939623,-215.20648154717136,-0.06512267828479601
2023-06-26T05:30:00-04:00,1.08954,1.08985,1.08939,1.08978,1.0902088173123852,1.0894444444444444,1.089491111111111,1.089645777777775,1.090016000000004,1.0902934000000015,1.0893042999999998,1.0924191500000042,1.0896022243245638,1.08960107289524,2024,-250328,-254484.6,-0.04064586027313442,-214.76064201856292,-0.05136012619917786
2023-06-26T05:45:00-04:00,1.08978,1.09011,1.08961,1.08966,1.0901188882736421,1.0894782222222223,1.08947,1.0895748888888863,1.089986500000004,1.0902860000000014,1.0893517999999998,1.0923703000000042,1.089613779459651,1.0895852583161918,-2553,-252881,-253267.4,-0.04505027964180504,-215.04176297875648,-0.017433591778677107
2023-06-26T06:00:00-04:00,1.08966,1.09,1.08939,1.08981,1.09011,1.0895462222222223,1.0894233333333334,1.0895139999999972,1.089950000000004,1.0902824000000013,1.0893969999999997,1.0923205000000045,1.0896530235677209,1.0895978066529532,1877,-251004,-252171,-0.04349585006934798,-214.78337962982218,-0.03852398117829146
2023-06-26T06:15:00-04:00,1.08981,1.09071,1.08969,1.09056,1.08871,1.0897735555555557,1.089567777777778,1.0895011111111086,1.0899460000000039,1.0902936000000014,1.0894496999999996,1.0922767500000043,1.0898344188541766,1.0896522453223625,1894,-249110,-251135,-0.04055560701019717,-213.47994141582151,0.1193470796687732
2023-06-26T06:30:00-04:00,1.09056,1.09069,1.0903,1.09055,1.08875,1.0899699999999999,1.0897055555555555,1.0895315555555531,1.0899280000000038,1.0902970000000014,1.0895015999999997,1.0922342000000043,1.0899775350833414,1.0897361962578898,-2104,-251214,-250907.4,-0.028327436152794584,-213.49923425619724,0.11383352764593255
2023-06-26T06:45:00-04:00,1.09055,1.09069,1.09037,1.09044,1.0887892000000001,1.0901168888888888,1.0898855555555558,1.089610444444442,1.0899165000000037,1.0902982000000014,1.0895452999999997,1.0921900000000044,1.090070028066673,1.0898297570063118,-2101,-253315,-251504.8,-0.015907204333776213,-213.71115484672464,0.14878492312780597
2023-06-26T07:00:00-04:00,1.09044,1.09072,1.09027,1.09064,1.088827616,1.0902677777777778,1.090047777777778,1.0897259999999978,1.089912000000004,1.0903038000000014,1.0895892999999996,1.0921422000000043,1.0901840224533386,1.0899438056050492,1638,-251677,-251264,0.0009218413936617319,-213.4107256621753,0.13404579591986787
2023-06-26T07:15:00-04:00,1.09064,1.09077,1.09032,1.09051,1.0889033113600002,1.0903602222222224,1.0901655555555558,1.0898744444444424,1.0899270000000039,1.0903012000000014,1.0896285999999997,1.0920960000000044,1.0902492179626708,1.0900630444840391,-1722,-253399,-251743,0.014085522363791394,-213.61598129189724,0.09729680113819458
2023-06-26T07:30:00-04:00,1.09051,1.09146,1.0904099999999999,1.09121,1.0890153126784001,1.0905691111111113,1.0903511111111115,1.090031111111109,1.0899850000000038,1.0903174000000013,1.0896756999999997,1.0920518000000043,1.0904413743701367,1.0901844355872314,1912,-251487,-252218.4,0.02586310466492984,-212.3886656322519,0.15327569432972268
2023-06-26T07:45:00-04:00,1.09121,1.09179,1.09106,1.09178,1.0892108876641282,1.090854888888889,1.0905733333333336,1.0902046666666647,1.0900585000000038,1.0903438000000014,1.0897253999999998,1.0920098000000042,1.0907090994961093,1.0903307484697848,2284,-249203,-251816.2,0.03885288325631258,-211.19560471822078,0.18352327992805903
2023-06-26T08:00:00-04:00,1.09178,1.09195,1.0914,1.09166,1.0894687988977154,1.0910722222222224,1.090795555555556,1.0903866666666648,1.090129000000004,1.0903656000000015,1.0897689,1.0919665000000043,1.0908992795968875,1.0904965987758277,-2454,-251657,-251484.6,0.05019912348119874,-211.46532938802582,0.18354349063010494
2023-06-26T08:15:00-04:00,1.09166,1.092,1.09162,1.0919699999999999,1.0897665430299897,1.091307111111111,1.0910355555555558,1.0905842222222204,1.090210500000004,1.0903926000000015,1.0898183999999997,1.0919228500000042,1.09111342367751,1.090682479020662,2291,-249366,-251022.4,0.06387109595970905,-210.81475136922916,0.1981996861838247
2023-06-26T08:30:00-04:00,1.0919699999999999,1.092,1.09164,1.0919,1.090079227005791,1.0914800000000002,1.0911844444444447,1.090787999999998,1.0903130000000039,1.0904266000000014,1.0898628999999997,1.0918805500000044,1.091270738942008,1.0908867832165297,-2182,-251548,-250652.2,0.07622255483591746,-210.95462700683782,0.12287265258217053
2023-06-26T08:45:00-04:00,1.0919,1.09198,1.0914,1.09174,1.0903481352249804,1.0915911111111112,1.0913166666666667,1.0909811111111092,1.0903885000000038,1.0904508000000015,1.0899042999999997,1.0918369500000045,1.0913645911536063,1.0910714265732235,-2008,-253556,-251066,0.07878417329041941,-211.2488664060505,0.1091192517537045
2023-06-26T09:00:00-04:00,1.09174,1.09193,1.09144,1.09191,1.090579396293483,1.0917097777777778,1.0914800000000002,1.0911624444444423,1.0905210000000038,1.0904746000000014,1.0899383999999999,1.0917947500000043,1.091473672922885,1.0912243412585787,2149,-251407,-251506.8,0.08391383635075285,-210.91423544996204,0.13480796742598036
2023-06-26T09:15:00-04:00,1.09191,1.092,1.09135,1.09139,1.0907782808123956,1.091691777777778,1.0915633333333337,1.091315999999998,1.090625000000004,1.0904920000000016,1.0899584999999998,1.0917514500000043,1.0914569383383081,1.091335873006863,-2371,-253778,-251931,0.08331655882239232,-212.0433761300544,0.06876696251742356
2023-06-26T09:30:00-04:00,1.09139,1.09166,1.0909,1.09112,1.092,1.091603111111111,1.0916311111111114,1.0914351111111091,1.0907400000000038,1.0905076000000016,1.0899842999999998,1.0917108000000042,1.0913895506706466,1.0913910984054904,-4144,-257922,-253642.2,0.07980834470725737,-213.0685641929833,0.05593713033351362
2023-06-26T09:45:00-04:00,1.09112,1.09129,1.09078,1.09125,1.092,1.091526888888889,1.091635555555556,1.0915253333333315,1.0908435000000039,1.0905210000000016,1.0900094999999999,1.0916725000000043,1.0913616405365172,1.091409278724392,3939,-253983,-254129.2,0.07597556104192763,-212.59925742562513,0.003665655556679283
2023-06-26T10:00:00-04:00,1.09125,1.0916,1.09083,1.09097,1.0919512,1.0913937777777778,1.0915455555555558,1.0915711111111093,1.0909195000000038,1.0905278000000016,1.0900274999999997,1.0916333500000044,1.0912833124292138,1.091393022979514,-4321,-258304,-255078.8,0.06595558551150854,-213.70796762035616,-0.07419077103445543
2023-06-26T10:15:00-04:00,1.09097,1.09124,1.09077,1.09101,1.091904352,1.0912866666666667,1.0914733333333335,1.0915697777777758,1.0909930000000039,1.0905404000000016,1.0900404999999997,1.0915927500000044,1.091228649943371,1.091344018383611,3609,-254695,-255736.4,0.05208342427144517,-213.57564500836853,-0.05954234835022254
2023-06-26T10:30:00-04:00,1.09101,1.09113,1.09031,1.09039,1.0918362908800001,1.09107,1.091297777777778,1.0915166666666647,1.0910235000000037,1.0905364000000015,1.0900513999999997,1.0915530500000044,1.0910609199546968,1.0912648147068886,-4201,-258896,-256760,0.03673028447979896,-215.962992512058,-0.14469261976060835
2023-06-26T10:45:00-04:00,1.09039,1.09152,1.09025,1.0908,1.0917141876096002,1.0909704444444446,1.0911755555555556,1.0914255555555537,1.091080500000004,1.0905344000000015,1.0900761999999997,1.0915158500000042,1.0910087359637575,1.091188651765511,5123,-253773,-255930.2,0.02155271183149346,-214.03668174251675,-0.10074182617456734
2023-06-26T11:00:00-04:00,1.0908,1.09111,1.09054,1.0911,1.09156776884864,1.0909553333333333,1.0911044444444444,1.0913193333333315,1.091145000000004,1.0905398000000015,1.0900952999999998,1.0914866000000043,1.091026988771006,1.0911217214124087,3351,-250422,-255218,0.00793446082997729,-213.1150645808007,-0.05862201623096836
2023-06-26T11:15:00-04:00,1.0911,1.09148,1.09092,1.09133,1.09025,1.0910004444444443,1.0910400000000002,1.0912182222222202,1.0911835000000039,1.0905570000000013,1.0901157999999997,1.0914545000000044,1.0910875910168047,1.0910825771299266,2602,-247820,-253121.2,-0.0024569885174414454,-212.56657223362822,-0.05311793096500856
2023-06-26T11:30:00-04:00,1.09133,1.09153,1.09118,1.09151,1.0902745999999999,1.0910944444444444,1.0910533333333334,1.0911342222222202,1.091231500000004,1.0905744000000015,1.090147,1.0914230500000044,1.0911720728134437,1.0910712617039413,2480,-245340,-251250.2,-0.010268302496268943,-212.15753005573504,0.010995152970056345
2023-06-26T11:45:00-04:00,1.09151,1.09178,1.09084,1.09094,1.0903248159999999,1.0910717777777779,1.0910333333333335,1.0910813333333316,1.091256500000004,1.0905752000000015,1.0901738999999997,1.0913872500000044,1.091125658250755,1.091084209363153,-2774,-248114,-249093.8,-0.016093861073348554,-213.60614710917466,-0.016496810616620443
2023-06-26T12:00:00-04:00,1.09094,1.09094,1.09064,1.09078,1.0904121270399998,1.0910211111111112,1.0909811111111114,1.0910424444444426,1.0912635000000042,1.0905802000000016,1.0902003999999998,1.0913475500000045,1.091056526600604,1.0910937674905223,-2189,-250303,-248399.8,-0.02069304688299984,-213.9271913462545,-0.043069873997706336
2023-06-26T12:15:00-04:00,1.09078,1.0909,1.09022,1.09023,1.09178,1.0908708888888887,1.090898888888889,1.0910013333333315,1.091249500000004,1.0905728000000015,1.0902214,1.0913100000000042,1.0908912212804833,1.0910666139924179,-1811,-252114,-248738.2,-0.0282516200823184,-214.84034523613155,-0.06782954618366802
2023-06-26T12:30:00-04:00,1.09023,1.09024,1.08998,1.09015,1.0917488,1.090721111111111,1.0908033333333336,1.0909539999999982,1.091196500000004,1.0905618000000015,1.0902310999999998,1.0912765500000043,1.0907429770243866,1.0909976911939343,-1890,-254004,-249975,-0.034195732602833186,-214.9790315683735,-0.07882604192446292
2023-06-26T12:45:00-04:00,1.09015,1.091,1.09015,1.09086,1.091678048,1.0907324444444444,1.0908555555555557,1.0909144444444425,1.091150500000004,1.0905714000000015,1.0902535,1.0912513500000045,1.0907663816195092,1.0909165529551472,1294,-252710,-251449,-0.034043515126955026,-214.13626681123,0.04310384357890025
2023-06-26T13:00:00-04:00,1.09086,1.09094,1.09063,1.09069,1.09161012608,1.0906993333333335,1.0908433333333334,1.0908764444444425,1.091102000000004,1.0905836000000015,1.0902743,1.0912218000000042,1.0907511052956074,1.0908416423641178,-1712,-254422,-252710.6,-0.026538708283539374,-214.40306548383694,-0.010084341767515081
2023-06-26T13:15:00-04:00,1.09069,1.0913,1.09064,1.09125,1.0915449210368,1.0907806666666666,1.0908600000000002,1.0908522222222206,1.0910660000000039,1.0906036000000014,1.0902987,1.0912016500000044,1.090850884236486,1.0908005138912942,1528,-252894,-253228.8,-0.020625584540502402,-213.61853459054905,0.013747594171028733
2023-06-26T13:30:00-04:00,1.09125,1.09131,1.09107,1.09117,1.091482324195328,1.0908426666666664,1.0908422222222223,1.0908408888888872,1.091029500000004,1.0906162000000015,1.0903225999999997,1.0911769500000044,1.0909147073891887,1.0908052111130353,-1188,-254082,-253622.4,-0.0164931877764486,-213.7056273740543,-0.01466100996031796
2023-06-26T13:45:00-04:00,1.09117,1.09128,1.09098,1.091,1.0914222312275148,1.090874222222222,1.0907855555555557,1.0908373333333317,1.090992500000004,1.0906234000000012,1.0903469,1.0911557000000043,1.0909317659113509,1.090842968890428,-1478,-255560,-253933.6,-0.0155903627812898,-213.9358939686271,-0.04672426271862012
2023-06-26T14:00:00-04:00,1.091,1.09117,1.09085,1.09111,1.0913645419784141,1.090939111111111,1.0908044444444447,1.0908271111111092,1.090952500000004,1.0906274000000014,1.0903641,1.0911343500000044,1.0909674127290807,1.0908831751123422,1043,-254517,-254295,-0.016507383365703975,-213.83073356532734,0.015582891818065474
2023-06-26T14:15:00-04:00,1.09111,1.0913599999999999,1.09092,1.09134,1.08998,1.0910462222222221,1.0908666666666669,1.090831777777776,1.090950000000004,1.0906408000000014,1.0903854999999998,1.0911140500000043,1.0910419301832646,1.0909413400898738,1310,-253207,-254052,-0.010353381151363406,-213.55459275459336,0.051339408496662374
2023-06-26T14:30:00-04:00,1.09134,1.09153,1.09121,1.0913,1.0900075999999999,1.091132888888889,1.0909855555555559,1.0908568888888872,1.0909590000000038,1.0906522000000014,1.0904038999999999,1.0910930500000042,1.0910935441466116,1.090989872071899,-1075,-254282,-254329.6,-0.005194170307508701,-213.5939938578243,0.09814442823990391
2023-06-26T14:45:00-04:00,1.0913,1.09149,1.0911899999999999,1.09148,1.0900684959999998,1.0912317777777778,1.0911333333333335,1.0909151111111093,1.090970500000004,1.0906776000000011,1.0904242,1.0910732500000044,1.0911708353172893,1.091041097657519,1668,-252614,-254036,0.0046921389433376695,-213.31887244299784,0.12200155941843356
2023-06-26T15:00:00-04:00,1.09148,1.09151,1.09097,1.09097,1.0901269561599998,1.0911991111111112,1.0911455555555558,1.0909871111111094,1.090970500000004,1.0906960000000012,1.0904411,1.0910515500000044,1.0911306682538315,1.0910808781260153,-1374,-253988,-253721.6,0.013430593469142566,-213.96088145827986,0.010083787103757999
2023-06-26T15:15:00-04:00,1.09097,1.09101,1.0906,1.09063,1.0901830779135997,1.091096,1.091138888888889,1.0910539999999984,1.090951500000004,1.0907024000000012,1.0904554,1.0910284500000045,1.0910305346030653,1.0910935025008122,-1260,-255248,-253867.8,0.012806612297669797,-214.35355953375398,-0.00550110480521037
2023-06-26T15:30:00-04:00,1.09063,1.0907,1.09051,1.09057,1.0902369547970556,1.0909822222222223,1.0910633333333335,1.0910933333333317,1.090960500000004,1.0907088000000014,1.0904703,1.0910036000000045,1.0909384276824523,1.09107280200065,-1379,-256627,-254551.8,0.013627474945175983,-214.42942394239847,-0.06231386025200585
2023-06-26T15:45:00-04:00,1.09057,1.0907,1.0904099999999999,1.0906,1.0902886766051734,1.0908895555555556,1.0910000000000002,1.0910962222222205,1.090950500000004,1.0907140000000013,1.0904844,1.0909780000000047,1.0908707421459618,1.09102824160052,2007,-254620,-254619.4,0.006752565822409896,-214.37421428139555,-0.0522375065296846
2023-06-26T16:00:00-04:00,1.0906,1.09085,1.09055,1.09067,1.0903383295409663,1.0908235555555554,1.0909633333333337,1.0910622222222206,1.090929000000004,1.090730400000001,1.0904973,1.0909533000000047,1.0908305937167695,1.090960193280416,1055,-253565,-254809.6,0.0027368343863714934,-214.30649926214008,-0.03024747937671324
2023-06-26T16:15:00-04:00,1.09067,1.09068,1.09051,1.09052,1.0903859963593276,1.090734888888889,1.090897777777778,1.0910126666666649,1.0908885000000041,1.0907362000000014,1.0905118,1.0909278000000047,1.0907684749734157,1.0908877546243327,-390,-253955,-254803,0.0008686504491423459,-214.36013601752902,-0.05407337482014558
2023-06-26T16:30:00-04:00,1.09052,1.09055,1.0904,1.09045,1.09153,1.0906453333333332,1.090798888888889,1.090944666666665,1.090835500000004,1.0907600000000013,1.0905269999999998,1.0909029500000045,1.0907047799787326,1.0908226036994662,-479,-254434,-254640.2,-0.0013401303111065903,-214.3908828172209,-0.08155112064068552
2023-06-26T16:45:00-04:00,1.09045,1.09065,1.09044,1.09057,1.0915073999999998,1.0905995555555554,1.0907177777777781,1.0908755555555536,1.0908170000000041,1.0907852000000013,1.0905415999999999,1.0908762500000047,1.0906778239829862,1.090770482959573,565,-253869,-254088.6,-0.004295577650239074,-214.32870665141772,-0.06689269678364312
2023-06-26T17:00:00-04:00,1.09057,1.09061,1.09052,1.09057,1.0914852519999998,1.0905699999999998,1.0906166666666668,1.0907988888888869,1.090806500000004,1.0908202000000013,1.0905548999999999,1.0908495500000046,1.0906562591863889,1.0907275863676584,0,-253869,-253938.4,-0.00937271766445896,-214.32870665141772,-0.08337303477846286
2023-06-26T17:15:00-04:00,1.09057,1.09077,1.09053,1.09063,1.0914635469599998,1.0905726666666669,1.0905788888888892,1.0907219999999982,1.0908265000000041,1.0908492000000012,1.0905680999999998,1.0908246500000047,1.0906510073491111,1.0906916690941268,253,-253616,-253948.6,-0.01651041002725147,-214.31478732482705,-0.031164926624930745
2023-06-26T17:30:00-04:00,1.09063,1.09063,1.09054,1.09057,1.0914422760207998,1.0905708888888888,1.0905722222222225,1.090656888888887,1.090847500000004,1.0908716000000012,1.0905800999999997,1.0907989000000047,1.090634805879289,1.0906649352753015,-144,-253760,-253909.6,-0.02166140628871469,-214.32270935154554,-0.005501407443399593
2023-06-26T17:45:00-04:00,1.09057,1.09084,1.09054,1.09062,1.0914214305003838,1.0905804444444445,1.090577777777778,1.0906126666666647,1.090835500000004,1.0908932000000013,1.0905947999999999,1.0907730000000047,1.090631844703431,1.0906503482202412,243,-253517,-253726.2,-0.02380435812247009,-214.3115683885629,0.004584758429067686
2023-06-26T18:00:00-04:00,1.09062,1.09077,1.09059,1.09076,1.0914010018903761,1.0906168888888887,1.090595555555556,1.0905882222222203,1.0908390000000039,1.0909128000000012,1.0906030999999998,1.0907488500000044,1.090657475762745,1.0906462785761928,169,-253348,-253622,-0.0216261333091653,-214.28987430629778,0.014670823399957634
2023-06-26T18:15:00-04:00,1.09076,1.09118,1.0907499999999999,1.09095,1.0913809818525686,1.0906877777777777,1.0906266666666669,1.0905902222222204,1.090824000000004,1.0909386000000014,1.0906122999999999,1.0907268000000045,1.090715980610196,1.0906582228609543,908,-252440,-253336.2,-0.019552351978788844,-214.13170935708794,0.025672293177593404
2023-06-26T18:30:00-04:00,1.09095,1.09105,1.09093,1.09094,1.0913613622155172,1.0907504444444445,1.0906733333333336,1.0906091111111094,1.090812500000004,1.0909612000000013,1.0906218,1.0907044500000045,1.0907607844881568,1.0906801782887634,-579,-253019,-253216.8,-0.01572416273832055,-214.1370166580642,0.038513736566049867
2023-06-26T18:45:00-04:00,1.09094,1.09114,1.0909,1.09108,1.091342134971207,1.0908317777777776,1.0907433333333336,1.0906433333333316,1.0908165000000039,1.0909716000000014,1.0906326,1.0906820000000044,1.0908246275905256,1.0907181426310106,183,-252836,-253032,-0.010197609236630779,-214.11353232345368,0.05777431335688298
2023-06-26T19:00:00-04:00,1.09108,1.0911,1.09085,1.09087,1.0913232922717828,1.090857111111111,1.0907766666666672,1.0906831111111095,1.090804500000004,1.0909780000000013,1.0906375,1.0906585500000043,1.0908337020724204,1.0907585141048084,-262,-253098,-252948.2,-0.005779842145467759,-214.16395942320807,0.0275085505744672
2023-06-26T19:15:00-04:00,1.09087,1.09092,1.09073,1.09091,1.0913048264263472,1.0908837777777778,1.0908144444444448,1.0907268888888872,1.090783000000004,1.0909874000000013,1.0906428000000001,1.0906352500000045,1.0908489616579362,1.0907968112838466,476,-252622,-252803,-0.001789845898403968,-214.1465054644412,0.031176357317733567
2023-06-26T19:30:00-04:00,1.09091,1.09098,1.09082,1.09092,1.0912867298978202,1.090904888888889,1.090846666666667,1.0907708888888872,1.0907640000000038,1.0909930000000014,1.0906484,1.0906120000000044,1.0908631693263489,1.0908262490270773,690,-251932,-252701.4,0.0032523405940600644,-214.1401804697121,0.02659013597644494
2023-06-26T19:45:00-04:00,1.09092,1.09106,1.09087,1.09098,1.0912689952998638,1.0909315555555557,1.0908922222222226,1.090814666666665,1.090739000000004,1.0910024000000014,1.0906518,1.0905891500000044,1.090886535461079,1.0908513992216615,813,-251119,-252321.4,0.00785811389572295,-214.0954659168575,0.037595019118444616
2023-06-26T20:00:00-04:00,1.09098,1.09101,1.09065,1.09076,1.0912516153938665,1.0909051111111112,1.0909077777777783,1.0908475555555541,1.090728500000004,1.0909934000000014,1.0906554000000002,1.0905657500000043,1.0908612283688632,1.0908587193773291,-1142,-252261,-252206.4,0.01274364193140013,-214.32575428144725,0.012836735068129046
2023-06-26T20:15:00-04:00,1.09076,1.09087,1.09071,1.09085,1.091234583085989,1.0908935555555554,1.0909177777777783,1.0908757777777762,1.0907395000000037,1.0909748000000012,1.0906593,1.0905429500000043,1.0908589826950905,1.090863775501863,1449,-250812,-251749.2,0.015376273388781577,-214.20619544173897,0.00825112765412607
2023-06-26T20:30:00-04:00,1.09085,1.09113,1.09074,1.09078,1.0912178914242694,1.0908660000000001,1.0908988888888893,1.0908926666666652,1.0907500000000039,1.0909572000000012,1.0906614000000001,1.0905200000000044,1.0908431861560723,1.0908626204014904,-1132,-251944,-251613.6,0.014904671658681902,-214.2788360431049,-0.015582748980246893
2023-06-26T20:45:00-04:00,1.09078,1.09085,1.09019,1.09044,1.091201533595784,1.0907742222222223,1.0908433333333336,1.0908919999999986,1.0907420000000037,1.0909266000000013,1.0906596,1.0904955000000043,1.0907625489248578,1.0908424963211922,-1754,-253698,-251966.8,0.010796561865000515,-214.82556407258838,-0.04583203475901011
2023-06-26T21:00:00-04:00,1.09044,1.09098,1.09038,1.09077,1.0911610722519527,1.0907595555555554,1.0908088888888894,1.0908753333333319,1.0907470000000037,1.0909040000000012,1.0906653000000002,1.0904717000000046,1.0907640391398863,1.0908179970569538,2133,-251565,-252056,0.00849573532445916,-214.18005400325868,-0.02841221541958724
2023-06-26T21:15:00-04:00,1.09077,1.09107,1.09053,1.09096,1.0911222293618745,1.0907897777777777,1.0908188888888892,1.0908575555555542,1.0907690000000039,1.0908884000000014,1.0906696,1.0904492500000043,1.090803231311909,1.0908063976455629,2279,-249286,-251461,0.006129425170168803,-213.78307755542843,0.008250295635586593
2023-06-26T21:30:00-04:00,1.09096,1.09183,1.09083,1.09176,1.09019,1.090978,1.0909133333333338,1.090856666666665,1.090834500000004,1.0908854000000014,1.09068,1.0904298000000043,1.090994585049527,1.0908335181164504,3052,-246234,-250545.4,0.00887496212992553,-211.54504866344303,0.07791660173616681
2023-06-26T21:45:00-04:00,1.09176,1.09351,1.09168,1.0924,1.0902228,1.0912753333333334,1.091077777777778,1.090892444444443,1.0909260000000038,1.0909056000000013,1.0906988000000002,1.0904141500000044,1.0912756680396216,1.0909200144931601,3612,-242622,-248681,0.014020635477221577,-209.427660226424,0.1356653100135801
2023-06-26T22:00:00-04:00,1.0924,1.0924099999999999,1.09176,1.09176,1.0903542880000001,1.0914117777777779,1.0911644444444448,1.0909566666666652,1.090985500000004,1.0909184000000012,1.090713,1.0903951500000044,1.0913725344316973,1.0910420115945283,-2031,-244653,-246872,0.01652533273292565,-210.6175540382145,0.07149535280206813
2023-06-26T22:15:00-04:00,1.09176,1.09226,1.09176,1.09205,1.0904805164800002,1.091588888888889,1.091307777777778,1.091056444444443,1.0910565000000039,1.0909344000000012,1.0907277000000002,1.0903782000000044,1.091508027545358,1.0911908092756224,1592,-243061,-245171.2,0.019871891116382507,-210.19467721546974,0.11826616304228367
2023-06-26T22:30:00-04:00,1.09205,1.09242,1.09198,1.09213,1.0906016958208002,1.0917533333333334,1.0914500000000003,1.0911826666666653,1.091134500000004,1.0909576000000012,1.0907427,1.0903620500000044,1.0916324220362863,1.091356647420498,1387,-241674,-243648.8,0.02588021084757983,-210.09307014619625,0.117339689233162
2023-06-26T22:45:00-04:00,1.09213,1.09233,1.09193,1.09228,1.0907180279879682,1.0919193333333332,1.091616666666667,1.091323333333332,1.091217500000004,1.0909830000000011,1.0907617000000003,1.0903459000000044,1.091761937629029,1.0915101179363984,1710,-239964,-242394.8,0.031520879146033,-209.85820799608612,0.137516272758928
2023-06-26T23:00:00-04:00,1.09228,1.09271,1.0921399999999999,1.09263,1.0908297068684496,1.0921219999999998,1.09186,1.0914797777777765,1.091311000000004,1.091027800000001,1.0907821000000002,1.0903315500000044,1.0919355501032233,1.0916420943491187,1708,-238256,-241521.6,0.03969982083176467,-209.31091243084632,0.20083635963463503
2023-06-26T23:15:00-04:00,1.09263,1.09282,1.09243,1.0927499999999999,1.0909369185937117,1.0923,1.0920800000000002,1.0916628888888873,1.0914010000000038,1.091066800000001,1.0908006000000001,1.0903186500000044,1.0920984400825786,1.091787275479295,1166,-237090,-240009,0.05217948276059627,-209.18285444232333,0.18152314420087376
2023-06-26T23:30:00-04:00,1.0927499999999999,1.09291,1.09255,1.09276,1.0910398418499632,1.092436,1.0922800000000004,1.091857333333332,1.091492000000004,1.091100000000001,1.0908199000000003,1.0903088000000043,1.0922307520660628,1.091931820383436,1632,-235458,-238488.4,0.06251096166908064,-209.16791964479407,0.16499230035931875
2023-06-26T23:45:00-04:00,1.09276,1.0928,1.09257,1.09267,1.0911386481759646,1.092514,1.0923811111111115,1.092043555555554,1.0915715000000037,1.0911268000000012,1.0908419000000003,1.0902988500000044,1.0923186016528503,1.0920690563067488,-1241,-236699,-237493.4,0.07062490102549256,-209.270128730046,0.0833516523778089
2023-06-27T00:00:00-04:00,1.09267,1.09281,1.09259,1.09279,1.0912335022489261,1.0925957777777777,1.0924244444444446,1.0922051111111095,1.0916675000000038,1.0911524000000012,1.0908634000000001,1.0902928000000043,1.0924128813222802,1.0921992450453992,1208,-235491,-236598.8,0.07259570881826298,-209.1374628748474,0.03570120834858023
2023-06-27T00:15:00-04:00,1.09279,1.09287,1.09259,1.09271,1.0913245621589691,1.092652888888889,1.0925300000000004,1.0923391111111096,1.0917575000000037,1.091187800000001,1.0908815000000003,1.0902868500000045,1.0924723050578242,1.0923065960363192,-1266,-236757,-236299,0.06740364458637466,-209.23014307872904,0.08701546127354055
2023-06-27T00:30:00-04:00,1.09271,1.09273,1.09248,1.09263,1.0914119796726103,1.0926728888888888,1.0925944444444449,1.0924419999999986,1.091843000000004,1.091224800000001,1.0909025000000003,1.0902811000000043,1.0925038440462593,1.0923876768290552,-1190,-237947,-236470.4,0.0678652708638108,-209.31726592010517,0.0531111212856577
2023-06-27T00:45:00-04:00,1.09263,1.09272,1.0923,1.09231,1.0914959004857059,1.0926159999999998,1.0926144444444448,1.0925088888888874,1.0919095000000039,1.0912664000000012,1.0909196000000003,1.0902734000000043,1.0924650752370075,1.0924345414632441,-1140,-239087,-237196.2,0.06418025597987152,-209.6511392349511,0.016481554393693695
2023-06-27T01:00:00-04:00,1.09231,1.09271,1.09228,1.09262,1.0915764644662775,1.092617111111111,1.0926522222222226,1.0925631111111096,1.0920025000000038,1.0913158000000012,1.0909388000000002,1.0902667000000044,1.092496060189606,1.0924700331705952,1252,-237835,-237423.4,0.06151112847762363,-209.29581885886736,0.031127549712528565
2023-06-27T01:15:00-04:00,1.09262,1.09271,1.09247,1.09266,1.0916538058876264,1.0926186666666666,1.092655555555556,1.0926093333333318,1.0920930000000038,1.091351800000001,1.0909616000000002,1.0902604000000045,1.0925288481516848,1.0924932265364764,1284,-236551,-237635.4,0.05670066904461623,-209.24881258038073,0.002745668707611405
2023-06-27T01:30:00-04:00,1.09266,1.09268,1.09211,1.09216,1.0917280536521214,1.0925195555555556,1.0925900000000004,1.0926213333333317,1.0921620000000039,1.0913812000000012,1.0909824000000004,1.0902524000000045,1.0924550785213478,1.092489781229181,-1702,-238253,-237934.6,0.046681741796938715,-210.02764588625806,-0.053992221459608185
2023-06-27T01:45:00-04:00,1.09216,1.09238,1.09173,1.09177,1.09351,1.0923555555555555,1.0924800000000003,1.0925984444444428,1.0922285000000038,1.091391600000001,1.0909976000000003,1.0902435000000041,1.0923180628170783,1.0924526249833446,-1921,-240174,-238380,0.03339000070223891,-210.71361680626998,-0.09059628829752613
2023-06-27T02:00:00-04:00,1.09177,1.0925,1.09162,1.09235,1.0934744,1.0923295555555554,1.0924444444444448,1.0925644444444427,1.0923075000000038,1.091415200000001,1.0910157000000005,1.0902388500000042,1.0923244502536626,1.092424499986676,2692,-237482,-238059,0.021306260823392736,-209.28349874110967,-0.029286060750281236
2023-06-27T02:15:00-04:00,1.09235,1.0927499999999999,1.09221,1.09266,1.093400224,1.0923726666666664,1.0924300000000005,1.0925199999999982,1.0923925000000039,1.091448400000001,1.0910359000000005,1.0902357000000042,1.0923915602029302,1.0924035999893404,2114,-235368,-237565.6,0.01297364597401349,-208.6835628231346,-0.011896155711524034
2023-06-27T02:30:00-04:00,1.09266,1.09311,1.09251,1.09305,1.0933290150400001,1.0924966666666667,1.0924677777777783,1.0924824444444428,1.0924570000000038,1.091487200000001,1.0910573000000003,1.0902340000000041,1.0925232481623441,1.0924024799914722,2859,-232509,-236757.2,0.006242126507909222,-207.66310815288006,0.031115300491439353
2023-06-27T02:45:00-04:00,1.09305,1.09335,1.09248,1.0931,1.09162,1.092623111111111,1.0925200000000004,1.0924684444444428,1.092492000000004,1.091522400000001,1.0910816000000003,1.0902330500000041,1.0926385985298752,1.0924391839931777,3065,-229444,-234995.4,0.00397084155711066,-207.52290413659568,0.04301547641927921
2023-06-27T03:00:00-04:00,1.0931,1.09398,1.09293,1.09387,1.0916546,1.092893111111111,1.092693333333334,1.0925111111111094,1.092597500000004,1.091573800000001,1.0911130000000004,1.0902371000000042,1.0928848788239,1.092552547194542,3904,-225540,-232068.6,0.008913118236118017,-204.77285382097978,0.14281659968324065
2023-06-27T03:15:00-04:00,1.09387,1.09414,1.09361,1.09364,1.091747616,1.0930824444444442,1.0928066666666671,1.092583555555554,1.0926770000000041,1.091617000000001,1.0911473000000003,1.0902416000000041,1.0930359030591201,1.0926948377556336,-2700,-228240,-230220.2,0.012891366053592066,-205.340562963748,0.09335359045230922
2023-06-27T03:30:00-04:00,1.09364,1.09376,1.09308,1.09361,1.09189115904,1.0932431111111112,1.0929122222222227,1.0926799999999985,1.092751000000004,1.091669800000001,1.0911829000000004,1.090244400000004,1.093150722447296,1.0928466702045068,-3192,-231432,-229433,0.015152208444419842,-205.42812376986328,0.08694378855270683
2023-06-27T03:45:00-04:00,1.09361,1.09413,1.0936,1.09394,1.0920260894976,1.0934486666666667,1.0931100000000005,1.092808444444443,1.092834000000004,1.0917360000000011,1.0912192000000005,1.090247800000004,1.0933085779578369,1.0930037361636054,2808,-228624,-228656,0.018976894813765754,-204.58080159833975,0.16297978318194153
2023-06-27T04:00:00-04:00,1.09394,1.09438,1.0937,1.09403,1.092152924127744,1.0936326666666667,1.0933611111111117,1.0929766666666652,1.092904000000004,1.091805200000001,1.0912570000000004,1.0902532500000042,1.0934528623662696,1.0931665889308841,3918,-224706,-227708.4,0.028460993145962454,-204.25846216473226,0.20700330655725574
2023-06-27T04:15:00-04:00,1.09403,1.09409,1.09366,1.09403,1.0923310901975243,1.0937664444444446,1.0935477777777782,1.093147555555554,1.092968000000004,1.091873800000001,1.0912939000000004,1.0902602500000043,1.0935682898930157,1.0933032711447073,0,-224706,-227541.6,0.04303743751686064,-204.25846216473226,0.15379685998078693
2023-06-27T04:30:00-04:00,1.09403,1.0941,1.09345,1.09373,1.0924950029817224,1.0938028888888889,1.0936666666666672,1.093319555555554,1.093016500000004,1.0919350000000012,1.0913327000000004,1.090268350000004,1.0936006319144125,1.0934162169157657,-2727,-227433,-227380.2,0.051391773395469166,-205.00624787444764,0.09792616184358596
2023-06-27T04:45:00-04:00,1.09373,1.09413,1.0936,1.09396,1.0926458027431847,1.0938615555555555,1.0937677777777783,1.0934906666666653,1.093081000000004,1.0920038000000012,1.0913700000000004,1.0902766000000041,1.09367250553153,1.0935205735326126,2582,-224851,-226064,0.0580545074583217,-204.46328023161087,0.08325328210054127
2023-06-27T05:00:00-04:00,1.09396,1.0939699999999999,1.09289,1.093,1.0927845385237298,1.0937080000000003,1.0937566666666672,1.0936199999999985,1.093091500000004,1.092054800000001,1.0914074000000005,1.0902805500000041,1.0935380044252239,1.09356645882609,-2689,-227540,-225847.2,0.056158629504889535,-206.82300087953234,-0.009148293843197236
2023-06-27T05:15:00-04:00,1.093,1.09327,1.09259,1.09296,1.09438,1.093548666666667,1.093655555555556,1.0936788888888873,1.093104000000004,1.0921026000000011,1.0914439000000005,1.090305600000004,1.0934224035401792,1.093560367060872,-2478,-230018,-226909.6,0.054136848997757614,-206.91368706434488,-0.08319087277281272
2023-06-27T05:30:00-04:00,1.09296,1.09383,1.09294,1.09346,1.0943441999999999,1.0935095555555556,1.093635555555556,1.0936964444444428,1.093145500000004,1.0921604000000011,1.0914903000000005,1.090339350000004,1.0934299228321434,1.0935326936486975,2575,-227443,-227457,0.04711716648818106,-205.73569335917688,-0.01645879814197057
2023-06-27T05:45:00-04:00,1.09346,1.09447,1.09343,1.09409,1.09259,1.0936004444444443,1.0936888888888892,1.0937008888888873,1.093234500000004,1.0922296000000011,1.0915394000000005,1.090375550000004,1.0935619382657147,1.093524954918958,2225,-225218,-227014,0.044870845493997294,-204.45375346197002,0.043891332376261735
2023-06-27T06:00:00-04:00,1.09409,1.09456,1.09408,1.09432,1.0926276,1.0937266666666667,1.0937311111111117,1.0936935555555538,1.093319500000004,1.0923046000000012,1.0915881000000005,1.0904139500000043,1.0937135506125717,1.0935331639351664,2479,-222739,-226591.6,0.042606366738178275,-203.932617175193,0.03473682286049025
2023-06-27T06:15:00-04:00,1.09432,1.09432,1.09384,1.09416,1.0927048959999999,1.0938124444444444,1.093745555555556,1.0936913333333316,1.0933945000000043,1.0923754000000012,1.0916343000000004,1.0904500000000044,1.0938028404900573,1.093586131148133,-1871,-224610,-226005.6,0.037908499578858335,-204.20617518381925,0.011882672321596618
2023-06-27T06:30:00-04:00,1.09416,1.09467,1.09404,1.09461,1.0927791001599998,1.0939853333333331,1.0938100000000004,1.0937222222222205,1.0935170000000043,1.092452400000001,1.0916826000000004,1.0904934500000043,1.0939642723920457,1.0936945049185065,1745,-222865,-224575,0.03471747414284954,-203.48850135183847,0.053014999588679
2023-06-27T06:45:00-04:00,1.09461,1.09528,1.09457,1.09513,1.0928925541503998,1.0942493333333334,1.093965555555556,1.0937882222222206,1.0936850000000042,1.0925360000000013,1.0917373000000004,1.0905445500000044,1.0941974179136367,1.0938480039348053,2172,-220693,-223225,0.03183910453412956,-202.4566817996695,0.12800234061421426
2023-06-27T07:00:00-04:00,1.09513,1.09523,1.09474,1.09503,1.0930835498183678,1.0944622222222222,1.0940844444444449,1.0938673333333315,1.093819000000004,1.092617800000001,1.0917895000000004,1.0905932500000042,1.0943639343309093,1.094008403147844,-2142,-222835,-222748.4,0.029527100540836848,-202.65227501691308,0.09780979194850857
2023-06-27T07:15:00-04:00,1.09503,1.09505,1.09449,1.09454,1.0932592658328983,1.0945533333333335,1.0942555555555562,1.0939722222222206,1.0939130000000044,1.0926870000000013,1.0918293000000003,1.0906395000000042,1.0943991474647274,1.0941455225182752,-2099,-224934,-223187.4,0.025292848523489918,-203.59152782277204,0.14089661482160082
2023-06-27T07:30:00-04:00,1.09454,1.09469,1.09427,1.09439,1.0934209245662665,1.0945802222222223,1.094414444444445,1.0941059999999985,1.0939800000000042,1.0927574000000013,1.0918677000000003,1.0906846500000043,1.0943973179717819,1.0942644180146202,-2047,-226981,-223661.6,0.03046666361978721,-203.87205662939417,0.13083735909823255
2023-06-27T07:45:00-04:00,1.09439,1.09483,1.09431,1.09444,1.0935696506009651,1.0945853333333333,1.094523333333334,1.094248666666665,1.0940470000000044,1.0928280000000015,1.0919077000000004,1.0907265000000042,1.0944058543774255,1.0943527344116961,2162,-224819,-224052.4,0.03794282590285112,-203.7732801420357,0.08962376310061464
2023-06-27T08:00:00-04:00,1.09444,1.09532,1.09442,1.0953,1.0937064785528878,1.0947406666666668,1.0946577777777782,1.0943871111111094,1.0941185000000044,1.0929156000000013,1.0919543000000005,1.0907718000000042,1.0945846835019404,1.094430187529357,2890,-221929,-224299.6,0.04518145701843362,-201.50234706210477,0.11059419243388874
2023-06-27T08:15:00-04:00,1.0953,1.09588,1.09523,1.09554,1.093867830697599,1.094917111111111,1.0947933333333337,1.0945288888888876,1.0942135000000044,1.0930068000000013,1.0920046000000003,1.0908166000000044,1.0947757468015522,1.0945125500234856,2896,-219033,-223539.2,0.05116218141707042,-200.86778118974098,0.11148475765772342
2023-06-27T08:30:00-04:00,1.09554,1.09721,1.09447,1.09708,1.0941092910138872,1.0953744444444444,1.095117777777778,1.0947013333333317,1.0943870000000042,1.0931332000000011,1.0920633000000004,1.0908695000000042,1.0952365974412417,1.0946800400187886,6406,-212627,-221077.8,0.06140631425069203,-191.86287036950566,0.26687138992469417
2023-06-27T08:45:00-04:00,1.09708,1.09712,1.09588,1.09653,1.09447,1.095656888888889,1.0953311111111117,1.0948846666666652,1.0945165000000043,1.093246800000001,1.0921108000000006,1.090918100000004,1.0954952779529934,1.0948996320150308,-4966,-217593,-219200.2,0.07034811199161498,-194.35247914917556,0.1754049387452994
2023-06-27T09:00:00-04:00,1.09653,1.0965799999999999,1.09616,1.09647,1.09447,1.0958846666666666,1.0954800000000005,1.0950759999999984,1.0946385000000045,1.0933606000000013,1.0921589000000005,1.0909639000000042,1.0956902223623948,1.0951565056120247,-4622,-222215,-218679.4,0.07632641342012945,-194.60538604638745,0.12235990247734232
2023-06-27T09:15:00-04:00,1.09647,1.09727,1.09647,1.09717,1.0948536,1.0962226666666666,1.095717777777778,1.0952879999999985,1.0947955000000045,1.0934952000000013,1.0922109000000004,1.0910146500000042,1.0959861778899158,1.0954368044896197,3538,-218677,-218029,0.08129207818749283,-192.346683117899,0.19542843575062152
2023-06-27T09:30:00-04:00,1.09717,1.09766,1.09684,1.09754,1.0952402239999999,1.096587111111111,1.0960511111111115,1.095539555555554,1.0949860000000045,1.0936306000000011,1.0922673000000005,1.0910651000000042,1.0962969423119326,1.0957410435916957,5785,-212892,-216800.8,0.08893837157996748,-190.39580039234153,0.27408774462330215
2023-06-27T09:45:00-04:00,1.09754,1.09765,1.09627,1.09657,1.09567578368,1.0966908888888889,1.0962933333333338,1.095774666666665,1.0951165000000045,1.0937428000000011,1.0923156000000005,1.091109950000004,1.096351553849546,1.0959640348733566,-5251,-218143,-217904,0.09511534251853566,-195.03660619440757,0.19919772658742047
2023-06-27T10:00:00-04:00,1.09657,1.09682,1.09422,1.09444,1.09766,1.0963202222222221,1.0962933333333338,1.0959671111111093,1.0951885000000043,1.0937964000000013,1.0923409000000004,1.0911396500000041,1.0959692430796368,1.0960588278986854,-9498,-227641,-219913.6,0.09348269343937128,-213.48571569038108,0
2023-06-27T10:15:00-04:00,1.09444,1.09611,1.09443,1.09595,1.09765,1.0962515555555556,1.0963655555555558,1.0961442222222204,1.0953380000000046,1.0938674000000013,1.0923865000000004,1.0911725000000043,1.0959653944637096,1.0961138623189481,5999,-221642,-219799,0.09443158438475578,-205.20888918550241,0.05934447183420428
2023-06-27T10:30:00-04:00,1.09595,1.09647,1.09484,1.09535,1.0975814,1.0960484444444445,1.096344444444445,1.096269555555554,1.0954325000000043,1.0939392000000012,1.0924288000000004,1.0912065500000043,1.0958423155709676,1.0960850898551586,-5505,-227147,-221493,0.08448790132756186,-208.22271280884257,-0.01734304543877106
2023-06-27T10:45:00-04:00,1.09535,1.09585,1.09474,1.09488,1.097514172,1.0957555555555556,1.0961000000000005,1.0962793333333316,1.0954720000000044,1.0939958000000012,1.0924651000000005,1.0912373000000042,1.0956498524567742,1.0959556718841268,-6599,-233746,-225663.8,0.07228455806589704,-211.05425523820287,-0.20053232216428882
2023-06-27T11:00:00-04:00,1.09488,1.09512,1.09457,1.09484,1.0974482885599999,1.0955035555555557,1.0959122222222224,1.0962031111111095,1.0954980000000043,1.094050000000001,1.0925038000000002,1.0912656500000042,1.0954878819654192,1.0957829375073014,-4666,-238412,-229717.6,0.04857356978813977,-211.22472140801162,-0.1541225502266212
2023-06-27T11:15:00-04:00,1.09484,1.09591,1.09484,1.0955,1.0973837227888,1.095421111111111,1.0958044444444448,1.0961053333333317,1.0955650000000043,1.0941144000000014,1.0925487000000005,1.0912946000000043,1.0954903055723353,1.095687150005841,3458,-234954,-231180.2,0.03403974534765268,-209.14014283945403,-0.08846571269621033
2023-06-27T11:30:00-04:00,1.0955,1.09628,1.09544,1.09605,1.097320448333024,1.0954702222222221,1.0956800000000004,1.0959682222222207,1.0956370000000044,1.0941828000000013,1.0926053000000002,1.0913283500000044,1.0956022444578681,1.0956145200046727,3445,-231509,-233153.6,0.021988625374286887,-207.41056730316907,-0.10208080789668054
2023-06-27T11:45:00-04:00,1.09605,1.09625,1.09574,1.09598,1.0972584393663634,1.0955302222222223,1.095506666666667,1.095800666666665,1.0956795000000044,1.0942474000000013,1.0926571000000005,1.0913666500000045,1.0956777955662944,1.0955816160037384,-3050,-234559,-234636,0.005171952199208657,-207.6053576868195,-0.1421360497111728
2023-06-27T12:00:00-04:00,1.09598,1.09655,1.0959,1.09643,1.097197670579036,1.0957148888888888,1.0954911111111114,1.095678888888887,1.0957495000000044,1.0943208000000013,1.0927104000000003,1.0914028500000044,1.0958282364530356,1.0956172928029904,2677,-231882,-234263.2,-0.01060842189598637,-206.50620441759912,-0.012767082812773374
2023-06-27T12:15:00-04:00,1.09643,1.09655,1.09608,1.09609,1.0971381171674552,1.0958346666666665,1.0956744444444446,1.0956313333333316,1.0958270000000045,1.0943892000000013,1.0927580000000003,1.0914369000000044,1.0958805891624286,1.0956958342423921,-1923,-233805,-233341.8,-0.01959490819183108,-207.10252155594813,0.1507620335513988
2023-06-27T12:30:00-04:00,1.09609,1.09618,1.09569,1.09575,1.0970797548241062,1.0958497777777778,1.0956522222222225,1.0956008888888873,1.0958950000000045,1.0944484000000014,1.0928004000000004,1.0914737000000043,1.095854471329943,1.0957686673939138,-1805,-235610,-233473,-0.012897456098214926,-207.66242083429208,-0.018249007710203748
2023-06-27T12:45:00-04:00,1.09575,1.09613,1.09574,1.09587,1.0970225597276242,1.0958933333333332,1.0957100000000002,1.0956068888888872,1.0959665000000043,1.0945116000000015,1.0928497000000004,1.0915118000000044,1.0958575770639543,1.095819733915131,1909,-233701,-233911.4,-0.020057556845070473,-207.45335854818686,0.04747341032545341
2023-06-27T13:00:00-04:00,1.09587,1.0959699999999999,1.09549,1.09561,1.0969665085330718,1.0958733333333333,1.0957911111111114,1.095663777777776,1.0959820000000042,1.0945712000000014,1.0928980000000004,1.0915492000000042,1.0958080616511634,1.0958457871321048,-2429,-236130,-234225.6,-0.022767819511768157,-208.02964953160625,0.06667397340346863
2023-06-27T13:15:00-04:00,1.09561,1.09602,1.09561,1.0959699999999999,1.0969115783624104,1.095909111111111,1.0959166666666669,1.095748888888887,1.0960035000000041,1.0946444000000013,1.0929554000000004,1.0915884000000045,1.0958404493209306,1.0958482297056837,1765,-234365,-234722.2,-0.015732800477330767,-207.44969863667114,0.1032114281538721
2023-06-27T13:30:00-04:00,1.0959699999999999,1.09618,1.09594,1.09601,1.0968577467951621,1.0959277777777778,1.0959733333333337,1.0958086666666649,1.0959500000000042,1.0947122000000014,1.0930140000000004,1.0916225500000045,1.0958743594567444,1.095846983764547,1653,-232712,-234503.6,-0.007099384430131552,-207.38936851814594,0.046554084892744
2023-06-27T13:45:00-04:00,1.09601,1.09639,1.0959699999999999,1.09619,1.0968049918592588,1.095971111111111,1.0959888888888891,1.0958759999999983,1.0959330000000045,1.0947828000000013,1.0930673000000004,1.0916604000000043,1.0959374875653956,1.0958635870116376,1614,-231098,-233601.2,0.0030631943514605317,-207.12429794397224,0.012773139911503034
2023-06-27T14:00:00-04:00,1.09619,1.09626,1.09604,1.09609,1.0967532920220737,1.0959913333333333,1.0960011111111114,1.0959342222222204,1.0959140000000045,1.0948614000000014,1.0931213000000004,1.0916978000000044,1.0959679900523165,1.0958856696093098,-1646,-232744,-233409.8,0.005340053661487576,-207.27445439495244,0.010036679501455729
2023-06-27T14:15:00-04:00,1.09609,1.09613,1.09579,1.09593,1.0967026261816322,1.095977111111111,1.095945555555556,1.0959651111111095,1.0958520000000045,1.0949446000000014,1.0931681000000004,1.0917334000000043,1.0959603920418532,1.0959161356874478,-1580,-234324,-233048.6,0.007230315531369827,-207.5050923900075,-0.04560254644618853
2023-06-27T14:30:00-04:00,1.09593,1.09612,1.09583,1.09592,1.0966529736579995,1.0959720000000002,1.095926666666667,1.0959671111111093,1.0957710000000045,1.0950160000000013,1.0932156000000004,1.0917691000000043,1.0959523136334826,1.0959385085499582,-1450,-235774,-233330.4,0.008008530845450166,-207.51832316204593,-0.015509675300386236
2023-06-27T14:45:00-04:00,1.09592,1.09605,1.09586,1.0959699999999999,1.0966043141848396,1.0959806666666665,1.0959511111111115,1.095962666666665,1.0957410000000043,1.0950822000000013,1.0932653000000003,1.0918061000000043,1.095955850906786,1.0959548068399667,1463,-234311,-233650.2,0.013736675620450622,-207.45157558923054,0.020077572438958427
2023-06-27T15:00:00-04:00,1.0959699999999999,1.09616,1.09592,1.09611,1.0965566279011427,1.0960124444444443,1.0959777777777782,1.0959604444444428,1.0958245000000044,1.0951434000000013,1.0933153000000004,1.0918397000000044,1.0959866807254288,1.0959646454719731,1370,-232941,-234018.8,0.01902139548492933,-207.2765707989534,0.02190040789509869
2023-06-27T15:15:00-04:00,1.09611,1.09622,1.09591,1.09618,1.0965098953431198,1.096052888888889,1.0960411111111115,1.0959684444444429,1.0958360000000043,1.0952050000000013,1.0933637000000003,1.0918746000000044,1.096025344580343,1.0959761163775785,1296,-231645,-233799,0.014287781470207105,-207.1938053830736,0.052025812104668584
2023-06-27T15:30:00-04:00,1.09618,1.0964,1.09617,1.09625,1.0964640974362574,1.0960946666666667,1.0960722222222226,1.095993777777776,1.0958810000000043,1.0952526000000014,1.0934132000000003,1.0919085500000043,1.0960702756642744,1.0959980931020628,1185,-230460,-233026.2,0.01882416741540078,-207.11813350436753,0.025548144566006188
2023-06-27T15:45:00-04:00,1.09625,1.09632,1.09612,1.0962399999999999,1.0964192154875323,1.0961282222222222,1.096097777777778,1.0960279999999982,1.0959490000000043,1.0953046000000013,1.0934608000000001,1.0919425000000045,1.0961042205314195,1.0960284744816504,-1670,-232130,-232297.4,0.017419937377120154,-207.13336725579296,0.02098520998895562
2023-06-27T16:00:00-04:00,1.0962399999999999,1.09632,1.09621,1.09622,1.0964,1.0961526666666666,1.0961011111111114,1.0960579999999984,1.0960180000000044,1.0953568000000014,1.0935133000000001,1.0919772000000045,1.0961273764251356,1.0960627795853202,-913,-233043,-232043.8,0.013512808926536992,-207.15002419223015,0.0027367518404632857
2023-06-27T16:15:00-04:00,1.09622,1.09625,1.09603,1.09604,1.0963564000000001,1.0961404444444443,1.096095555555556,1.0960815555555539,1.0960450000000044,1.0953988000000012,1.0935674000000004,1.0920114000000045,1.0961099011401085,1.0960874236682563,-429,-233472,-232150,0.006929841330791995,-207.22046625677928,-0.004561669206005484
2023-06-27T16:30:00-04:00,1.09604,1.0961,1.0959699999999999,1.09605,1.09632,1.0961313333333331,1.0961088888888892,1.0960951111111092,1.0960450000000044,1.0954392000000013,1.0936222000000004,1.0920462500000045,1.096097920912087,1.0961019389346052,384,-233088,-232438.6,0.004175183940784453,-207.21696273501,0.010949604445530094
2023-06-27T16:45:00-04:00,1.09605,1.09611,1.09599,1.09604,1.0962779999999999,1.0961175555555553,1.0961222222222224,1.0961051111111093,1.0960480000000044,1.0954794000000012,1.0936766000000002,1.0920805000000045,1.0960863367296696,1.096105151147684,-446,-233534,-233053.4,0.005222240662996187,-207.22103189243896,0.010949704357973024
2023-06-27T17:00:00-04:00,1.09604,1.0961,1.09566,1.09609,1.0962368399999998,1.096111111111111,1.096135555555556,1.096112666666665,1.0960310000000044,1.0955266000000012,1.0937308000000003,1.0921140500000044,1.0960870693837357,1.0961017209181472,198,-233336,-233294.6,0.00629533324232829,-207.21199937537753,0.010949204814011335
2023-06-27T17:15:00-04:00,1.09609,1.0961,1.09576,1.096,1.0961965031999998,1.096084,1.0961233333333338,1.0961171111111097,1.0960265000000047,1.095567400000001,1.0937856000000004,1.0921487000000043,1.0960696555069886,1.0960901767345177,-140,-233476,-233381.2,0.008437381336006841,-207.22349478177662,-0.010035489138848516
2023-06-27T17:30:00-04:00,1.096,1.09625,1.09587,1.09606,1.09422,1.0960713333333332,1.0961100000000004,1.0961199999999984,1.0960420000000046,1.0956286000000013,1.0938417000000005,1.0921843500000044,1.096067724405591,1.0960817413876143,261,-233215,-233329.8,0.008111540415247398,-207.20920646060875,-0.01094710722690598
2023-06-27T17:45:00-04:00,1.09606,1.09612,1.0959699999999999,1.096,1.0942606,1.0960493333333334,1.0960822222222226,1.096114666666665,1.0960485000000046,1.0956894000000013,1.0938960000000004,1.0922188000000042,1.0960541795244727,1.0960729931100914,-100,-233315,-233375.2,0.005383015218688899,-207.21468061348358,-0.02280501710375019
2023-06-27T18:00:00-04:00,1.096,1.09627,1.09598,1.09612,1.094300388,1.0960568888888889,1.0960688888888894,1.0961039999999984,1.0960740000000047,1.0957426000000012,1.0939515000000002,1.0922532000000043,1.0960673436195782,1.0960691944880732,356,-232959,-233260.2,0.003110732069371533,-207.17570251129382,-0.0109465080639183
2023-06-27T18:15:00-04:00,1.09612,1.0962,1.09602,1.09606,1.09437917248,1.096055111111111,1.0960511111111115,1.0960871111111097,1.0960785000000046,1.0957820000000014,1.0940058000000004,1.0922869500000043,1.0960658748956627,1.0960649555904585,-406,-233365,-233266,-0.000486585447149097,-207.19792635539847,-0.01459561037017551
2023-06-27T18:30:00-04:00,1.09606,1.09612,1.09589,1.0959699999999999,1.0944548055808,1.096038888888889,1.0960433333333337,1.0960711111111094,1.0960765000000046,1.0958150000000013,1.0940598000000004,1.0923199500000043,1.0960466999165301,1.0960603644723668,-293,-233658,-233302.4,-0.0027674547320659004,-207.22198525728345,-0.006386628225248577
2023-06-27T18:45:00-04:00,1.0959699999999999,1.09601,1.09561,1.09572,1.0945274133575682,1.0959742222222224,1.096006666666667,1.0960504444444428,1.0960530000000044,1.0958462000000013,1.0941108000000002,1.0923528000000042,1.0959813599332242,1.0960430915778934,-575,-234233,-233506,-0.004427114446489479,-207.35314760661777,-0.030108115505674146
2023-06-27T19:00:00-04:00,1.09572,1.09585,1.0956299999999999,1.09568,1.0945971168232655,1.0959088888888888,1.0959666666666672,1.096027333333332,1.0960325000000044,1.0958676000000012,1.0941600000000002,1.0923815500000043,1.0959210879465793,1.0960164732623148,-523,-234756,-233794.2,-0.005587237810106691,-207.3722400754967,-0.03284551658697821
2023-06-27T19:15:00-04:00,1.09568,1.09578,1.09553,1.09554,1.094664032150335,1.0958235555555556,1.0959055555555561,1.0959946666666653,1.0960130000000046,1.095875800000001,1.0942059000000004,1.0924091000000042,1.0958448703572634,1.0959719786098518,-448,-235204,-234243.2,-0.007759755198130359,-207.42948306615094,-0.05017836126595904
2023-06-27T19:30:00-04:00,1.09554,1.0957,1.09548,1.0956299999999999,1.0947282708643216,1.0957684444444444,1.095864444444445,1.095957333333332,1.0959985000000043,1.0958878000000012,1.0942528000000002,1.0924373000000043,1.0958018962858107,1.0959191828878816,891,-234313,-234432.8,-0.010653509379524601,-207.3562862864807,-0.0337591240876098
2023-06-27T19:45:00-04:00,1.0956299999999999,1.09579,1.09559,1.09574,1.0947899400297487,1.0957435555555555,1.0958288888888892,1.095914444444443,1.0959870000000043,1.0959118000000012,1.0942994000000004,1.0924660000000044,1.0957895170286485,1.095867746310305,1226,-233087,-234318.6,-0.012243810857602315,-207.23319728745724,-0.02919548199916957
2023-06-27T20:00:00-04:00,1.09574,1.09609,1.09555,1.09606,1.0948491424285587,1.0957897777777776,1.095835555555556,1.0958802222222208,1.0959845000000041,1.0959452000000014,1.0943513000000002,1.0924944000000043,1.0958436136229188,1.0958401970482439,1817,-231270,-233726,-0.01263479870323074,-206.70256045755218,0.005474452554739871
2023-06-27T20:15:00-04:00,1.09606,1.09614,1.09584,1.09594,1.0949059767314164,1.0958106666666667,1.095815555555556,1.0958499999999982,1.0959725000000042,1.0959752000000014,1.0944016000000003,1.0925222000000043,1.095862890898335,1.095828557638595,-1680,-232950,-233364.8,-0.012443717595121343,-206.88649199414706,-0.016421559683252655
2023-06-27T20:30:00-04:00,1.09594,1.0959699999999999,1.09547,1.09547,1.0949605376621598,1.0957415555555554,1.0957500000000002,1.0958188888888871,1.0959335000000043,1.0959786000000014,1.0944471000000002,1.0925477500000043,1.095784312718668,1.095816446110876,-1550,-234500,-233224,-0.01529008139039222,-207.5512181652878,-0.05382916993596066
2023-06-27T20:45:00-04:00,1.09547,1.09561,1.09526,1.09545,1.0950129161556734,1.0956815555555555,1.0956922222222225,1.0957844444444427,1.0958940000000044,1.0959768000000014,1.0944918000000003,1.0925718000000044,1.0957174501749343,1.0957995568887005,-2366,-236866,-233734.6,-0.017380634149543592,-207.59441423638037,-0.047446554193988334
2023-06-27T21:00:00-04:00,1.09545,1.09562,1.09528,1.0953,1.0950631995094464,1.095603111111111,1.0956455555555558,1.095747777777776,1.0958480000000042,1.0959412000000013,1.0945372000000004,1.0925963000000045,1.0956339601399474,1.0957684455109604,-1773,-238639,-234845,-0.019410616003216176,-207.83719117736368,-0.038330960464360145
2023-06-27T21:15:00-04:00,1.0953,1.0954,1.09493,1.09538,1.09627,1.0955499999999998,1.0956122222222224,1.0957031111111093,1.0958150000000042,1.0959182000000014,1.0945825000000002,1.0926209000000044,1.0955831681119579,1.0957163564087682,2475,-236164,-235823.8,-0.018863792208591763,-207.65641878623777,-0.027380257009342778
2023-06-27T21:30:00-04:00,1.09538,1.09551,1.0948,1.09481,1.0962432,1.0953895555555555,1.0955311111111115,1.0956462222222203,1.0957530000000042,1.0958850000000013,1.0946228000000002,1.0926421000000044,1.0954285344895662,1.0956294851270143,-4366,-240530,-237339.8,-0.021459199490756812,-209.92834268479336,-0.06663380615951014
2023-06-27T21:45:00-04:00,1.09481,1.09495,1.09462,1.09463,1.096185472,1.0952093333333333,1.0954200000000003,1.0955802222222206,1.0956825000000043,1.0958342000000014,1.0946647,1.0926621500000044,1.095268827591653,1.0955263881016113,-2404,-242934,-239026.6,-0.02359440739938483,-210.3235893485982,-0.09127168843495431
2023-06-27T22:00:00-04:00,1.09463,1.09477,1.09455,1.0947,1.0960915436799998,1.0950653333333333,1.0953044444444449,1.095502666666665,1.0956130000000042,1.0957774000000013,1.0947040000000003,1.0926846500000043,1.0951550620733224,1.0954139104812888,1652,-241282,-239909.8,-0.026260031683865193,-210.21794634593974,-0.09491302681292368
2023-06-27T22:15:00-04:00,1.0947,1.09473,1.09422,1.0944099999999999,1.0959682201855998,1.0948864444444446,1.0951211111111112,1.0953977777777761,1.0955335000000042,1.0957342000000012,1.0947385000000003,1.0927040500000045,1.0950060496586578,1.095288328385031,-1855,-243137,-240809.4,-0.031099676745640688,-210.70935951849864,-0.1505392040581858
2023-06-27T22:30:00-04:00,1.0944099999999999,1.09495,1.09435,1.0949,1.0957933981670398,1.0948422222222223,1.0950055555555558,1.0952764444444427,1.095475500000004,1.0957434000000013,1.0947699000000002,1.0927249500000042,1.0949848397269262,1.0951686627080248,1511,-241626,-241901.8,-0.036908453039557476,-210.03283974985604,-0.0948957059692985
2023-06-27T22:45:00-04:00,1.0949,1.09506,1.09478,1.0949,1.0956360583503357,1.094821111111111,1.0949422222222223,1.095158666666665,1.0954205000000043,1.0957224000000012,1.0947949000000003,1.0927468500000044,1.094967871781541,1.0950765301664198,0,-241626,-242121,-0.04136163457328006,-210.03283974985604,-0.05203246095282933
2023-06-27T23:00:00-04:00,1.0949,1.09527,1.09486,1.09527,1.095494452515302,1.0948866666666666,1.0949222222222224,1.0950591111111094,1.0953780000000042,1.0957208000000014,1.0948300000000004,1.0927715000000042,1.0950282974252328,1.0950284241331356,1203,-240423,-241618.8,-0.040015336676261094,-209.62630947311845,-0.016431603450643022
2023-06-27T23:15:00-04:00,1.09527,1.09543,1.09512,1.09518,1.09422,1.0949382222222221,1.094908888888889,1.0949799999999983,1.0953340000000042,1.095726800000001,1.0948613000000005,1.0927945000000043,1.0950586379401863,1.0950091393065084,-1275,-241698,-241702,-0.03839542593591123,-209.7310781602914,-0.010955902492458503
2023-06-27T23:30:00-04:00,1.09518,1.09534,1.09496,1.09508,1.0942442,1.0949724444444444,1.0948755555555558,1.0949308888888871,1.0952895000000042,1.0957316000000012,1.0948908000000004,1.0928167500000043,1.095062910352149,1.0950205114452065,-1036,-242734,-241621.4,-0.03614506020379497,-209.82567448235716,-0.027387755847282858
2023-06-27T23:45:00-04:00,1.09508,1.0952,1.09501,1.09509,1.094267916,1.0950153333333332,1.0949066666666667,1.0949111111111092,1.095258000000004,1.0957234000000013,1.0949189000000004,1.0928403000000042,1.095068328281719,1.0950372091561653,927,-241807,-241657.6,-0.034968227302325745,-209.81720934739,0.025575213964051838
2023-06-28T00:00:00-04:00,1.09509,1.09536,1.09508,1.09531,1.0942911576799998,1.095096,1.094982222222222,1.0949191111111092,1.0952395000000041,1.0957086000000011,1.0949457000000005,1.0928639000000042,1.0951166626253752,1.0950669673249318,1175,-240632,-241458.8,-0.028621154263083655,-209.58115568969964,0.06212144742972638
2023-06-28T00:15:00-04:00,1.09531,1.09532,1.09489,1.09493,1.0943139345264,1.0950855555555556,1.095007777777778,1.0949362222222203,1.0952090000000043,1.095687600000001,1.0949675000000003,1.0928840500000043,1.0950793301003001,1.0950771738599454,-1156,-241788,-241731.8,-0.02262201452854168,-209.98221109867066,0.021010322462770847
2023-06-28T00:30:00-04:00,1.09493,1.09499,1.09467,1.0949,1.094336255835872,1.0950639999999998,1.0950622222222224,1.0949668888888868,1.0951725000000043,1.0956570000000012,1.0949889000000004,1.0929044000000043,1.09504346408024,1.0950741390879561,-1165,-242953,-241982.8,-0.018013764028524688,-210.0141309474281,0.0447729827030182
2023-06-28T00:45:00-04:00,1.0949,1.09506,1.09462,1.09486,1.0943581307191546,1.0950235555555556,1.095057777777778,1.095003333333331,1.0951285000000042,1.0956324000000013,1.0950108000000005,1.0929263500000044,1.095006771264192,1.095062911270365,-1271,-244224,-242280.8,-0.01055729747070272,-210.06056441167146,-0.0036533016713891685
2023-06-28T01:00:00-04:00,1.09486,1.09505,1.09465,1.095,1.0943795681047714,1.095012,1.095068888888889,1.0950357777777755,1.095075500000004,1.0956174000000012,1.0950329000000003,1.0929481500000042,1.0950054170113537,1.0950503290162916,1216,-243008,-242521,-0.006426765958015616,-209.90507421201121,0.009133254178462781
2023-06-28T01:15:00-04:00,1.095,1.0952,1.09472,1.09516,1.094400576742676,1.0950302222222221,1.0950566666666668,1.0950506666666644,1.095036500000004,1.095603200000001,1.0950574000000004,1.0929694500000044,1.095036333609083,1.0950342632130332,1237,-241771,-242748.8,-0.0001391505810704954,-209.72432535356378,-0.010043185698508542
2023-06-28T01:30:00-04:00,1.09516,1.09548,1.09501,1.09524,1.0944211652078226,1.095066888888889,1.0950633333333333,1.0950617777777754,1.0950250000000041,1.095595800000001,1.0950835000000005,1.0929930000000043,1.0950770668872662,1.0950338105704265,1240,-240531,-242497.4,0.0026308957615787253,-209.63374498174588,0.005478551470986411
2023-06-28T01:45:00-04:00,1.09524,1.09538,1.09512,1.09533,1.0944635185995097,1.095120222222222,1.095091111111111,1.0950675555555534,1.0950190000000042,1.095583000000001,1.0951137000000006,1.0930166500000043,1.095127653509813,1.095050648456341,1323,-239208,-241748.4,0.004609531380545498,-209.52502908386057,0.022829382328219072
2023-06-28T02:00:00-04:00,1.09533,1.09548,1.09504,1.09508,1.0945041778555293,1.0951179999999998,1.09509,1.0950739999999977,1.0950080000000042,1.0955644000000013,1.0951383000000006,1.0930385500000042,1.0951181228078504,1.0950729187650725,-2418,-241626,-241228.8,0.006218618805920767,-210.0769175558276,-0.0009131669542999634
2023-06-28T02:15:00-04:00,1.09508,1.09517,1.09439,1.09447,1.09548,1.094994,1.0949966666666666,1.0950595555555531,1.0949625000000043,1.095530000000001,1.0951564000000005,1.0930590000000042,1.0949884982462803,1.0950695350120578,-2076,-243702,-241367.6,0.004166190106405838,-211.2333262200348,-0.07669061726816627
2023-06-28T02:30:00-04:00,1.09447,1.09479,1.0939699999999999,1.09405,1.09548,1.0948046666666664,1.0948988888888889,1.0950279999999974,1.0949245000000043,1.0954892000000012,1.0951753000000004,1.0930788500000042,1.0948007985970243,1.095022428009646,-2640,-246342,-242281.8,-0.0015569752925104305,-212.24641931532312,-0.0803704346396566
2023-06-28T02:45:00-04:00,1.09405,1.09432,1.09358,1.09381,1.0954196,1.094586888888889,1.0947777777777778,1.0949708888888865,1.0948835000000043,1.095446800000001,1.0951957000000005,1.0930966500000043,1.0946026388776193,1.0949275424077167,-2918,-249260,-244027.6,-0.007437272477872739,-212.88653631180415,-0.09955247054525851
2023-06-28T03:00:00-04:00,1.09381,1.09487,1.09381,1.09478,1.095309224,1.0945873333333331,1.094768888888889,1.094906444444442,1.0948875000000045,1.095424000000001,1.0952200000000003,1.0931178500000045,1.0946381111020955,1.0948296339261732,3344,-245916,-245369.2,-0.009185623976253816,-209.92104870426678,-0.007306870284772297
2023-06-28T03:15:00-04:00,1.09478,1.09513,1.09464,1.09493,1.09520547056,1.0946195555555556,1.094761111111111,1.0948406666666641,1.0949135000000043,1.0954032000000011,1.0952427000000005,1.0931393000000045,1.0946964888816764,1.0947453071409385,3247,-242669,-245577.8,-0.00954651654322642,-209.47616480065182,-0.006392694063928265
2023-06-28T03:30:00-04:00,1.09493,1.0954,1.09476,1.09538,1.09358,1.0947433333333334,1.0947855555555557,1.094798444444442,1.0949375000000043,1.095388600000001,1.0952660000000005,1.0931616500000043,1.094833191105341,1.0947142457127506,3029,-239640,-244765.4,-0.01029414642709547,-208.2312906991109,0.020088388911219276
2023-06-28T03:45:00-04:00,1.09538,1.09569,1.09505,1.09526,1.0936164,1.0948382222222224,1.094787777777778,1.09477622222222,1.0949555000000044,1.0953702000000012,1.0952876000000005,1.0931846000000045,1.0949185528842729,1.0947377965702,-2863,-242503,-243997.6,-0.010946329065413792,-208.54493527907434,0.0018260837807155491
2023-06-28T04:00:00-04:00,1.09526,1.09571,1.09487,1.09567,1.093699344,1.0950146666666665,1.0948255555555557,1.0947857777777754,1.0949755000000043,1.095358600000001,1.0953056000000005,1.0932093000000045,1.0950688423074182,1.0948310372561598,3813,-238690,-241883.6,-0.010367570378710092,-207.11757556539897,0.031040873526700354
2023-06-28T04:15:00-04:00,1.09567,1.09578,1.09492,1.09497,1.09381998336,1.0950435555555555,1.0948133333333334,1.0947946666666641,1.0949650000000042,1.0953332000000011,1.0953189000000005,1.0932331000000044,1.0950490738459346,1.0949132298049278,-4273,-242963,-241293,-0.012350790276347494,-209.84750337212878,-0.010044928224426937
2023-06-28T04:30:00-04:00,1.09497,1.09586,1.09453,1.09583,1.0939767846912,1.095246888888889,1.0949644444444444,1.094835333333331,1.0950025000000043,1.095325400000001,1.0953411000000004,1.0932620000000044,1.0952052590767478,1.0950149838439418,3717,-239246,-240608.4,-0.008327850287972347,-206.92813571822018,0.12426105786362603
2023-06-28T04:45:00-04:00,1.09583,1.09606,1.09526,1.09528,1.09416510622208,1.09531,1.095101111111111,1.094898444444442,1.095012000000004,1.095310200000001,1.0953545000000005,1.0932868500000044,1.0952202072613983,1.0950923870751534,-2509,-241755,-241031.4,-0.0018003655521648943,-208.1874095106881,0.11242630592752291
2023-06-28T05:00:00-04:00,1.09528,1.09569,1.09442,1.09541,1.0943924934754306,1.0953717777777778,1.0952788888888891,1.0949966666666644,1.0950170000000041,1.095297400000001,1.0953683000000005,1.0933126500000043,1.0952581658091187,1.0951603096601226,3813,-237942,-240119.2,0.009227832220755322,-207.73484030464047,0.1462776899095863
2023-06-28T05:15:00-04:00,1.09541,1.0959,1.09501,1.09501,1.09442,1.095318,1.0953044444444446,1.095092444444442,1.095021000000004,1.095276800000001,1.0953781000000005,1.0933360000000045,1.095208532647295,1.0951882477280979,-2226,-240168,-240414.8,0.021491301502547026,-208.54768663615096,0.021008787153579025
2023-06-28T05:30:00-04:00,1.09501,1.09532,1.09478,1.09511,1.09442,1.095279111111111,1.0953244444444445,1.0951946666666645,1.0950315000000042,1.095257200000001,1.0953919000000003,1.0933623000000043,1.095188826117836,1.0952161981824782,2532,-237636,-239349.4,0.02372200162408249,-208.31645587113513,0.016439407085390757
2023-06-28T05:45:00-04:00,1.09511,1.09532,1.09445,1.09474,1.09606,1.0951622222222221,1.0952533333333332,1.095252444444442,1.0950255000000042,1.095232000000001,1.0953997000000002,1.0933848500000045,1.0950990608942688,1.0951949585459824,-2639,-240275,-239555.2,0.0226828270215538,-209.208083196244,-0.058427212474207485
2023-06-28T06:00:00-04:00,1.09474,1.09566,1.09452,1.09536,1.0960278,1.0951835555555556,1.0952644444444446,1.0952851111111088,1.095043500000004,1.095218000000001,1.0954233000000004,1.0934153500000043,1.095151248715415,1.0951811668367857,2834,-237441,-238692.4,0.020325388863596472,-207.60306282611086,0.009130252177564139
2023-06-28T06:15:00-04:00,1.09536,1.09607,1.09536,1.09588,1.09445,1.0953066666666667,1.095287777777778,1.0952868888888865,1.095079500000004,1.0952156000000008,1.0954525000000002,1.0934482000000043,1.095296998972332,1.0951889334694282,2172,-235269,-238157.8,0.02215965299474413,-206.5719497673903,0.01916635483311978
2023-06-28T06:30:00-04:00,1.09588,1.09622,1.09548,1.09561,1.0944824,1.095371111111111,1.095358888888889,1.0952977777777755,1.0950980000000041,1.0952054000000009,1.0954740000000003,1.0934821500000043,1.0953595991778655,1.0952191467755423,-2316,-237585,-237641.2,0.019654566643195308,-207.14255968818452,0.05844908992940208
2023-06-28T06:45:00-04:00,1.09561,1.09595,1.09534,1.09544,1.094551904,1.0953873333333333,1.0953155555555556,1.0952959999999976,1.095103500000004,1.095193000000001,1.0954875000000002,1.0935134500000045,1.0953756793422924,1.0952565174204336,-2071,-239656,-238045.2,0.023076521694059635,-207.4639057876177,-0.0355894618690958
2023-06-28T07:00:00-04:00,1.09544,1.09556,1.09467,1.09482,1.09461862784,1.0952882222222222,1.0952644444444444,1.0952982222222198,1.095090500000004,1.0951700000000009,1.0954925000000002,1.0935403000000046,1.095264543473834,1.0952896139363466,-2233,-241889,-238368,0.016071738396210587,-208.72774497552408,-0.041998393104971055
2023-06-28T07:15:00-04:00,1.09482,1.0954,1.09469,1.09518,1.09467,1.0952713333333333,1.0952388888888889,1.0952931111111088,1.095126000000004,1.095159200000001,1.0955027000000004,1.0935685000000044,1.0952476347790672,1.095308891149077,2337,-239552,-238790.2,0.014723666010483461,-207.95928988701607,-0.020996704430300297
2023-06-28T07:30:00-04:00,1.09518,1.09528,1.0947,1.09474,1.09622,1.0951715555555555,1.095208888888889,1.095277333333331,1.095160500000004,1.095140400000001,1.0955040000000005,1.0935933000000044,1.0951461078232538,1.0952787129192614,-2186,-241738,-240084,0.007431320079266059,-208.83753821149242,-0.024657309065669944
2023-06-28T07:45:00-04:00,1.09474,1.09486,1.09376,1.09404,1.0961896,1.0949377777777778,1.09509,1.0952235555555532,1.0951720000000038,1.095110400000001,1.0954931000000003,1.0936152000000043,1.094924886258603,1.095191770335409,-3444,-245182,-241603.4,-0.0013827740270475962,-211.03970493601193,-0.09770707965411021
2023-06-28T08:00:00-04:00,1.09404,1.09446,1.09324,1.09324,1.096092416,1.0945677777777778,1.0949233333333332,1.0951451111111088,1.095095000000004,1.0950626000000008,1.0954752000000003,1.0936323500000045,1.0945879090068824,1.0950342162683269,-3663,-248845,-243441.2,-0.015980567629461363,-213.71821760465264,-0.13701883552259503
2023-06-28T08:15:00-04:00,1.09324,1.09379,1.09282,1.09303,1.0959212710400001,1.0941891111111108,1.0946644444444447,1.0950251111111087,1.095000000000004,1.0950084000000009,1.0954601000000002,1.0936447000000045,1.0942763272055058,1.0948365730146612,-4390,-253235,-245710.4,-0.023987896462117284,-214.56149081090211,-0.2127154542798663
2023-06-28T08:30:00-04:00,1.09303,1.09332,1.09273,1.0927499999999999,1.0956731693568,1.0938062222222222,1.0943166666666668,1.0948406666666641,1.094868500000004,1.0949422000000009,1.0954437000000004,1.0936557000000047,1.0939710617644047,1.0945812584117287,-4796,-258031,-249406.2,-0.038346870208818516,-215.79007557069852,-0.2856152133445338
2023-06-28T08:45:00-04:00,1.0927499999999999,1.09331,1.0925799999999999,1.09276,1.09537885242112,1.0934948888888887,1.094,1.0945988888888867,1.094743500000004,1.0948786000000008,1.0954269000000003,1.0936673000000043,1.0937288494115238,1.0942978067293827,3390,-254641,-251986.8,-0.055454231880960075,-215.75905292141897,-0.26012906052336315
2023-06-28T09:00:00-04:00,1.09276,1.0933599999999999,1.09236,1.0924,1.0950429901305856,1.0931748888888888,1.093662222222222,1.094313333333331,1.094580000000004,1.0948172000000007,1.0953979000000005,1.0936761000000044,1.093463079529219,1.094005445383506,-4200,-258841,-254718.6,-0.0723443888723559,-217.14270532450809,-0.277514058277946
2023-06-28T09:15:00-04:00,1.0924,1.09341,1.09238,1.09337,1.0946673715123036,1.0931164444444446,1.093501111111111,1.0940288888888865,1.094500000000004,1.094775600000001,1.0953762000000002,1.0936904000000043,1.0934444636233753,1.0937767563068046,3194,-255647,-256079,-0.08125744780146954,-214.30658302498435,-0.13244186258927965
2023-06-28T09:30:00-04:00,1.09337,1.09443,1.09271,1.0930199999999999,1.09236,1.093020222222222,1.093261111111111,1.09374822222222,1.094359500000004,1.094730000000001,1.0953356000000003,1.0936994500000043,1.0933595708987003,1.0935934050454434,-5791,-261438,-257719.6,-0.08922674217722515,-216.1603470755806,-0.19722785295569328
2023-06-28T09:45:00-04:00,1.0930199999999999,1.09443,1.0924,1.09347,1.09443,1.0930620000000002,1.0931199999999999,1.0935088888888864,1.094269000000004,1.094691800000001,1.0953050000000004,1.0937079000000045,1.0933816567189603,1.0934755240363545,10873,-250565,-256226.4,-0.0945925835025436,-211.68389650742935,-0.11600928074246893
2023-06-28T10:00:00-04:00,1.09347,1.09367,1.09148,1.09184,1.09443,1.092806,1.0928755555555556,1.0932839999999977,1.094090500000004,1.094632400000001,1.0952587000000005,1.0937088000000044,1.093073325375168,1.0933444192290833,-7166,-257731,-256844.4,-0.10613990726439058,-222.36601855924619,-0.20108953968776094
2023-06-28T10:15:00-04:00,1.09184,1.09293,1.09152,1.09154,1.09443,1.0925388888888887,1.0926866666666666,1.0930888888888866,1.093917000000004,1.094570600000001,1.0952024000000002,1.0937066500000043,1.0927666603001345,1.0932051353832666,-5835,-263566,-257789.4,-0.11216474741359321,-223.96927544670206,-0.1555010793604364
2023-06-28T10:30:00-04:00,1.09154,1.092,1.09146,1.0916,1.094312,1.0923215555555554,1.0925277777777778,1.09289422222222,1.0937415000000041,1.0945086000000013,1.0951430000000004,1.0937051500000043,1.0925333282401075,1.093022908306613,5701,-257865,-258233,-0.11232941836126759,-223.6559016811967,-0.13082897999140394
2023-06-28T10:45:00-04:00,1.0916,1.09172,1.08966,1.08986,1.0941408799999999,1.091788,1.0922066666666668,1.0926833333333312,1.093497500000004,1.0944176000000012,1.0950759000000003,1.0936957500000042,1.0919986625920861,1.09275072664529,-8575,-266440,-259233.4,-0.11848189546618297,-237.32436998460338,-0.26447037291236214
2023-06-28T11:00:00-04:00,1.08986,1.09141,1.08978,1.09135,1.0937824096,1.0916166666666667,1.09205,1.092469333333331,1.0932970000000042,1.094346600000001,1.0950450000000003,1.0936929500000043,1.0918689300736688,1.092448181316232,6369,-260071,-261134.6,-0.11653956875236457,-228.61700390088626,-0.12903107727222002
2023-06-28T11:15:00-04:00,1.09135,1.0917,1.09122,1.09147,1.093452616832,1.0915006666666667,1.0919466666666666,1.0922835555555532,1.0930765000000042,1.0942780000000012,1.0950002000000005,1.0936933500000041,1.0917891440589351,1.0921913450529854,4168,-255903,-260769,-0.11141500718039833,-228.1587091283572,-0.08513365067741646
2023-06-28T11:30:00-04:00,1.09147,1.09147,1.09064,1.09065,1.09314920748544,1.091241333333333,1.0916444444444444,1.0920751111111089,1.0928285000000042,1.0941856000000012,1.0949532000000004,1.0936910000000042,1.0915613152471482,1.091950276042388,-2735,-258638,-259783.4,-0.1046654391867611,-230.2134609767819,-0.2487721448366112
2023-06-28T11:45:00-04:00,1.09065,1.09083,1.09021,1.09032,1.0928700708866048,1.0909764444444445,1.0913444444444445,1.091838444444442,1.0925725000000042,1.0940884000000013,1.0949076000000004,1.0936863500000045,1.0913130521977186,1.0917062208339101,-2774,-261412,-260492.8,-0.10954861421280439,-231.05279531868797,-0.24702201240598753
2023-06-28T12:00:00-04:00,1.09032,1.09117,1.09029,1.09116,1.0926132652156764,1.0909395555555554,1.0910877777777779,1.0916146666666644,1.0923895000000043,1.0940100000000013,1.0948708000000005,1.0936873000000045,1.0912824417581748,1.091562976667128,2486,-258926,-258990,-0.10793889622816646,-229.13754108139995,-0.2112540810447506
2023-06-28T12:15:00-04:00,1.09116,1.09184,1.09104,1.09165,1.0923770039984222,1.091052,1.0910666666666666,1.0914179999999978,1.0922130000000043,1.0939412000000013,1.0948323000000004,1.0936905000000043,1.0913559534065398,1.0914603813337023,2439,-256487,-258273.2,-0.1107960787182693,-228.04227549248517,-0.017401817116052945
2023-06-28T12:30:00-04:00,1.09165,1.09165,1.09101,1.09109,1.0921596436785483,1.0910566666666666,1.0910166666666667,1.0912319999999978,1.0920305000000043,1.0938568000000013,1.0947827000000006,1.0936940000000042,1.0913027627252319,1.0913631050669614,-2124,-258611,-258814.8,-0.0998502311930259,-229.13185548607308,-0.04122615753889564
2023-06-28T12:45:00-04:00,1.09109,1.09138,1.091,1.09108,1.0919596721842644,1.0910693333333332,1.0909588888888888,1.0910948888888867,1.0918825000000043,1.0937798000000014,1.0947337000000004,1.0936954000000043,1.0912582101801855,1.091302484053569,-2298,-260909,-259269,-0.08811823289049117,-229.1529169933728,-0.0476364968852926
2023-06-28T13:00:00-04:00,1.09108,1.09171,1.09098,1.0916,1.0917756984095233,1.0911975555555553,1.0911522222222223,1.0910564444444422,1.0918005000000044,1.0937138000000013,1.0946854000000004,1.0936979000000044,1.0913265681441484,1.091305187242855,2834,-258075,-258601.6,-0.07748618031521953,-227.80225526371083,0.15965353348135106
2023-06-28T13:15:00-04:00,1.0916,1.09176,1.09149,1.09162,1.08966,1.091291111111111,1.091182222222222,1.0910753333333312,1.0917300000000043,1.0936490000000014,1.0946407000000002,1.0936993500000043,1.0913852545153186,1.0913257497942837,2088,-255987,-258013.8,-0.05430565653723399,-227.76399949236577,0.024740000916295638
2023-06-28T13:30:00-04:00,1.09162,1.09168,1.09129,1.09156,1.0897020000000002,1.0913666666666666,1.0911922222222223,1.0911004444444423,1.0916705000000042,1.0935802000000014,1.0945988000000004,1.0936996000000043,1.091420203612255,1.0913385998354268,-1853,-257840,-258284.4,-0.04597368246547391,-227.86584812100935,0.008245760304923225
2023-06-28T13:45:00-04:00,1.09156,1.0917,1.09144,1.0915,1.0897431600000003,1.0914282222222222,1.0912866666666667,1.091154444444442,1.0916075000000043,1.0935070000000013,1.0945551000000002,1.0937024000000044,1.091436162889804,1.091365279868341,-1722,-259562,-258474.6,-0.04024879486954358,-227.96050164440732,0.07793517627103264
2023-06-28T14:00:00-04:00,1.0915,1.0921,1.09149,1.09201,1.0897834968000002,1.0915728888888887,1.0914744444444446,1.0912575555555535,1.0915880000000042,1.0934424000000014,1.0945191000000003,1.0937085500000043,1.0915509303118431,1.0914238238946727,1931,-257631,-257819,-0.024519982411253936,-227.05824786520438,0.15500036686477084
2023-06-28T14:15:00-04:00,1.09201,1.09226,1.09199,1.09209,1.0898761569280002,1.0916959999999998,1.091577777777778,1.0913426666666646,1.0915240000000044,1.0933776000000015,1.0944803000000003,1.0937178500000042,1.0916587442494745,1.0914902591157378,1275,-256356,-257475.2,-0.006953456770680797,-226.9648421271616,0.08523039700869693
2023-06-28T14:30:00-04:00,1.09209,1.09217,1.09201,1.09211,1.0900191875123202,1.0918024444444443,1.091628888888889,1.091431999999998,1.0914785000000042,1.0933182000000015,1.0944413000000004,1.0937276500000044,1.0917489953995796,1.09156300729259,1383,-254973,-257272.4,0.00724612707408848,-226.9395145442702,0.04213804790911967
2023-06-28T14:45:00-04:00,1.09211,1.09237,1.09206,1.09225,1.090153636261581,1.0919266666666667,1.0917577777777778,1.091545111111109,1.0914175000000044,1.0932738000000013,1.0944019000000003,1.093734600000004,1.0918491963196637,1.0916488058340719,1605,-253368,-256378,0.01610256079173298,-226.73376603908295,0.10631570264598246
2023-06-28T15:00:00-04:00,1.09225,1.09225,1.09181,1.09195,1.0903309453606544,1.091965111111111,1.0918544444444445,1.0916586666666646,1.0914230000000045,1.0932318000000012,1.0943605000000003,1.0937409000000042,1.091869357055731,1.0917354446672571,-1692,-255060,-255477.6,0.030614782529327925,-227.19849480996868,0.07973750779043941
2023-06-28T15:15:00-04:00,1.09195,1.092,1.09174,1.09174,1.0904940697318022,1.0919422222222221,1.09187,1.0917377777777755,1.0914330000000043,1.0931904000000012,1.0943186000000003,1.0937433500000042,1.0918434856445847,1.0917939557338054,-1090,-256150,-255181.4,0.03709828012002843,-227.4081197927976,0.012825210699892727
2023-06-28T15:30:00-04:00,1.09174,1.09191,1.09166,1.09166,1.090644144153258,1.091900222222222,1.0918744444444444,1.0917971111111089,1.0914360000000045,1.0931280000000012,1.0942760000000005,1.0937458000000042,1.0918067885156677,1.091823564587044,-1471,-257621,-255434.4,0.03712426353588255,-227.51591102514212,0.0036642787783331197
2023-06-28T15:45:00-04:00,1.09166,1.09171,1.09137,1.09159,1.0907822126209974,1.0918433333333333,1.0918777777777775,1.0918468888888866,1.0915225000000044,1.0930612000000013,1.0942322000000004,1.093748750000004,1.0917634308125341,1.091826451669635,-1856,-259477,-256335.2,0.03689304376804755,-227.63492243895232,0.0027483601451110786
2023-06-28T16:00:00-04:00,1.09159,1.09171,1.09141,1.09164,1.0909092356113177,1.0917957777777778,1.0918933333333334,1.0918739999999976,1.0915370000000046,1.0929864000000014,1.0941875000000003,1.0937514000000041,1.0917387446500273,1.0918043613357078,1392,-258085,-257278.6,0.029857661321773067,-227.57116223594585,0.012826385707744296
2023-06-28T16:15:00-04:00,1.09164,1.09165,1.09117,1.09118,1.0910260967624124,1.091653111111111,1.091801111111111,1.0918633333333307,1.0915225000000046,1.0929048000000012,1.0941375000000004,1.0937506000000041,1.0916269957200218,1.091755889068566,-603,-258688,-258004.2,0.02766783934358811,-227.82525699245895,-0.07600662997590557
2023-06-28T16:30:00-04:00,1.09118,1.09127,1.09111,1.09114,1.09237,1.091520888888889,1.0916955555555556,1.0918284444444422,1.0915470000000045,1.0928142000000012,1.0940864000000003,1.093749800000004,1.0915295965760174,1.0916931112548525,-417,-259105,-258595.2,0.021137277126370264,-227.840543196385,-0.08698916755945081
2023-06-28T16:45:00-04:00,1.09114,1.09134,1.09111,1.09126,1.0923448,1.0914337777777778,1.091601111111111,1.0917737777777754,1.0915940000000044,1.0927400000000012,1.0940366000000004,1.0937487000000041,1.0914756772608138,1.0916268890038816,608,-258497,-258770.4,0.010871556831667769,-227.77367734965594,-0.07783098772101871
2023-06-28T17:00:00-04:00,1.09126,1.09133,1.09116,1.09132,1.092320104,1.0913775555555556,1.0914977777777777,1.0916977777777754,1.0916020000000044,1.0926498000000011,1.0939876000000002,1.0937504500000044,1.0914445418086511,1.091563111203105,75,-258422,-258559.4,-0.0007285195781162763,-227.76955367610427,-0.08514534218355463
2023-06-28T17:15:00-04:00,1.09132,1.09134,1.0912,1.09132,1.0922959019199998,1.091342,1.0914277777777777,1.0916046666666643,1.0915855000000045,1.0925706000000013,1.0939404000000004,1.0937539000000043,1.0914196334469208,1.0914992889624837,0,-258422,-258626.8,-0.00994618589917736,-227.76955367610427,-0.05769494940243678
2023-06-28T17:30:00-04:00,1.09132,1.09135,1.0912,1.09129,1.0922721838815999,1.0913144444444447,1.0913777777777776,1.0915199999999976,1.0915955000000044,1.0924882000000011,1.0938928000000003,1.0937575000000044,1.0913937067575368,1.0914526311699868,-120,-258542,-258597.6,-0.014422196047328872,-227.7728524335723,-0.041218605162386596
2023-06-28T17:45:00-04:00,1.09129,1.09132,1.0912,1.09126,1.092248940203968,1.091290888888889,1.091333333333333,1.091447555555553,1.0916045000000045,1.092413200000001,1.0938450000000004,1.0937608000000045,1.0913669654060294,1.091420104935989,-63,-258605,-258497.6,-0.019560994399701187,-227.7745843288522,-0.03664144513861257
2023-06-28T18:00:00-04:00,1.09126,1.09152,1.09125,1.09143,1.0922261613998885,1.0913102222222222,1.0913155555555554,1.091390444444442,1.0915960000000045,1.0923396000000012,1.0937984000000003,1.0937646000000043,1.0913795723248234,1.091400883948791,281,-258324,-258463,-0.02319451811905204,-227.73080924317142,-0.014657517932571754
2023-06-28T18:15:00-04:00,1.09143,1.09152,1.09142,1.09148,1.0922038381718908,1.0913431111111112,1.0912977777777775,1.0913504444444417,1.0915890000000046,1.092274400000001,1.0937532000000003,1.0937694000000042,1.0913996578598588,1.0913919071590326,368,-257956,-258369.8,-0.02367886090162039,-227.71395062649418,-0.014656846579452747
2023-06-28T18:30:00-04:00,1.09148,1.09148,1.09138,1.09143,1.092181961408453,1.0913695555555556,1.0913255555555554,1.0913299999999975,1.0915825000000043,1.0921958000000012,1.0937069000000004,1.0937743000000042,1.0914057262878871,1.091389125727226,-282,-258238,-258333,-0.024774017251184097,-227.7268688659489,0.022910977107338977
2023-06-28T18:45:00-04:00,1.09143,1.09151,1.09137,1.09137,1.092160522180284,1.0913784444444443,1.0913511111111107,1.0913246666666638,1.0915760000000043,1.0921056000000013,1.0936606000000004,1.0937783000000043,1.0913985810303097,1.0913901005817803,-216,-258454,-258315.4,-0.022204753125580432,-227.7387431959563,0.02107887163883209
2023-06-28T19:00:00-04:00,1.09137,1.09165,1.09137,1.09159,1.0921395117366783,1.0914262222222224,1.0913877777777774,1.0913355555555528,1.0915550000000045,1.0920252000000013,1.0936153000000004,1.0937834000000042,1.0914368648242478,1.0914040804654241,373,-258081,-258210.6,-0.01847480555616213,-227.66355329702188,0.030240272712292536
2023-06-28T19:15:00-04:00,1.09159,1.09167,1.09155,1.0916,1.0921189215019447,1.0914686666666664,1.0914188888888885,1.0913562222222193,1.0915305000000044,1.0919484000000013,1.0935707000000001,1.0937882500000042,1.0914694918593983,1.0914220643723391,418,-257663,-258078.4,-0.013571699668558191,-227.65972402046205,0.025657002529032358
2023-06-28T19:30:00-04:00,1.0916,1.09187,1.09157,1.09179,1.0920987430719058,1.091542888888889,1.0914711111111108,1.0913908888888861,1.0915145000000044,1.0918878000000012,1.0935289000000004,1.0937943500000042,1.0915335934875188,1.091448851497871,451,-257212,-257929.6,-0.00795728195964017,-227.58122457011387,0.043067111388041125
2023-06-28T19:45:00-04:00,1.09179,1.09185,1.09151,1.09151,1.0920789682104677,1.0915506666666666,1.0914955555555552,1.091424888888886,1.0914775000000043,1.0918144000000012,1.0934868000000002,1.0937988000000043,1.091528874790015,1.0914734811982967,-715,-257927,-257867.4,-0.0035991937802447413,-227.7645931666389,0.020159627596687126
2023-06-28T20:00:00-04:00,1.09151,1.09161,1.09093,1.09094,1.0920595888462583,1.0914395555555554,1.0914599999999994,1.0914466666666638,1.0914270000000044,1.0917384000000012,1.0934394000000003,1.0937997000000044,1.091411099832012,1.091475984958637,-1597,-259524,-258081.4,-0.001090727117612683,-228.59856628644533,-0.02932390081189414
2023-06-28T20:15:00-04:00,1.09094,1.09096,1.09048,1.09048,1.092014405292408,1.0912435555555555,1.0913544444444438,1.0914399999999973,1.0913640000000044,1.0916672000000012,1.0933888000000003,1.0937973500000042,1.0912248798656095,1.0914335879669097,-1543,-261067,-258678.6,-0.0018238127106854224,-229.2491795190706,-0.08704177088773503
2023-06-28T20:30:00-04:00,1.09048,1.09061,1.09026,1.09037,1.0919223409748635,1.0910466666666667,1.0912311111111106,1.0914024444444415,1.0912995000000043,1.0916098000000012,1.0933362000000002,1.0937945000000042,1.0910539038924876,1.0913504703735275,-1270,-262337,-259613.4,-0.005559034193806748,-229.3772882418347,-0.10169677868581599
2023-06-28T20:45:00-04:00,1.09037,1.09074,1.0901,1.09069,1.0917893536968744,1.0909384444444445,1.0911488888888883,1.091337999999997,1.0912545000000042,1.0915630000000012,1.0932857000000002,1.093792550000004,1.09098112311399,1.0912399762988216,1541,-260796,-260330.2,-0.008565813197714512,-228.9250380882173,-0.06780095837570554
2023-06-28T21:00:00-04:00,1.09069,1.091,1.09057,1.09081,1.091620418327187,1.0908706666666665,1.091086666666666,1.0912562222222193,1.0912130000000042,1.0915242000000012,1.0932332000000005,1.0937922500000041,1.090946898491192,1.091123581039057,1671,-259125,-260569.8,-0.010843999144342387,-228.74119116562682,-0.05131165415944125
2023-06-28T21:15:00-04:00,1.09081,1.09144,1.09077,1.09126,1.0914683764944682,1.0909053333333334,1.0910499999999994,1.0911742222222192,1.0912170000000043,1.0914942000000012,1.0931864000000002,1.0937940000000042,1.0910095187929536,1.0910432648312451,2527,-256598,-259984.6,-0.010193964614014929,-227.69870897349475,-0.030231130735913984
2023-06-28T21:30:00-04:00,1.09126,1.09141,1.09098,1.09098,1.0901,1.0908913333333334,1.0909811111111105,1.0910995555555523,1.091209000000004,1.0914658000000013,1.0931415000000004,1.093794300000004,1.091003615034363,1.0909990118649957,-2477,-259075,-259586.2,-0.014911421703547674,-228.3342678687164,-0.05679736167092735
2023-06-28T21:45:00-04:00,1.09098,1.09127,1.09061,1.09064,1.0901262,1.090823111111111,1.0908533333333326,1.0910239999999969,1.0911780000000042,1.0914112000000014,1.0930934,1.0937926000000042,1.0909308920274903,1.0909744094919962,-1678,-260753,-259269.4,-0.021527552910789373,-228.8572105441092,-0.10533161139046743
2023-06-28T22:00:00-04:00,1.09064,1.09066,1.08937,1.08942,1.09141,1.0905364444444443,1.0906211111111106,1.090918444444441,1.0910830000000042,1.091339200000001,1.0930346000000002,1.093785900000004,1.0906287136219923,1.0909039275935966,-2619,-263372,-259784.6,-0.03522021142562707,-231.78684818806136,-0.19147786094492267
2023-06-28T22:15:00-04:00,1.08942,1.08986,1.08932,1.08982,1.0913692,1.0903762222222222,1.090496666666666,1.0908004444444412,1.0910080000000044,1.091266200000001,1.0929790000000004,1.093780750000004,1.0904669708975938,1.090807942074877,1704,-261668,-260293.2,-0.04416563225036071,-231.1611941703272,-0.10266375786019487
2023-06-28T22:30:00-04:00,1.08982,1.08991,1.08968,1.08977,1.091287232,1.0902308888888887,1.0904177777777773,1.0906739999999968,1.0909320000000045,1.0912248000000013,1.0929286000000002,1.0937757000000041,1.0903275767180751,1.0906715536599012,-1352,-263020,-261577.6,-0.04812760231006012,-231.2232227622049,-0.06510894285085361
2023-06-28T22:45:00-04:00,1.08977,1.08983,1.08931,1.08934,1.09120854272,1.0900153333333333,1.0903033333333327,1.0905384444444413,1.0908360000000044,1.0911808000000012,1.0928757000000002,1.0937702000000042,1.09013006137446,1.0904968429279207,-1645,-264665,-262695.6,-0.05006988830926141,-231.87230467857248,-0.09446334730413404
2023-06-28T23:00:00-04:00,1.08934,1.08952,1.08917,1.08935,1.0910946301568,1.0898246666666667,1.090154444444444,1.0903986666666636,1.0907320000000043,1.091135800000001,1.0928222000000003,1.093763100000004,1.089974049099568,1.0903054743423362,1482,-263183,-263181.6,-0.05108689530727761,-231.85870011066888,-0.12285800731645993
2023-06-28T23:15:00-04:00,1.08935,1.08957,1.0893,1.08941,1.0909406597442561,1.089675777777778,1.0899988888888883,1.090274222222219,1.0906285000000042,1.0911268000000012,1.0927722000000002,1.093755350000004,1.0898612392796543,1.0901519794738685,1496,-261687,-262844.6,-0.05400791563026845,-231.77630235053675,-0.1283449913367193
2023-06-28T23:30:00-04:00,1.08941,1.08941,1.08905,1.0892,1.0907990069647155,1.089516,1.0897699999999995,1.0901288888888858,1.0905170000000044,1.0910838000000012,1.0927152000000004,1.093742550000004,1.0897289914237234,1.0900043835790945,-1395,-263082,-263127.4,-0.058820781100819654,-232.04520937360434,-0.18877261147663718
2023-06-28T23:45:00-04:00,1.0892,1.08934,1.08905,1.08929,1.090624106268244,1.08942,1.0895822222222218,1.0899617777777748,1.0904130000000045,1.091040200000001,1.0926591000000003,1.0937270000000041,1.0896411931389787,1.089867106863275,1049,-262033,-262930,-0.06754694289781632,-231.95853107760715,-0.15490659773781087
2023-06-29T00:00:00-04:00,1.08929,1.08932,1.08898,1.08908,1.0904666956414197,1.0893195555555555,1.0894088888888882,1.089782888888886,1.0902875000000045,1.0910088000000011,1.0925972000000004,1.093713600000004,1.089528954511183,1.0897468854906198,-1211,-263244,-262645.8,-0.07497814156542355,-232.1919950770931,-0.14303528203623614
2023-06-29T00:15:00-04:00,1.08908,1.08913,1.08899,1.08907,1.0902882921644494,1.0892517777777777,1.0893699999999993,1.089625999999997,1.0901610000000044,1.090983800000001,1.0925361000000005,1.093698700000004,1.0894371636089464,1.0896395083924955,-1072,-264316,-262872.4,-0.07838017507852454,-232.2018382474755,-0.03212718694351788
2023-06-29T00:30:00-04:00,1.08907,1.08917,1.08898,1.08902,1.0901312971047155,1.089181777777778,1.0892811111111103,1.0894824444444415,1.0900225000000046,1.090941000000001,1.0924755000000004,1.093683150000004,1.089353730887157,1.0895380067139961,-1310,-265626,-263660.2,-0.07078817974960211,-232.2619813053137,-0.07340661760656915
2023-06-29T00:45:00-04:00,1.08902,1.0891,1.08806,1.08852,1.0899931414521495,1.0890295555555556,1.0891422222222216,1.089356888888886,1.0898730000000045,1.090878400000001,1.0924098000000004,1.0936643500000038,1.0891869847097255,1.0894296053711963,-1574,-267200,-264483.8,-0.0684390778611071,-232.98464939221776,-0.1147031024895137
2023-06-29T01:00:00-04:00,1.08852,1.08868,1.0884,1.0886,1.0897225016488485,1.0889211111111112,1.0890599999999993,1.0892524444444416,1.0897560000000044,1.090828600000001,1.0923427000000003,1.093644200000004,1.0890695877677805,1.089315284296957,1840,-265360,-265149.2,-0.06646840915347918,-232.84941990631015,-0.06793104081370031
2023-06-29T01:15:00-04:00,1.0886,1.08887,1.08847,1.08877,1.0894897514180097,1.0888631111111111,1.0889955555555548,1.089169777777775,1.0896705000000044,1.090782400000001,1.0922811000000003,1.093624300000004,1.0890096702142245,1.089211427437565,1642,-263718,-265244,-0.06222281264203752,-232.59299881500021,-0.05324275944370725
2023-06-29T01:30:00-04:00,1.08877,1.08945,1.08859,1.08872,1.08806,1.088808,1.0889188888888883,1.0890795555555526,1.0895880000000044,1.090724800000001,1.0922193000000002,1.093604100000004,1.0889517361713796,1.0891143419500515,-2578,-266296,-265640,-0.060317811322247936,-232.71138929232808,-0.06333703564315359
2023-06-29T01:45:00-04:00,1.08872,1.08941,1.08844,1.08941,1.0880878,1.088906222222222,1.0889422222222214,1.0890117777777748,1.0895240000000046,1.0906806000000009,1.0921648000000002,1.0935878000000039,1.0890433889371036,1.089052273560041,1851,-264445,-265403.8,-0.05612475236149724,-231.53827774849665,0.019280205655530985
2023-06-29T02:00:00-04:00,1.08941,1.08982,1.08917,1.0896,1.088115044,1.0890377777777778,1.088976666666666,1.0889786666666637,1.0894635000000046,1.0906414000000009,1.0921108000000002,1.093571850000004,1.0891547111496829,1.0890458188480325,2756,-261689,-264301.6,-0.04769214093616753,-231.0576139029291,0.02845890442396519
2023-06-29T02:15:00-04:00,1.0896,1.0896,1.08898,1.08922,1.08818324224,1.0890864444444444,1.0889922222222215,1.0889651111111083,1.0893615000000043,1.090595800000001,1.0920514,1.093554400000004,1.0891677689197463,1.0890654550784258,-2661,-264350,-264099.6,-0.041388220987976114,-231.9856425372899,0.012854886693358521
2023-06-29T02:30:00-04:00,1.08922,1.08968,1.08901,1.0895,1.0882487125504,1.0891879999999998,1.0890399999999993,1.088973999999997,1.0892875000000044,1.090545600000001,1.0919940000000001,1.093538750000004,1.089234215135797,1.0891103640627402,2875,-261475,-263651,-0.02984255179788849,-231.24658155787387,0.03948322880989564
2023-06-29T02:45:00-04:00,1.0895,1.09,1.08944,1.08972,1.0883115640483838,1.089324,1.0891177777777772,1.0890137777777746,1.0892415000000044,1.090498200000001,1.0919379,1.093525800000004,1.0893313721086375,1.0891862912501917,2515,-258960,-262183.8,-0.018369021488583843,-230.73873392134308,0.06427797469283603
2023-06-29T03:00:00-04:00,1.08972,1.09116,1.08972,1.09096,1.0884128702054807,1.0896924444444442,1.0893888888888883,1.089103111111108,1.0893185000000043,1.0904752000000009,1.0918967000000002,1.0935175000000041,1.08965709768691,1.0893090330001531,5451,-253509,-259996.6,-0.001958402310515805,-224.53600294457888,0.22415757174879633
2023-06-29T03:15:00-04:00,1.09096,1.09207,1.09084,1.0916299999999999,1.0886326405890423,1.0901406666666666,1.089725555555555,1.0892528888888857,1.0894090000000045,1.090462800000001,1.0918683,1.093512350000004,1.090051678149528,1.0894884264001221,4214,-249295,-257517.8,0.016928927354193483,-221.94802538353193,0.27833915120336816
2023-06-29T03:30:00-04:00,1.0916299999999999,1.091985,1.0912799999999998,1.091735,1.0889763765301381,1.0905425555555555,1.090054999999999,1.0894654444444414,1.0895072500000045,1.090458500000001,1.0918451500000002,1.093510225000004,1.0903883425196224,1.0897325411200973,4262,-245033,-253654.4,0.03733186945884542,-221.5380787899058,0.2723256518823888
2023-06-29T03:45:00-04:00,1.091735,1.091875,1.0913599999999999,1.091675,1.0892857388771242,1.0908665555555555,1.0903833333333326,1.089734111111108,1.0896240000000044,1.090457200000001,1.0918238,1.093509750000004,1.0906456740156978,1.0900148328960773,-3189,-248222,-251003.8,0.0556642784537668,-221.7133411017304,0.27141964876185254
2023-06-29T04:00:00-04:00,1.091675,1.09219,1.091495,1.09175,1.0895641649894119,1.0911398888888888,1.0906433333333327,1.090039222222219,1.0897440000000045,1.090459000000001,1.0917934999999999,1.093506750000004,1.0908665392125583,1.0903218663168615,3404,-244818,-248175.4,0.07293232064217738,-221.47948029150743,0.21479516435501866
2023-06-29T04:15:00-04:00,1.09175,1.0919050000000001,1.09112,1.09137,1.0898792651906826,1.0912852222222222,1.0908399999999994,1.0903294444444414,1.0898420000000042,1.090454600000001,1.0917579,1.0935003000000039,1.0909672313700467,1.0905838930534888,-3565,-248383,-247150.2,0.08208422087537522,-222.7203321348783,0.16244493392070938
2023-06-29T04:30:00-04:00,1.09137,1.09204,1.0910449999999998,1.0919249999999998,1.0901565533678006,1.0915022222222222,1.0911405555555551,1.0906124444444412,1.0899782500000041,1.090460300000001,1.0917233499999999,1.0934946750000039,1.0911587850960374,1.0908053144427907,2571,-245812,-246453.6,0.09241870411132747,-221.41288827990735,0.24834285084737107
2023-06-29T04:45:00-04:00,1.0919249999999998,1.0919349999999999,1.091285,1.09143,1.0904005669636645,1.091560111111111,1.0913549999999994,1.0908724444444413,1.0900852500000042,1.090465300000001,1.09168505,1.093486325000004,1.09121302807683,1.0909702515542323,-2508,-248320,-247111,0.10294222684545469,-222.54983449874086,0.1771454795777868
2023-06-29T05:00:00-04:00,1.09143,1.09161,1.091165,1.091445,1.0906152989280247,1.0915781111111111,1.091546666666666,1.091105111111108,1.0902035000000043,1.090471400000001,1.0916427999999998,1.093474200000004,1.091259422461464,1.0910930012433855,1747,-246573,-246781.2,0.11136082190561342,-222.52582471341321,0.15829754432331025
2023-06-29T05:15:00-04:00,1.091445,1.091715,1.091285,1.09151,1.0908042630566617,1.0915707777777777,1.091607777777777,1.091297999999997,1.090325500000004,1.090476400000001,1.0916082,1.093463550000004,1.0913095379691713,1.0911816009947082,1800,-244773,-246772.2,0.11715361654994043,-222.41862737410617,0.050414313998684686
2023-06-29T05:30:00-04:00,1.09151,1.09171,1.0912799999999998,1.091575,1.0909705514898622,1.0915642222222222,1.0916016666666661,1.0914503333333303,1.0904532500000041,1.090481500000001,1.09156565,1.0934533750000037,1.091362630375337,1.091260680795766,2161,-242612,-245618,0.11184123039148075,-222.28993867679696,-0.005038337165515443
2023-06-29T05:45:00-04:00,1.091575,1.0919400000000001,1.09137,1.0916700000000001,1.0911168853110786,1.0915778888888887,1.0915944444444436,1.091541111111108,1.0906107500000042,1.090488500000001,1.09152955,1.0934420250000039,1.0914241043002697,1.0913137446366126,2175,-240437,-244543,0.10062340793902673,-222.10064797299705,-0.0059538257910353425
2023-06-29T06:00:00-04:00,1.0916700000000001,1.09215,1.0916350000000001,1.092145,1.0912456590737492,1.091688,1.091646666666666,1.0915994444444412,1.090788000000004,1.090505600000001,1.0914969,1.093432600000004,1.0915682834402158,1.0913847957092897,1933,-238504,-242579.8,0.08853991117887665,-221.25957420528374,0.04305310646483344
2023-06-29T06:15:00-04:00,1.092145,1.0926200000000001,1.09203,1.09232,1.0913589799848993,1.0918226666666666,1.0917099999999993,1.0916321111111078,1.0909655000000043,1.090526800000001,1.0914700000000002,1.0934240500000039,1.0917186267521726,1.0914766365674313,2175,-236329,-240531,0.07819948245373645,-220.91106278967493,0.05220975498053212
2023-06-29T06:30:00-04:00,1.09232,1.0927850000000001,1.092075,1.0922100000000001,1.0915355227870134,1.0919226666666666,1.0918033333333326,1.091671222222219,1.0911400000000042,1.090542400000001,1.091441,1.0934164500000039,1.091816901401738,1.0915781092539447,-2077,-238406,-239257.6,0.06738967995178477,-221.12022310899496,0.07696748123919239
2023-06-29T06:45:00-04:00,1.0922100000000001,1.09279,1.092015,1.092775,1.0917354391410912,1.0921169999999998,1.0918977777777772,1.0917304444444411,1.091308250000004,1.090568300000001,1.09142135,1.093410525000004,1.0920085211213904,1.0917072874031555,1810,-236596,-238054.4,0.06255788912165627,-220.18391049512047,0.07784417427939094
2023-06-29T07:00:00-04:00,1.092775,1.09306,1.09259,1.09299,1.0919252600956948,1.0923354444444444,1.0920711111111105,1.0918257777777747,1.0914777500000041,1.090599500000001,1.0913976500000002,1.0934104750000038,1.0922048168971124,1.0918634299225238,1876,-234720,-236911,0.05668620854516978,-219.81481347148824,0.1429317500893329
2023-06-29T07:15:00-04:00,1.09299,1.09348,1.09293,1.093385,1.092015,1.0925982222222224,1.092286666666666,1.0919537777777746,1.0916860000000042,1.090639800000001,1.0913727000000002,1.093412600000004,1.09244085351769,1.0920379439380188,1947,-232773,-235764.8,0.05807501132091932,-219.1111794034727,0.1777460156031731
2023-06-29T07:30:00-04:00,1.093385,1.0936750000000002,1.093165,1.09352,1.092308,1.0928448888888889,1.0925099999999994,1.0921137777777745,1.091887000000004,1.090678400000001,1.0913518000000002,1.093412900000004,1.092656682814152,1.0922255551504148,1897,-230876,-234674.2,0.05831491274173249,-218.8769572401908,0.1841485648322111
2023-06-29T07:45:00-04:00,1.09352,1.093985,1.093385,1.09388,1.0925814,1.093118888888889,1.0927661111111104,1.0923063333333303,1.0920950000000043,1.0907240000000011,1.0913362000000002,1.0934118500000038,1.0929013462513215,1.0924424441203313,2249,-228627,-232718.4,0.060907166611388265,-218.13655925935842,0.21116276939284992
2023-06-29T08:00:00-04:00,1.09388,1.09414,1.09356,1.0936599999999999,1.09286212,1.0932976666666667,1.0929872222222217,1.0925242222222191,1.0922300000000043,1.090761400000001,1.0913246000000003,1.093408550000004,1.0930530770010571,1.092651355296265,-2387,-231014,-231602,0.06280858195782349,-218.61663019949833,0.18228951972663113
2023-06-29T08:15:00-04:00,1.0936599999999999,1.0939,1.0933799999999998,1.09349,1.093117696,1.093398222222222,1.093136666666666,1.0927373333333303,1.0923230000000042,1.090801000000001,1.0913077000000002,1.0934052000000039,1.0931404616008458,1.0928384842370114,-2936,-233950,-231448,0.06843420703330798,-219.07300603842393,0.12315214554845297
2023-06-29T08:30:00-04:00,1.09349,1.0935000000000001,1.08963,1.090525,1.09414,1.0928758888888888,1.0929372222222216,1.0928674444444417,1.0922625000000041,1.090792700000001,1.0912655500000001,1.0933847750000039,1.0926173692806767,1.092873787389609,-12599,-246549,-234203.2,0.05842311009959908,-253.23521602662805,-0.1643291343196125
2023-06-29T08:45:00-04:00,1.090525,1.09063,1.0873300000000001,1.0881150000000002,1.0940497999999999,1.0919114444444444,1.0924822222222217,1.092861888888886,1.0920845000000043,1.0907454000000012,1.0912063000000003,1.0933497000000039,1.0917168954245413,1.0926858299116868,-8849,-255398,-239107.6,0.0357121599908327,-272.79101713159884,-0.3749278984810576
2023-06-29T09:00:00-04:00,1.0881150000000002,1.08853,1.0867049999999998,1.087225,1.0937810079999999,1.0908600000000002,1.091865555555555,1.0926817777777749,1.0918582500000042,1.090682500000001,1.0911461500000001,1.0933106750000037,1.0908185163396331,1.0922692639293492,-8434,-263832,-246148.6,0.009470574600154602,-279.68942400954876,-0.5078813113403897
2023-06-29T09:15:00-04:00,1.087225,1.087895,1.0870600000000001,1.087135,1.09335644752,1.089913888888889,1.0912149999999992,1.0923273333333303,1.0916465000000042,1.0906114000000011,1.0910872000000003,1.0932736500000038,1.0900818130717065,1.091675011143479,-5754,-269586,-253863,-0.022061742342903496,-280.16573756010257,-0.5356865113129987
2023-06-29T09:30:00-04:00,1.087135,1.087485,1.08602,1.0861649999999998,1.0929573606688,1.0889038888888887,1.0904127777777772,1.0917825555555525,1.0913585000000041,1.090518500000001,1.0910213500000001,1.0932325250000037,1.089298450457365,1.0909066089147827,-6809,-276395,-262352,-0.061891623556298375,-286.24109158697223,-0.6603346488199697
2023-06-29T09:45:00-04:00,1.0861649999999998,1.087005,1.0860349999999999,1.086895,1.092402371815296,1.0882003333333332,1.089676666666666,1.0911304444444414,1.091131750000004,1.0904312000000012,1.0909627000000002,1.0931948000000036,1.088817760365892,1.090146687131826,5398,-270997,-267241.6,-0.09943237919555802,-282.61315292203585,-0.6058416855658884
2023-06-29T10:00:00-04:00,1.086895,1.088355,1.08689,1.08833,1.0918917820700722,1.087931,1.0890599999999993,1.090445999999997,1.0909760000000042,1.0903782000000013,1.090922,1.0931599500000038,1.0887202082927137,1.0895473497054604,7231,-263766,-268915.2,-0.1334863023007323,-273.06624636712434,-0.507368267085964
2023-06-29T10:15:00-04:00,1.08833,1.0894050000000002,1.08833,1.089145,1.0914220395044665,1.0879480000000001,1.0885583333333326,1.0897845555555523,1.090857750000004,1.0903483000000012,1.09087975,1.0931279750000038,1.088805166634171,1.089144679764368,7415,-256351,-267419,-0.16686480857751224,-267.5134958227122,-0.4128339703381147
2023-06-29T10:30:00-04:00,1.089145,1.089205,1.0882049999999999,1.0882900000000002,1.0909898763441093,1.0878943333333335,1.087980555555555,1.0891376666666635,1.0906935000000042,1.0903257000000013,1.09083245,1.0930840250000038,1.0887021333073368,1.0888687438114941,-7075,-263426,-266187,-0.20206330852736532,-273.0675083738406,-0.4755416144637693
2023-06-29T10:45:00-04:00,1.0882900000000002,1.0891600000000001,1.087885,1.0889600000000002,1.0905922862365804,1.0880902222222224,1.0878066666666664,1.0886164444444413,1.0905580000000041,1.0903085000000012,1.09078735,1.0930461750000038,1.0887537066458695,1.0887597950491947,6293,-257133,-262334.6,-0.23220492838621948,-269.1932561065225,-0.143508860411253
2023-06-29T11:00:00-04:00,1.0889600000000002,1.08969,1.0884749999999999,1.0885500000000001,1.090226503337654,1.088238888888889,1.0878549999999996,1.0882521111111079,1.090378250000004,1.0902841000000012,1.09075445,1.0930065750000038,1.0887129653166956,1.0887388360393555,-5481,-262614,-260658,-0.23672352182590953,-271.2568856245949,0.039977392095501225
2023-06-29T11:15:00-04:00,1.0885500000000001,1.0889250000000001,1.08834,1.08874,1.0898899830706417,1.0884158888888888,1.0880233333333331,1.0880447777777746,1.0901992500000042,1.0902721000000013,1.09072645,1.092964425000004,1.0887183722533564,1.0887384688314843,3618,-258996,-259704,-0.21615496474173776,-270.6253850045042,0.13934558164132843
2023-06-29T11:30:00-04:00,1.08874,1.08875,1.08788,1.0881699999999999,1.08969,1.088445222222222,1.0881383333333328,1.0879607777777747,1.089997250000004,1.0902485000000013,1.09069215,1.092917575000004,1.0886086978026852,1.0886991750651869,-3714,-262710,-260975.8,-0.18939676059294222,-272.5698161818291,0.09520436744285642
2023-06-29T11:45:00-04:00,1.0881699999999999,1.088585,1.08803,1.088035,1.0893964,1.0884245555555556,1.0883461111111106,1.0880338888888859,1.089760250000004,1.0902210000000014,1.0906738999999999,1.0928749000000038,1.0884939582421482,1.0886575400521492,-2492,-265202,-261331,-0.16293268344309175,-272.87897743420643,0.17216537082305733
2023-06-29T12:00:00-04:00,1.088035,1.088375,1.0878700000000001,1.087955,1.089126288,1.0883463333333336,1.0884638888888882,1.08816533333333,1.089508500000004,1.0901961000000013,1.09063995,1.0928424750000039,1.0883861665937187,1.088584032041719,-2587,-267789,-263462.2,-0.12547655131509536,-273.0691919034103,0.09752551994443447
2023-06-29T12:15:00-04:00,1.087955,1.0880100000000001,1.0876450000000002,1.0878999999999999,1.0888777849600002,1.0882335555555556,1.0884161111111108,1.0882775555555522,1.089234250000004,1.0901683000000013,1.09060425,1.092802225000004,1.088288933274975,1.088499225633375,-2163,-269952,-264929.8,-0.09403109615414283,-273.17853925693163,-0.039510075069156644
2023-06-29T12:30:00-04:00,1.0878999999999999,1.08796,1.087585,1.0876000000000001,1.0886491621632002,1.0880703333333333,1.0882444444444441,1.0883217777777745,1.088938250000004,1.0901387000000013,1.0905737500000001,1.092763475000004,1.08815114661998,1.0883857805066994,-2139,-272091,-267548.8,-0.07546469449778176,-273.7683912653878,-0.1418543903704197
2023-06-29T12:45:00-04:00,1.0876000000000001,1.08764,1.08687,1.08708,1.0884388291901441,1.0878374444444445,1.0881099999999995,1.088316111111108,1.0885982500000042,1.0900989000000014,1.09054135,1.0927244750000038,1.087936917295984,1.0882514244053592,-2614,-274705,-269947.8,-0.06628663843348762,-275.01818898513784,-0.11118359995958386
2023-06-29T13:00:00-04:00,1.08708,1.08731,1.08685,1.0871499999999998,1.0882453228549327,1.0876454444444446,1.0879088888888886,1.0882286666666636,1.0882727500000042,1.0900615000000016,1.09050125,1.092686025000004,1.0877795338367873,1.088108539524287,2070,-272635,-271434.4,-0.04733779063585423,-274.8848961272069,-0.16621363502794512
2023-06-29T13:15:00-04:00,1.0871499999999998,1.087445,1.0868250000000002,1.087395,1.0880672970265381,1.0875426666666665,1.087780555555555,1.0880919999999967,1.0879680000000043,1.0900390000000015,1.0904587,1.092645500000004,1.0877026270694299,1.0879718316194293,2284,-270351,-271946.8,-0.034317382733061674,-274.3701741477191,-0.10610445087503918
2023-06-29T13:30:00-04:00,1.087395,1.087515,1.08721,1.087275,1.087903513264415,1.0874415555555554,1.0876177777777776,1.0879323333333304,1.0878055000000042,1.0900125000000014,1.09042055,1.092601625000004,1.0876171016555438,1.087837465295543,-1438,-271789,-272314.2,-0.018843037497257818,-274.5288653316954,-0.13455921523963935
2023-06-29T13:45:00-04:00,1.087275,1.08737,1.087125,1.087245,1.087752832203262,1.087367,1.0875149999999998,1.0877864444444414,1.0877620000000043,1.0899820000000013,1.0903821999999999,1.092557950000004,1.087542681324435,1.087715772236434,-1347,-273136,-272523.2,-0.018230684590390973,-274.56603164196645,-0.0850051003060039
2023-06-29T14:00:00-04:00,1.087245,1.087275,1.086925,1.087085,1.087614205627001,1.0872810000000002,1.0874094444444442,1.0876463333333304,1.0877550000000042,1.0899493000000013,1.09033705,1.092511225000004,1.087451145059548,1.0876186177891465,-2057,-275193,-272620.8,-0.023697237474322907,-274.8687417027162,-0.08731336767659187
2023-06-29T14:15:00-04:00,1.087085,1.0872600000000001,1.086935,1.087195,1.087486669176841,1.0872381111111111,1.0873249999999999,1.0875295555555526,1.0877580000000042,1.0899050000000015,1.0902928,1.0924667500000038,1.0873999160476384,1.0875426942313169,1943,-273250,-272743.8,-0.03128844978102184,-274.67213334182475,-0.06985583043417182
2023-06-29T14:30:00-04:00,1.087195,1.087255,1.086965,1.087105,1.0873693356426937,1.0871941111111112,1.0872366666666666,1.087420777777775,1.0878050000000044,1.0898551000000014,1.09024825,1.0924235250000038,1.0873409328381107,1.087470355385053,-1568,-274818,-273637.2,-0.03897161686858712,-274.80193526328304,-0.07307656953763023
2023-06-29T14:45:00-04:00,1.087105,1.087105,1.0865550000000002,1.08671,1.087261388791278,1.0870887777777776,1.0871377777777775,1.0873247777777748,1.0877957500000044,1.0898049000000014,1.09020035,1.092377725000004,1.0872147462704886,1.0873898843080418,-1939,-276757,-274630.8,-0.05229654320072352,-275.5064716236161,-0.08183155571901961
2023-06-29T15:00:00-04:00,1.08671,1.0869849999999999,1.086665,1.086905,1.087255,1.0870422222222222,1.0871183333333332,1.0872454444444417,1.0877245000000044,1.0897530000000015,1.0901493,1.092334200000004,1.087152797016391,1.087311907446433,1624,-275133,-275030.2,-0.05872961394395303,-275.2150599314444,-0.01609817124774959
2023-06-29T15:15:00-04:00,1.086905,1.0871300000000002,1.086655,1.08707,1.0871562000000001,1.0870325555555556,1.0871094444444442,1.0871854444444415,1.0876207500000046,1.0897000000000014,1.0900991,1.092289700000004,1.0871362376131128,1.0872489259571458,1428,-273705,-274732.6,-0.0533085305903425,-274.9982792560404,-0.007358690153139675
2023-06-29T15:30:00-04:00,1.08707,1.0872,1.086905,1.086915,1.08602,1.0869936666666666,1.087056111111111,1.087131666666664,1.0875520000000045,1.0896191000000015,1.09004715,1.092244225000004,1.0870919900904903,1.0871873407657162,-1418,-275123,-275107.2,-0.0457106228594002,-275.2004649478541,-0.04414219303931083
2023-06-29T15:45:00-04:00,1.086915,1.0870199999999999,1.0867049999999998,1.0869300000000002,1.0860436,1.0869684444444445,1.0870177777777776,1.087087888888886,1.0874505000000045,1.0895251000000017,1.0899939499999998,1.092197925000004,1.0870595920723922,1.0871310726125727,1905,-273218,-274787.2,-0.04403412387312973,-275.17417494357574,-0.03173070290403234
2023-06-29T16:00:00-04:00,1.0869300000000002,1.0869650000000002,1.08674,1.08693,1.086066728,1.086950888888889,1.0869827777777776,1.087056888888886,1.0873695000000045,1.0894290000000015,1.0899437499999998,1.092152125000004,1.0870336736579138,1.0870948580900577,-926,-274144,-274264.6,-0.03832117267742095,-275.1741749435759,-0.02897231074873329
2023-06-29T16:15:00-04:00,1.08693,1.08694,1.0865,1.086525,1.08608939344,1.0868593333333334,1.0869205555555554,1.0870173333333306,1.0872587500000044,1.0893260000000016,1.0898915999999998,1.092105100000004,1.086931938926331,1.0870506864720455,-554,-274698,-274177.6,-0.036077913051297386,-275.38060038035655,-0.05151391105572388
2023-06-29T16:30:00-04:00,1.086525,1.086745,1.086385,1.0865049999999998,1.0861116055712,1.0867762222222221,1.0868438888888887,1.0869642222222196,1.0871755000000045,1.0892211000000014,1.0898400499999998,1.092058025000004,1.0868465511410648,1.086992749177636,-694,-275392,-274515,-0.03162710759747368,-275.3933750519012,-0.06346607554303317
2023-06-29T16:45:00-04:00,1.0865049999999998,1.086595,1.08622,1.08654,1.086133373459776,1.0867154444444445,1.086781111111111,1.0869092222222194,1.0871007500000043,1.0891245000000014,1.0897895499999997,1.092010875000004,1.0867852409128518,1.0869313993421084,1019,-274373,-274365,-0.030514606844540163,-275.360549616215,-0.05197290050178471
2023-06-29T17:00:00-04:00,1.08654,1.0866850000000001,1.086425,1.086615,1.0861547059905805,1.0866822222222223,1.0867705555555556,1.0868597777777749,1.0870337500000045,1.0890183000000015,1.0897392999999997,1.091963400000004,1.0867511927302815,1.0868697194736863,138,-274235,-274568.4,-0.028803743369257118,-275.3510239659858,-0.008741982681668176
2023-06-29T17:15:00-04:00,1.086615,1.08671,1.08655,1.0865900000000002,1.0861756118707688,1.0866461111111112,1.0867355555555556,1.0868103333333305,1.0869682500000046,1.0889215000000014,1.0896933999999996,1.091915450000004,1.0867189541842253,1.0868067755789486,-123,-274358,-274611.2,-0.023929717379263554,-275.35385385513695,-0.028981373717099763
2023-06-29T17:30:00-04:00,1.0865900000000002,1.0866449999999999,1.086525,1.086615,1.0861960996333535,1.0866220000000002,1.0866850000000001,1.0867632222222194,1.0869190000000046,1.0888249000000014,1.0896481499999997,1.0918672750000038,1.0866981633473802,1.0867600204631582,39,-274319,-274535.4,-0.020969526828276283,-275.3529565525665,-0.041855630272187826
2023-06-29T17:45:00-04:00,1.086615,1.086635,1.08637,1.086475,1.0862161776406865,1.0865799999999999,1.0866361111111111,1.086721666666664,1.0868887500000046,1.0887242000000015,1.0896002999999999,1.0918184500000039,1.0866535306779042,1.086721416370526,-114,-274433,-274343.6,-0.021516018392711524,-275.36764436747796,-0.04048154639507191
2023-06-29T18:00:00-04:00,1.086475,1.0865749999999998,1.0863,1.0863999999999998,1.0862358540878727,1.0865327777777778,1.0865772222222223,1.0866808888888861,1.0868512500000045,1.0886207000000017,1.0895510999999998,1.091769350000004,1.0866028245423234,1.0866849330964203,-470,-274903,-274449.6,-0.023275759145379372,-275.40008874033526,-0.0487611897730639
2023-06-29T18:15:00-04:00,1.0863999999999998,1.086705,1.08624,1.086695,1.0872,1.0865563333333332,1.0865511111111112,1.0866369999999974,1.0868162500000045,1.0885212000000015,1.0895048499999997,1.0917226250000038,1.0866212596338587,1.086658946477136,805,-274098,-274422.2,-0.02344490731535415,-275.18149982280937,-0.021620527540870637
2023-06-29T18:30:00-04:00,1.086695,1.086695,1.086515,1.0865200000000002,1.0871808,1.086550111111111,1.0865505555555557,1.0865999999999973,1.0867785000000045,1.0884087000000016,1.0894571499999999,1.0916749750000039,1.086601007707087,1.086635357181708,-336,-274434,-274437.4,-0.0233844641188189,-275.2356088414392,-0.00046018269251151255
2023-06-29T18:45:00-04:00,1.0865200000000002,1.08667,1.086495,1.086565,1.087161984,1.086553,1.0865572222222226,1.0865744444444416,1.0867445000000047,1.0882936000000014,1.0894101999999999,1.0916276000000038,1.0865938061656695,1.086614485745366,302,-274132,-274400,-0.019906113078013588,-275.2231010182975,0.0055222939609271045
2023-06-29T19:00:00-04:00,1.086565,1.08674,1.086475,1.08655,1.08714354432,1.0865515555555554,1.0865583333333335,1.0865588888888862,1.0867177500000047,1.0881804000000015,1.0893613999999996,1.0915799000000037,1.0865850449325356,1.086600788596292,-464,-274596,-274432.6,-0.016447253108984983,-275.22950652556125,0.0009203526791322425
2023-06-29T19:15:00-04:00,1.08655,1.086665,1.086525,1.086615,1.0871254734336,1.086562888888889,1.0865583333333335,1.0865551111111085,1.0866887500000046,1.0880572000000015,1.0893127499999997,1.091532975000004,1.0865910359460285,1.0865984308770331,262,-274334,-274318.8,-0.013697927826541527,-275.2138330636865,0
2023-06-29T19:30:00-04:00,1.086615,1.08676,1.0864449999999999,1.0867550000000001,1.087107763964928,1.086602222222222,1.0865766666666667,1.0865602222222197,1.0866712500000046,1.0879325000000015,1.0892659999999996,1.0914864500000039,1.0866238287568228,1.0865989447016258,485,-273849,-274269,-0.010481789861655343,-275.151345430072,0.015185120422603806
2023-06-29T19:45:00-04:00,1.0867550000000001,1.08682,1.08651,1.08676,1.0870904086856295,1.086638888888889,1.0865927777777777,1.086568666666664,1.0866737500000045,1.0878000000000012,1.0892198999999996,1.0914402500000038,1.0866510630054582,1.0866089557613001,668,-273181,-274018.4,-0.007405724361643631,-275.1482720602694,0.013344192745345838
2023-06-29T20:00:00-04:00,1.08676,1.0868799999999998,1.0864,1.086405,1.087073400511917,1.0866013333333333,1.0865850000000001,1.0865742222222197,1.0866487500000046,1.0876577000000014,1.0891680499999998,1.091391675000004,1.0866018504043666,1.0866105646090394,-1342,-274523,-274096.6,-0.008001794925828566,-275.58664851873294,-0.006442854184405025
2023-06-29T20:15:00-04:00,1.086405,1.0867200000000001,1.0863550000000002,1.0865,1.0870567325016787,1.0865843333333334,1.086596111111111,1.0865817777777753,1.0866202500000046,1.0875101000000014,1.0891170499999996,1.091343875000004,1.0865814803234932,1.086609851687231,1244,-273279,-273833.2,-0.00599707048442393,-275.4778677233574,0.009204712812979661
2023-06-29T20:30:00-04:00,1.0865,1.0869900000000001,1.08635,1.08691,1.0870403978516452,1.0866471111111111,1.0866200000000001,1.0865941111111086,1.0866200000000046,1.0873751000000014,1.0890682499999997,1.091298575000004,1.0866471842587946,1.0866210813497843,1400,-271879,-273342.2,-0.0006025597171546629,-274.94956583656494,0.019784760213314337
2023-06-29T20:45:00-04:00,1.08691,1.087405,1.0866,1.087225,1.08624,1.0867681111111112,1.0866983333333333,1.086618444444442,1.0866347500000046,1.0872498000000015,1.0890253999999997,1.0912561000000038,1.0867627474070356,1.0866488650798267,2276,-269603,-272493,0.0029163494145311077,-274.2899528051271,0.06488605824098549
2023-06-29T21:00:00-04:00,1.087225,1.08755,1.087195,1.0872600000000001,1.0862633000000002,1.0868804444444444,1.0867755555555556,1.0866549999999975,1.0866512500000045,1.0871845000000016,1.0889885999999998,1.091214000000004,1.0868621979256285,1.0866910920638608,1789,-267814,-271419.6,0.008280033856664456,-274.23236123024606,0.06396303948683348
2023-06-29T21:15:00-04:00,1.0872600000000001,1.0874000000000001,1.086905,1.087015,1.086314768,1.0869283333333335,1.0868272222222224,1.086703444444442,1.0866757500000044,1.0871625000000016,1.0889539499999998,1.0911713750000038,1.0868927583405028,1.0867492736510882,-1980,-269794,-270473.8,0.01204862042343147,-274.67852866029966,0.0427960057061488
2023-06-29T21:30:00-04:00,1.087015,1.0870449999999998,1.08633,1.086435,1.08755,1.086849888888889,1.0868072222222223,1.0867456666666642,1.0866722500000046,1.0871467000000015,1.0889145999999998,1.0911254000000037,1.0868012066724022,1.0867932189208698,-2144,-271938,-270205.6,0.011384775164178866,-275.822505514345,-0.016565204787350532
2023-06-29T21:45:00-04:00,1.086435,1.086565,1.08603,1.08617,1.0875256,1.0867224444444445,1.0867422222222225,1.0867701111111085,1.0866537500000046,1.0871274000000015,1.0888693999999997,1.0910775500000038,1.0866749653379217,1.0867987751366954,-2299,-274237,-270677.2,0.00875781646657421,-276.38327076951435,-0.05382998007831182
2023-06-29T22:00:00-04:00,1.08617,1.086825,1.08612,1.086635,1.087465776,1.086701,1.0867283333333337,1.0867761111111087,1.0866547500000046,1.0871368000000015,1.0888276499999998,1.0910304250000038,1.0866669722703375,1.0867796201093558,2167,-272070,-271170.6,0.007237164714536818,-275.45555687574097,-0.011502079575980964
2023-06-29T22:15:00-04:00,1.086635,1.08681,1.0865200000000002,1.086775,1.08740834496,1.0867103333333332,1.0867694444444447,1.0867748888888864,1.0866640000000045,1.0871344000000016,1.0887827999999997,1.0909846000000036,1.08668857781627,1.086744896087484,1350,-270720,-271751.8,0.006674008222131213,-275.2816254268183,0.03405728066420731
2023-06-29T22:30:00-04:00,1.086775,1.087155,1.086735,1.0871,1.0873532111616,1.0867764444444448,1.0868361111111113,1.086776666666664,1.0866882500000044,1.0871098000000015,1.0887439999999997,1.0909427500000037,1.0867708622530161,1.0867205168699867,1314,-269406,-271674.2,0.010834613622018919,-274.8886738038974,0.05522319374136529
2023-06-29T22:45:00-04:00,1.0871,1.08711,1.0866500000000001,1.086655,1.087300282715136,1.086740222222222,1.086807777777778,1.0867767777777755,1.0866972500000045,1.0870600000000017,1.0887041499999999,1.0908987750000037,1.0867476898024129,1.0867098134959887,-1489,-270895,-271465.6,0.012085667135280982,-275.49818994776643,-0.0234610041309875
2023-06-29T23:00:00-04:00,1.086655,1.08691,1.086585,1.08674,1.0872494714065304,1.0867266666666666,1.086753888888889,1.0867791111111087,1.0867142500000044,1.0870290000000016,1.0886773499999998,1.0908559750000038,1.0867461518419304,1.0867240507967906,1284,-269611,-270540.4,0.009359929380203707,-275.3977532866365,-0.04460898158155567
2023-06-29T23:15:00-04:00,1.08674,1.086905,1.08663,1.0868000000000002,1.087200692550269,1.086735888888889,1.086702777777778,1.0867739999999977,1.0867195000000045,1.0869858000000014,1.0886471499999997,1.0908130750000038,1.0867569214735444,1.0867420406374317,1242,-268369,-269800.2,0.0036961432818842692,-275.329181227082,-0.04230818755402616
2023-06-29T23:30:00-04:00,1.0868000000000002,1.087285,1.0867749999999998,1.08723,1.08603,1.086841333333333,1.0867266666666668,1.086765444444442,1.0867550000000044,1.0869594000000016,1.0886217499999997,1.0907751750000039,1.0868515371788354,1.0867746325099445,1817,-266552,-268966.6,0.0010757343259517954,-274.61027250422643,0.019778935893235528
2023-06-29T23:45:00-04:00,1.08723,1.08751,1.087095,1.0871499999999998,1.0860551,1.0869259999999998,1.0868061111111114,1.086759444444442,1.0867842500000044,1.0869276000000014,1.0885998499999998,1.0907377750000038,1.0869112297430683,1.0868027060079553,-1178,-267730,-268631.4,-0.0004425505807659647,-274.69695149579223,0.06581157639433552
2023-06-30T00:00:00-04:00,1.0871499999999998,1.0873300000000001,1.0871149999999998,1.087285,1.086113296,1.0870217777777778,1.08693,1.086783888888886,1.0868210000000045,1.0869099000000015,1.0885791999999999,1.090700700000004,1.0869859837944547,1.0868503648063637,962,-266768,-267806,0.004223814867565975,-274.5774923595183,0.10265428063746716
2023-06-30T00:15:00-04:00,1.087285,1.08739,1.0871149999999998,1.087265,1.08616916416,1.0870887777777778,1.0870000000000002,1.0868331111111085,1.0868535000000044,1.0868945000000014,1.0885577499999999,1.090664975000004,1.0870417870355638,1.0869094918450903,-931,-267699,-267423.6,0.011166032128810247,-274.5946175842755,0.05797714964085534
2023-06-30T00:30:00-04:00,1.087265,1.0872950000000001,1.086835,1.08698,1.0862227975936,1.087084777777778,1.087022777777778,1.0868971111111085,1.0868647500000044,1.0868750000000016,1.0885355499999998,1.0906253750000041,1.087029429628451,1.0869639934760715,-1053,-268752,-267500.2,0.012740946501948902,-274.8706358502915,0.01886315014607538
2023-06-30T00:45:00-04:00,1.08698,1.0870950000000001,1.0868099999999998,1.086995,1.0862742856898562,1.0870792222222223,1.0870111111111112,1.0869539999999973,1.0868765000000045,1.0868569000000015,1.0885125999999998,1.090585850000004,1.0870225437027607,1.0869981947808567,992,-267760,-267741.8,0.013713460528576313,-274.8569465459806,-0.009658725048295626
2023-06-30T01:00:00-04:00,1.086995,1.087135,1.08669,1.08689,1.086323714262262,1.0870549999999999,1.0870372222222224,1.0870002222222195,1.0869007500000045,1.0868427000000016,1.0884907,1.090543950000004,1.0869960349622085,1.0870151558246848,-1238,-268998,-267995.4,0.011211675915882693,-274.97653311261615,0.021625999052135705
2023-06-30T01:15:00-04:00,1.08689,1.0872600000000001,1.086835,1.0872199999999999,1.0863711656917714,1.0870915555555556,1.0870905555555557,1.0870323333333307,1.0869367500000044,1.0868455000000017,1.0884721999999998,1.0905041500000041,1.0870408279697668,1.0870261246597472,1055,-267943,-268230.4,0.012838860147892813,-274.6562155091789,0.04416879842462906
2023-06-30T01:30:00-04:00,1.0872199999999999,1.0875599999999999,1.087155,1.08739,1.0864167190641005,1.0871514444444443,1.087156111111111,1.0870635555555528,1.0869607500000042,1.0868503000000016,1.0884558999999998,1.090465700000004,1.0871106623758133,1.087039899727797,1450,-266493,-267989.2,0.014919308468168215,-274.4294904673287,0.05428781744570006
2023-06-30T01:45:00-04:00,1.08739,1.08753,1.086795,1.086965,1.0864853159202545,1.0871132222222222,1.0871266666666668,1.0870843333333304,1.0869477500000042,1.0868417000000017,1.08844035,1.090425075000004,1.0870815299006507,1.087050319782237,-1787,-268280,-267894.8,0.016196314933456996,-275.12792893006997,-0.024373867534924508
2023-06-30T02:00:00-04:00,1.086965,1.0869849999999999,1.0859999999999999,1.08642,1.0875599999999999,1.0869718888888888,1.0870455555555556,1.0870912222222195,1.0869057500000043,1.0868246000000017,1.0884185499999999,1.090380625000004,1.0869492239205205,1.087035655825789,-2565,-270845,-268511.8,0.012271430371148044,-276.4140098986385,-0.06714804764750931
2023-06-30T02:15:00-04:00,1.08642,1.08648,1.08568,1.085875,1.08753,1.0867377777777778,1.0868888888888888,1.0870615555555527,1.0868487500000044,1.0867972000000017,1.0883895999999997,1.0903353500000041,1.0867343791364164,1.0869833246606304,-2828,-273673,-269446.8,0.006609273838975096,-277.8326693489432,-0.12968081045909152
2023-06-30T02:30:00-04:00,1.085875,1.08663,1.08587,1.086405,1.0874560000000002,1.086641,1.0867933333333335,1.0870021111111083,1.0868472500000044,1.0867836000000017,1.0883664499999997,1.090292875000004,1.086668503309133,1.0869088597285035,2842,-270831,-270024.4,0.0011851881714238209,-276.44552994523616,-0.07909755211469706
2023-06-30T02:45:00-04:00,1.086405,1.0865200000000002,1.0858349999999999,1.0863999999999998,1.0873849600000003,1.0865623333333334,1.0867288888888889,1.086916666666664,1.0868587500000042,1.0867677000000016,1.0883363499999996,1.090250575000004,1.0866148026473064,1.0868096877828024,-2844,-273675,-271460.8,-0.00662041431666904,-276.45861898661644,-0.05335884744891782
2023-06-30T03:00:00-04:00,1.0863999999999998,1.0866099999999999,1.0855299999999999,1.08629,1.0873167616000003,1.0864745555555555,1.0866505555555555,1.0868214444444417,1.0868415000000042,1.0867514000000016,1.0883032499999998,1.090207025000004,1.086549842117845,1.086703350226241,-3783,-277458,-273296.4,-0.013494883445271146,-276.8416547009016,-0.064857704037273
2023-06-30T03:15:00-04:00,1.08629,1.0869199999999999,1.08602,1.08676,1.0872095559040003,1.0864964444444445,1.086636111111111,1.0867395555555528,1.0868407500000044,1.0867524000000015,1.0882786499999997,1.090165025000004,1.086591873694276,1.0866318801809922,3691,-273767,-273880.8,-0.016204725023171704,-275.2446870403322,-0.011960731996794845
2023-06-30T03:30:00-04:00,1.08676,1.08694,1.08594,1.08594,1.0871087825497603,1.0863572222222222,1.0864938888888889,1.0866605555555529,1.0867827500000042,1.0867331000000016,1.0882430499999998,1.0901185250000038,1.0864614989554207,1.086577304144793,-3403,-277170,-274580.2,-0.02128796457709153,-277.8123744782211,-0.1177314618936322
2023-06-30T03:45:00-04:00,1.08594,1.08616,1.08532,1.08561,1.0870140555967747,1.0861804444444443,1.0862961111111114,1.0865611111111084,1.086730500000004,1.0867039000000016,1.0882019499999998,1.0900699250000039,1.0862911991643365,1.0865018433158338,-3059,-280229,-276459.8,-0.02957548584582955,-278.7419562230687,-0.1636947185462543
2023-06-30T04:00:00-04:00,1.08561,1.08566,1.08501,1.08515,1.08694,1.0859512222222223,1.0860944444444445,1.0864342222222194,1.0866510000000043,1.0866686000000016,1.0881438499999998,1.0900202750000039,1.0860629593314692,1.0863914746526664,-3458,-283687,-278462.2,-0.04359598873922609,-280.2071969632974,-0.1669786975661498
2023-06-30T04:15:00-04:00,1.08515,1.08547,1.0841399999999999,1.08435,1.086747,1.0856023333333331,1.0858644444444443,1.0862769999999973,1.0865285000000042,1.0866170000000015,1.0880710499999997,1.0899696750000039,1.0857203674651754,1.0862255797221325,-2896,-286583,-280287.2,-0.05719326986377319,-282.3422013405728,-0.1905340476058998
2023-06-30T04:30:00-04:00,1.08435,1.0844,1.08352,1.08404,1.0864341599999998,1.0852374444444444,1.0856605555555554,1.0860818888888861,1.0863690000000044,1.0865592000000017,1.0879941,1.089919625000004,1.0853842939721403,1.0859840637777054,-3216,-289799,-283493.6,-0.06700969247299297,-283.26160928081356,-0.16898814320248934
2023-06-30T04:45:00-04:00,1.08404,1.08419,1.08372,1.08388,1.0860261775999998,1.0848813333333334,1.0853799999999998,1.0858591111111084,1.0862055000000042,1.0865063000000015,1.0879161499999999,1.0898699750000038,1.0850834351777123,1.0857084510221637,-2887,-292686,-286596.8,-0.07069973337692059,-283.68771901846145,-0.23241792885711224
2023-06-30T05:00:00-04:00,1.08388,1.08447,1.08354,1.0841,1.0856753127359997,1.0846253333333333,1.0851244444444446,1.085624777777775,1.086046250000004,1.0864582000000016,1.08783965,1.0898165750000037,1.0848867481421698,1.0854275608177304,3055,-289631,-288477.2,-0.07855943101154338,-283.06763192394885,-0.21170839469806213
2023-06-30T05:15:00-04:00,1.0841,1.08446,1.08388,1.08436,1.0853735689529598,1.0844724444444445,1.0849099999999998,1.0853878888888862,1.0859010000000042,1.0864146000000015,1.08776955,1.0897637250000038,1.0847813985137358,1.0851712486541838,2125,-287506,-289241,-0.08452865202042442,-282.55799259178406,-0.17766894659805277
2023-06-30T05:30:00-04:00,1.08436,1.08473,1.08421,1.08469,1.0851140692995453,1.0844284444444443,1.0846799999999999,1.0851509999999973,1.0857865000000042,1.0863761000000016,1.0876972,1.0897102750000038,1.0847631188109885,1.0849797989233463,2303,-285203,-288965,-0.08798077070629991,-281.8571275654092,-0.19047443777835182
2023-06-30T05:45:00-04:00,1.08469,1.08494,1.08446,1.08456,1.08352,1.0844044444444445,1.0845266666666666,1.0849242222222195,1.0856647500000043,1.0863355000000015,1.0876285,1.0896567750000037,1.0847224950487908,1.0848474391386764,-2048,-287251,-288455.4,-0.09763910897587831,-282.10258018320775,-0.1270788441350293
2023-06-30T06:00:00-04:00,1.08456,1.08471,1.0842,1.08439,1.0835484,1.084377111111111,1.084391111111111,1.0847264444444416,1.0855397500000044,1.0862910000000014,1.08755795,1.0896003750000036,1.0846559960390327,1.0847619513109403,-2869,-290120,-287942.2,-0.10050143249160548,-282.55228328861455,-0.11237921537200274
2023-06-30T06:15:00-04:00,1.08439,1.08446,1.08411,1.08422,1.083576232,1.0843428888888889,1.0842877777777777,1.0845591111111081,1.0853897500000043,1.0862459000000013,1.0874850500000002,1.0895466250000037,1.084568796831226,1.0846983610487517,-1965,-292085,-288433,-0.10160554840573127,-282.8603366642451,-0.0857024374510526
2023-06-30T06:30:00-04:00,1.08422,1.08474,1.08417,1.0847,1.0836035073599999,1.0844253333333331,1.0843266666666667,1.0844424444444414,1.0852552500000043,1.0862119000000012,1.0874163000000001,1.0894909750000037,1.0845950374649809,1.0846610888390007,1740,-290345,-289000.8,-0.09470661285619551,-282.0900132981385,0.032277401208103705
2023-06-30T06:45:00-04:00,1.0847,1.08538,1.08458,1.08533,1.0836302372128,1.0846259999999999,1.08447,1.0844004444444415,1.0851735000000045,1.0861846000000013,1.0873529000000002,1.0894412250000036,1.0847420299719848,1.0846568710712,2188,-288157,-289591.6,-0.07664618950854447,-280.8192103111377,0.11899929891886032
2023-06-30T07:00:00-04:00,1.08533,1.0855,1.08491,1.08531,1.083700227724288,1.0847939999999998,1.0846288888888889,1.084420888888886,1.0851180000000045,1.0861604000000014,1.0872845500000003,1.0893907250000037,1.0848556239775877,1.0846834968569594,-2037,-290194,-290180.2,-0.057686282459685795,-280.8567472814599,0.13193342436432468
2023-06-30T07:15:00-04:00,1.08531,1.08542,1.0849,1.0850899999999999,1.0838082140608307,1.0848862222222222,1.0847388888888887,1.0844904444444414,1.0850787500000043,1.0861309000000012,1.08721225,1.0893411250000036,1.0849024991820702,1.0847327974855667,-1926,-292120,-290580.2,-0.040702228638641924,-281.2471610802825,0.09131998893089423
2023-06-30T07:30:00-04:00,1.0850899999999999,1.08551,1.08504,1.08532,1.0839097212171809,1.0850024444444444,1.0848455555555554,1.084601999999997,1.0850245000000043,1.086106300000001,1.0871433500000003,1.0892921750000035,1.084985999345656,1.0848162379884527,1802,-290318,-290226.8,-0.027024304978454365,-280.86520198011544,0.08853148400900733
2023-06-30T07:45:00-04:00,1.08532,1.08593,1.08523,1.08535,1.0840377435198063,1.0851033333333333,1.0849188888888888,1.0847204444444416,1.0849720000000045,1.0860810000000012,1.0870691000000001,1.0892452250000035,1.0850587994765248,1.0849089903907616,2607,-287711,-289700,-0.01327140013233845,-280.79314028402587,0.06084687790982723
2023-06-30T08:00:00-04:00,1.08535,1.08726,1.0853,1.08704,1.0842269691678257,1.0855275555555555,1.0851944444444444,1.0848653333333302,1.0850095000000044,1.0860867000000012,1.0870096,1.0892036250000035,1.08545503958122,1.0850515923126087,3721,-283990,-288866.6,0.005577868982336881,-274.99916599001943,0.22866415873718723
2023-06-30T08:15:00-04:00,1.08704,1.08763,1.08677,1.08714,1.0845909328676866,1.0859166666666664,1.0855,1.0850395555555525,1.0850285000000044,1.0860943000000012,1.08694715,1.0891599250000035,1.0857920316649758,1.0852388738500864,3772,-280218,-286871.4,0.025623888362869853,-274.652168639416,0.25359879748061404
2023-06-30T08:30:00-04:00,1.08714,1.08939,1.08713,1.08898,1.0850164022662105,1.0866126666666667,1.0860288888888887,1.0852975555555524,1.0851805000000043,1.0861458000000013,1.08690175,1.0891267750000033,1.0864296253319807,1.0855442990800683,9039,-271179,-282683.2,0.058175786709615825,-259.3535318493056,0.43902529007028995
2023-06-30T08:45:00-04:00,1.08898,1.08977,1.08877,1.0897,1.0857161779036169,1.0873468888888889,1.0865844444444444,1.0856453333333302,1.0853850000000043,1.0862098000000011,1.0868599500000002,1.0890980750000034,1.0870837002655847,1.085963839264054,5846,-265333,-277686.2,0.09215862022708908,-255.48833689623117,0.46095694662117576
2023-06-30T09:00:00-04:00,1.0897,1.09048,1.08961,1.09047,1.0864458658809657,1.088124,1.0871555555555554,1.0860926666666637,1.0856510000000044,1.0862810000000014,1.0868280500000003,1.0890763250000035,1.0877609602124678,1.0865042714112427,5970,-259363,-272016.6,0.12397047657810675,-251.26983639150424,0.47358867809791905
2023-06-30T09:15:00-04:00,1.09047,1.09098,1.09032,1.09067,1.0872526927047725,1.0888268888888888,1.0877511111111111,1.086603999999997,1.0859670000000041,1.0863499000000012,1.0867998500000002,1.0890537750000036,1.0883427681699742,1.0870818171289935,4783,-254580,-266134.6,0.14891011060088735,-250.39259997051155,0.4938681114151746
2023-06-30T09:30:00-04:00,1.09067,1.0913599999999999,1.08966,1.09101,1.087998154163818,1.0894786666666667,1.0884088888888888,1.087185777777775,1.0863155000000044,1.0864249000000012,1.0868047000000003,1.0890351250000034,1.0888762145359794,1.0876986537031943,6356,-248224,-259735.8,0.17214553919640121,-248.41121238306528,0.5455768645918908
2023-06-30T09:45:00-04:00,1.09101,1.09168,1.09085,1.09142,1.0886705233310543,1.0900808888888889,1.0890866666666668,1.0877973333333304,1.0866925000000043,1.0865130000000014,1.0868377500000002,1.0890220250000033,1.0893849716287836,1.0882897229625548,6391,-241833,-253866.6,0.1980039206357898,-246.0094837096341,0.5620462167839895
2023-06-30T10:00:00-04:00,1.09142,1.09268,1.09129,1.09254,1.0892724186648435,1.0907715555555557,1.0898855555555553,1.0884575555555525,1.0871145000000042,1.0866351000000014,1.0868909000000004,1.0890185250000035,1.090015977303027,1.0888761783700431,7874,-233959,-247591.8,0.2264133750456571,-237.92929459820124,0.6624591145713391
2023-06-30T10:15:00-04:00,1.09254,1.09318,1.09218,1.09236,1.0899539349318748,1.0912664444444444,1.0904766666666665,1.0891217777777749,1.0875145000000042,1.0867589000000013,1.0869431500000004,1.0890151750000034,1.0904847818424215,1.089420942696034,-5757,-239716,-243662.4,0.25462619308851914,-238.87778161011877,0.4894024138946121
2023-06-30T10:30:00-04:00,1.09236,1.09284,1.09142,1.0921,1.0905991479454997,1.0915911111111112,1.0910277777777777,1.0897771111111083,1.0878850000000042,1.0868682000000012,1.0870025000000003,1.0890119250000034,1.0908078254739373,1.0899139541568266,-7550,-247266,-242199.6,0.2671743193250965,-240.67480823137865,0.4562429861839391
2023-06-30T10:45:00-04:00,1.0921,1.0925799999999999,1.09084,1.0910199999999999,1.09318,1.0915895555555557,1.0912544444444445,1.0903462222222193,1.088208000000004,1.0869531000000012,1.08704375,1.0890032250000035,1.09085026037915,1.0903087633254607,-8556,-255822,-243719.2,0.2750569834988024,-249.13601141790153,0.18733126411870005
2023-06-30T11:00:00-04:00,1.0910199999999999,1.09187,1.09064,1.09129,1.0931332,1.0915966666666668,1.0914311111111112,1.0908151111111084,1.088553000000004,1.0870369000000013,1.08707335,1.0889976750000034,1.09093820830332,1.090619410660368,7148,-248674,-245087.4,0.2667547565245199,-247.36706126116604,0.14591171882171264
2023-06-30T11:15:00-04:00,1.09129,1.09184,1.09097,1.09139,1.0930334720000001,1.0915884444444446,1.0915333333333335,1.0911446666666638,1.0889115000000043,1.0871316000000013,1.0870958000000002,1.0889877750000034,1.091028566642656,1.0908219285282938,3680,-244994,-247294.4,0.2515784616262967,-247.02984567227585,0.08436729116803139
2023-06-30T11:30:00-04:00,1.09139,1.09157,1.0911,1.09153,1.09293773312,1.0915877777777776,1.0916288888888888,1.0913751111111083,1.0892530000000042,1.0872274000000013,1.0871282,1.0889803250000034,1.0911288533141248,1.0909507428226344,3506,-241488,-247648.8,0.22926781916417466,-246.58010726529088,0.07885061475972209
2023-06-30T11:45:00-04:00,1.09153,1.09192,1.09114,1.09189,1.0928458237952001,1.0916400000000002,1.0917266666666667,1.0915148888888861,1.0895810000000041,1.0873292000000014,1.0871575,1.0889724250000035,1.0912810826512997,1.0910453942581069,2735,-238753,-245946.2,0.2089657930802956,-245.67807067445014,0.08065920569013958
2023-06-30T12:00:00-04:00,1.09189,1.09225,1.09132,1.09133,1.0927575908433922,1.0915606666666666,1.0917166666666667,1.0916073333333305,1.0898820000000042,1.0874112000000014,1.0871853000000002,1.0889698750000034,1.0912908661210399,1.0911335154064852,-2787,-241540,-243089.8,0.18562729018802215,-247.1074454283176,-0.008246138058689186
2023-06-30T12:15:00-04:00,1.09133,1.09177,1.09127,1.09132,1.0926728872096565,1.0914813333333333,1.0915811111111111,1.0916373333333305,1.090193500000004,1.0874946000000012,1.0872111000000002,1.0889687750000037,1.091296692896832,1.0912052123251876,-3349,-244889,-242332.8,0.15840387680384152,-247.13813275479032,-0.11166639207717784
2023-06-30T12:30:00-04:00,1.09132,1.09186,1.09131,1.09133,1.0925915717212702,1.091431111111111,1.0914666666666666,1.091623999999997,1.090494000000004,1.0875755000000011,1.0872427,1.0889674250000034,1.0913033543174655,1.0912601698601494,2228,-242661,-241866.2,0.12000768720116678,-247.11771711134966,-0.09429125929181648
2023-06-30T12:45:00-04:00,1.09133,1.09183,1.0912,1.09182,1.0925135088524194,1.0915017777777778,1.0914355555555555,1.0915853333333305,1.090817500000004,1.0876666000000013,1.08728055,1.0889772250000034,1.0914066834539724,1.091315735888119,2362,-240299,-241628.4,0.08663985643020222,-246.05719462960698,-0.025638677776765678
2023-06-30T13:00:00-04:00,1.09182,1.09229,1.09176,1.09219,1.0924385684983227,1.0916526666666666,1.0915655555555555,1.0915531111111083,1.091075000000004,1.087770800000001,1.0873229,1.0889814250000034,1.091563346763178,1.0913721887104946,2189,-238110,-241499.8,0.05758114659460569,-245.31537821298156,0.10723909735844582
2023-06-30T13:15:00-04:00,1.09219,1.09222,1.09165,1.09167,1.0923666257583897,1.0916735555555555,1.0916077777777775,1.0915313333333303,1.091301500000004,1.087864300000001,1.0873606,1.0889824250000035,1.0915846774105424,1.091430950968395,-2070,-240180,-241227.8,0.04332006439998108,-246.30092102146742,0.034821174939734155
2023-06-30T13:30:00-04:00,1.09167,1.09169,1.091,1.09116,1.092297560728054,1.0915839999999999,1.091582222222222,1.0915315555555527,1.091410500000004,1.0879497000000011,1.0873962,1.0889849750000034,1.091499741928434,1.0914715607747154,-1864,-242044,-240658.8,0.024579802323408468,-247.1717336296732,-0.021074043192641907
2023-06-30T13:45:00-04:00,1.09116,1.09122,1.09097,1.09117,1.092231258298932,1.0915015555555554,1.091542222222222,1.0915466666666638,1.0914840000000041,1.088028700000001,1.0874370999999998,1.0889892250000033,1.0914337935427472,1.091497648619772,1393,-240651,-240256.8,0.013006460035487923,-247.15896739923946,-0.032981228184284075
2023-06-30T14:00:00-04:00,1.09117,1.09158,1.09116,1.09147,1.0921676079669747,1.0914871111111109,1.0914955555555552,1.0915586666666637,1.0915340000000042,1.088110300000001,1.0874803,1.0889907750000034,1.0914410348341976,1.091504518895817,1637,-239014,-239999.8,0.004733619386818351,-246.7089000403495,-0.03846541318265457
2023-06-30T14:15:00-04:00,1.09147,1.09148,1.09128,1.09138,1.0921065036482958,1.091464,1.0915011111111108,1.0915457777777746,1.091569500000004,1.088198600000001,1.0875201499999998,1.0889894250000034,1.091428827867358,1.091477615116653,-1382,-240396,-240457,-0.003908898240036329,-246.82285644776326,0.004581565612610807
2023-06-30T14:30:00-04:00,1.09138,1.09148,1.09124,1.09133,1.092047843502364,1.0914297777777777,1.091502222222222,1.0915246666666636,1.091585500000004,1.088296800000001,1.0875606999999998,1.0889906250000037,1.0914090622938863,1.091442492093322,-1515,-241911,-240803.2,-0.006788025155448703,-246.89226398684238,0.0009163215188802063
2023-06-30T14:45:00-04:00,1.09133,1.09137,1.09104,1.09112,1.0919915297622693,1.0913533333333334,1.0914788888888884,1.091503999999997,1.0915705000000042,1.088401700000001,1.08759945,1.0889908250000035,1.091351249835109,1.0914127936746567,-1766,-243677,-241129.8,-0.009100098024190473,-247.23208787145995,-0.01924257557290842
2023-06-30T15:00:00-04:00,1.09112,1.09129,1.09101,1.09125,1.0919374685717786,1.0913075555555554,1.0914155555555551,1.0914786666666634,1.091506000000004,1.088498600000001,1.0876411,1.0889890750000035,1.0913309998680871,1.0913922349397247,1707,-241970,-241393.6,-0.009091440521822486,-247.02870969124152,-0.052206407649608856
2023-06-30T15:15:00-04:00,1.09125,1.09145,1.09116,1.09121,1.0918855698289076,1.0912664444444444,1.0913066666666664,1.0914408888888858,1.0914485000000043,1.088594800000001,1.08768125,1.0889870250000036,1.0913067998944697,1.0913653879517793,-1176,-243146,-242220,-0.008878193368000059,-247.07181622045118,-0.08972797773281031
2023-06-30T15:30:00-04:00,1.09121,1.09145,1.0911899999999999,1.09129,1.0918357470357514,1.0912631111111113,1.091264444444444,1.0913935555555523,1.0914080000000042,1.0886948000000012,1.0877230999999998,1.0889856750000035,1.0913034399155757,1.0913403103614225,1651,-241495,-242439.8,-0.012456228681173114,-246.95077627396964,-0.034809054018139635
2023-06-30T15:45:00-04:00,1.09129,1.09129,1.09091,1.09128,1.0917879171543212,1.0912662222222222,1.0912777777777773,1.0913486666666632,1.0914210000000042,1.0887852000000011,1.0877687999999999,1.0889845750000036,1.0912987519324606,1.0913182482891375,-2558,-244053,-242868.2,-0.012452311225425394,-246.9742164227845,0.010997470581777193
2023-06-30T16:00:00-04:00,1.09128,1.09131,1.09092,1.09094,1.0917420004681484,1.0911986666666667,1.0912522222222218,1.0913033333333302,1.0914035000000042,1.0888852000000009,1.08780915,1.0889792250000037,1.0912270015459684,1.0912933986313094,-1662,-245715,-243275.8,-0.014119067896832253,-247.49203036604382,-0.02107829210846637
2023-06-30T16:15:00-04:00,1.09094,1.09099,1.09078,1.0909,1.0916979204494224,1.0911282222222223,1.0911888888888885,1.0912579999999967,1.091379000000004,1.088991000000001,1.08784745,1.0889732750000036,1.0911616012367746,1.0912595189050467,-705,-246420,-244165.8,-0.014891594168147637,-247.51787963364794,-0.05222314859775894
2023-06-30T16:30:00-04:00,1.0909,1.09095,1.09076,1.09086,1.0916556036314455,1.0910624444444443,1.0911311111111108,1.0912228888888857,1.091345500000004,1.089105200000001,1.0878869,1.0889670250000036,1.0911012809894196,1.0912184151240367,-507,-246927,-244922,-0.018168775884963757,-247.5364697885659,-0.04764609943375139
2023-06-30T16:45:00-04:00,1.09086,1.09109,1.09084,1.09097,1.0916149794861878,1.0910302222222223,1.0910911111111108,1.091188222222219,1.091299500000004,1.0892376000000012,1.0879272999999998,1.0889606250000037,1.0910750247915357,1.0911727320992288,746,-246181,-245859.2,-0.01948260484794113,-247.46124473677187,-0.0329872724107205
2023-07-02T17:00:00-04:00,1.09105,1.09115,1.09087,1.0911,1.0915759803067402,1.091032,1.0910888888888883,1.091150444444441,1.091288000000004,1.089378800000001,1.087969,1.0889563750000038,1.0910800198332287,1.0911289856793824,34,-246147,-246278,-0.018143664836715236,-247.45719329631063,-0.001832978957413577
2023-07-02T17:15:00-04:00,1.0911,1.09113,1.09076,1.09082,1.0915385410944707,1.0909782222222222,1.0910411111111105,1.091108222222219,1.091263000000004,1.0895176000000013,1.0880119499999998,1.0889517750000037,1.0910280158665828,1.0910891885435052,-64,-246211,-246377.2,-0.018667706961206697,-247.47361708881363,-0.039404352806428636
2023-07-02T17:30:00-04:00,1.09082,1.09086,1.0907,1.09073,1.091502599450692,1.0909159999999998,1.0909877777777772,1.0910679999999968,1.0912330000000041,1.0896502000000012,1.0880541999999997,1.0889471250000038,1.0909684126932662,1.0910505508348036,-532,-246743,-246441.8,-0.020858797721274077,-247.51751067345634,-0.0439878666801107
2023-07-02T17:45:00-04:00,1.09073,1.09074,1.09069,1.0907,1.0914680954726643,1.0908584444444442,1.0909222222222215,1.0910262222222187,1.091177000000004,1.0897770000000013,1.0880957999999998,1.0889426750000037,1.090914730154613,1.0910132406678423,-49,-246792,-246414.8,-0.022783844547624034,-247.51885839470725,-0.05406445582751518
2023-07-02T18:00:00-04:00,1.0907,1.09125,1.09068,1.0911899999999999,1.0914349716537577,1.0909119999999999,1.0909122222222214,1.090990444444441,1.0911270000000042,1.089907000000001,1.0881415499999998,1.0889404250000039,1.0909697841236903,1.0909921925342734,592,-246200,-246418.6,-0.020951588781214822,-247.25290075282595,-0.008247195953389186
2023-07-02T18:15:00-04:00,1.0911899999999999,1.09135,1.09104,1.09109,1.0914031727876075,1.0909475555555554,1.0909288888888882,1.090958444444441,1.0910980000000041,1.0900376000000012,1.0881865499999999,1.0889399750000037,1.0909938272989521,1.0909749540274176,-420,-246620,-246513.2,-0.017893280112868504,-247.29139084162807,0.013749610427692857
2023-07-02T18:30:00-04:00,1.09109,1.0912,1.09086,1.09098,1.091372645876103,1.0909577777777777,1.0909377777777771,1.0909377777777742,1.0910890000000042,1.0901694000000013,1.0882302,1.088939175000004,1.0909910618391616,1.0909675632219336,-669,-247289,-246728.8,-0.01451581508061671,-247.3588371567807,0.007333394444961042
2023-07-02T18:45:00-04:00,1.09098,1.09099,1.09082,1.09089,1.09135,1.0909482222222222,1.0909411111111105,1.090928444444441,1.0910750000000042,1.0903028000000012,1.08827435,1.0889373250000038,1.0909708494713293,1.090968050577546,-523,-247812,-246942.6,-0.013429251151997985,-247.40198185237557,0.0027501237555666623
2023-07-02T19:00:00-04:00,1.09089,1.09094,1.09079,1.09085,1.0913216000000001,1.09093,1.090927777777777,1.090929555555552,1.0910440000000041,1.090425800000001,1.08831885,1.088934975000004,1.0909466795770635,1.0909744404620363,-302,-248114,-247207,-0.012124465626319428,-247.41305537949557,-0.010999385867613039
2023-07-02T19:15:00-04:00,1.09085,1.09091,1.0908,1.09081,1.091294336,1.0909064444444445,1.0908955555555548,1.0909262222222185,1.0910155000000041,1.0905354000000012,1.08836,1.0889324250000039,1.0909193436616509,1.0909643523696284,-128,-248242,-247615.4,-0.010710689608361542,-247.4177489670649,-0.02657868206396311
2023-07-02T19:30:00-04:00,1.09081,1.09086,1.09067,1.09083,1.09126816256,1.0908933333333333,1.090896666666666,1.0909197777777742,1.0909905000000042,1.0906458000000012,1.0884031,1.0889301250000039,1.0909014749293207,1.090945881895702,260,-247982,-247887.8,-0.010785146439396083,-247.41298186738672,0.0009167415338979404
2023-07-02T19:45:00-04:00,1.09083,1.0910199999999999,1.09063,1.09073,1.0912430360576,1.0908600000000002,1.0908966666666662,1.090911555555552,1.0909710000000044,1.0907586000000011,1.0884447499999998,1.088927475000004,1.0908671799434566,1.090921105516561,-1244,-249226,-248275.2,-0.008991494744024204,-247.52702346873613,0
2023-07-02T20:00:00-04:00,1.09073,1.0909,1.09052,1.09082,1.091206253894144,1.0908446666666667,1.0909099999999994,1.0909053333333298,1.0909495000000045,1.0908686000000012,1.08848745,1.088924425000004,1.0908577439547653,1.090898484413248,1551,-247675,-248247.8,-0.00685719573401742,-247.3990449589309,0.011002108737498668
2023-07-02T20:15:00-04:00,1.09082,1.09095,1.09052,1.09076,1.0911513535826125,1.0908146666666665,1.0908622222222215,1.0908922222222188,1.0909270000000044,1.0909768000000013,1.0885288999999998,1.0889208250000038,1.0908381951638122,1.0908767875305978,-1335,-249010,-248427,-0.004168530865357849,-247.47247595579557,-0.039406519487892165
2023-07-02T20:30:00-04:00,1.09076,1.09077,1.09047,1.09052,1.0911008452960036,1.0907462222222222,1.0907988888888882,1.0908728888888857,1.0908885000000044,1.091046400000001,1.08856655,1.0889162750000039,1.0907745561310498,1.0908478300244777,-1240,-250250,-248828.6,-0.007298422545170427,-247.74531324355826,-0.052241336645002655
2023-07-02T20:45:00-04:00,1.09052,1.09057,1.09003,1.0901399999999999,1.0910377607664032,1.0906144444444443,1.0907055555555547,1.0908346666666633,1.0908315000000044,1.0911064000000013,1.0886003499999999,1.088910125000004,1.09064764490484,1.0907970640195814,-1684,-251934,-249619,-0.010987471139553229,-248.33211586982836,-0.0769949953253198
2023-07-02T21:00:00-04:00,1.0901399999999999,1.0905,1.0901,1.09042,1.090916829474435,1.0905573333333334,1.0906533333333328,1.0907859999999965,1.0908055000000043,1.0911352000000012,1.0886405,1.0889042750000038,1.090602115923872,1.0907440512156643,1339,-250595,-249892.8,-0.01236737161671348,-247.98819674017523,-0.043084087304858465
2023-07-02T21:15:00-04:00,1.09042,1.09071,1.09038,1.09059,1.0908104099375027,1.0905446666666667,1.0906244444444437,1.0907288888888855,1.0907900000000041,1.0911530000000011,1.0886813999999998,1.0888992250000038,1.0905996927390975,1.0906924409725307,1670,-248925,-250142.8,-0.013589910375233171,-247.72783834616192,-0.023834624375500664
2023-07-02T21:30:00-04:00,1.09059,1.09176,1.09059,1.09128,1.09003,1.0906757777777776,1.090676666666666,1.0906917777777743,1.0908110000000042,1.0911692000000013,1.0887250999999998,1.0888966750000038,1.090735754191278,1.090671952778024,2660,-246265,-249593.8,-0.011306548018902324,-246.0448960855505,0.04308724709160811
2023-07-02T21:45:00-04:00,1.09128,1.09145,1.09068,1.0909,1.0900646,1.0907204444444445,1.090684444444444,1.0906688888888856,1.0908075000000041,1.091173800000001,1.0887618499999998,1.0888936250000039,1.0907686033530224,1.0906707622224185,-1805,-248070,-249157.8,-0.010656075490643043,-246.6734240527084,0.006417131908731379
2023-07-02T22:00:00-04:00,1.0909,1.09105,1.09072,1.091,1.090098508,1.0907835555555556,1.0907144444444437,1.0906706666666635,1.0908025000000043,1.0911736000000012,1.0887992499999997,1.0888939250000038,1.090814882682418,1.090704209777934,1766,-246304,-248031.8,-0.00922855964154038,-246.51153937033607,0.02475406379213852
2023-07-02T22:15:00-04:00,1.091,1.09106,1.09066,1.09083,1.0901317378400002,1.0908066666666667,1.090715555555555,1.0906831111111077,1.0908030000000042,1.0911618000000012,1.0888373999999998,1.088895675000004,1.0908179061459344,1.0907473678223467,-1312,-247616,-247436,-0.007133228095349388,-246.7159756673113,0.0009167415338979404
2023-07-02T22:30:00-04:00,1.09083,1.09096,1.09063,1.09091,1.0901643030832002,1.0908455555555554,1.0907322222222213,1.0907046666666633,1.0908120000000043,1.0911292000000012,1.0888821499999997,1.0888983750000039,1.0908363249167476,1.0907946942578766,1541,-246075,-246866,-0.006701017200983473,-246.60296080706718,0.01375187942352988
2023-07-02T22:45:00-04:00,1.09091,1.09096,1.09068,1.09076,1.0901962170215362,1.090851111111111,1.090758888888888,1.0907211111111077,1.090815000000004,1.0910972000000012,1.0889280499999996,1.088898725000004,1.090821059933398,1.0908117554063006,-1167,-247242,-247061.4,-0.006831972759099773,-246.76342317334863,0.0220078494663113
2023-07-02T23:00:00-04:00,1.09076,1.09088,1.09064,1.09085,1.0902274926811055,1.0908693333333332,1.090837777777777,1.0907517777777744,1.0907980000000044,1.0910722000000013,1.0889701999999997,1.0888989250000038,1.0908268479467185,1.0908234043250398,1284,-245958,-246639,-0.004461489098048839,-246.65747869426966,0.06512924945421786
2023-07-02T23:15:00-04:00,1.09085,1.09095,1.09073,1.09074,1.0902581428274833,1.0908497777777777,1.0908733333333325,1.0907835555555523,1.0907805000000041,1.091066600000001,1.0890098499999996,1.0888963250000039,1.0908094783573747,1.090822323460031,-1138,-247096,-246797.4,0.0030034880627568344,-246.77223324347446,0.02934649034317951
2023-07-02T23:30:00-04:00,1.09074,1.09123,1.09069,1.0911899999999999,1.0902881799709336,1.0909131111111112,1.0909399999999991,1.090828444444441,1.0907910000000043,1.091064600000001,1.0890507499999997,1.088897375000004,1.0908855826858999,1.0908358587680242,1259,-245837,-246441.6,0.00962596259660767,-246.25281523368312,0.05501609220696448
2023-07-02T23:45:00-04:00,1.0911899999999999,1.09137,1.09108,1.09127,1.090317616371515,1.0909791111111111,1.090938888888888,1.0908697777777743,1.0908100000000043,1.091062200000001,1.0890968999999995,1.088900525000004,1.0909624661487198,1.0908610870144186,1302,-244535,-246133.6,0.01459373495314153,-246.15735981345372,-0.0009163551059366534
2023-07-03T00:00:00-04:00,1.09127,1.09145,1.09124,1.0914,1.0903464640440845,1.0910713333333333,1.0909944444444433,1.0909168888888856,1.0908375000000043,1.091059600000001,1.0891434999999996,1.088910425000004,1.0910499729189758,1.090906869611534,1053,-243482,-245381.6,0.013467146274940032,-246.0319188135179,0.04583371528095563
2023-07-03T00:15:00-04:00,1.0914,1.09165,1.0913,1.09157,1.090374734763203,1.0911864444444446,1.0910577777777766,1.0909608888888855,1.0908755000000045,1.0910532000000013,1.0891911999999995,1.0889191750000038,1.0911539783351807,1.0909722956892267,761,-242721,-244734.2,0.01646563344704283,-245.91338298797274,0.052245646196146606
2023-07-03T00:30:00-04:00,1.09157,1.09162,1.0914,1.09147,1.0904024400679388,1.0912688888888888,1.091128888888888,1.0910119999999968,1.0909075000000044,1.0910560000000011,1.0892335999999994,1.0889276750000039,1.0912171826681445,1.0910538365513807,-1086,-243807,-244076.4,0.017892546940440002,-246.0128727137805,0.05867092030838664
2023-07-03T00:45:00-04:00,1.09147,1.09183,1.09142,1.09175,1.09042959126658,1.091393111111111,1.0912222222222212,1.091068444444441,1.0909585000000044,1.0910646000000013,1.0892795999999993,1.0889397250000037,1.0913237461345155,1.0911414692411037,1159,-242648,-243438.6,0.02230913273335797,-245.71554892109717,0.0769999358333824
2023-07-03T01:00:00-04:00,1.09175,1.09175,1.09153,1.09161,1.0904856076159168,1.0914706666666667,1.0913166666666656,1.0911439999999968,1.0909980000000044,1.0910702000000012,1.0893228499999994,1.0889510250000038,1.0913809969076125,1.0912251753928823,-1249,-243897,-243311,0.02488348279753655,-245.87571379400765,0.07792731673328848
2023-07-03T01:15:00-04:00,1.09161,1.0917,1.09139,1.09156,1.0905393833112802,1.0915193333333333,1.0913955555555548,1.091224222222219,1.0910380000000044,1.0910650000000013,1.0893657999999995,1.0889617750000038,1.09141679752609,1.091298540314305,-1289,-245186,-243651.8,0.028985418689271937,-245.93475502668218,0.06508685887152114
2023-07-03T01:30:00-04:00,1.09156,1.0917999999999999,1.09142,1.09144,1.090591007978829,1.0915282222222222,1.0914733333333322,1.09130733333333,1.0910840000000044,1.0910500000000014,1.0894103999999993,1.0889729750000037,1.091421438020872,1.0913520322514434,-1637,-246823,-244472.2,0.03142430670156427,-246.1147176489844,0.06417661404183608
2023-07-03T01:45:00-04:00,1.09144,1.09144,1.0903,1.09033,1.09183,1.0912995555555556,1.091377777777777,1.0913571111111078,1.0910935000000044,1.0910232000000013,1.0894437499999996,1.0889781750000038,1.0912031504166977,1.0913492258011541,-1968,-248791,-245469,0.028495972200058447,-248.1161836022204,-0.07881303897578433
2023-07-03T02:00:00-04:00,1.09033,1.09068,1.08929,1.08942,1.0917999999999999,1.090908,1.091172222222221,1.091347111111108,1.0910435000000045,1.0909884000000012,1.0894690499999995,1.0889798750000037,1.0908465203333582,1.0912537806409226,-3443,-252234,-247386.2,0.015415980506012662,-250.98974481763213,-0.16952724806875544
2023-07-03T02:15:00-04:00,1.08942,1.08945,1.08882,1.08927,1.0916995999999999,1.0905275555555556,1.0909355555555544,1.0912708888888856,1.0909775000000044,1.0909504000000012,1.0894895499999995,1.0889808750000036,1.0905312162666865,1.0910838245127372,-3465,-255699,-249746.6,0.0021038719103100277,-251.46683354374358,-0.19516217702033767
2023-07-03T02:30:00-04:00,1.08927,1.08927,1.0888,1.08897,1.0915268239999998,1.0901344444444445,1.0906466666666657,1.0911211111111077,1.0908620000000044,1.090900400000001,1.0895053499999994,1.0889806250000036,1.0902189730133491,1.0908442596101893,-2356,-258055,-252320.4,-0.01309992963284635,-252.11570847833272,-0.2381890304790289
2023-07-03T02:45:00-04:00,1.08897,1.08946,1.08896,1.08901,1.0913086780799999,1.0898071111111112,1.0903733333333323,1.0909011111111078,1.0907675000000046,1.0908530000000012,1.0895257999999994,1.0889830750000038,1.0899771784106793,1.0905554076881507,2511,-255544,-254064.6,-0.026660845838704983,-252.0234745324939,-0.22538411500086186
2023-07-03T03:00:00-04:00,1.08901,1.08907,1.08816,1.08824,1.0911079838336,1.0893804444444444,1.0899833333333324,1.0906222222222188,1.0906295000000044,1.090791200000001,1.0895439999999994,1.0889812750000036,1.0896297427285435,1.09024072615052,-3783,-259327,-256171.8,-0.044665486938646394,-254.69829845513902,-0.32150217540644854
2023-07-03T03:15:00-04:00,1.08824,1.08846,1.08789,1.08803,1.0908131854502399,1.0889897777777777,1.0895855555555545,1.0903048888888855,1.0904895000000046,1.0907294000000012,1.0895655499999992,1.0889775750000037,1.089309794182835,1.0899333809204153,-3739,-263066,-258338.2,-0.06581481200039041,-255.4198212809864,-0.32795595496559365
2023-07-03T03:30:00-04:00,1.08803,1.08835,1.08779,1.08804,1.0904624031962111,1.0886806666666666,1.0891944444444435,1.0899566666666636,1.0903460000000045,1.090665200000001,1.0895818999999993,1.0889741750000037,1.0890558353462678,1.0896383047363316,3648,-259418,-259082,-0.0863793643324379,-255.38629279372097,-0.3224742570266581
2023-07-03T03:45:00-04:00,1.08804,1.08804,1.08701,1.0875,1.0900882667487415,1.088341777777778,1.0887566666666655,1.0895786666666634,1.0901830000000046,1.090591000000001,1.0895928999999993,1.0889646250000036,1.0887446682770143,1.0893434437890646,-3301,-262719,-260014.8,-0.10873828644676127,-257.024596532554,-0.360990984387603
2023-07-03T04:00:00-04:00,1.0875,1.08846,1.08729,1.08842,1.0895957440689428,1.0882744444444443,1.0885444444444432,1.0892128888888855,1.0900615000000047,1.090533600000001,1.0896141999999993,1.0889587250000037,1.0886797346216115,1.0890839550312512,3295,-259424,-260790.8,-0.1262314302585251,-254.23710227968036,-0.17517632276467476
2023-07-03T04:15:00-04:00,1.08842,1.08881,1.08819,1.0887499999999999,1.0891820250179118,1.0883155555555555,1.0884699999999987,1.088910222222219,1.0899620000000048,1.090483000000001,1.0896340999999992,1.0889563750000035,1.088693787697289,1.0888967640250002,2450,-256974,-260320.2,-0.13156411670053078,-253.49428241234986,-0.06150061500616571
2023-07-03T04:30:00-04:00,1.0887499999999999,1.08891,1.08838,1.08867,1.08701,1.0883555555555555,1.088403333333332,1.0886737777777744,1.0898360000000047,1.0904376000000011,1.0896613999999993,1.0889522250000037,1.0886890301578314,1.0887726112199996,-2536,-259510,-259609,-0.1294133016073679,-253.680624547826,-0.055082761849673076
2023-07-03T04:45:00-04:00,1.08867,1.0889,1.08836,1.08862,1.087048,1.0883988888888887,1.0883644444444431,1.0885077777777743,1.0897035000000046,1.0903920000000011,1.0896914999999994,1.0889467250000038,1.0886752241262652,1.088696488975999,-2352,-261862,-260097.8,-0.12416245509104228,-253.7886462623954,-0.03214046300633373
2023-07-03T05:00:00-04:00,1.08862,1.08913,1.0886,1.08887,1.08708524,1.0885,1.0883488888888875,1.0884262222222187,1.0895770000000045,1.090352200000001,1.089728699999999,1.0889362750000036,1.0887141793010122,1.0886903911807984,2706,-259156,-259385.2,-0.1146050288989264,-253.1672172972834,-0.012855712987027574
2023-07-03T05:15:00-04:00,1.08887,1.08906,1.08877,1.08881,1.0871670303999998,1.0885922222222222,1.0884122222222208,1.0883997777777743,1.0894390000000045,1.0903090000000009,1.0897732999999992,1.0889221750000038,1.0887333434408097,1.0887011129446382,-1840,-260996,-259699.6,-0.10513388125585389,-253.26860681118305,0.052378151878258415
2023-07-03T05:30:00-04:00,1.08881,1.08886,1.08779,1.08782,1.0872455491839998,1.0884737777777778,1.0883888888888873,1.0883835555555519,1.0892565000000045,1.090243400000001,1.0898110999999993,1.0889026000000037,1.0885506747526479,1.08867249035571,-2235,-263231,-260951,-0.09261428708779812,-255.30077955022853,-0.019300938393246828
2023-07-03T05:45:00-04:00,1.08782,1.08918,1.08759,1.089,1.0873209272166398,1.0885960000000001,1.0884955555555542,1.0884019999999963,1.0891190000000044,1.0902070000000008,1.0898622999999992,1.0888892250000035,1.0886405398021184,1.0886627922845673,2700,-260531,-261155.2,-0.07292080616804258,-252.371986183679,0.08823205029227528
2023-07-03T06:00:00-04:00,1.089,1.08927,1.08813,1.08862,1.0874324715836414,1.0886208888888889,1.0886199999999986,1.0884531111111075,1.0889695000000044,1.090164800000001,1.0899074999999991,1.0888735750000038,1.0886364318416948,1.0886550338276533,-2402,-262933,-261369.4,-0.053919811114205046,-253.21014963638802,0.10298850574712735
2023-07-03T06:15:00-04:00,1.08862,1.08883,1.08844,1.08855,1.0875794738569502,1.0886068888888887,1.0886344444444431,1.0885102222222185,1.0888190000000044,1.090121800000001,1.0899493999999992,1.0888594750000038,1.0886191454733558,1.088636027062122,-1785,-264718,-262481.8,-0.03090352694613793,-253.32492797961157,0.011943918707848394
2023-07-03T06:30:00-04:00,1.08855,1.08961,1.08855,1.08956,1.0877147159483942,1.088792,1.088724444444443,1.088572666666663,1.0887250000000044,1.090089200000001,1.0899980999999994,1.0888476500000037,1.0888073163786847,1.0886508216496968,2054,-262664,-262815.4,-0.011689875858667187,-251.41914505737523,0.07439724454651661
2023-07-03T06:45:00-04:00,1.08956,1.08956,1.089,1.0892,1.0879042443535547,1.088887111111111,1.088783333333332,1.0886515555555518,1.0886685000000045,1.090051400000001,1.0900444999999994,1.0888365000000038,1.0888858531029477,1.088717857319757,-2246,-264910,-263151.2,0.002239357584643893,-252.16124278489855,0.04868325571568238
2023-07-03T07:00:00-04:00,1.0892,1.09036,1.08871,1.09032,1.0880748199181993,1.0891944444444446,1.088972222222221,1.0887468888888854,1.0887135000000046,1.090038200000001,1.0901037999999992,1.0888308750000038,1.0891726824823582,1.0888242858558048,2972,-261938,-263432.6,0.017438130065944496,-249.10520165379313,0.15616101118848036
2023-07-03T07:15:00-04:00,1.09032,1.09047,1.08948,1.08949,1.0883490415280155,1.089298,1.0890411111111098,1.0888311111111078,1.0887245000000045,1.090010200000001,1.0901564999999993,1.0888207750000038,1.0892361459858866,1.0889442286846431,-2230,-264168,-263679.6,0.025122726970860428,-250.80277667763912,0.05693976324079687
2023-07-03T07:30:00-04:00,1.08949,1.08986,1.0893,1.08973,1.0886459757140934,1.0894357777777777,1.0891433333333318,1.0889328888888854,1.0887625000000045,1.089987800000001,1.0902067999999994,1.088811550000004,1.0893349167887092,1.0890873829477137,2674,-261494,-263034.8,0.031009148792624848,-250.2137304266409,0.08449591756137727
2023-07-03T07:45:00-04:00,1.08973,1.0899699999999999,1.08923,1.08987,1.0889013391141202,1.0895811111111111,1.0893711111111097,1.089062222222219,1.0888055000000043,1.0899690000000009,1.0902521999999992,1.0888025500000038,1.0894419334309673,1.0892143063581703,2545,-258949,-262291.8,0.03680715430349477,-249.88676870217748,0.18845029508557345
2023-07-03T08:00:00-04:00,1.08987,1.09019,1.08955,1.08968,1.0891209516381435,1.089642888888889,1.0894466666666651,1.0891948888888856,1.0888775000000044,1.089946000000001,1.0902958999999992,1.088790225000004,1.0894895467447738,1.0893350450865356,-2950,-261899,-261689.6,0.050958221868010065,-250.40105022199154,0.06244260789715463
2023-07-03T08:15:00-04:00,1.08968,1.09033,1.08937,1.09002,1.08923,1.0897575555555556,1.0896022222222208,1.0893208888888855,1.0889770000000045,1.089931800000001,1.0903451999999993,1.0887787250000038,1.089595637395819,1.0894196360692276,2830,-259069,-261115.8,0.05253728314848742,-249.51803869567186,0.1286031856846345
2023-07-03T08:30:00-04:00,1.09002,1.09068,1.08976,1.09051,1.08937,1.0899391111111112,1.0898199999999987,1.089476666666663,1.0891005000000045,1.089925600000001,1.0903970999999992,1.088770225000004,1.0897785099166553,1.0895281088553816,2470,-256599,-259602,0.05904228456027947,-248.40769209652666,0.18005603784853097
2023-07-03T08:45:00-04:00,1.09051,1.0910199999999999,1.09051,1.09087,1.08937,1.0901491111111112,1.089965555555554,1.0896411111111077,1.0892690000000045,1.089927800000001,1.0904522999999993,1.088760700000004,1.0899968079333242,1.0896604870843043,2971,-253628,-258028.8,0.06796258276210013,-247.42690329128897,0.12023202026505399
2023-07-03T09:00:00-04:00,1.09087,1.09112,1.09042,1.0907499999999999,1.089667,1.090306,1.0901377777777763,1.089794444444441,1.0893855000000046,1.089932400000001,1.0904893999999994,1.088749500000004,1.0901474463466594,1.089801589667443,-3159,-256787,-257596.4,0.06467002941526732,-247.7744057434605,0.14230627983840805
2023-07-03T09:15:00-04:00,1.0907499999999999,1.09148,1.0907,1.09133,1.0899576,1.0905444444444445,1.0902499999999986,1.0899551111111077,1.0895145000000046,1.089956200000001,1.0905312999999994,1.0887392250000039,1.0903839570773275,1.0899804717339534,2713,-254074,-256031.4,0.07149338433812245,-246.33178369441163,0.09263335534521566
2023-07-03T09:30:00-04:00,1.09133,1.09168,1.09071,1.09118,1.09026208,1.0907304444444443,1.0904377777777765,1.0901222222222189,1.0896400000000044,1.089971400000001,1.0905532999999994,1.088727525000004,1.090543165661862,1.0901699773871623,-5572,-259646,-256146.8,0.06875869426254,-247.09763820221337,0.15511844991693077
2023-07-03T09:45:00-04:00,1.09118,1.09205,1.09106,1.09133,1.090545664,1.090908888888889,1.0906155555555541,1.0902813333333299,1.0897755000000044,1.089986200000001,1.0905695999999994,1.088714775000004,1.0907005325294896,1.090354381909729,5272,-254374,-255701.8,0.07401198996892275,-246.37291817435425,0.1468253604103607
2023-07-03T10:00:00-04:00,1.09133,1.09339,1.09133,1.09173,1.09071,1.0911317777777778,1.0908222222222208,1.0904526666666632,1.0899185000000045,1.0899952000000008,1.0905821999999994,1.088705125000004,1.0909064260235917,1.0905363055277824,11046,-243328,-253641.8,0.07876441196087887,-242.32428027380908,0.17066255608468855
2023-07-03T10:15:00-04:00,1.09173,1.09177,1.09085,1.09095,1.09339,1.0911573333333333,1.090963333333332,1.0906177777777741,1.0900255000000045,1.089996200000001,1.0905849999999992,1.088692425000004,1.0909151408188733,1.0906898444222253,-5713,-249041,-252092.6,0.0795785982286878,-246.40600377687304,0.11654797738786657
2023-07-03T10:30:00-04:00,1.09095,1.09107,1.09057,1.09098,1.09339,1.091160666666667,1.0910699999999987,1.0907817777777742,1.0901835000000044,1.089995800000001,1.0905846999999993,1.088694700000004,1.0909281126550987,1.0907986755377794,4751,-244290,-250135.8,0.08201737851088921,-246.27535617615817,0.08807177849948367
2023-07-03T10:45:00-04:00,1.09098,1.09109,1.09025,1.09067,1.0932772000000002,1.0910806666666666,1.0910877777777763,1.0909117777777744,1.0902670000000045,1.0899926000000009,1.0905771999999991,1.0887074750000039,1.090876490124079,1.090865340430223,-4720,-249010,-248008.6,0.075520849258291,-247.61653566615811,0.014672034185833963
2023-07-03T11:00:00-04:00,1.09067,1.09099,1.09016,1.09098,1.093095568,1.0910591111111112,1.0910999999999984,1.0910086666666632,1.0903850000000046,1.089994000000001,1.0905615999999994,1.088726250000004,1.0908971920992632,1.0909046723441775,4387,-244623,-246058.4,0.07117737697621733,-246.3696232178464,0.010083694665730518
2023-07-03T11:15:00-04:00,1.09098,1.09141,1.09092,1.0914,1.09286072256,1.0911191111111112,1.0911722222222207,1.0910786666666632,1.0905275000000048,1.090006800000001,1.0905519999999995,1.0887475750000037,1.0909977536794104,1.0909229378753413,2945,-241678,-245728.4,0.06388897380280091,-245.23587191168167,0.059592023836813154
2023-07-03T11:30:00-04:00,1.0914,1.0919,1.0904099999999999,1.09184,1.0926446647552,1.0912526666666669,1.0912288888888875,1.0911317777777743,1.0906415000000047,1.090026600000001,1.0905493999999993,1.0887759500000038,1.0911662029435283,1.0909731503002724,3196,-238482,-243616.6,0.05950907307089705,-243.94739839143247,0.04673196924853257
2023-07-03T11:45:00-04:00,1.09184,1.09229,1.09177,1.09181,1.092445891574784,1.0913688888888888,1.0912988888888873,1.091177555555552,1.0907720000000047,1.0900480000000008,1.0905572999999995,1.0888005250000037,1.0912949623548227,1.091046520240217,-2482,-240964,-242951.4,0.05408074521179149,-244.01559519682513,0.05773566231051783
2023-07-03T12:00:00-04:00,1.09181,1.09212,1.09152,1.09191,1.09229,1.0914911111111112,1.0913633333333317,1.0912326666666632,1.0908515000000047,1.090062400000001,1.0905634999999994,1.0888184250000037,1.0914179698838582,1.091154816192173,2097,-238867,-240922.8,0.048936258450136876,-243.82352881164823,0.05314616110617549
2023-07-03T12:15:00-04:00,1.09191,1.09194,1.0913599999999999,1.09167,1.09229,1.0915524444444444,1.091356666666665,1.0912839999999964,1.0909605000000049,1.090070400000001,1.0905662999999992,1.0888310500000038,1.0914683759070865,1.0912690529537377,-2031,-240898,-240177.8,0.046157136808620575,-244.26993923008934,-0.005495864362083209
2023-07-03T12:30:00-04:00,1.09167,1.092,1.09141,1.09162,1.09212,1.0916051111111111,1.0914311111111092,1.0913357777777741,1.0910550000000048,1.090074800000001,1.0905671999999993,1.0888477000000039,1.0914987007256691,1.0913692423629893,-2162,-243060,-240454.2,0.03584767553195954,-244.36896182849338,0.06141436362802588
2023-07-03T12:45:00-04:00,1.09162,1.09195,1.09151,1.09158,1.092,1.091634888888889,1.091497777777776,1.091389555555552,1.0911405000000047,1.090075000000001,1.0905640999999993,1.0888608000000037,1.0915149605805352,1.0914389938903908,-1344,-244404,-241638.6,0.03354474465700416,-244.4182097352742,0.05499642523235384
2023-07-03T13:00:00-04:00,1.09158,1.0916299999999999,1.09113,1.09134,1.092,1.0916033333333333,1.0915722222222206,1.0914442222222187,1.0912235000000048,1.090072400000001,1.0905641999999993,1.0888747500000038,1.091479968464428,1.0914759951123119,-1241,-245645,-242574.8,0.030426614123040045,-244.69106193117372,0.061430130103509624
2023-07-03T13:15:00-04:00,1.09134,1.09156,1.09127,1.09145,1.09195,1.0915788888888889,1.0916244444444427,1.0914964444444408,1.0912950000000048,1.090066400000001,1.0905654999999994,1.0888883000000038,1.0914739747715425,1.0914871960898487,622,-245023,-243806,0.029848245237695522,-244.62836836180026,0.04308053309867921
2023-07-03T13:30:00-04:00,1.09145,1.09146,1.0912,1.09123,1.0918068,1.0915,1.091605555555554,1.0915462222222188,1.091331000000005,1.090058800000001,1.0905644999999995,1.0889036000000036,1.091425179817234,1.0914785568718783,-597,-245620,-244750.4,0.02685763880590758,-244.74870369553068,-0.015576323987539262
2023-07-03T13:45:00-04:00,1.09123,1.09128,1.09083,1.09083,1.0916750560000001,1.0913448888888888,1.0914933333333317,1.091558666666663,1.0913290000000049,1.090044200000001,1.0905545999999995,1.0889175750000037,1.0913061438537872,1.0914400454975017,-583,-246203,-245379,0.020237853688265528,-244.96240749766218,-0.0925043962485305
2023-07-03T14:00:00-04:00,1.09083,1.09126,1.09083,1.0912,1.09155385152,1.0912862222222222,1.0914255555555537,1.0915442222222187,1.091351500000005,1.090039400000001,1.0905446999999995,1.0889338000000037,1.0912849150830297,1.0913940363980008,563,-245640,-245626.2,0.012933189864294158,-244.77144281938968,-0.055870526923182555
2023-07-03T14:15:00-04:00,1.0912,1.09126,1.0911,1.09122,1.0914423433984,1.091245111111111,1.091348888888887,1.091499555555552,1.0913460000000048,1.090057200000001,1.0905401999999995,1.0889504000000036,1.0912719320664237,1.0913524291183996,470,-245170,-245531.2,0.005475985295934431,-244.76282844988816,-0.06319202132042544
2023-07-03T14:30:00-04:00,1.09122,1.09122,1.09098,1.09103,1.0913397559265279,1.0911813333333333,1.091277777777776,1.0914302222222187,1.0913385000000049,1.090089400000001,1.0905388999999994,1.0889675500000038,1.091223545653139,1.091302343294719,-515,-245685,-245663.6,-0.0012784738596415544,-244.85249872719254,-0.05862577518847032
2023-07-03T14:45:00-04:00,1.09103,1.0911899999999999,1.09097,1.09118,1.09126,1.0911617777777778,1.0912288888888872,1.0913548888888853,1.091331000000005,1.090127600000001,1.0905389999999995,1.0889880500000038,1.0912148365225112,1.0912602746357745,765,-244920,-245523.6,-0.005768404241718835,-244.74732288418173,-0.04030706656162364
2023-07-03T15:00:00-04:00,1.09118,1.09118,1.091,1.09114,1.09016,1.091144,1.0911799999999983,1.0912922222222186,1.0913015000000048,1.0901710000000011,1.0905356999999996,1.0890080000000035,1.091199869218009,1.0912390197086188,-840,-245760,-245435,-0.0093377363229133,-244.77811523741403,-0.04030854357903186
2023-07-03T15:15:00-04:00,1.09114,1.09117,1.0910199999999999,1.09103,1.0901804,1.0911140000000001,1.0911455555555538,1.0912362222222187,1.091305500000005,1.090211400000001,1.0905321999999993,1.0890261750000036,1.0911658953744072,1.0912152157668944,-273,-246033,-245513.6,-0.011323442011810198,-244.80563691199293,-0.028405446515296102
2023-07-03T15:30:00-04:00,1.09103,1.09115,1.09103,1.09114,1.0902003919999999,1.0911128888888888,1.0911111111111094,1.0911886666666633,1.091313500000005,1.090269400000001,1.0905302999999993,1.0890455000000037,1.0911607162995258,1.091192972613515,183,-245850,-245649.6,-0.013985098560765703,-244.78718645691836,-0.028402583718909018
2023-07-03T15:45:00-04:00,1.09114,1.09115,1.09091,1.09094,1.0902199841599998,1.0910786666666668,1.0910788888888872,1.0911488888888854,1.0913270000000048,1.090327600000001,1.0905284999999996,1.0890639750000037,1.0911165730396206,1.0911715780908113,-353,-246203,-245753.2,-0.018483925398946766,-244.85188942812277,-0.02657551570245516
2023-07-03T16:00:00-04:00,1.09094,1.09122,1.0909,1.09116,1.0902391844767998,1.0910948888888887,1.0911155555555538,1.0911262222222189,1.091336000000005,1.090390000000001,1.0905275999999995,1.0890843500000036,1.0911252584316964,1.0911536624726483,397,-245806,-245930.4,-0.02126304122979361,-244.77183002980576,0.030252193284007724
2023-07-03T16:15:00-04:00,1.09116,1.09121,1.09108,1.0911899999999999,1.0902784170977278,1.0911097777777776,1.0911144444444427,1.0911131111111079,1.0913255000000048,1.090463800000001,1.0905273999999994,1.0891043250000036,1.091138206745357,1.091141329978118,256,-245550,-245888.4,-0.01888043019592117,-244.76479164863343,-0.000916422287396033
2023-07-03T16:30:00-04:00,1.0911899999999999,1.09139,1.09116,1.09137,1.0903160804138186,1.0911608888888888,1.0911311111111095,1.091110222222219,1.0913020000000049,1.090522800000001,1.0905281999999994,1.0891256500000037,1.0911845653962855,1.0911450639824938,178,-245372,-245756.2,-0.017191817043818596,-244.7354292094615,0.013746082366513852
2023-07-03T16:45:00-04:00,1.09137,1.09142,1.09091,1.09091,1.0903805155889894,1.0911166666666667,1.091117777777776,1.0911115555555522,1.091257000000005,1.0905660000000008,1.0905244999999995,1.0891466500000038,1.0911296523170284,1.091138851185994,-365,-245737,-245733.6,-0.015975075216900735,-244.88927254398595,-0.010998780968433312
2023-07-03T17:00:00-04:00,1.09091,1.09103,1.09091,1.09103,1.0904636743418703,1.091099111111111,1.0911011111111093,1.0911159999999966,1.091213000000005,1.0906132000000008,1.0905253999999993,1.0891672750000039,1.0911097218536228,1.0911374809487946,42,-245695,-245632,-0.012571908830817234,-244.88465254783594,-0.013746586264419665
2023-07-03T17:15:00-04:00,1.09103,1.09122,1.09093,1.09122,1.0905401803945207,1.0911228888888889,1.0911099999999982,1.0911148888888857,1.091190500000005,1.090665200000001,1.0905285999999996,1.089188025000004,1.0911317774828981,1.091138784759035,115,-245580,-245586.8,-0.009194657933903854,-244.86462560082256,0.007331781439602618
2023-07-03T17:30:00-04:00,1.09122,1.09132,1.0911899999999999,1.09129,1.090610565962959,1.091158888888889,1.0911388888888873,1.0911197777777744,1.091174000000005,1.090713600000001,1.0905328999999993,1.089209900000004,1.0911634219863184,1.0911438278072272,75,-245505,-245577.8,-0.006161875793296108,-244.85981447199427,0.023830692098306096
2023-07-03T17:45:00-04:00,1.09129,1.09143,1.09095,1.09095,1.0906753206859223,1.0911211111111112,1.091117777777776,1.0911171111111078,1.091142500000005,1.090756400000001,1.0905326999999994,1.089230000000004,1.0911207375890548,1.0911310622457808,-133,-245638,-245631,-0.003971296689064662,-244.90125167017257,-0.01741298091903078
2023-07-03T18:00:00-04:00,1.09095,1.09147,1.09091,1.09143,1.09075078861733,1.0911835555555554,1.0911722222222204,1.0911279999999968,1.091147000000005,1.090828600000001,1.0905359999999993,1.089252500000004,1.0911825900712437,1.091141649796624,353,-245285,-245540.6,-0.0006589777200354165,-244.7459374944542,0.044915394063823805
2023-07-03T18:15:00-04:00,1.09143,1.09153,1.09135,1.09135,1.0908370939832503,1.091219111111111,1.0911933333333317,1.0911464444444412,1.091142000000005,1.090875600000001,1.0905412999999995,1.0892766250000039,1.091216072056995,1.0911629198372983,-316,-245601,-245521.8,0.0030548622719411404,-244.76909976780198,0.017412661754475468
2023-07-03T18:30:00-04:00,1.09135,1.0913599999999999,1.09127,1.09129,1.09091,1.0912384444444445,1.0912044444444426,1.0911653333333302,1.091145000000005,1.090929000000001,1.0905468999999994,1.0893005500000037,1.091230857645596,1.091182735869838,-198,-245799,-245565.6,0.004944547316846649,-244.77998536820513,0.009164306857670163
2023-07-03T18:45:00-04:00,1.09129,1.09144,1.09121,1.09125,1.0909968,1.0912475555555556,1.0911911111111094,1.0911757777777746,1.0911660000000052,1.090983000000001,1.0905523999999993,1.0893241000000038,1.0912346861164768,1.0911969886958697,-333,-246132,-245691,0.0054071392571776716,-244.79219110636822,-0.010995354462730145
2023-07-03T19:00:00-04:00,1.09125,1.09149,1.09121,1.09143,1.091071448,1.0912953333333333,1.0912488888888872,1.091201999999997,1.091177500000005,1.091020400000001,1.0905547999999994,1.0893481750000038,1.0912737488931814,1.0912275909566946,427,-245705,-245704.4,0.0033384610353430506,-244.72175811667756,0.047666626944464156
2023-07-03T19:15:00-04:00,1.09143,1.09148,1.09132,1.09135,1.09113564528,1.0913155555555556,1.091284444444443,1.0912244444444414,1.091184000000005,1.091063400000001,1.0905573999999996,1.0893719750000037,1.0912889991145451,1.091248872765355,-205,-245910,-245829.4,0.006716154118475523,-244.73678427502026,0.029330082582522753
2023-07-03T19:30:00-04:00,1.09135,1.09143,1.09125,1.09131,1.0911908549408,1.0913206666666668,1.091294444444443,1.0912446666666638,1.091198000000005,1.0910832000000008,1.0905606999999995,1.0893954500000036,1.0912931992916362,1.0912642982122833,-183,-246093,-245927.8,0.008889377652329531,-244.74349156415758,0.00824764941990831
2023-07-03T19:45:00-04:00,1.09131,1.09132,1.0912,1.09127,1.09153,1.0913157777777778,1.0912922222222208,1.0912622222222192,1.091202500000005,1.091118800000001,1.0905644999999995,1.0894194250000035,1.0912885594333088,1.091275838569826,-583,-246676,-246103.2,0.008300156708419076,-244.76486037778525,-0.0018326934178935959
2023-07-03T20:00:00-04:00,1.09127,1.09137,1.09099,1.09115,1.0915233999999998,1.0912873333333333,1.091314444444443,1.091286888888886,1.0912030000000048,1.0911472000000009,1.0905674999999997,1.0894431750000038,1.091260847546647,1.09128107085586,-1063,-247739,-246424.6,0.007148093842071611,-244.88175170623734,0.018332645859111596
2023-07-03T20:15:00-04:00,1.09115,1.09118,1.09095,1.09107,1.0915020639999997,1.0912384444444443,1.0912744444444429,1.091291999999997,1.0912050000000049,1.091171200000001,1.0905700999999997,1.0894650500000038,1.0912226780373175,1.0912708566846872,-723,-248462,-246976,0.008553300810827212,-244.93476000023912,-0.03298425002060746
2023-07-03T20:30:00-04:00,1.09107,1.09128,1.09095,1.09122,1.0914689401599997,1.0912275555555555,1.0912599999999986,1.0912871111111082,1.091209000000005,1.0912020000000011,1.0905739999999995,1.0894885500000036,1.091222142429854,1.0912574853477488,941,-247521,-247298.2,0.005799613534039711,-244.80539158208072,-0.01191185229302822
2023-07-03T20:45:00-04:00,1.09122,1.0913,1.09085,1.09097,1.0914378037503998,1.0911695555555556,1.091224444444443,1.0912731111111083,1.0912105000000047,1.091221000000001,1.0905763999999996,1.0895105750000038,1.0911717139438832,1.0912331882781983,-1211,-248732,-247826,0.00305911154887773,-245.08283334451184,-0.029323094686114413
2023-07-03T21:00:00-04:00,1.09097,1.09114,1.09087,1.09114,1.0913907794503679,1.0911526666666667,1.0912122222222207,1.091257111111108,1.0912095000000046,1.091233600000001,1.0905795999999996,1.0895335250000038,1.0911653711551066,1.091208550622558,715,-248017,-248094.2,0.0008116829989211518,-244.97141873182773,-0.010080183276064558
2023-07-03T21:15:00-04:00,1.09114,1.0916299999999999,1.09112,1.09141,1.09085,1.0911922222222223,1.0912099999999985,1.0912362222222192,1.0912205000000048,1.091244400000001,1.0905860999999997,1.0895575000000037,1.0912142969240852,1.0911992404980455,1133,-246884,-247923.2,0.0011869643390964146,-244.6910605743044,-0.0018324583344702804
2023-07-03T21:30:00-04:00,1.09141,1.09141,1.09093,1.09101,1.0908656,1.0911522222222223,1.0911722222222207,1.0912157777777751,1.0912025000000047,1.091249600000001,1.0905909999999996,1.0895787750000039,1.091173437539268,1.0911893923984355,-1247,-248131,-247857,-0.0018764657156806598,-245.14808405768824,-0.03115407522792935
2023-07-03T21:45:00-04:00,1.09101,1.09111,1.09083,1.09107,1.0916299999999999,1.0911317777777778,1.091145555555554,1.091192888888886,1.0912105000000047,1.091244400000001,1.0906002999999995,1.0896003250000037,1.0911527500314144,1.0911755139187478,1345,-246786,-247710,-0.0031333023781292806,-245.0741158997429,-0.021991917970147618
2023-07-03T22:00:00-04:00,1.09107,1.09113,1.09056,1.0906,1.0916139999999999,1.091022666666667,1.0910711111111098,1.0911622222222195,1.0911890000000048,1.091232800000001,1.0906020999999995,1.0896213000000037,1.0910422000251316,1.0911496111349974,-924,-247710,-247505.6,-0.008287216869394607,-245.47214719012754,-0.061396354705980045
2023-07-03T22:15:00-04:00,1.0906,1.09069,1.09035,1.09036,1.0915718399999998,1.0908804444444444,1.0909833333333319,1.0911164444444417,1.0911460000000048,1.0912134000000009,1.0905997999999995,1.0896406000000036,1.0909057600201053,1.0910976889079973,-775,-248485,-247599.2,-0.013703329035736556,-245.64269551215213,-0.07240067818357407
2023-07-03T22:30:00-04:00,1.09036,1.09037,1.09022,1.09028,1.0914985296,1.0907397777777776,1.0908955555555542,1.0910535555555527,1.0910955000000047,1.0911844000000008,1.0905897999999996,1.0896574500000036,1.0907806080160842,1.091010951126397,-776,-249261,-248074.6,-0.017575022257534535,-245.69963083626533,-0.07240598678362235
2023-07-03T22:45:00-04:00,1.09028,1.09057,1.09025,1.09057,1.091396247232,1.0906746666666667,1.090823333333332,1.0909837777777749,1.0910765000000047,1.0911768000000008,1.0905864999999997,1.0896741750000039,1.0907384864128673,1.090923960901117,782,-248479,-248144.2,-0.01901583765662893,-245.49162922200102,-0.059566356921614286
2023-07-03T23:00:00-04:00,1.09057,1.09057,1.0904,1.09042,1.0913021474534401,1.090594,1.0907622222222206,1.0909071111111082,1.0910260000000047,1.0911656000000007,1.0905806999999996,1.0896899750000038,1.090674789130294,1.0908283687208928,-824,-249303,-248647.6,-0.024035492395449186,-245.6049644503679,-0.050413851893273916
2023-07-03T23:15:00-04:00,1.09042,1.09063,1.0904099999999999,1.09055,1.0912155756571649,1.0905515555555556,1.0906966666666653,1.0908322222222193,1.090986000000005,1.0911632000000009,1.0905778999999998,1.0897076500000038,1.0906498313042352,1.0907498949767136,744,-248559,-248817.4,-0.02404514498845926,-245.5162646833057,-0.05407188811702352
2023-07-03T23:30:00-04:00,1.09055,1.09092,1.09052,1.0907,1.0911359296045917,1.0905522222222221,1.0906177777777764,1.0907591111111081,1.0909565000000048,1.091157600000001,1.0905757999999997,1.0897289750000037,1.090659865043388,1.0907007159813702,809,-247750,-248670.4,-0.02524178954341467,-245.4049905555719,-0.06505346295159367
2023-07-03T23:45:00-04:00,1.0907,1.09076,1.09044,1.09045,1.0910626552362244,1.0905186666666666,1.090555555555554,1.0906911111111082,1.0909165000000047,1.091138600000001,1.0905726999999996,1.089750375000004,1.0906178920347105,1.0906681727850953,-511,-248261,-248470.4,-0.030375938799024508,-245.52211717150666,-0.05132858543919084
2023-07-04T00:00:00-04:00,1.09045,1.09052,1.09032,1.09037,1.0909952428173264,1.0904815555555556,1.090477777777776,1.0906219999999969,1.0908635000000046,1.091109200000001,1.0905678999999997,1.089769050000004,1.0905683136277684,1.0906341382280758,-911,-249172,-248609,-0.032402537027012186,-245.58895196448194,-0.06415720347914643
2023-07-04T00:15:00-04:00,1.09037,1.09054,1.09035,1.09045,1.0909332233919402,1.090476,1.0904611111111095,1.0905617777777745,1.0908185000000046,1.091082000000001,1.0905649999999996,1.0897874250000037,1.0905446509022148,1.0906081105824599,805,-248367,-248421.8,-0.03380956288934405,-245.52988944442004,-0.01375389693747428
2023-07-04T00:30:00-04:00,1.09045,1.09045,1.09021,1.09042,1.090876165520585,1.0904677777777778,1.090467777777776,1.0905159999999967,1.0907740000000046,1.091052200000001,1.0905572999999997,1.0898040250000038,1.0905197207217718,1.0905820884659672,-2507,-250874,-248884.8,-0.031401169696459556,-245.59886096993696,0.005502769727424794
2023-07-04T00:45:00-04:00,1.09042,1.09043,1.09004,1.09006,1.0908095489685266,1.0903862222222223,1.0904433333333319,1.090481111111108,1.0907135000000046,1.091020000000001,1.0905451999999998,1.0898210500000038,1.0904277765774175,1.0905356707727731,-1217,-252091,-249753,-0.028696114564038058,-246.0006511058478,-0.020178302821283245
2023-07-04T01:00:00-04:00,1.09006,1.09011,1.08978,1.08986,1.0907172030923034,1.0902695555555557,1.0903644444444427,1.0904428888888855,1.0906490000000046,1.0909848000000009,1.0905297999999997,1.0898366500000038,1.0903142212619341,1.0904749366182178,-1191,-253282,-250757.2,-0.026392620020556846,-246.21917118731116,-0.06510356969291181
2023-07-04T01:15:00-04:00,1.08986,1.08986,1.0894,1.0894,1.0905859946593808,1.0900766666666668,1.0902511111111095,1.0903975555555523,1.0905655000000047,1.090941200000001,1.0905080999999996,1.0898496500000039,1.0901313770095473,1.0903875492945736,-1309,-254591,-251841,-0.029481652124867665,-246.77166416806114,-0.09354193796885796
2023-07-04T01:30:00-04:00,1.0894,1.08977,1.0894,1.08977,1.0903962355138799,1.0899804444444443,1.0901644444444427,1.0903382222222189,1.0904930000000046,1.090909800000001,1.0904910999999995,1.0898623500000038,1.0900591016076377,1.0902904394356585,923,-253668,-252901.2,-0.029767155085738455,-246.45817968118763,-0.07152354316629252
2023-07-04T01:45:00-04:00,1.08977,1.08994,1.08947,1.08952,1.0902368378316591,1.0898515555555557,1.0900333333333316,1.09025133333333,1.0904205000000047,1.090871200000001,1.0904687999999993,1.089874200000004,1.0899512812861103,1.0901767515485261,-1242,-254910,-253708.4,-0.03179125373661848,-246.74310218777143,-0.10818740258549178
2023-07-04T02:00:00-04:00,1.08952,1.09021,1.08951,1.09008,1.0894,1.089860888888889,1.0899922222222207,1.0901611111111076,1.0903675000000048,1.0908482000000008,1.0904534999999995,1.0898881750000038,1.0899770250288883,1.0900866012388204,1899,-253011,-253892.4,-0.03359173465110626,-245.76703933440498,-0.03393094593974794
2023-07-04T02:15:00-04:00,1.09008,1.09073,1.09,1.09072,1.0894161999999998,1.0900064444444446,1.0900311111111096,1.090094444444441,1.0903330000000049,1.0908460000000009,1.0904450999999995,1.0899054500000038,1.0901256200231106,1.0900488809910556,1705,-251306,-253497.2,-0.029281943849011578,-244.76601188687823,0.03209919568585438
2023-07-04T02:30:00-04:00,1.09072,1.09128,1.09072,1.09111,1.089468752,1.0902222222222222,1.0901044444444432,1.0900651111111077,1.090338000000005,1.090844200000001,1.0904417999999996,1.0899261000000038,1.0903224960184885,1.090087104792844,1755,-249551,-252489.2,-0.021185469152274112,-244.13849061652454,0.06052547113577927
2023-07-04T02:45:00-04:00,1.09111,1.09145,1.09083,1.09145,1.08957742688,1.0904913333333335,1.0902188888888875,1.0900759999999967,1.0903570000000047,1.090848800000001,1.0904529999999995,1.0899483750000036,1.0905479968147909,1.0901848838342745,2017,-247534,-251262.4,-0.013935587104452528,-243.50997470153885,0.09445901579208804
2023-07-04T03:00:00-04:00,1.09145,1.09146,1.09082,1.09112,1.0897272327296,1.0906715555555555,1.0903366666666652,1.0901366666666632,1.0903830000000048,1.090850600000001,1.0904699999999994,1.0899695250000039,1.0906623974518328,1.090327107067419,-2722,-250256,-250331.6,-0.007734212118789003,-244.33297163222724,0.09724235363191576
2023-07-04T03:15:00-04:00,1.09112,1.0912,1.09078,1.09083,1.0899005094566399,1.0907702222222222,1.0904444444444428,1.0902271111111077,1.0904065000000047,1.090843600000001,1.0904855999999996,1.0899875750000039,1.0906959179614661,1.0904708856539347,-2045,-252301,-250189.6,-0.0016769664720881273,-244.87649571757098,0.089002257170638
2023-07-04T03:30:00-04:00,1.09083,1.09092,1.08961,1.0901,1.09146,1.0907013333333335,1.0905222222222206,1.0903253333333298,1.0903975000000048,1.090822800000001,1.0904968999999993,1.090001125000004,1.090576734369173,1.090561108523147,-2514,-254815,-250891.4,0.0016595169149948436,-246.5589026920764,0.06425555351571002
2023-07-04T03:45:00-04:00,1.0901,1.09056,1.08977,1.09029,1.091423,1.0906548888888887,1.0905799999999983,1.090420444444441,1.0903835000000046,1.090808000000001,1.0905096999999995,1.090017750000004,1.0905193874953385,1.090600486818517,2465,-252350,-251451.2,0.009778044077121842,-246.12926320946033,0.04771649063564569
2023-07-04T04:00:00-04:00,1.09029,1.09045,1.08972,1.09003,1.0913867400000001,1.0905448888888891,1.0906366666666651,1.0905039999999964,1.0903640000000048,1.090785800000001,1.0905275999999995,1.0900358000000039,1.0904215099962709,1.0905751894548132,-2240,-254590,-252862.4,0.01452110910736771,-246.6634330174929,0.046809604229386376
2023-07-04T04:15:00-04:00,1.09003,1.09032,1.0897999999999999,1.0897999999999999,1.0913512052,1.0903775555555557,1.090605555555554,1.0905577777777744,1.0903265000000046,1.090763000000001,1.0905452999999996,1.0900554250000036,1.0902972079970166,1.0905021515638498,-2050,-256640,-254139.2,0.019797284195542487,-247.09598991959686,-0.02568618816968094
2023-07-04T04:30:00-04:00,1.0897999999999999,1.09027,1.08938,1.08949,1.091316381096,1.0901544444444446,1.0904688888888876,1.0905626666666632,1.0902660000000046,1.090729600000001,1.0905597999999994,1.0900708500000038,1.0901357663976132,1.0903901212510791,-2291,-258931,-255465.2,0.019016405471700665,-247.74767830278603,-0.11276954672141727
2023-07-04T04:45:00-04:00,1.08949,1.0899,1.0891899999999999,1.08955,1.09123892585216,1.0899706666666664,1.090295555555554,1.09051733333333,1.0902210000000048,1.090696800000001,1.0905802999999994,1.0900866000000038,1.0900186131180907,1.0902784970008625,2155,-256776,-255857.4,0.013308658228171531,-247.62899892068992,-0.14297366901595676
2023-07-04T05:00:00-04:00,1.08955,1.09009,1.08943,1.09,1.0911159903010303,1.0899115555555556,1.0901344444444432,1.090428222222219,1.0902025000000048,1.090669400000001,1.0905960999999995,1.0901051500000036,1.0900148904944726,1.0901775976006896,2162,-254614,-256310.2,0.005092944045255171,-246.73606146944846,-0.13285079481423348
2023-07-04T05:15:00-04:00,1.09,1.0903,1.08994,1.0902,1.0910004308829686,1.0899246666666667,1.090032222222221,1.09030733333333,1.0901900000000047,1.090655200000001,1.0906105999999993,1.0901223500000037,1.090051912395578,1.0901036780805509,1696,-252918,-255975.8,-0.0056302346655530645,-246.42486880889803,-0.0843170320404751
2023-07-04T05:30:00-04:00,1.0902,1.09029,1.08983,1.09015,1.0908918050299905,1.0899482222222223,1.0899566666666651,1.0901775555555522,1.090176500000005,1.0906376000000009,1.0906253999999995,1.0901434000000036,1.0900715299164625,1.0900585424644402,-1648,-254566,-255561,-0.013217465749347315,-246.50045127083177,-0.06233785282766462
2023-07-04T05:45:00-04:00,1.09015,1.09016,1.08967,1.08985,1.0907896967281911,1.089926888888889,1.0899288888888874,1.0900695555555522,1.0901660000000049,1.090610200000001,1.0906376999999994,1.0901646000000038,1.09002722393317,1.0900368339715516,-1972,-256538,-255082.4,-0.019717490383325625,-247.0431288840042,-0.022933675809566414
2023-07-04T06:00:00-04:00,1.08985,1.09003,1.0895299999999999,1.08995,1.0906937149244997,1.0899311111111112,1.0898911111111098,1.0899886666666634,1.090170500000005,1.090583400000001,1.0906484999999995,1.0901886000000038,1.090011779146536,1.0900354671772408,1885,-254653,-254657.8,-0.020613044794006597,-246.87016930241043,-0.031184363793119903
2023-07-04T06:15:00-04:00,1.08995,1.09015,1.08986,1.09002,1.0906034920290297,1.089956888888889,1.0898899999999987,1.0899397777777746,1.090201500000005,1.090564800000001,1.0906605999999994,1.0902169500000038,1.0900134233172287,1.090035173741792,1318,-253335,-254402,-0.023788484294040846,-246.78552321772764,-0.0009174059429617085
2023-07-04T06:30:00-04:00,1.09002,1.09036,1.08999,1.09022,1.090518682507288,1.0900228888888888,1.0899366666666657,1.0899206666666634,1.090224000000005,1.0905406000000009,1.0906845999999992,1.0902478500000037,1.0900547386537829,1.0900357389934328,1207,-252128,-254244,-0.02562652194291055,-246.56405939137585,0.038539181501200864
2023-07-04T06:45:00-04:00,1.09022,1.09038,1.08955,1.08961,1.0904389615568506,1.0899575555555556,1.0899499999999989,1.0899193333333304,1.090228500000005,1.090505800000001,1.0906906999999995,1.0902765000000039,1.0899657909230263,1.0900145911947456,-1940,-254068,-254144.4,-0.02667063857929955,-247.64952837928655,0.011014327804743316
2023-07-04T07:00:00-04:00,1.08961,1.0897999999999999,1.08902,1.0891,1.09038,1.0897875555555556,1.089899999999999,1.0899135555555526,1.090179500000005,1.090462000000001,1.0906954999999994,1.0903015000000038,1.089792632738421,1.089967672955796,-1697,-255765,-253989.8,-0.028413967703384283,-248.44382175030924,-0.041301454729022205
2023-07-04T07:15:00-04:00,1.0891,1.08962,1.08895,1.08957,1.09038,1.0897215555555555,1.0898522222222211,1.089905777777775,1.090122000000005,1.090428400000001,1.0907056999999996,1.0903275500000038,1.0897481061907368,1.089914938364636,1703,-254062,-253871.6,-0.026003400141859673,-247.70889382817174,-0.039449541284417654
2023-07-04T07:30:00-04:00,1.08957,1.09007,1.08952,1.09002,1.090237,1.089755111111111,1.0898322222222212,1.0898942222222197,1.0900675000000049,1.090400200000001,1.0907102999999994,1.090354200000004,1.0898024849525894,1.0898727506917083,1465,-252597,-253724,-0.022762953391289944,-247.1038386229072,-0.016510731975790588
2023-07-04T07:45:00-04:00,1.09002,1.09021,1.08978,1.08982,1.08895,1.0897526666666666,1.0897955555555545,1.0898659999999973,1.089986000000005,1.090369600000001,1.0907164999999994,1.0903805000000037,1.0898059879620714,1.089823000553366,-1630,-254227,-254143.8,-0.02061493580241726,-247.40291570406166,-0.03027106361509347
2023-07-04T08:00:00-04:00,1.08982,1.09,1.08937,1.0899,1.0889752000000001,1.0897735555555557,1.08980111111111,1.0898362222222195,1.0899250000000051,1.090341400000001,1.0907122999999992,1.0904080500000037,1.0898247903696572,1.0897948004426923,2115,-252112,-253752.6,-0.016138319464983755,-247.2476607078236,0.004587787310189982
2023-07-04T08:15:00-04:00,1.0899,1.09002,1.08958,1.08984,1.0889998960000002,1.0897813333333333,1.0897888888888876,1.0898139999999972,1.089875500000005,1.0903128000000009,1.0907157999999995,1.0904361500000035,1.0898278322957258,1.0898018403541532,-1529,-253641,-253327.8,-0.010638604634155906,-247.33183356771923,-0.010092206064503373
2023-07-04T08:30:00-04:00,1.08984,1.08994,1.08962,1.08985,1.0890240980800003,1.0897935555555556,1.0897699999999988,1.0897975555555526,1.0898630000000051,1.0902868000000008,1.0907169999999993,1.0904619000000038,1.0898322658365807,1.089818672283322,1423,-252218,-252959,-0.007274757769862124,-247.31877660522923,-0.015596044109282718
2023-07-04T08:45:00-04:00,1.08985,1.09011,1.0897999999999999,1.09006,1.0890478161184003,1.0898515555555555,1.089752222222221,1.0897815555555526,1.089851500000005,1.0902666000000008,1.0907188999999995,1.0904855500000037,1.0898778126692645,1.0898337378266572,1559,-250659,-252571.4,-0.006732985775164167,-247.0183774677332,-0.014675936966845039
2023-07-04T09:00:00-04:00,1.09006,1.09011,1.08959,1.08982,1.0890710597960322,1.089865111111111,1.0897755555555542,1.0897775555555524,1.089841000000005,1.0902386000000008,1.0907202999999994,1.0905081000000036,1.0898662501354117,1.0898457902613252,-1651,-252310,-252188,-0.008349772904167215,-247.38188039417764,0.01927295087233446
2023-07-04T09:15:00-04:00,1.08982,1.09003,1.08976,1.08993,1.0890938386001117,1.089896,1.0898677777777765,1.0897908888888856,1.0898475000000052,1.090217800000001,1.0907193999999993,1.0905323000000038,1.0898790001083294,1.0898566322090595,1255,-251055,-251976.6,-0.004976678645563059,-247.25520809967023,0.07620971444312813
2023-07-04T09:30:00-04:00,1.08993,1.09009,1.08972,1.08982,1.0891161618281093,1.0898864444444445,1.0898955555555545,1.089812222222219,1.089864000000005,1.090191400000001,1.0907124999999995,1.0905548000000038,1.0898672000866636,1.0898645057672471,-1531,-252586,-251765.6,0.0015423757921278697,-247.40972260977645,0.022944831447275854
2023-07-04T09:45:00-04:00,1.08982,1.09002,1.08964,1.08998,1.0891380385915472,1.0899033333333334,1.08989111111111,1.0898364444444415,1.089885500000005,1.090162800000001,1.0907035999999994,1.0905779500000037,1.089889760069331,1.0898760046137972,1487,-251099,-251541.8,0.003163331915158091,-247.19141132901458,-0.0036696574374818812
2023-07-04T10:00:00-04:00,1.08998,1.09024,1.08986,1.09018,1.0891594778197162,1.089961111111111,1.08993111111111,1.0898722222222195,1.0898945000000049,1.090146200000001,1.0906978999999994,1.0905936500000037,1.0899478080554648,1.0898900036910373,1830,-249269,-251263.8,0.0018787227659958327,-246.85562535129026,0.03303297792295204
2023-07-04T10:15:00-04:00,1.09018,1.09069,1.09007,1.09061,1.0892026987069277,1.090096888888889,1.0900099999999988,1.0899191111111084,1.0899150000000049,1.090137000000001,1.0906906999999995,1.0906110000000038,1.0900802464443717,1.0899328029528292,1193,-248076,-250417,0.006461760273014069,-246.38507003015047,0.06514359115515078
2023-07-04T10:30:00-04:00,1.09061,1.09074,1.08982,1.09002,1.089291936784512,1.090098888888889,1.0900299999999987,1.0899515555555528,1.0899085000000048,1.090125400000001,1.0906790999999993,1.0906162000000037,1.0900681971554973,1.0899706423622628,-1507,-249583,-250122.6,0.00834923664159388,-247.20032938042246,0.016516185862151235
2023-07-04T10:45:00-04:00,1.09002,1.09026,1.08982,1.09017,1.089407781841751,1.090126888888889,1.0900655555555545,1.0899855555555529,1.0899245000000048,1.090121600000001,1.0906674999999995,1.0906185500000039,1.090088557724398,1.0900149138898096,1837,-247746,-249154.6,0.011289591119694159,-246.947535853698,0.02936183878516291
2023-07-04T11:00:00-04:00,1.09017,1.09026,1.08978,1.09011,1.0895143592944108,1.0901357777777778,1.09007111111111,1.090021555555553,1.0899325000000049,1.090118200000001,1.0906512999999993,1.090616750000004,1.0900928461795183,1.0900555311118472,-2031,-249777,-248890.2,0.0125389932109409,-247.05931658514388,0.0045869034731926195
2023-07-04T11:15:00-04:00,1.09011,1.09013,1.08972,1.08996,1.089612410550858,1.0901135555555554,1.0900866666666655,1.090052666666664,1.0899295000000049,1.090106000000001,1.0906413999999995,1.090613200000004,1.0900662769436147,1.0900792248894773,-1091,-250868,-249210,0.011577810972700588,-247.20943904984915,0.012846158081153676
2023-07-04T11:30:00-04:00,1.08996,1.09002,1.08965,1.09001,1.09074,1.090098222222222,1.0900955555555543,1.090069777777775,1.0899190000000047,1.090097800000001,1.0906316999999996,1.090608200000004,1.0900550215548916,1.090074179911581,844,-250024,-249599.6,0.013364731788196724,-247.170722032711,0.007339920912339137
2023-07-04T11:45:00-04:00,1.09001,1.09017,1.08987,1.0901,1.0907182,1.0900991111111114,1.0901266666666656,1.0900891111111084,1.0899435000000046,1.0900888000000009,1.0906259999999997,1.0906016000000038,1.0900640172439133,1.0900733439292645,877,-249147,-249512.4,0.01544881966857819,-247.09830985300613,0.02569231616230735
2023-07-04T12:00:00-04:00,1.0901,1.09013,1.08972,1.08981,1.090696836,1.0900357777777776,1.0901077777777766,1.090097555555553,1.0899790000000047,1.090071000000001,1.0906142999999995,1.090587950000004,1.0900132137951306,1.0900582751434107,-1128,-250275,-250018.2,0.014483141885326446,-247.39839241423917,-0.015596616451678333
2023-07-04T12:15:00-04:00,1.08981,1.08986,1.08925,1.08932,1.09067589928,1.089878222222222,1.0900122222222213,1.0900857777777753,1.0899665000000047,1.0900484000000008,1.0905934999999995,1.090572750000004,1.0898745710361044,1.090014620114728,-818,-251093,-250281.4,0.0074665012302018606,-247.76618129486965,-0.07888605551375562
2023-07-04T12:30:00-04:00,1.08932,1.08952,1.08918,1.08925,1.0906188633088,1.0897257777777778,1.08986111111111,1.090040666666664,1.0899280000000047,1.090026000000001,1.0905675999999995,1.0905585000000038,1.0897496568288836,1.0899512960917819,-876,-251969,-250501.6,0.0003320433162588956,-247.82247329354774,-0.12470085548454789
2023-07-04T12:45:00-04:00,1.08925,1.08956,1.08924,1.08942,1.090532531510272,1.0896375555555555,1.0897944444444434,1.0899804444444419,1.0899080000000045,1.090005400000001,1.0905436999999996,1.090550500000004,1.0896837254631069,1.089877036873425,792,-251177,-250732.2,-0.007964879381761726,-247.69886530640062,-0.05504486156216711
2023-07-04T13:00:00-04:00,1.08942,1.08968,1.08933,1.08966,1.0904513796196558,1.0896106666666667,1.0897377777777768,1.0899026666666642,1.0898960000000046,1.089990200000001,1.0905211999999995,1.090542350000004,1.0896789803704856,1.0898000294987393,445,-250732,-251049.2,-0.01056894016083863,-247.60083149024155,-0.04678169459809116
2023-07-04T13:15:00-04:00,1.08966,1.08971,1.08952,1.08956,1.0903750968424764,1.0895751111111112,1.0896766666666657,1.089816444444442,1.0898820000000047,1.0899802000000012,1.0905000999999996,1.0905332000000039,1.0896551842963884,1.089728423598991,-344,-251076,-251209.4,-0.014680515285734498,-247.63240097062993,-0.050453623946191524
2023-07-04T13:30:00-04:00,1.08956,1.08965,1.08939,1.08947,1.0903033910319277,1.0895337777777778,1.0896222222222212,1.089738444444442,1.0898630000000047,1.089972400000001,1.0904785999999995,1.0905229000000038,1.0896181474371107,1.0896771388791922,-410,-251486,-251288,-0.01893642316537274,-247.6662678526741,-0.04495577819370449
2023-07-04T13:45:00-04:00,1.08947,1.08956,1.0893,1.08938,1.090235987570012,1.0894853333333334,1.0895522222222214,1.0896766666666642,1.0898290000000048,1.089972000000001,1.0904565999999996,1.0905103500000037,1.0895705179496886,1.0896413111033532,-367,-251853,-251264.8,-0.022205094325433147,-247.69658534650137,-0.05779763488407524
2023-07-04T14:00:00-04:00,1.08938,1.08955,1.0893599999999999,1.08947,1.0901726283158113,1.089468888888889,1.0894822222222211,1.0896142222222198,1.0898115000000046,1.089966000000001,1.0904378999999995,1.0905010500000039,1.089550414359751,1.0896146488826821,341,-251512,-251331.8,-0.024582660616053943,-247.66841335876524,-0.05779286304010003
2023-07-04T14:15:00-04:00,1.08947,1.0896,1.08944,1.08946,1.0901130706168627,1.0894644444444443,1.0894433333333324,1.0895553333333308,1.0897880000000044,1.089964800000001,1.0904179999999997,1.090491750000004,1.0895323314878007,1.089585319106145,-212,-251724,-251530.2,-0.02888267734083931,-247.67035925906535,-0.03211568989088469
2023-07-04T14:30:00-04:00,1.08946,1.08949,1.08903,1.0891,1.0900570863798509,1.0893957777777776,1.0894188888888878,1.0895037777777752,1.0897520000000047,1.0899452000000012,1.0903966999999997,1.0904806000000038,1.0894458651902406,1.0895434552849155,-307,-252031,-251721.2,-0.03177209736009687,-247.77180401151156,-0.02019608563141308
2023-07-04T14:45:00-04:00,1.0891,1.08913,1.08867,1.08873,1.0899749194694628,1.089258,1.08936111111111,1.0894515555555528,1.0896895000000044,1.089905400000001,1.0903756999999996,1.0904651500000038,1.0893026921521924,1.0894803642279318,-311,-252342,-251892.4,-0.03242472721899716,-247.8774600577883,-0.04773927014001156
2023-07-04T15:00:00-04:00,1.08873,1.08878,1.08841,1.08867,1.0898444275225165,1.089119777777778,1.0892777777777765,1.0893966666666637,1.0896140000000045,1.089856600000001,1.0903503999999995,1.090447550000004,1.089176153721754,1.0894014913823449,-635,-252977,-252117.2,-0.03202452883092334,-247.91245496010566,-0.06884397202181237
2023-07-04T15:15:00-04:00,1.08867,1.08868,1.08844,1.08844,1.0896722962198147,1.0889522222222223,1.089142222222221,1.0893286666666637,1.0895055000000045,1.089796400000001,1.0903225999999995,1.090431400000004,1.089028922977403,1.0892971931058752,-309,-253286,-252472,-0.033416780590492724,-247.9777364503644,-0.11196152928436381
2023-07-04T15:30:00-04:00,1.08844,1.0886,1.08807,1.08812,1.0895208206734368,1.0887477777777779,1.0889822222222212,1.0892364444444413,1.0894105000000045,1.089736400000001,1.0902934999999996,1.090416200000004,1.0888471383819225,1.0891601544846998,-696,-253982,-252923.6,-0.036672417402612546,-248.18235958071617,-0.13216344212343586
2023-07-04T15:45:00-04:00,1.08812,1.08856,1.08809,1.08833,1.0893177057791557,1.0886173333333333,1.0888555555555544,1.0891237777777747,1.0893185000000045,1.089686400000001,1.0902649999999996,1.0904020000000039,1.088743710705538,1.0890197235877594,424,-253558,-253229,-0.0405786889098001,-248.10053037070256,-0.10463803500784041
2023-07-04T16:00:00-04:00,1.08833,1.08836,1.088,1.08826,1.089143026970074,1.0884982222222221,1.0887311111111098,1.0889977777777748,1.0892260000000042,1.089649600000001,1.0902361999999997,1.090385950000004,1.0886469685644304,1.088888578870207,-473,-254031,-253566.8,-0.04334059173820482,-248.1309531285058,-0.10281077310029649
2023-07-04T16:15:00-04:00,1.08826,1.08837,1.08816,1.08824,1.088960142654862,1.0884000000000003,1.0885944444444435,1.0888611111111082,1.0891400000000044,1.0896086000000011,1.0902082999999996,1.0903702500000039,1.0885655748515444,1.088766463096165,-261,-254292,-253829.8,-0.04563506983820152,-248.13574977636569,-0.11289893250845295
2023-07-04T16:30:00-04:00,1.08824,1.08826,1.08784,1.08806,1.0888065198300843,1.0882931111111112,1.0884388888888878,1.0887204444444416,1.0890425000000044,1.089569200000001,1.0901774999999996,1.090353900000004,1.0884644598812354,1.0886535704769316,-300,-254592,-254091,-0.050277951943783365,-248.18537118340828,-0.12850402951921758
2023-07-04T16:45:00-04:00,1.08806,1.08818,1.08765,1.08777,1.088632546260669,1.0881593333333333,1.08829111111111,1.0885822222222195,1.0889260000000043,1.089528600000001,1.0901457999999997,1.0903371500000039,1.0883255679049884,1.0885492563815446,-967,-255559,-254406.4,-0.05600687754631057,-248.44310513190388,-0.12211918097512198
2023-07-04T17:00:00-04:00,1.08777,1.08817,1.08775,1.08807,1.088436037008535,1.0881151111111111,1.0882177777777766,1.088454666666664,1.0888390000000043,1.0895002000000011,1.0901148999999997,1.090321250000004,1.0882744543239906,1.088455405105235,138,-255421,-254779,-0.05659348420523725,-248.40504561564583,-0.06062109062851974
2023-07-04T17:15:00-04:00,1.08807,1.08823,1.08801,1.08804,1.088278829606828,1.0880795555555554,1.0881477777777766,1.0883379999999971,1.0887750000000043,1.089470000000001,1.0900833999999997,1.0903054000000039,1.0882275634591925,1.0883715240841876,-154,-255575,-255087.8,-0.0551939617277873,-248.40929166599187,-0.05786877566205833
2023-07-04T17:30:00-04:00,1.08804,1.08817,1.08795,1.088,1.08765,1.08805,1.0880988888888876,1.088238888888886,1.0887125000000042,1.089430000000001,1.0900496999999998,1.0902889500000037,1.088182050767354,1.0882948192673496,-171,-255746,-255378.6,-0.05557766746092372,-248.41557819957518,-0.040424828194479796
2023-07-04T17:45:00-04:00,1.088,1.08805,1.08782,1.08787,1.0876604,1.0880042222222222,1.08807111111111,1.0881653333333305,1.088635000000004,1.0893834000000011,1.0900192999999998,1.0902719000000038,1.0881196406138833,1.088225855413879,-401,-256147,-255689.6,-0.05478057153026936,-248.46349180251642,-0.022975407124221914
2023-07-04T18:00:00-04:00,1.08787,1.08795,1.08771,1.08795,1.087670592,1.08798,1.0880288888888878,1.088112888888886,1.088549500000004,1.0893394000000012,1.0899884999999998,1.0902569500000039,1.0880857124911067,1.0881778843311027,445,-255702,-255718.2,-0.049915466095363265,-248.43076730418477,-0.03491588029366525
2023-07-04T18:15:00-04:00,1.08795,1.08802,1.08789,1.0879,1.08768058016,1.087954222222222,1.0879888888888878,1.0880671111111082,1.0884665000000042,1.089300400000001,1.0899553,1.0902419500000038,1.0880485699928855,1.0881327074648817,-392,-256094,-255852.8,-0.04617022086342971,-248.44878283798684,-0.03308033006817451
2023-07-04T18:30:00-04:00,1.0879,1.08811,1.08788,1.08805,1.0876903685568,1.0879664444444443,1.0879677777777765,1.0880311111111083,1.0883955000000043,1.089262400000001,1.0899229,1.0902279000000037,1.0880488559943085,1.0880969659719049,458,-255636,-255865,-0.04149644447406879,-248.3856336514808,-0.017459383959433073
2023-07-04T18:45:00-04:00,1.08805,1.08817,1.08801,1.08806,1.087699961185664,1.087984888888889,1.0879677777777765,1.0880048888888858,1.0883295000000044,1.089223200000001,1.089894,1.0902133500000037,1.0880510847954468,1.0880707727775234,402,-255234,-255762.6,-0.03698377272952846,-248.381938968332,0
2023-07-04T19:00:00-04:00,1.08806,1.08809,1.08795,1.08808,1.0877093619619507,1.0880073333333333,1.088002222222221,1.087991111111108,1.0882600000000044,1.089180400000001,1.0898605000000001,1.0901982500000036,1.0880568678363574,1.0880582182220182,542,-254692,-255471.6,-0.031113991144617152,-248.37197628245076,0.028498671594181905
2023-07-04T19:15:00-04:00,1.08808,1.08818,1.08801,1.0881,1.0877185747227116,1.0880268888888889,1.0880055555555543,1.0879864444444416,1.0881920000000043,1.089150200000001,1.089828,1.0901846500000039,1.088065494269086,1.0880541745776142,375,-254317,-255194.6,-0.02208871366466208,-248.36508340692686,0.0027571755493648836
2023-07-04T19:30:00-04:00,1.0881,1.08832,1.08808,1.08824,1.087737031733803,1.0880737777777776,1.0880277777777765,1.087994222222219,1.0881490000000043,1.089133000000001,1.0897975000000002,1.0901722000000038,1.0881003954152688,1.0880645396620907,509,-253808,-254737.4,-0.015188989360841303,-248.29959310272687,0.018381677144241024
2023-07-04T19:45:00-04:00,1.08824,1.0883099999999999,1.08816,1.08824,1.087772009829775,1.0881162222222223,1.088054444444443,1.0880115555555525,1.0881245000000042,1.0891064000000013,1.0897674000000002,1.0901599000000037,1.088128316332215,1.0880804317296722,0,-253808,-254371.8,-0.009588109518586827,-248.29959310272687,0.022058823529413414
2023-07-04T20:00:00-04:00,1.08824,1.08857,1.08824,1.08841,1.0878048892399885,1.0881873333333334,1.0881144444444433,1.088040888888886,1.0881115000000043,1.089074200000001,1.0897372,1.0901460000000038,1.0881846530657722,1.0881071453837372,1123,-252685,-253862,-0.004419957200504184,-248.1241630505325,0.04963828398615708
2023-07-04T20:15:00-04:00,1.08841,1.08871,1.08836,1.08869,1.0878660981007895,1.0883024444444445,1.0881966666666654,1.0880797777777746,1.0881240000000045,1.089051600000001,1.0897106,1.0901340000000037,1.0882857224526177,1.0881529163069892,894,-251791,-253281.8,0.0030283244616179624,-247.89417618896394,0.06801783170182113
2023-07-04T20:30:00-04:00,1.08869,1.08909,1.08867,1.08891,1.0879504882907105,1.088445111111111,1.0883088888888877,1.0881404444444414,1.0881635000000043,1.089031800000001,1.0896866,1.0901236500000038,1.088410577962094,1.0882219330455907,1002,-250789,-252576.2,0.009793714955946579,-247.6916943070691,0.09283941538743959
2023-07-04T20:45:00-04:00,1.08891,1.08897,1.08856,1.08865,1.0880872296958253,1.0885133333333334,1.088375555555554,1.088209999999997,1.0881795000000043,1.089008000000001,1.0896604,1.0901124500000037,1.0884584623696751,1.088293546436472,-1319,-252108,-252236.2,0.014366407724459048,-248.0066330990723,0.05514452460823804
2023-07-04T21:00:00-04:00,1.08865,1.08871,1.08808,1.08812,1.08909,1.0884622222222222,1.0883822222222208,1.0882755555555526,1.0881725000000042,1.088973400000001,1.0896301000000002,1.0900988000000036,1.08839076989574,1.088346037149177,-1226,-253334,-252141.4,0.0159287860736482,-248.60350077922652,0.005514401779308952
2023-07-04T21:15:00-04:00,1.08812,1.0885,1.0881,1.08845,1.0890697999999999,1.0884757777777778,1.088423333333332,1.0883373333333304,1.0881830000000043,1.0889412000000012,1.0896039,1.0900870000000036,1.088402615916592,1.088389629719341,1549,-251785,-251961.4,0.0186811599913813,-248.13372722483922,0.03400485258436709
2023-07-04T21:30:00-04:00,1.08845,1.08851,1.08808,1.08813,1.089050004,1.088417111111111,1.0884266666666653,1.0883833333333306,1.0881865000000044,1.088907400000001,1.0895730000000001,1.0900735000000037,1.0883480927332736,1.0884021037754723,-1486,-253271,-252257.4,0.01962209524971367,-248.5706053542892,0.002757099531290735
2023-07-04T21:45:00-04:00,1.08813,1.08813,1.08761,1.08769,1.08903060392,1.0882697777777777,1.088365555555554,1.0883946666666637,1.0881825000000043,1.088862600000001,1.0895402,1.0900583000000037,1.088216474186619,1.0883632830203773,-1722,-254993,-253098.2,0.017473749990444896,-249.26691921384642,-0.050540321987801444
2023-07-04T22:00:00-04:00,1.08769,1.08781,1.08749,1.08767,1.0889737797632,1.0881306666666666,1.0883022222222207,1.088379999999997,1.0881625000000041,1.088819600000001,1.0895055000000002,1.0900425500000037,1.0881071793492951,1.0882930264163013,-1186,-256179,-253912.4,0.012673228505249292,-249.28872689802128,-0.05237815187827882
2023-07-04T22:15:00-04:00,1.08767,1.08775,1.08747,1.08756,1.088884752977408,1.0879822222222222,1.088207777777776,1.0883451111111082,1.0881385000000043,1.088771200000001,1.0894670000000002,1.0900265500000037,1.0879977434794361,1.0882144211330407,-1088,-257267,-254699,0.008656148294366731,-249.39876027211434,-0.07809557060299127
2023-07-04T22:30:00-04:00,1.08756,1.08769,1.08754,1.0876,1.0887715727392153,1.0878606666666666,1.088086666666665,1.0882777777777748,1.0881185000000042,1.0887196000000012,1.0894329000000003,1.0900119500000036,1.0879181947835488,1.088117536906432,1045,-256222,-255586.4,0.0031378047710631436,-249.36032561103835,-0.10012032810074818
2023-07-04T22:45:00-04:00,1.0876,1.08783,1.08756,1.08781,1.088667446920078,1.0878053333333333,1.0879644444444427,1.0881853333333305,1.0881155000000042,1.088663600000001,1.0894003,1.0900003000000036,1.087896555826839,1.088027229525145,847,-255375,-256007.2,-0.0041181294849246325,-249.19678202883898,-0.10101844964231212
2023-07-04T23:00:00-04:00,1.08781,1.08787,1.0877,1.08785,1.0885716511664718,1.0877824444444444,1.087875555555554,1.0880873333333303,1.0881105000000042,1.088620200000001,1.0893728,1.0899874500000037,1.0878872446614711,1.0879613836201154,910,-254465,-255901.6,-0.013772332447333432,-249.16332030298608,-0.07348550957607237
2023-07-04T23:15:00-04:00,1.08785,1.08793,1.08752,1.08765,1.088483519073154,1.0877373333333331,1.0878233333333316,1.0879915555555524,1.0880980000000042,1.088569800000001,1.0893457,1.0899727500000038,1.087839795729177,1.0879079068960917,-951,-255416,-255749,-0.021650023238400918,-249.33816058427485,-0.04319376539352006
2023-07-04T23:30:00-04:00,1.08765,1.08788,1.08765,1.08785,1.0884024375473018,1.0877426666666667,1.087756666666665,1.08790133333333,1.0880880000000042,1.0885246000000008,1.0893214,1.0899556000000037,1.0878418365833415,1.0878767255168729,709,-254707,-255237,-0.023912671483680006,-249.20778776213538,-0.055124259267760024
2023-07-04T23:45:00-04:00,1.08785,1.08788,1.08769,1.08774,1.0883278425435177,1.0877393333333332,1.0877133333333315,1.0878266666666634,1.0880720000000044,1.088480200000001,1.0892931000000001,1.0899398000000036,1.0878214692666732,1.0878573804134977,-1001,-255708,-255134.2,-0.029081599159492627,-249.3090057609404,-0.03584130572634818
2023-07-05T00:00:00-04:00,1.08774,1.08775,1.08759,1.08772,1.0882592151400363,1.0877406666666667,1.0877166666666649,1.0877771111111076,1.0880540000000043,1.088434400000001,1.0892661000000001,1.0899234000000035,1.0878011754133385,1.0878383043307978,-660,-256368,-255332.8,-0.03136220324926233,-249.32114101385005,0.002758138807930062
2023-07-05T00:15:00-04:00,1.08772,1.08775,1.08754,1.08766,1.0881960779288333,1.0877293333333335,1.0877155555555538,1.0877451111111078,1.0880320000000043,1.088385600000001,1.0892372000000001,1.0899075500000037,1.0877729403306708,1.0878154434646377,-1095,-257463,-255932.4,-0.029800330346206747,-249.38154258778448,-0.0009193965081176706
2023-07-05T00:30:00-04:00,1.08766,1.08768,1.08752,1.08766,1.0881379916945266,1.0877182222222224,1.087726666666665,1.0877257777777745,1.0880030000000043,1.088342600000001,1.0892068000000001,1.0898913000000037,1.0877503522645366,1.0877975547717096,0,-257463,-256341.8,-0.02796706975986223,-249.38154258778448,0.009194894994298151
2023-07-05T00:45:00-04:00,1.08766,1.08768,1.08751,1.08757,1.0880845523589644,1.0876868888888889,1.0877233333333316,1.0877191111111078,1.0879695000000043,1.088307600000001,1.0891780000000002,1.0898753500000036,1.0877142818116292,1.0877720438173673,-728,-258191,-257038.6,-0.024943506175204796,-249.44178200083644,-0.0027583670467060035
2023-07-05T01:00:00-04:00,1.08757,1.08758,1.08677,1.08689,1.0880353881702471,1.0875202222222222,1.0876211111111094,1.0877006666666635,1.087893500000004,1.0882604000000011,1.0891432,1.0898555500000036,1.0875494254493034,1.087717635053893,-1611,-259802,-257857.4,-0.02556214841074202,-250.4490550959016,-0.08457359281492466
2023-07-05T01:15:00-04:00,1.08689,1.08743,1.08681,1.08738,1.0879088493532225,1.0874720000000002,1.087568888888887,1.0876711111111077,1.0878280000000042,1.088219600000001,1.0891125000000001,1.0898387500000037,1.0875155403594428,1.087660508043114,1073,-258729,-258329.6,-0.02500738665560631,-249.9653170911356,-0.04320448591257714
2023-07-05T01:30:00-04:00,1.08738,1.08779,1.08732,1.08778,1.0877949644179004,1.087514222222222,1.0875833333333316,1.0876446666666633,1.087771500000004,1.088182000000001,1.0890861,1.0898217000000037,1.0875684322875543,1.0876196064344907,1137,-257592,-258355.4,-0.021668387005010857,-249.5470640425234,0.01195237438513892
2023-07-05T01:45:00-04:00,1.08778,1.0884,1.08773,1.08812,1.08677,1.0876215555555555,1.0876133333333313,1.0876219999999965,1.0877450000000042,1.0881532000000012,1.0890666999999998,1.0898059500000037,1.0876787458300434,1.0876052851475921,1132,-256460,-258154.8,-0.013890135289561312,-249.19324249772572,0.024819598290204758
2023-07-05T02:00:00-04:00,1.08812,1.08845,1.08774,1.08798,1.0868026,1.0876948888888889,1.087639999999998,1.08760533333333,1.087738000000004,1.0881234000000013,1.0890479,1.0897888500000037,1.0877389966640347,1.087610228118073,-2111,-258571,-258230.8,-0.009762341700941403,-249.4648485705854,0.022064096199461085
2023-07-05T02:15:00-04:00,1.08798,1.08804,1.08731,1.08742,1.086868496,1.087650888888889,1.0876066666666648,1.087602444444441,1.0876865000000042,1.088084200000001,1.0890281,1.0897681000000035,1.0876751973312277,1.087635382494458,-2086,-260657,-258401.8,-0.009640060624429958,-250.53854477823606,-0.027580627367334146
2023-07-05T02:30:00-04:00,1.08742,1.08817,1.08713,1.08808,1.0869317561599998,1.0877455555555555,1.0876533333333311,1.0876193333333297,1.087684000000004,1.0880564000000013,1.0890112,1.0897511500000037,1.0877561578649821,1.0876835059955658,2320,-258337,-258323.4,-0.00471065996931608,-249.13044119360478,0.03861500836657272
2023-07-05T02:45:00-04:00,1.08808,1.08889,1.08806,1.08826,1.0869924859135998,1.0878668888888887,1.087719999999998,1.087646666666663,1.087712500000004,1.0880324000000012,1.0889986,1.0897337000000036,1.0878569262919857,1.087741204796452,2936,-255401,-257885.2,0.00023640724064959227,-248.64474161269143,0.055164297666544126
2023-07-05T03:00:00-04:00,1.08826,1.09033,1.08822,1.09018,1.0871063367587839,1.0883588888888889,1.088009999999998,1.0877259999999962,1.0878380000000039,1.0880540000000012,1.0889996000000002,1.0897265500000035,1.0883215410335885,1.087869763837161,4578,-250823,-256757.8,0.012501953430480906,-240.5678482232444,0.23998455271844585
2023-07-05T03:15:00-04:00,1.09018,1.09079,1.08981,1.08993,1.0873642298180812,1.088742888888889,1.0883477777777757,1.0878675555555517,1.087956500000004,1.0880780000000012,1.0889917,1.0897184000000038,1.0886432328268707,1.0880506110697283,-4168,-254991,-256041.8,0.024301113203082297,-241.52365368656186,0.27969711746360293
2023-07-05T03:30:00-04:00,1.08993,1.09018,1.08954,1.08968,1.0877068068362732,1.0890093333333333,1.0886033333333311,1.088066888888885,1.088060500000004,1.088098200000001,1.0889774,1.0897096000000035,1.0888505862614966,1.0882856888557821,-3396,-258387,-255587.8,0.040662949186682625,-242.3026027933855,0.21151759274586332
2023-07-05T03:45:00-04:00,1.08968,1.08968,1.08856,1.08866,1.0880151261526458,1.0890206666666669,1.0887011111111091,1.0882764444444404,1.088103000000004,1.0881026000000011,1.0889495,1.0897012500000036,1.0888124690091971,1.0884969510846252,-4911,-263298,-256580,0.0477858298539907,-246.89956703976983,0.08089871113644229
2023-07-05T04:00:00-04:00,1.08866,1.08869,1.08663,1.0877,1.09079,1.0888204444444443,1.0886544444444424,1.0884633333333293,1.088095500000004,1.0880942000000011,1.0889153,1.0896926500000037,1.0885899752073578,1.0886435608676996,-6919,-270217,-259543.2,0.04753222790985968,-253.00086588422127,-0.038598683968687916
2023-07-05T04:15:00-04:00,1.0877,1.08842,1.08745,1.0881,1.0907068,1.0887095555555555,1.0886677777777756,1.088594888888885,1.088118000000004,1.0880896000000009,1.088888,1.0896868000000037,1.0884919801658863,1.0886776486941592,4266,-265951,-262568.8,0.04625380907953988,-251.43205095363308,0.011029614514983733
2023-07-05T04:30:00-04:00,1.0881,1.08929,1.08771,1.08924,1.090625264,1.088824,1.0888699999999976,1.0886993333333295,1.088187500000004,1.088109200000001,1.0888794,1.0896881500000037,1.088641584132709,1.0886773189553272,3969,-261982,-263967,0.050871711390252004,-247.27373829854653,0.16736863401445004
2023-07-05T04:45:00-04:00,1.08924,1.08942,1.08873,1.08879,1.09054535872,1.088808,1.0889488888888865,1.0887684444444405,1.0882400000000039,1.088120200000001,1.0888643999999998,1.0896870500000038,1.0886712673061671,1.0886414551642611,-3124,-265106,-265310.8,0.059345700740713256,-248.56436295426997,0.06525255495919312
2023-07-05T05:00:00-04:00,1.08879,1.08928,1.08807,1.08811,1.0904670515456,1.0886402222222222,1.08893222222222,1.0888146666666627,1.0882595000000042,1.088121200000001,1.0888452,1.0896864000000037,1.0885590138449337,1.0885907641314083,-3208,-268314,-266314,0.05800136612822982,-250.56790817419304,-0.013783470861751282
2023-07-05T05:15:00-04:00,1.08811,1.08914,1.08752,1.08895,1.0903903105146882,1.0886437777777778,1.0887955555555533,1.088842888888885,1.088324000000004,1.088144800000001,1.0888366999999999,1.0896910000000037,1.088637211075947,1.0886002113051263,2952,-265362,-265343,0.05895649540985052,-248.2890209293368,-0.11282540497897985
2023-07-05T05:30:00-04:00,1.08895,1.08948,1.08871,1.08932,1.0903151043043944,1.0887486666666666,1.0887277777777753,1.088854888888885,1.0884070000000041,1.0881698000000009,1.088835,1.089697400000004,1.0887737688607577,1.0886565690441006,2239,-263123,-264777.4,0.043787572520136216,-247.52826056384714,-0.05596689695668523
2023-07-05T05:45:00-04:00,1.08932,1.08957,1.08896,1.08942,1.0902414022183065,1.0888871111111111,1.0886988888888864,1.0888206666666629,1.0884995000000042,1.0881974000000008,1.0888337,1.089707000000004,1.088903015088606,1.08870885523528,2593,-260530,-264487,0.03139880197210581,-247.2902221545643,-0.023860215843176616
2023-07-05T06:00:00-04:00,1.08942,1.08949,1.08852,1.08877,1.0901691741739403,1.0889013333333333,1.0887111111111087,1.0887731111111072,1.088593500000004,1.0882128000000009,1.0888213999999998,1.089708750000004,1.088876412070885,1.0887498841882235,-2461,-262991,-264064,0.017787491535239612,-248.7585722858269,0.010104164753004106
2023-07-05T06:15:00-04:00,1.08877,1.08901,1.08841,1.0885,1.0900983906904615,1.0888591111111112,1.0887999999999978,1.0887466666666625,1.088649500000004,1.088225400000001,1.0888044,1.0897075000000038,1.088801129656708,1.0887983073505783,-1861,-264852,-263371.6,0.009273690671057308,-249.22007471517375,0.07354969201067703
2023-07-05T06:30:00-04:00,1.0885,1.08876,1.0881399999999999,1.08828,1.0900290228766523,1.0887551111111111,1.0888199999999975,1.0887515555555514,1.088674500000004,1.088232000000001,1.0887856999999999,1.089705550000004,1.0886969037253664,1.0888102458804623,-2093,-266945,-263688.2,0.010664324423161987,-249.64309722321255,0.01654259718774441
2023-07-05T06:45:00-04:00,1.08828,1.08829,1.08772,1.0877999999999999,1.0899610424191193,1.0885511111111112,1.0886599999999975,1.0887379999999958,1.0886585000000042,1.088230000000001,1.0887651999999999,1.089701450000004,1.088517522980293,1.0887589967043694,-2076,-269021,-264867.8,0.007821080962891443,-250.55874393178027,-0.1322022694723025
2023-07-05T07:00:00-04:00,1.0877999999999999,1.08811,1.08779,1.08793,1.089894421570737,1.0884051111111113,1.0885644444444418,1.0887111111111067,1.088656000000004,1.088227600000001,1.088745,1.0896967500000039,1.0884000183842344,1.0886583973634951,1862,-267159,-266193.6,-0.0033812896140059277,-250.33622140925743,-0.07898676512457507
2023-07-05T07:15:00-04:00,1.08793,1.08822,1.0877999999999999,1.08799,1.0898291331393222,1.0882902222222224,1.0885511111111086,1.088679111111107,1.088684500000004,1.088226200000001,1.0887247,1.0896926500000041,1.0883180147073874,1.0885467178907955,1851,-265308,-266657,-0.010773755079909008,-250.2341376354853,-0.011028296771456744
2023-07-05T07:30:00-04:00,1.08799,1.08821,1.0875299999999999,1.08819,1.0897651504765358,1.0882180000000001,1.0884666666666643,1.0886124444444403,1.0886900000000042,1.0882284000000009,1.0887044,1.089694500000004,1.0882924117659099,1.0884449743126359,2186,-263122,-266311,-0.013406596482614174,-249.83229570679114,-0.06979200146931391
2023-07-05T07:45:00-04:00,1.08819,1.08823,1.08787,1.0879,1.089702447467005,1.0881046666666667,1.0883088888888865,1.088510222222218,1.088672000000004,1.088224400000001,1.0886873,1.0896890000000041,1.088213929412728,1.088348379450108,-2283,-265405,-266003,-0.022264311052727543,-250.44070967861572,-0.13035655271178137
2023-07-05T08:00:00-04:00,1.0879,1.08803,1.08755,1.0879,1.089640998517665,1.088022888888889,1.0881399999999974,1.088406222222218,1.088558000000004,1.088217600000001,1.0886752999999998,1.0896854000000038,1.0881511435301825,1.0882751035600862,0,-265405,-265279.8,-0.03373380562968546,-250.44070967861572,-0.13952378329753132
2023-07-05T08:15:00-04:00,1.0879,1.08889,1.0879,1.0887499999999999,1.0895807785473117,1.0881448888888887,1.0881377777777752,1.088320888888885,1.088499000000004,1.088227800000001,1.0886670999999999,1.089686400000004,1.088270914824146,1.0882492828480683,2959,-262446,-264337.2,-0.0336353030258838,-248.12877843493578,-0.0018369352572288936
2023-07-05T08:30:00-04:00,1.0887499999999999,1.08987,1.08863,1.08984,1.08663,1.0884853333333333,1.0882866666666642,1.088267999999996,1.088507000000004,1.088256400000001,1.0886653,1.0896878000000039,1.088584731859317,1.088302626278454,3121,-259325,-263140.6,-0.02341225783903256,-245.00419519727782,0.12310519062929691
2023-07-05T08:45:00-04:00,1.08984,1.09021,1.08924,1.08942,1.0866948,1.0887120000000001,1.0884133333333308,1.0882573333333292,1.088545000000004,1.088271000000001,1.0886612999999998,1.0896889000000038,1.0887517854874535,1.088394501022763,-3742,-263067,-263129.6,-0.013823538160580353,-246.4462784388541,0.10475245341273762
2023-07-05T09:00:00-04:00,1.08942,1.0899699999999999,1.08926,1.08962,1.086835408,1.0889533333333332,1.0886155555555532,1.0883186666666627,1.088641000000004,1.088285200000001,1.0886584999999998,1.0896854000000038,1.0889254283899628,1.08853680081821,3445,-259622,-261973,-0.005712905917876809,-245.8138318158805,0.16731016731018156
2023-07-05T09:15:00-04:00,1.08962,1.0901399999999999,1.08951,1.08954,1.08697039168,1.0891382222222221,1.088794444444442,1.0884495555555516,1.0887130000000043,1.088303000000001,1.0886554999999998,1.0896856500000038,1.0890483427119702,1.0887162406545674,-3487,-263109,-261513.8,0.0022219928303946587,-246.0698476746205,0.14798746242863872
2023-07-05T09:30:00-04:00,1.08954,1.08989,1.08901,1.08904,1.0870999760128,1.0891873333333333,1.0889111111111085,1.088604222222218,1.088703000000004,1.088321400000001,1.0886474,1.089682200000004,1.0890466741695761,1.0888713925236533,-4699,-267808,-262586.2,0.008305887601764712,-248.22626230831887,0.09650823996544043
2023-07-05T09:45:00-04:00,1.08904,1.08939,1.08856,1.08912,1.087224376972288,1.0892291111111112,1.0890144444444418,1.0887497777777737,1.0887195000000038,1.088334800000001,1.0886379999999998,1.0896784500000039,1.089061339335661,1.088966714018922,4869,-262939,-263309,0.019209926178538325,-247.868589495566,0.08546301656880669
2023-07-05T10:00:00-04:00,1.08912,1.08949,1.0882,1.0885799999999999,1.0873438018933965,1.089142222222222,1.0890899999999972,1.0888851111111069,1.088743000000004,1.088343800000001,1.0886255999999996,1.0896729500000037,1.0889650714685288,1.0890093712151372,-5739,-268678,-264431.2,0.02371083022048734,-250.71406106894744,0.0625057450133093
2023-07-05T10:15:00-04:00,1.0885799999999999,1.08907,1.08779,1.08804,1.0874584498176607,1.0889322222222222,1.0891055555555529,1.0889831111111068,1.0886975000000039,1.0883508000000008,1.0886066999999997,1.0896630500000037,1.088780057174823,1.0889802969721092,-4996,-273674,-267241.6,0.02530300180668481,-253.1923722633474,0.012868829855667518
2023-07-05T10:30:00-04:00,1.08804,1.0883,1.08703,1.08729,1.09021,1.0885691111111109,1.0889433333333307,1.0890128888888846,1.088596000000004,1.088343200000001,1.0885813999999998,1.0896469500000037,1.0884820457398583,1.088867037577687,-5483,-279157,-270451.2,0.026962666942219927,-256.9718748551629,-0.13409873708379288
2023-07-05T10:45:00-04:00,1.08729,1.08742,1.08668,1.0873599999999999,1.0901463999999998,1.0882524444444444,1.088667777777775,1.0889642222222178,1.088493000000004,1.088339200000001,1.0885551999999996,1.089629400000004,1.0882576365918866,1.088709230062149,4541,-274616,-271812.8,0.022769746029000365,-256.67952414836066,-0.227556338545111
2023-07-05T11:00:00-04:00,1.0873599999999999,1.08749,1.0868,1.0873599999999999,1.0900077439999998,1.087990888888889,1.088438888888886,1.0888491111111067,1.088422500000004,1.088334400000001,1.0885269999999998,1.0896124500000037,1.0880781092735092,1.0885125840497185,0,-274616,-274148.2,0.008999344627493485,-256.67952414836066,-0.18909144315325335
2023-07-05T11:15:00-04:00,1.0873599999999999,1.08771,1.08725,1.08735,1.0898746342399999,1.0877731111111109,1.088186666666664,1.08866844444444,1.0883650000000038,1.0883252000000012,1.0884943999999999,1.0895925500000037,1.0879324874188074,1.0883060672397744,-3068,-277684,-275949.4,-0.00380647363007675,-256.70773927490524,-0.20832950937023864
2023-07-05T11:30:00-04:00,1.08735,1.08767,1.0865,1.08662,1.0897468488703999,1.0874597777777777,1.0878622222222194,1.0884197777777735,1.088282000000004,1.088300600000001,1.0884603999999998,1.0895697500000037,1.087669989935046,1.0880840537918188,-2806,-280490,-277312.6,-0.02314701372868807,-258.59156692929463,-0.268003010444778
2023-07-05T11:45:00-04:00,1.08662,1.08695,1.08647,1.08671,1.0895520379381758,1.0872293333333334,1.0876033333333304,1.0881517777777734,1.088227500000004,1.0882818000000012,1.0884257999999998,1.0895466500000037,1.0874779919480368,1.0878832430334548,2354,-278136,-277108.4,-0.04228449152903661,-258.3965953660983,-0.21394990083008367
2023-07-05T12:00:00-04:00,1.08671,1.08671,1.08608,1.08625,1.0893054749031217,1.0869586666666666,1.0872844444444416,1.087875111111107,1.088143500000004,1.0882498000000012,1.0883871999999999,1.0895192500000037,1.0872323935584294,1.0876781944267633,-2560,-280696,-278324.4,-0.061144467589487335,-259.48023313514466,-0.2635154987512992
2023-07-05T12:15:00-04:00,1.08625,1.0865,1.08605,1.08637,1.0889829274128096,1.0867757777777778,1.087038888888886,1.0875951111111068,1.088062500000004,1.0882224000000011,1.0883512999999998,1.0894963500000037,1.0870599148467435,1.08747455554141,1918,-278778,-279156.8,-0.07959564519408172,-259.26834820994304,-0.20301677414611913
2023-07-05T12:30:00-04:00,1.08637,1.08648,1.08619,1.08628,1.0886309761232724,1.086624,1.0868433333333305,1.08732644444444,1.087967000000004,1.0881936000000012,1.0883139999999998,1.0894728500000037,1.0869039318773948,1.0872688444331275,-1755,-280533,-279726.6,-0.09325734554211619,-259.41374066371134,-0.16175875886915775
2023-07-05T12:45:00-04:00,1.08628,1.08651,1.08589,1.08607,1.0883212589884796,1.0864693333333333,1.0867077777777747,1.087095555555551,1.0878755000000038,1.088161800000001,1.0882736999999998,1.0894498500000038,1.086737145501916,1.0870822755465015,-2053,-282586,-280145.8,-0.10209490659147785,-259.8106272859447,-0.1122055753294888
2023-07-05T13:00:00-04:00,1.08607,1.08628,1.08589,1.0862,1.0879808827300925,1.0863677777777778,1.086578888888886,1.0868906666666622,1.0877905000000039,1.0881326000000011,1.0882375999999998,1.0894259500000039,1.0866297164015328,1.0869126204372008,1816,-280770,-280672.6,-0.10468089465300458,-259.59325639824874,-0.10668040023541679
2023-07-05T13:15:00-04:00,1.0862,1.08639,1.08594,1.08601,1.0876881591478795,1.086254,1.0864288888888862,1.086719555555551,1.087653500000004,1.088101400000001,1.0882044999999996,1.0893990000000038,1.0865057731212262,1.08676729634976,-1997,-282767,-281086.8,-0.1088267047018994,-259.94257512408217,-0.12415391406709485
2023-07-05T13:30:00-04:00,1.08601,1.0861,1.08582,1.0859,1.0874364168671764,1.0861482222222223,1.086267777777775,1.086565333333329,1.087456500000004,1.088081600000001,1.0881709999999998,1.0893693000000038,1.086384618496981,1.0866322370798076,-1523,-284290,-282189.2,-0.10978603676055862,-260.0968370553717,-0.1333517266749392
2023-07-05T13:45:00-04:00,1.0859,1.08602,1.0858,1.08595,1.087177790168428,1.0860846666666668,1.0861933333333305,1.086435333333329,1.087283000000004,1.0880530000000013,1.0881362999999997,1.0893400000000037,1.0862976947975849,1.0865109896638456,1328,-282962,-282675,-0.10564447332761136,-260.0356896200647,-0.061659089654152184
2023-07-05T14:00:00-04:00,1.08595,1.08654,1.08591,1.08604,1.086929787938111,1.0860540000000003,1.086118888888886,1.086317555555551,1.087104000000004,1.0880182000000012,1.0881000999999997,1.0893106500000038,1.0862461558380678,1.086412791731076,2411,-280551,-282268,-0.09619082240892682,-259.8358737906068,-0.061653983123388066
2023-07-05T14:15:00-04:00,1.08604,1.08606,1.08528,1.08544,1.086726426109251,1.0859182222222221,1.0860288888888858,1.086207555555551,1.086899000000004,1.0879646000000012,1.0880588999999998,1.0892795000000037,1.0860849246704543,1.0863038333848603,-2876,-283427,-282799.4,-0.0895804712905415,-261.4247655441332,-0.07456846950517629
2023-07-05T14:30:00-04:00,1.08544,1.08556,1.0850899999999999,1.08556,1.08654,1.0858244444444445,1.085938888888886,1.086109555555551,1.0867250000000042,1.0879162000000013,1.0880197999999999,1.0892492000000038,1.0859799397363634,1.0861986667078878,2353,-281074,-282460.8,-0.07850666461005275,-261.164631404982,-0.07456023270156369
2023-07-05T14:45:00-04:00,1.08556,1.08574,1.08532,1.08535,1.08625,1.0857066666666666,1.0858355555555528,1.0860231111111065,1.0865365000000042,1.0878748000000011,1.0879794999999999,1.0892180500000037,1.0858539517890908,1.0860925333663096,-2412,-283486,-282300,-0.0717357914269376,-261.6312292899447,-0.08561328570901383
2023-07-05T15:00:00-04:00,1.08535,1.08551,1.08525,1.08544,1.086018,1.0856275555555555,1.0857655555555528,1.0859375555555508,1.086379500000004,1.0878220000000012,1.0879391999999999,1.0891885500000036,1.0857711614312726,1.0859872266930473,1898,-281588,-282025.2,-0.06334980849082614,-261.4738422719322,-0.05800731076267003
2023-07-05T15:15:00-04:00,1.08544,1.08555,1.08529,1.0853599999999999,1.0858324,1.0855464444444445,1.0856722222222193,1.0858482222222174,1.086245500000004,1.0877640000000013,1.0878982,1.0891581000000037,1.085688929145018,1.0858757813544373,-1505,-283093,-282533.6,-0.05577972160523793,-261.58476503136626,-0.07733382434175787
2023-07-05T15:30:00-04:00,1.0853599999999999,1.08564,1.08535,1.08555,1.08568392,1.0855219999999999,1.0856211111111083,1.0857666666666623,1.0861585000000038,1.0876714000000012,1.0878626999999998,1.0891297000000038,1.0856611433160144,1.0857910250835494,1220,-281873,-282222.8,-0.05085386265751214,-261.3711953402037,-0.042356884374904924
2023-07-05T15:45:00-04:00,1.08555,1.08567,1.08546,1.0855,1.0850899999999999,1.085497777777778,1.0855766666666637,1.0856942222222177,1.0860655000000041,1.0875828000000012,1.0878303999999999,1.0891030500000036,1.0856289146528115,1.085720820066839,-1513,-283386,-282685.2,-0.04770554354965677,-261.4408835167043,-0.03683580440189502
2023-07-05T16:00:00-04:00,1.0855,1.08557,1.08538,1.08546,1.0851015999999998,1.0854744444444444,1.0855222222222194,1.085631555555551,1.0859705000000042,1.0874984000000012,1.0877982999999998,1.0890743500000035,1.0855951317222492,1.0856690560534705,-834,-284220,-282832,-0.043430086767848486,-261.4716158980952,-0.0451217827708347
2023-07-05T16:15:00-04:00,1.08546,1.0855299999999999,1.08528,1.08548,1.0851129679999998,1.085466,1.085459999999997,1.0855704444444398,1.085877000000004,1.0874348000000011,1.0877686999999998,1.0890456500000036,1.0855721053777994,1.0856292448427758,769,-283451,-283204.6,-0.03951784025245191,-261.4574467900673,-0.051563478324913814
2023-07-05T16:30:00-04:00,1.08548,1.08548,1.08538,1.08539,1.0851241086399999,1.085452,1.0854544444444416,1.0855268888888845,1.085815500000004,1.0873886000000013,1.0877413999999996,1.0890174500000036,1.0855356843022395,1.08559859587422,-387,-283838,-283353.6,-0.036911923160524315,-261.4895339773024,-0.004606426886781718
2023-07-05T16:45:00-04:00,1.08539,1.08544,1.08527,1.08538,1.0851350264672,1.0854371111111112,1.0854344444444415,1.085489555555551,1.0857490000000038,1.0873342000000012,1.0877119,1.0889884500000035,1.0855045474417915,1.0855672766993756,-947,-284785,-283936,-0.03202832772461883,-261.49825895173564,-0.01658130365894736
2023-07-05T17:00:00-04:00,1.08538,1.0854,1.08523,1.08534,1.0851457259378559,1.0854182222222222,1.0854333333333304,1.0854608888888841,1.085703500000004,1.0872562000000012,1.0876826999999998,1.0889594500000037,1.0854716379534333,1.0855358213595,-162,-284947,-284248.2,-0.02804785195975009,-261.50422921099965,-0.0009213617727060867
2023-07-05T17:15:00-04:00,1.08534,1.08554,1.08532,1.08552,1.0851562114190987,1.0854355555555557,1.0854422222222193,1.0854448888888841,1.085661000000004,1.0871908000000012,1.0876554999999997,1.0889319000000035,1.0854813103627465,1.0855130570875995,164,-284783,-284360.8,-0.023281120405884054,-261.4770303608697,0.0073702830188752955
2023-07-05T17:30:00-04:00,1.08552,1.08569,1.0853599999999999,1.08544,1.0851664871907167,1.0854351111111111,1.085451111111108,1.0854431111111065,1.085619000000004,1.0871374000000011,1.0876293,1.0889034000000037,1.0854730482901973,1.085493245670079,-259,-285042,-284679,-0.019202882976226694,-261.49611798707656,0.007370826269632197
2023-07-05T17:45:00-04:00,1.08544,1.08559,1.08541,1.08559,1.085187427703088,1.0854628888888889,1.0854555555555525,1.0854433333333284,1.0855950000000039,1.0870702000000012,1.0876074999999998,1.0888766500000038,1.085496438632158,1.0854853965360627,237,-284805,-284872.4,-0.014058269222892992,-261.4633662919114,0.0036847680899120263
2023-07-05T18:00:00-04:00,1.08559,1.08565,1.08551,1.08561,1.0852075305949644,1.085493777777778,1.085467777777775,1.0854499999999951,1.085565500000004,1.0869960000000012,1.0875829,1.0888489000000035,1.0855191509057263,1.0854883172288496,358,-284447,-284804.8,-0.011488096726155923,-261.4567708000591,0.010133578995859467
2023-07-05T18:15:00-04:00,1.08561,1.08571,1.08556,1.08566,1.0852268293711658,1.0855322222222223,1.0854899999999974,1.0854613333333287,1.085548000000004,1.0869208000000012,1.0875591,1.0888212500000036,1.085547320724581,1.0855034537830792,318,-284129,-284641.2,-0.007645752922228381,-261.4421246564163,0.0184253680467247
2023-07-05T18:30:00-04:00,1.08566,1.08572,1.08543,1.0855,1.0852558196088957,1.0855342222222222,1.0854922222222194,1.0854713333333288,1.085528000000004,1.0868554000000012,1.0875341,1.0887919000000037,1.0855378565796647,1.0855147630264628,-358,-284487,-284582,-0.005040256250114129,-261.49488518917985,0.0018425028558710413
2023-07-05T18:45:00-04:00,1.0855,1.08554,1.08526,1.08528,1.08572,1.0854917777777777,1.0854799999999973,1.0854771111111066,1.0854945000000038,1.0867910000000012,1.0875082,1.0887637500000036,1.0854862852637317,1.0855174104211698,-292,-284779,-284529.4,-0.004163040273807815,-261.5540652905156,-0.010134605994163801
2023-07-05T19:00:00-04:00,1.08528,1.08548,1.08519,1.0854,1.08572,1.0854757777777777,1.0854822222222194,1.08548244444444,1.0854625000000038,1.0867334000000013,1.0874826999999998,1.0887356000000037,1.0854690282109853,1.0855119283369352,414,-284365,-284441.4,-0.001658237293558949,-261.5082890852967,0.0018426726123485764
2023-07-05T19:15:00-04:00,1.0854,1.08563,1.08531,1.0856,1.0856988,1.0854993333333331,1.0855111111111084,1.0854911111111067,1.0854705000000038,1.0866894000000011,1.0874597,1.0887075000000037,1.0854952225687882,1.0855071426695475,403,-283962,-284344.4,0.0022987648528297274,-261.4340307473568,0.02395562680818241
2023-07-05T19:30:00-04:00,1.0856,1.08561,1.08532,1.08534,1.0856784480000001,1.085465111111111,1.0854911111111085,1.0854913333333291,1.0854595000000038,1.0866376000000013,1.0874325999999999,1.0886777500000036,1.0854641780550305,1.0854905141356375,-349,-284311,-284380.8,0.0027374724445493534,-261.5176158615793,-0.016581914658418913
2023-07-05T19:45:00-04:00,1.08534,1.08556,1.08533,1.08552,1.08565891008,1.0854708888888889,1.0854999999999972,1.0854928888888846,1.0854680000000037,1.0865882000000011,1.0874072,1.0886506000000038,1.0854753424440244,1.0854780113085094,440,-283871,-284257.6,0.002912956559006502,-261.4446433368405,0.0073702830188752955
2023-07-05T20:00:00-04:00,1.08552,1.08559,1.08503,1.08531,1.0856401536768001,1.085432888888889,1.0854688888888862,1.0854906666666626,1.0854615000000036,1.0865306000000012,1.0873795,1.0886200000000037,1.0854422739552196,1.0854692090468068,-1640,-285511,-284404,0.0018907928917078118,-261.7619106373049,-0.02579242623827209
2023-07-05T20:15:00-04:00,1.08531,1.08557,1.08525,1.0853,1.085603544456192,1.085399111111111,1.0854344444444417,1.0854811111111071,1.0854585000000037,1.0864786000000013,1.0873514999999998,1.0885897500000035,1.0854138191641758,1.085458167237445,-1162,-286673,-284865.6,-0.00016670666143158377,-261.7726172556905,-0.02855537439780699
2023-07-05T20:30:00-04:00,1.0853,1.08546,1.08519,1.08524,1.08559,1.0853602222222223,1.085387777777775,1.0854564444444403,1.0854430000000037,1.086425400000001,1.0873215,1.0885595000000037,1.0853790553313407,1.0854349337899554,-1135,-287808,-285634.8,-0.0030489931520546534,-261.83536488307453,-0.03868614483356547
2023-07-05T20:45:00-04:00,1.08524,1.08526,1.08462,1.08489,1.08557,1.0852606666666667,1.0853199999999972,1.085422222222218,1.0854125000000039,1.086348200000001,1.087288,1.0885277000000035,1.0852812442650726,1.085398347031964,-1821,-289629,-286698.4,-0.007247600767539935,-262.42265433057014,-0.05619530170428369
2023-07-05T21:00:00-04:00,1.08489,1.08494,1.08456,1.08463,1.085494,1.0851226666666667,1.085247777777775,1.0853717777777736,1.0853710000000039,1.086244000000001,1.0872502,1.0884937000000035,1.085150995412058,1.0853334776255708,-1465,-291094,-288143,-0.011446556994756014,-262.77374983333993,-0.059892378003836746
2023-07-05T21:15:00-04:00,1.08463,1.08467,1.08427,1.08438,1.0854006,1.0849491111111111,1.0851344444444413,1.0853048888888845,1.085316000000004,1.086143200000001,1.0872070999999999,1.0884588500000034,1.0849967963296463,1.085244382100456,-1436,-292530,-289546.8,-0.015001009134640463,-263.10473828101345,-0.09397457158651382
2023-07-05T21:30:00-04:00,1.08438,1.08503,1.08433,1.08485,1.085264928,1.0848922222222221,1.085051111111108,1.0852282222222178,1.085289000000004,1.0860478000000011,1.0871665,1.0884265500000034,1.084967437063717,1.0851551056803643,2179,-290351,-290282.4,-0.017304947485971257,-262.16029998447493,-0.06908621960204554
2023-07-05T21:45:00-04:00,1.08485,1.08507,1.08467,1.085,1.08514553664,1.0848820000000001,1.0850133333333303,1.085153333333329,1.085270000000004,1.0859570000000012,1.08713,1.0883952000000034,1.0849739496509736,1.0850740845442908,1990,-288361,-290393,-0.02112257676107091,-261.8851467374825,-0.03132658890301721
2023-07-05T22:00:00-04:00,1.085,1.08521,1.0849199999999999,1.08519,1.08427,1.0849173333333333,1.0849766666666636,1.0850846666666623,1.085262500000004,1.085880000000001,1.0871007,1.0883654000000036,1.085017159720779,1.085021267635432,1531,-286830,-289833.2,-0.021671224834224494,-261.6170453549938,-0.03040017687375096
2023-07-05T22:15:00-04:00,1.08519,1.08532,1.08504,1.08525,1.0842888000000002,1.084972,1.084969999999997,1.0850291111111066,1.0852490000000041,1.0858026000000012,1.0870686999999999,1.0883363000000035,1.085063727776623,1.0850038141083451,1063,-285767,-288767.8,-0.023764287751242886,-261.5582722369224,-0.005528374381508415
2023-07-05T22:30:00-04:00,1.08525,1.08534,1.08482,1.08484,1.0843300480000002,1.084946,1.0849188888888859,1.0849859999999956,1.085219000000004,1.085727800000001,1.0870357999999998,1.0883044000000037,1.0850189822212986,1.0850082512866757,-1509,-287276,-287717,-0.025112089520446506,-262.1283620779729,-0.04238459412143232
2023-07-05T22:45:00-04:00,1.08484,1.08484,1.08458,1.08471,1.0843906451200003,1.0849042222222223,1.084859999999997,1.0849477777777734,1.0851750000000038,1.085661200000001,1.087006,1.0882731000000037,1.0849571857770388,1.08500620102934,-1386,-288662,-287379.2,-0.027346418834391772,-262.29445108649026,-0.0488371235855589
2023-07-05T23:00:00-04:00,1.08471,1.08471,1.08432,1.08438,1.08534,1.0848082222222222,1.0848033333333305,1.0849057777777733,1.085113500000004,1.085603000000001,1.0869730999999998,1.0882393000000037,1.084841748621631,1.0849797608234715,-1115,-289777,-287662.4,-0.029963296278307596,-262.6336661762379,-0.047009374222272346
2023-07-05T23:15:00-04:00,1.08438,1.08441,1.08428,1.08434,1.0853196,1.0847155555555557,1.0847711111111082,1.0848646666666624,1.085047500000004,1.0855426000000008,1.0869409,1.0882039500000036,1.084741398897305,1.0849246086587767,-1065,-290842,-288464.8,-0.029460283912109406,-262.6729512976896,-0.02673722836358034
2023-07-05T23:30:00-04:00,1.08434,1.08457,1.08427,1.08454,1.085278016,1.0846693333333335,1.084788888888886,1.0848284444444398,1.084999500000004,1.085486200000001,1.0869102999999998,1.0881716000000035,1.084701119117844,1.084852086927021,1317,-289525,-289216.4,-0.025375798369708994,-262.430038558143,0.014754975193212713
2023-07-05T23:45:00-04:00,1.08454,1.08456,1.08399,1.08402,1.08521753504,1.0845155555555557,1.0846966666666635,1.0847839999999955,1.084936500000004,1.085419600000001,1.0868723999999998,1.0881363500000034,1.0845648952942752,1.0847612695416164,-1603,-291128,-289986.8,-0.022199779582015043,-263.1986224739046,-0.07650827303314821
2023-07-06T00:00:00-04:00,1.08402,1.0841399999999999,1.08343,1.08366,1.0851193322368,1.0843082222222222,1.0845477777777748,1.084721555555551,1.0848495000000038,1.085360400000001,1.0868305,1.0881016500000036,1.0843839162354203,1.0846466156332926,-2179,-293307,-290915.8,-0.026059601297109537,-263.9222622591482,-0.12350230414745593
2023-07-06T00:15:00-04:00,1.08366,1.08371,1.08338,1.0834,1.08495039901312,1.0840786666666666,1.0843488888888857,1.084630666666662,1.084739500000004,1.0852942000000008,1.0867879999999999,1.0880668500000035,1.0841871329883361,1.0845156925066337,-1285,-294592,-291878.8,-0.03203193623969914,-264.2305692927198,-0.16494807360924632
2023-07-06T00:30:00-04:00,1.0834,1.08378,1.08335,1.0836,1.0847619511315456,1.083928888888889,1.0841655555555525,1.0845095555555508,1.084652500000004,1.085241200000001,1.0867455,1.0880334500000037,1.0840697063906688,1.0843813540053067,1376,-293216,-292353.6,-0.037913127310376674,-263.97655415518983,-0.15203870076020745
2023-07-06T00:45:00-04:00,1.0836,1.08436,1.08347,1.08432,1.0845642779731293,1.0839597777777776,1.0841077777777748,1.0843733333333285,1.084592500000004,1.085200200000001,1.0867113000000002,1.0880022000000036,1.084119765112535,1.0842650832042449,1610,-291606,-292769.8,-0.04201099600154578,-262.90678671332927,-0.04793333579146012
2023-07-06T01:00:00-04:00,1.08432,1.08464,1.08416,1.08462,1.08335,1.084062222222222,1.0840977777777745,1.0842535555555508,1.0845580000000041,1.0851670000000009,1.0866803,1.0879732000000037,1.084219812090028,1.0841960665633954,1739,-289867,-292517.6,-0.040089618803768476,-262.42565568189946,-0.008297148546629562
2023-07-06T01:15:00-04:00,1.08462,1.08467,1.08427,1.08444,1.0833758,1.0841306666666666,1.0841044444444412,1.084164888888884,1.084515000000004,1.085134400000001,1.0866481000000001,1.0879426500000036,1.0842638496720223,1.0841720532507158,-1549,-291416,-292139.4,-0.03876077907917084,-262.6827226731035,0.005533115697465006
2023-07-06T01:30:00-04:00,1.08444,1.08463,1.08441,1.08457,1.083427568,1.0842237777777777,1.084129999999997,1.0841211111111062,1.084481500000004,1.085101800000001,1.0866172,1.0879120000000038,1.0843250797376178,1.0841996426005722,1505,-289911,-291203.2,-0.033804803276387685,-262.50230697467856,0.021211059261850754
2023-07-06T01:45:00-04:00,1.08457,1.08564,1.0842,1.0855299999999999,1.08347726528,1.0845037777777777,1.0842399999999968,1.084135999999995,1.084513500000004,1.085092200000001,1.0865968000000001,1.0878874000000038,1.0845660637900942,1.084298914080457,2834,-287077,-289975.4,-0.024105209359471847,-259.99381051986273,0.09128294023270919
2023-07-06T02:00:00-04:00,1.0855299999999999,1.08632,1.08529,1.08587,1.0836070293632,1.0848297777777778,1.0844455555555523,1.0842035555555505,1.084575500000004,1.085091600000001,1.0865866000000002,1.0878649000000038,1.0848268510320753,1.0844403312643651,4576,-282501,-288154.4,-0.016144087628359043,-258.5605567175726,0.17066105791405206
2023-07-06T02:15:00-04:00,1.08587,1.08677,1.08587,1.08656,1.0838240670141441,1.0852526666666666,1.0847677777777747,1.0843375555555506,1.084684500000004,1.085103800000001,1.0865784000000003,1.0878454500000037,1.0851734808256603,1.0846310650114916,3009,-279492,-286079.4,-0.00119852120901475,-256.6485322579225,0.2676116124983761
2023-07-06T02:30:00-04:00,1.08656,1.08673,1.08615,1.08636,1.0841186603127297,1.085571111111111,1.0850966666666635,1.084535999999995,1.0847600000000042,1.0851102000000008,1.0865642000000002,1.0878251500000038,1.0854107846605283,1.0848604520091931,-2784,-282276,-284251.4,0.014999967076645117,-257.16097519710667,0.27321395606424903
2023-07-06T02:45:00-04:00,1.08636,1.0869199999999999,1.08633,1.08673,1.0843837942814567,1.0858977777777776,1.085444444444441,1.084798888888884,1.084846500000004,1.085136000000001,1.0865503,1.0878085000000037,1.0856746277284226,1.085130361607354,2420,-279856,-282240.4,0.03744195509354363,-256.33675486498845,0.2888519748984937
2023-07-06T03:00:00-04:00,1.08673,1.08674,1.0856999999999999,1.08596,1.084688138967682,1.0860008888888888,1.0856266666666636,1.0850762222222172,1.0848850000000039,1.085144000000001,1.0865301000000003,1.0877890000000037,1.0857317021827382,1.0853634892858828,-5271,-285127,-281850.4,0.05497985549698717,-260.0715095878724,0.15124686439428267
2023-07-06T03:15:00-04:00,1.08596,1.08751,1.08588,1.08677,1.08495596229156,1.0862295555555557,1.0858655555555525,1.0853602222222172,1.0849610000000038,1.085172400000001,1.0865236000000003,1.0877758500000037,1.0859393617461905,1.0855859914287058,4164,-280963,-281542.8,0.07062266535074214,-256.96564933519284,0.19822610683927055
2023-07-06T03:30:00-04:00,1.08677,1.08683,1.08591,1.08624,1.0853135275707417,1.0863044444444445,1.0860655555555523,1.0856197777777727,1.0850310000000039,1.085188400000001,1.0865052000000004,1.0877582000000037,1.0859994893969525,1.0857511931429642,-3997,-284960,-282636.4,0.08120529495583431,-258.9149210302154,0.1659842868208498
2023-07-06T03:45:00-04:00,1.08624,1.08633,1.08522,1.08556,1.08751,1.0862033333333334,1.0861755555555521,1.0858355555555506,1.085073500000004,1.085192400000001,1.0864782000000002,1.0877384000000034,1.085911591517562,1.0858513545143709,-3472,-288432,-283867.6,0.08836496507991809,-261.0884370119506,0.09128041527979258
2023-07-06T04:00:00-04:00,1.08556,1.08607,1.08533,1.08534,1.0874641999999999,1.0860362222222224,1.086154444444441,1.0859775555555504,1.085121500000004,1.0851882000000008,1.0864298000000003,1.0877147000000036,1.0857972732140495,1.0858758836114961,-3449,-291881,-286272.6,0.09269397515510369,-261.78741265585825,-0.017502970898999794
2023-07-06T04:15:00-04:00,1.08534,1.08568,1.0847,1.08526,1.0874193159999999,1.0858573333333332,1.0860866666666633,1.0860695555555504,1.085167500000004,1.085183400000001,1.0863831000000002,1.0876874000000034,1.0856898185712396,1.0858675068891963,-3510,-295391,-288325.4,0.08634047593260627,-262.0461334253869,-0.0561761536832217
2023-07-06T04:30:00-04:00,1.08526,1.08528,1.08453,1.08527,1.0873105433599999,1.085694,1.08594333333333,1.086085111111106,1.085204000000004,1.085179600000001,1.0863390000000002,1.0876582000000037,1.0856058548569916,1.0858008055113566,3640,-291751,-290483,0.07672689263346313,-262.0125930756088,-0.11872331026358539
2023-07-06T04:45:00-04:00,1.08527,1.08656,1.08521,1.0864,1.0871437107583999,1.0857853333333334,1.0859477777777746,1.0860615555555504,1.085323000000004,1.085198000000001,1.0863164000000003,1.0876329500000037,1.0857646838855932,1.0857538444090846,3677,-288074,-291105.8,0.06708502848578608,-258.184043498084,0.003682020692959977
2023-07-06T05:00:00-04:00,1.0864,1.08687,1.08599,1.08671,1.086986888112896,1.0859377777777777,1.0859455555555522,1.0860155555555504,1.0854755000000043,1.085224400000001,1.0863065,1.0876109000000036,1.0859537471084746,1.0857622755272671,3273,-284801,-290379.6,0.05849998047682952,-257.25010572194253,-0.001840383535920512
2023-07-06T05:15:00-04:00,1.08671,1.0867499999999999,1.08607,1.08618,1.08687,1.0859846666666666,1.0859699999999968,1.0859786666666615,1.0856145000000041,1.0852404000000009,1.0862873000000002,1.0875876500000037,1.0859989976867797,1.0858026204218132,-2351,-287152,-289433.8,0.04237204489114014,-258.396713372558,0.020258573059770798
2023-07-06T05:30:00-04:00,1.08618,1.08682,1.0861,1.0866,1.08453,1.0861106666666667,1.0859511111111078,1.0859515555555503,1.0857645000000042,1.085265600000001,1.0862609,1.0875701500000035,1.0861191981494238,1.08588849633745,2731,-284421,-287239.8,0.034225350444880634,-257.3407005570023,-0.01564268428462356
2023-07-06T05:45:00-04:00,1.0866,1.08679,1.08603,1.08615,1.0845758,1.0861504444444443,1.0859411111111077,1.0859511111111062,1.0858560000000042,1.085278200000001,1.0862345000000004,1.0875494500000036,1.086125358519539,1.0859923970699594,-2072,-286493,-286188.2,0.017327852977911316,-258.19879001034315,-0.0082854617764164
2023-07-06T06:00:00-04:00,1.08615,1.08694,1.08611,1.08694,1.0846206840000001,1.0863502222222223,1.086094444444441,1.0859804444444392,1.0859720000000042,1.085308200000001,1.0862228000000003,1.0875340000000036,1.0862882868156312,1.086097117655967,1956,-284537,-285480.8,0.012282900501251928,-256.776113584435,0.12712332805187523
2023-07-06T06:15:00-04:00,1.08694,1.08882,1.08687,1.08869,1.08471345664,1.0868693333333335,1.0864666666666634,1.0860846666666615,1.0861845000000043,1.0853702000000012,1.0862202000000003,1.0875284500000035,1.086768629452505,1.086260094124773,4583,-279954,-284511.4,0.02325486569941477,-249.39737142755456,0.3086590377208952
2023-07-06T06:30:00-04:00,1.08869,1.089,1.08834,1.08857,1.0849598492416002,1.0872899999999999,1.086834444444441,1.0862575555555505,1.0863845000000043,1.085429400000001,1.0862127000000001,1.0875238500000035,1.087128903562004,1.086486075299818,-4533,-284487,-283978.4,0.034880366960773374,-249.89701779153287,0.30499603781583645
2023-07-06T06:45:00-04:00,1.08857,1.08895,1.08845,1.08867,1.0852830613022721,1.087657111111111,1.087212222222219,1.0865097777777728,1.0865415000000043,1.0854896000000012,1.0862052000000002,1.0875194500000036,1.0874371228496031,1.0867496602398539,3029,-281458,-283385.8,0.048289911274400986,-249.61876283319307,0.31328609470455
2023-07-06T07:00:00-04:00,1.08867,1.08886,1.08834,1.08871,1.0855804163980904,1.0879566666666667,1.0874688888888855,1.0868153333333281,1.0866835000000044,1.085553800000001,1.0862046000000003,1.0875130000000037,1.0876916982796825,1.0870629281918824,3146,-278312,-281749.6,0.06600483620638405,-249.50317225018802,0.2126288659793846
2023-07-06T07:15:00-04:00,1.08871,1.08951,1.08836,1.08943,1.0858539830862433,1.088348888888889,1.0877711111111077,1.0871506666666615,1.0868270000000042,1.085636800000001,1.0862139000000004,1.0875091500000038,1.088039358623746,1.0874131425535054,2696,-275616,-279965.4,0.07827595725406743,-247.72021811180448,0.2502967673068099
2023-07-06T07:30:00-04:00,1.08943,1.08978,1.08898,1.08961,1.086219584777619,1.0887166666666666,1.0881522222222189,1.0874877777777725,1.0869895000000043,1.085721000000001,1.0862272000000004,1.0875064500000038,1.0883534868989968,1.0877301140428037,2881,-272735,-278521.6,0.09158355657897772,-247.2442077210495,0.3157855972306657
2023-07-06T07:45:00-04:00,1.08961,1.08976,1.08912,1.0895299999999999,1.0866468346043048,1.0889922222222221,1.0884777777777745,1.0878164444444391,1.087129500000004,1.0857996000000012,1.0862445000000003,1.0875048500000037,1.0885887895191975,1.0880220912342424,-3107,-275842,-276792.6,0.10850082262656528,-247.4723260386129,0.26964844468984694
2023-07-06T08:00:00-04:00,1.0895299999999999,1.09006,1.08911,1.08969,1.0870228144517882,1.0892346666666666,1.0888711111111078,1.0881482222222167,1.0873160000000042,1.0858866000000011,1.0862621000000003,1.0875035500000036,1.088809031615358,1.0882964729873934,3946,-271896,-274880.2,0.12394294393750424,-246.8928468136254,0.3259218340008377
2023-07-06T08:15:00-04:00,1.08969,1.0897,1.08608,1.08786,1.09006,1.0890324444444446,1.08897333333333,1.0884491111111056,1.087370500000004,1.0859334000000012,1.0862608000000005,1.0874927500000038,1.0886192252922864,1.0884819783899142,-13928,-285824,-276382.6,0.1313381956350489,-270.2832055395015,0.08464128654755845
2023-07-06T08:30:00-04:00,1.08786,1.08815,1.08584,1.08695,1.09006,1.0886277777777775,1.0887799999999968,1.0886508888888835,1.087406000000004,1.0859662000000012,1.0862484000000006,1.087476400000004,1.088285380233829,1.0885311827119306,-11781,-297605,-280780.4,0.13064084125876224,-280.13806737834074,-0.15982511091310225
2023-07-06T08:45:00-04:00,1.08695,1.08763,1.08648,1.08738,1.0898912,1.088347777777778,1.0886477777777746,1.0887499999999948,1.087497000000004,1.086007800000001,1.0862432000000004,1.087465250000004,1.0881043041870633,1.088481346169544,7889,-289716,-284176.6,0.1135950603229854,-277.01716025289846,-0.10931772876342581
2023-07-06T09:00:00-04:00,1.08738,1.08849,1.0867,1.08697,1.089729152,1.0880122222222224,1.0884588888888855,1.088746222222217,1.0875785000000042,1.086042400000001,1.0862339000000005,1.0874546000000038,1.0878774433496505,1.0883390769356347,-6600,-296316,-288271.4,0.09270080759635488,-279.5057107136391,-0.15615383908806477
2023-07-06T09:15:00-04:00,1.08697,1.08877,1.08697,1.0886,1.08957358592,1.0880404444444445,1.0884466666666635,1.0886613333333284,1.0877455000000043,1.086116600000001,1.0862324000000003,1.0874497500000038,1.0880219546797205,1.0881816615485072,5120,-291196,-292131.4,0.07777087473539293,-271.8278539190632,-0.01010370071001961
2023-07-06T09:30:00-04:00,1.0886,1.08876,1.0875,1.08763,1.0894242424832,1.0878771111111112,1.0882466666666635,1.088515999999995,1.087863500000004,1.086176600000001,1.0862103000000005,1.0874378000000038,1.0879435637437764,1.088046529238805,-7962,-299158,-294798.2,0.05745858385299237,-278.9224157415869,-0.16522401622865185
2023-07-06T09:45:00-04:00,1.08763,1.0886,1.08688,1.08833,1.0892808727838719,1.087893777777778,1.0881044444444412,1.0883808888888837,1.087960000000004,1.086255600000001,1.0861994000000004,1.0874303500000038,1.088020850995021,1.0879936233910434,7720,-291438,-293564.8,0.033945267360253724,-273.9538142870487,-0.11747322436467615
2023-07-06T10:00:00-04:00,1.08833,1.08833,1.08461,1.0856,1.089143237872517,1.087392888888889,1.0876677777777748,1.0881848888888839,1.0879045000000043,1.086270600000001,1.0861592000000004,1.0874088500000039,1.087536680796017,1.0878800987128343,-12885,-304323,-296486.2,0.000586566746264815,-306.27493931346675,-0.36070599249217455
2023-07-06T10:15:00-04:00,1.0856,1.08605,1.08421,1.0845,1.088871243600166,1.0867593333333334,1.087091111111108,1.0879113333333281,1.0878205000000043,1.086260600000001,1.0861088000000003,1.087382150000004,1.0869293446368136,1.0876904789702668,-6526,-310849,-299392.8,-0.035981033674157704,-312.88750379393764,-0.47628224540924735
2023-07-06T10:30:00-04:00,1.0845,1.08476,1.08333,1.0839699999999999,1.0884983441121527,1.086135111111111,1.0866588888888857,1.0875537777777726,1.0876890000000041,1.086236200000001,1.0860581000000002,1.0873527500000038,1.0863374757094508,1.087353583176213,-6734,-317583,-304670.2,-0.07889973809519647,-316.1784397091068,-0.3575827771956107
2023-07-06T10:45:00-04:00,1.0839699999999999,1.08744,1.08377,1.0868,1.0879815097009375,1.0861633333333331,1.0866422222222192,1.0872328888888836,1.0877215000000042,1.086267200000001,1.0860349000000002,1.087336450000004,1.0864299805675606,1.0870508665409697,8240,-309343,-306707.2,-0.08952049378758478,-294.66566721540227,-0.013800082800505497
2023-07-06T11:00:00-04:00,1.0868,1.08705,1.08634,1.08666,1.0875163587308438,1.086166888888889,1.086562222222219,1.0869244444444393,1.0877075000000043,1.086303600000001,1.0860157000000001,1.0873206500000039,1.0864759844540484,1.0867418932327753,-5279,-314622,-311344,-0.0944175606327991,-295.34570034017236,-0.06621420294653699
2023-07-06T11:15:00-04:00,1.08666,1.08694,1.08587,1.08604,1.08744,1.0860624444444444,1.0864588888888855,1.0866826666666614,1.0875750000000042,1.086330200000001,1.0859957000000002,1.087301200000004,1.0863887875632388,1.0865123145862197,-4054,-318676,-314214.6,-0.10280124639920517,-297.65873293546457,-0.08555893906916451
2023-07-06T11:30:00-04:00,1.08604,1.08783,1.08583,1.08687,1.08333,1.0861446666666665,1.0862666666666634,1.0865177777777724,1.087490000000004,1.086380000000001,1.0859915000000002,1.087286450000004,1.086485030050591,1.0864234516689752,4682,-313994,-314843.6,-0.09575989880164566,-294.08054060368994,-0.15891971339335012
2023-07-06T11:45:00-04:00,1.08687,1.08733,1.08652,1.08723,1.0834199999999998,1.0863373333333333,1.0862222222222189,1.086430444444439,1.0874180000000042,1.086437800000001,1.0859902000000003,1.087272700000004,1.0866340240404728,1.0864827613351795,4059,-309935,-313314,-0.1024958149108637,-292.73609278564396,-0.036777212838941364
2023-07-06T12:00:00-04:00,1.08723,1.08859,1.08722,1.08776,1.0835081999999998,1.0866448888888887,1.0861588888888856,1.0863337777777722,1.0873705000000042,1.086502200000001,1.0859942000000002,1.087260600000004,1.0868592192323783,1.086568609068143,4316,-305619,-312569.2,-0.09731950961873377,-290.6321405400284,-0.05237382044048767
2023-07-06T12:15:00-04:00,1.08776,1.08781,1.08708,1.08714,1.0837114719999998,1.086841111111111,1.0863299999999967,1.086287333333328,1.087256000000004,1.086564600000001,1.0859921000000003,1.087243250000004,1.0869153753859027,1.086656487254514,-2406,-308025,-311249.8,-0.10139459722193585,-292.00350922429715,0.1418570375829124
2023-07-06T12:30:00-04:00,1.08714,1.08769,1.08714,1.08741,1.08390661312,1.0870571111111111,1.08665333333333,1.0863262222222168,1.0871460000000042,1.0866396000000011,1.0860000000000003,1.087230200000004,1.087014300308722,1.0867815898036106,2294,-305731,-308660.8,-0.07590924001826309,-291.4337757953,0.2683264177040081
2023-07-06T12:45:00-04:00,1.08741,1.08769,1.08706,1.08724,1.0840939485952,1.0871744444444444,1.0870166666666632,1.0864762222222168,1.0870315000000041,1.0867164000000011,1.0860053000000005,1.087215550000004,1.0870594402469775,1.086896471842888,-2396,-308127,-307487.4,-0.04033261264897897,-291.8083539213058,0.3016688653745128
2023-07-06T13:00:00-04:00,1.08724,1.0877,1.08721,1.08765,1.084273790651392,1.087301111111111,1.0871111111111076,1.0866539999999945,1.086929500000004,1.0867974000000011,1.0860193000000005,1.087203250000004,1.087177552197582,1.0870051774743097,2255,-305872,-306674.8,0.0017522126067312453,-290.95798969629567,0.07821126242179034
2023-07-06T13:15:00-04:00,1.08765,1.08803,1.08759,1.08791,1.0844464390253363,1.087460888888889,1.0872499999999965,1.0868722222222167,1.0869320000000042,1.086869200000001,1.0860347000000004,1.087193000000004,1.0873240417580656,1.0870981419794472,2028,-303844,-306319.8,0.01976211859049638,-290.47320139123445,0.11503138056061449
2023-07-06T13:30:00-04:00,1.08791,1.08821,1.08762,1.08789,1.0846121814643228,1.087588888888889,1.0874555555555518,1.0870973333333276,1.0869790000000044,1.0869346000000013,1.0860508000000002,1.087182400000004,1.0874372334064526,1.087202513583557,-1936,-305780,-305870.8,0.030946446963506024,-290.50879257065174,0.1703436337519916
2023-07-06T13:45:00-04:00,1.08789,1.0882,1.0875299999999999,1.08818,1.08477129420575,1.0877337777777776,1.0876011111111075,1.0872868888888831,1.0870190000000044,1.0870094000000012,1.0860719000000003,1.087172800000004,1.0875857867251622,1.0873168108668452,1933,-303847,-305494,0.04524316008255469,-289.993510694727,0.12052959415568765
2023-07-06T14:00:00-04:00,1.08818,1.08826,1.08783,1.08784,1.08492404243752,1.0877815555555554,1.0876688888888852,1.0874173333333277,1.0870625000000043,1.0870748000000012,1.0860883000000003,1.0871629500000042,1.0876366293801296,1.0874322486934755,-1783,-305630,-304994.6,0.05215036476810713,-290.5506060282196,0.05610588375964602
2023-07-06T14:15:00-04:00,1.08784,1.08803,1.08772,1.08777,1.0850706807400192,1.0878017777777778,1.0876699999999966,1.0875291111111054,1.0870210000000042,1.0871196000000014,1.0861059000000002,1.0871552000000042,1.0876633035041037,1.0875293989547798,-1643,-307273,-305274.8,0.05361158735708925,-290.6563292963473,0.0009193204383175946
2023-07-06T14:30:00-04:00,1.08777,1.08835,1.08775,1.08835,1.0852114535104185,1.087937777777778,1.0878044444444408,1.0876399999999944,1.0870570000000042,1.0871692000000015,1.0861304000000003,1.087150700000004,1.087800642803283,1.0876247191638233,1410,-305863,-305678.6,0.06013464588791688,-289.9045159534531,0.11130121235534829
2023-07-06T14:45:00-04:00,1.08835,1.08857,1.08804,1.08807,1.0853465953700017,1.087990888888889,1.087877777777774,1.0877244444444387,1.0870440000000041,1.0871994000000014,1.0861516000000002,1.0871439500000042,1.0878545142426264,1.087708175331058,-1710,-307573,-306037.2,0.0667609610672613,-290.3444479606196,0.06069467818027285
2023-07-06T15:00:00-04:00,1.08807,1.08851,1.08806,1.08823,1.0854763315552016,1.0880613333333333,1.087987777777774,1.0878017777777722,1.087175500000004,1.0872368000000014,1.0861735000000003,1.0871368000000041,1.087929611394101,1.0877769402648458,1561,-306012,-306470.2,0.07474229174974202,-290.11490390554974,0.09105625252934461
2023-07-06T15:15:00-04:00,1.08823,1.08859,1.08823,1.08847,1.0856008782929936,1.0881577777777778,1.088078888888885,1.0878837777777721,1.087374000000004,1.0872716000000013,1.0862038000000003,1.0871313500000042,1.0880376891152808,1.087857152211876,994,-305018,-306347.8,0.07347588776825917,-289.8956855417847,0.07539189996782447
2023-07-06T15:30:00-04:00,1.08847,1.0887499999999999,1.08819,1.08863,1.085720443161274,1.088268,1.0881588888888851,1.0879815555555497,1.087607000000004,1.0873250000000012,1.0862345000000004,1.0871271500000041,1.0881561512922246,1.0879557217695004,1350,-303668,-305626.8,0.06438925018346323,-289.6972418547746,0.06618194519767756
2023-07-06T15:45:00-04:00,1.08863,1.08888,1.08852,1.08882,1.0859022165715975,1.0884002222222222,1.0882622222222185,1.0880731111111053,1.0877080000000041,1.0873660000000014,1.0862692000000003,1.0871243500000043,1.0882889210337796,1.0880533774155996,1765,-301903,-304834.8,0.051508342907083296,-289.38919412505936,0.08548658412154495
2023-07-06T16:00:00-04:00,1.08882,1.08882,1.08852,1.0886,1.0861404392458698,1.0884677777777776,1.088308888888885,1.0881593333333273,1.087805000000004,1.0874132000000012,1.0863008000000003,1.0871200000000043,1.0883511368270238,1.0881527019324793,-1063,-302966,-303913.4,0.05015155786809113,-289.6039771011251,0.03859655571689307
2023-07-06T16:15:00-04:00,1.0886,1.08886,1.08857,1.08883,1.0863596041062002,1.088572,1.088418888888885,1.0882455555555495,1.0879445000000039,1.0874786000000014,1.0863355000000001,1.0871168500000044,1.088446909461619,1.0882561615459827,598,-302368,-303184.6,0.046623036271367706,-289.4776313359221,0.0910060302985776
2023-07-06T16:30:00-04:00,1.08883,1.08905,1.08878,1.089,1.0865612357777041,1.0886882222222223,1.0885555555555517,1.0883408888888828,1.088051000000004,1.0875518000000013,1.08637,1.0871163500000043,1.0885575275692951,1.0883601292367857,568,-301800,-302541,0.04432356773458698,-289.38894898881557,0.11307537438981259
2023-07-06T16:45:00-04:00,1.089,1.08926,1.08847,1.08876,1.0868101121999336,1.088729111111111,1.0886011111111074,1.0884293333333273,1.088127500000004,1.0876218000000013,1.0864026000000002,1.0871165000000043,1.088598022055436,1.088448503389428,-809,-302609,-302329.2,0.04514704299154026,-289.5672409998349,0.037671704874353056
2023-07-06T17:00:00-04:00,1.08876,1.08877,1.0886,1.0887499999999999,1.0871040987359415,1.0887588888888888,1.0886766666666627,1.088512222222216,1.088177000000004,1.0876914000000013,1.0864355,1.0871169000000043,1.0886284176443488,1.088516402711542,-151,-302760,-302500.6,0.04216827926669923,-289.56862789869234,0.062495979118971375
2023-07-06T17:15:00-04:00,1.0887499999999999,1.08888,1.0887499999999999,1.08883,1.0873628068876284,1.0887895555555553,1.0887433333333294,1.088599111111105,1.088261500000004,1.0877400000000013,1.0864690000000001,1.0871188500000044,1.088668734115479,1.0885799221692332,70,-302690,-302445.4,0.0444680354819631,-289.5634843854891,0.05513540336141568
2023-07-06T17:30:00-04:00,1.08883,1.08888,1.0888,1.08888,1.087590470061113,1.088816888888889,1.0887888888888848,1.088673111111105,1.088335000000004,1.0877834000000013,1.0865039,1.0871226500000044,1.0887109872923832,1.0886327377353857,62,-302628,-302497.4,0.042823807184206114,-289.5606372927382,0.037667551701013484
2023-07-06T17:45:00-04:00,1.08888,1.0889199999999999,1.08883,1.08891,1.0877908136537795,1.0888411111111111,1.088819999999996,1.0887259999999936,1.088418500000004,1.0878380000000012,1.0865392,1.0871255500000043,1.0887507898339066,1.088671390188308,40,-302588,-302655,0.04030082767456709,-289.55953524292556,0.02572040087082461
2023-07-06T18:00:00-04:00,1.08891,1.08908,1.08891,1.08898,1.087967116015326,1.0888731111111114,1.0888377777777738,1.088773333333327,1.088485000000004,1.0878856000000012,1.0865756000000002,1.0871291500000044,1.0887966318671254,1.0887111121506459,317,-302271,-302587.4,0.03590092464814982,-289.5391570665841,0.014694807222512447
2023-07-06T18:15:00-04:00,1.08898,1.08903,1.08896,1.08899,1.0881222620934867,1.0889035555555555,1.0888811111111072,1.0888142222222157,1.088539000000004,1.0879424000000013,1.0866103,1.0871329000000045,1.0888353054937003,1.088752489720516,402,-301869,-302409.2,0.031598486177765915,-289.5354655387324,0.035825831342999305
2023-07-06T18:30:00-04:00,1.08899,1.0891,1.08897,1.08909,1.0882587906422683,1.0889453333333332,1.088909999999996,1.088847555555549,1.0885990000000039,1.0879854000000013,1.0866468,1.0871380500000043,1.0888862443949603,1.0887959917764123,369,-301500,-302171.2,0.030936308911963334,-289.5015809300583,0.023878842427185784
2023-07-06T18:45:00-04:00,1.08909,1.08912,1.08904,1.08911,1.088378935765196,1.0889853333333332,1.0889222222222186,1.0888742222222159,1.088645500000004,1.0879938000000013,1.086682,1.0871447500000044,1.0889309955159683,1.0888399934211292,308,-301192,-301884,0.02817013537005523,-289.49592483184784,0.010101010101015107
2023-07-06T19:00:00-04:00,1.08911,1.08942,1.08906,1.08941,1.0884846634733725,1.0890828888888888,1.0889944444444408,1.0889091111111047,1.088724000000004,1.0880106000000014,1.08672,1.0871514500000043,1.0890267964127747,1.088895194736903,511,-300681,-301502.6,0.02655461038106896,-289.3551676998777,0.05970094419339794
2023-07-06T19:15:00-04:00,1.08941,1.08949,1.08925,1.08926,1.0886156105871003,1.0891359999999999,1.0890511111111074,1.0889517777777713,1.0887985000000038,1.0880224000000014,1.086756,1.0871575500000044,1.0890734371302198,1.088950555789522,-646,-301327,-301313.8,0.02493467822881171,-289.44411492819404,0.04684270952927766
2023-07-06T19:30:00-04:00,1.08926,1.0893,1.08907,1.08913,1.0887555128931643,1.089151777777778,1.089084444444441,1.0889924444444383,1.088837500000004,1.0880308000000014,1.0867923,1.0871632000000044,1.0890847497041758,1.0890004446316168,-476,-301803,-301300.6,0.02247530078621785,-289.5009241381164,0.02755251049291138
2023-07-06T19:45:00-04:00,1.08913,1.08917,1.08895,1.08895,1.088873030830258,1.089124888888889,1.0890922222222188,1.0890288888888828,1.088881500000004,1.0880212000000014,1.0868289999999998,1.0871686000000045,1.0890577997633406,1.089034755705293,-568,-302371,-301474.8,0.020952780802976297,-289.5947972294828,0.006428623907135267
2023-07-06T20:00:00-04:00,1.08895,1.0891,1.08865,1.08871,1.08949,1.0890484444444446,1.0890699999999967,1.0890584444444384,1.088905500000004,1.0880032000000013,1.0868620999999998,1.0871724000000045,1.0889882398106725,1.0890462045642342,-1526,-303897,-302015.8,0.016592073764639836,-289.9311212113002,-0.01836699084405304
2023-07-06T20:15:00-04:00,1.08871,1.0889,1.0885799999999999,1.08861,1.0894732,1.0889564444444444,1.0890288888888857,1.0890653333333273,1.088912500000004,1.0879848000000014,1.0868922,1.0871759500000044,1.088912591848538,1.0890233636513866,-1373,-305270,-302933.6,0.012174898717758344,-290.0572337665261,-0.03397674888427533
2023-07-06T20:30:00-04:00,1.08861,1.08878,1.08828,1.08844,1.089437472,1.0888386666666667,1.0889677777777744,1.0890486666666608,1.088903000000004,1.0879598000000015,1.0869232,1.0871779000000046,1.0888180734788304,1.0889722909211088,-1485,-306755,-304019.2,0.007346931278934376,-290.2891349983722,-0.05050551428386197
2023-07-06T20:45:00-04:00,1.08844,1.0885799999999999,1.08822,1.08851,1.0893680236799999,1.0887471111111113,1.08890333333333,1.0890124444444385,1.088887500000004,1.0879728000000015,1.0869531000000001,1.0871801500000045,1.0887564587830643,1.0889066327368864,1678,-305077,-304674,0.00346357149357073,-290.1812190820148,-0.05325547016314565
2023-07-06T21:00:00-04:00,1.08851,1.08898,1.08847,1.0889199999999999,1.0892761817855998,1.0887504444444445,1.088882222222219,1.0889704444444386,1.0889035000000038,1.0880122000000012,1.0869892,1.0871843500000045,1.0887891670264513,1.0888529061895087,1561,-303516,-304903,0.0014650143640305693,-289.5932502071311,-0.017445437100029795
2023-07-06T21:15:00-04:00,1.0889199999999999,1.08914,1.08873,1.08877,1.0891916872427518,1.0887280000000001,1.088811111111108,1.0889186666666608,1.088900500000004,1.0880400000000012,1.0870239,1.0871877000000045,1.088785333621161,1.0888123249516064,-1805,-305321,-305187.8,-0.002400856436310667,-289.84189106229013,-0.05874739537914779
2023-07-06T21:30:00-04:00,1.08877,1.08888,1.08863,1.08878,1.08914,1.0887217777777778,1.0887577777777746,1.0888644444444386,1.088889500000004,1.0880762000000013,1.0870593,1.0871904000000046,1.0887842668969288,1.0887866599612843,1668,-303653,-304864.4,-0.007967887053310106,-289.8265710222448,-0.04406661403152727
2023-07-06T21:45:00-04:00,1.08878,1.08887,1.08865,1.08871,1.08914,1.0887122222222223,1.088711111111108,1.0888131111111055,1.088887000000004,1.0880784000000014,1.0870975,1.0871927500000047,1.088769413517543,1.088776927969027,-1589,-305242,-304561.8,-0.011750814509956829,-289.92873123826644,-0.03856288964585173
2023-07-06T22:00:00-04:00,1.08871,1.08885,1.08864,1.08866,1.0890664,1.088702,1.0886788888888856,1.0887682222222164,1.088882500000004,1.0880990000000013,1.0871378,1.0871940000000047,1.0887475308140344,1.088775142375221,-1593,-306835,-304913.4,-0.015629919882092037,-290.00189121658957,-0.026631158455404147
2023-07-06T22:15:00-04:00,1.08866,1.08872,1.08844,1.08845,1.088998688,1.0886562222222222,1.0886499999999968,1.088721777777772,1.088863500000004,1.0881014000000013,1.0871785,1.0871928000000046,1.0886880246512276,1.0887549139001762,-1247,-308082,-305826.6,-0.018910089608285958,-290.24243463694125,-0.02388147440550275
2023-07-06T22:30:00-04:00,1.08845,1.08855,1.08834,1.08854,1.08893639296,1.0886342222222223,1.088642222222219,1.088687999999994,1.0888465000000038,1.0881602000000015,1.0872153999999998,1.0871909500000045,1.088658419720982,1.0887295311201404,1033,-307049,-306172.2,-0.01920334333189006,-290.1570195972057,-0.006430218351844507
2023-07-06T22:45:00-04:00,1.08854,1.08864,1.08846,1.0886,1.0888790815232,1.0886257777777777,1.0886599999999966,1.0886684444444386,1.0888310000000039,1.0882422000000012,1.0872514,1.0871907000000045,1.0886467357767857,1.088702024896112,1077,-305972,-306636,-0.01807086912012717,-290.09765567856243,0.014699937525259818
2023-07-06T23:00:00-04:00,1.0886,1.08913,1.08857,1.08906,1.08822,1.0887057777777778,1.088721111111108,1.0886704444444386,1.088835000000004,1.088344000000001,1.0872901,1.0871954000000046,1.0887293886214287,1.0886940199168889,1152,-304820,-306551.6,-0.013032632311497386,-289.61086530560647,0.050527785688677954
2023-07-06T23:15:00-04:00,1.08906,1.08916,1.08887,1.08902,1.0882382,1.0887655555555555,1.0887322222222189,1.0886811111111052,1.0888365000000042,1.0883884000000013,1.0873278,1.0871982500000046,1.088787510897143,1.0887020159335106,-1104,-305924,-306369.4,-0.008523676490050197,-289.6514140357038,0.009183411086233243
2023-07-06T23:30:00-04:00,1.08902,1.08905,1.08869,1.08871,1.0882750719999998,1.088761111111111,1.0887255555555524,1.0886962222222163,1.0888175000000042,1.0884294000000012,1.0873665,1.0872011500000047,1.0887720087177144,1.088718812746808,-1117,-307041,-306161.2,-0.009227900271850862,-289.9693788113737,-0.005510805771645893
2023-07-06T23:45:00-04:00,1.08871,1.08888,1.08866,1.08877,1.0883104691199998,1.0887699999999998,1.088724444444441,1.0887126666666607,1.088800500000004,1.0884840000000011,1.0874070999999998,1.0872065500000045,1.0887716069741715,1.0887414501974457,1188,-305853,-305922,-0.007828517846943847,-289.9039068307729,-0.0009184591928640783
2023-07-07T00:00:00-04:00,1.08877,1.08885,1.08855,1.08885,1.0883444503551998,1.0887951111111112,1.0887399999999967,1.0887286666666607,1.0887725000000041,1.0885236000000011,1.0874518,1.0872124500000044,1.0887872855793372,1.0887695601579561,886,-304967,-305721,-0.0060485828468875786,-289.83880584525707,0.012859255449112159
2023-07-07T00:15:00-04:00,1.08885,1.08922,1.08881,1.08921,1.0883770723409918,1.088889111111111,1.0888011111111078,1.0887446666666607,1.0887700000000042,1.088563200000001,1.0875004999999998,1.0872207000000045,1.0888718284634697,1.0887980481263644,653,-304314,-305619.8,-0.000581683698446999,-289.6229083387135,0.05052082376500013
2023-07-07T00:30:00-04:00,1.08921,1.08949,1.08913,1.08947,1.0884276480005324,1.0890228888888889,1.088914444444441,1.0887811111111052,1.088787000000004,1.088597400000001,1.0875498,1.0872300500000045,1.0889914627707757,1.088838838501091,1023,-303291,-305093.2,0.005939242165265945,-289.3787130044805,0.09371124075520428
2023-07-07T00:45:00-04:00,1.08947,1.08952,1.08909,1.0891,1.0885126361604898,1.08906,1.0889766666666632,1.0888313333333275,1.088794500000004,1.088636600000001,1.0876005999999998,1.0872365000000046,1.0890131702166206,1.0888870708008722,-731,-304022,-304489.4,0.012040320422408624,-289.6269713319241,0.05144505484409336
2023-07-07T01:00:00-04:00,1.0891,1.08962,1.08903,1.08947,1.0886133725444407,1.0891586666666666,1.08907333333333,1.0889011111111053,1.0888325000000039,1.088677800000001,1.0876586999999998,1.0872446000000047,1.0891045361732965,1.0889536566406972,1502,-302520,-303822.8,0.01830716857321373,-289.11669679331425,0.07991916222670645
2023-07-07T01:15:00-04:00,1.08947,1.08954,1.08917,1.08924,1.0887341678391078,1.089192,1.08909333333333,1.088971777777772,1.088864000000004,1.0887178000000008,1.0877170999999997,1.0872525500000048,1.0891316289386372,1.0890225253125572,-1250,-303770,-303583.4,0.0218666319136177,-289.38058657458396,0.01652801498540659
2023-07-07T01:30:00-04:00,1.08924,1.0893599999999999,1.08909,1.08924,1.088840467698415,1.0892213333333332,1.0891177777777745,1.0890351111111056,1.088904000000004,1.0887496000000008,1.0877734999999997,1.0872595000000047,1.0891533031509097,1.0890788202500452,0,-303770,-303474.6,0.020763981576864928,-289.38058657458396,0.02020164918916888
2023-07-07T01:45:00-04:00,1.08924,1.08938,1.08862,1.08874,1.08962,1.0891457777777778,1.0891211111111079,1.0890764444444387,1.0889155000000041,1.088766200000001,1.0878176999999996,1.0872645000000047,1.0890706425207277,1.0890946562000354,-2026,-305796,-303975.6,0.016880353280761862,-290.31059281746883,0.002755554739092549
2023-07-07T02:00:00-04:00,1.08874,1.09002,1.0887,1.08974,1.08862,1.0892695555555554,1.0892288888888855,1.0891268888888832,1.088956500000004,1.0888032000000007,1.0878688999999997,1.0872746000000046,1.0892045140165822,1.089132924960028,3000,-302796,-303730.4,0.020959373449307775,-287.55511400710117,0.0890913599750099
2023-07-07T02:15:00-04:00,1.08974,1.08977,1.08905,1.0891899999999999,1.08862,1.0892617777777778,1.0892666666666633,1.08916555555555,1.0889775000000042,1.0888234000000008,1.0879163999999997,1.0872822500000046,1.0892016112132659,1.0891523399680216,-2170,-304966,-304219.6,0.023635317330129083,-288.65032937957545,0.031225604996077044
2023-07-07T02:30:00-04:00,1.0891899999999999,1.08948,1.08913,1.08926,1.0886479999999998,1.0892604444444445,1.0892722222222189,1.0892013333333277,1.0890015000000042,1.0888518000000007,1.0879632999999997,1.0872902500000046,1.0892132889706128,1.089168671974417,2082,-302884,-304042.4,0.02525710782535078,-288.51652352384775,0.004590483010611679
2023-07-07T02:45:00-04:00,1.08926,1.0893599999999999,1.08811,1.08829,1.09002,1.0890639999999998,1.0891411111111078,1.0892059999999943,1.0889805000000041,1.0888622000000008,1.0879908999999996,1.0872938500000047,1.0890286311764903,1.089143737579533,-2781,-305665,-304421.4,0.01895198248086824,-290.99303969078653,-0.10830954500811944
2023-07-07T03:00:00-04:00,1.08829,1.0891,1.08793,1.08855,1.0899818,1.0889457777777778,1.0890799999999965,1.0891977777777722,1.0889750000000042,1.088866200000001,1.0880176999999995,1.0873021500000046,1.0889329049411922,1.0891161900636257,4163,-301502,-303562.6,0.011203349985629229,-289.998470228603,-0.05050041318520342
2023-07-07T03:15:00-04:00,1.08855,1.08886,1.08772,1.08816,1.0898997279999998,1.0887617777777778,1.0889344444444409,1.0891388888888833,1.0889605000000042,1.0888680000000006,1.0880336999999995,1.0873060500000047,1.0887783239529538,1.0890309520509,-3883,-305385,-304080.4,0.004757810812609636,-291.3896511573611,-0.12024195250901103
2023-07-07T03:30:00-04:00,1.08816,1.08879,1.08803,1.0882,1.0897689443199998,1.0886148888888887,1.0888188888888852,1.0890493333333278,1.088943500000004,1.0888674000000007,1.0880520999999996,1.0873081500000046,1.0886626591623632,1.0889231616407196,4491,-300894,-303266,-0.005811764427739324,-291.22456514059866,-0.09547941684109378
2023-07-07T03:45:00-04:00,1.0882,1.08844,1.08716,1.0876,1.0896460076607999,1.088371111111111,1.0886366666666631,1.0889222222222166,1.0888935000000042,1.0888500000000008,1.0880607999999996,1.0873055500000048,1.0884501273298905,1.0887705293125751,-4056,-304950,-303679.2,-0.016762534837808013,-293.4609187520677,-0.1505636957878967
2023-07-07T04:00:00-04:00,1.0876,1.0876,1.08676,1.08715,1.0894471270479358,1.0880737777777776,1.0884599999999967,1.0887859999999943,1.0887980000000042,1.0888204000000008,1.0880726999999997,1.0873014000000047,1.0881901018639124,1.0886028234500595,-3709,-308659,-304278,-0.029617293140036832,-294.99553625850336,-0.14604037694949945
2023-07-07T04:15:00-04:00,1.08715,1.08806,1.0867,1.08779,1.0891784143431422,1.0879397777777777,1.08824333333333,1.088618666666661,1.088736500000004,1.0887998000000008,1.0880828999999996,1.0873032500000048,1.08811008149113,1.0884382587600472,3375,-305284,-305034.4,-0.03278989667018228,-293.0086899171522,-0.17894176592580766
2023-07-07T04:30:00-04:00,1.08779,1.08808,1.08756,1.08758,1.0888810046219652,1.087807111111111,1.088064444444441,1.088444666666661,1.088680000000004,1.0887794000000008,1.0880962999999997,1.087300750000005,1.088004065192904,1.0882834070080372,-3114,-308398,-305637,-0.04633390064226478,-293.6098537447293,-0.1478162671342823
2023-07-07T04:45:00-04:00,1.08758,1.08801,1.08734,1.08778,1.0886192840673294,1.0877502222222222,1.0878999999999965,1.0882608888888834,1.088630500000004,1.0887584000000006,1.0881184999999995,1.0872983500000049,1.087959252154323,1.088142725606429,2787,-305611,-306580.4,-0.05521976363598936,-293.09733972277235,-0.1358720599305883
2023-07-07T05:00:00-04:00,1.08778,1.0885,1.08777,1.0881,1.0867,1.0877902222222224,1.0878788888888853,1.0881093333333278,1.0885930000000041,1.0887404000000007,1.0881460999999997,1.0872879500000048,1.0879874017234585,1.0880501804851428,3145,-302466,-306083.6,-0.06294642642299265,-292.17215264450255,-0.017458581811825198
2023-07-07T05:15:00-04:00,1.0881,1.08816,1.08732,1.08737,1.086736,1.0876884444444443,1.0877477777777742,1.0879668888888834,1.088501000000004,1.0887126000000007,1.0881671999999998,1.0872751500000049,1.0878639213787669,1.0879849443881136,-2902,-305368,-305425.4,-0.0649278212779854,-294.1190876688572,-0.10840108401083634
2023-07-07T05:30:00-04:00,1.08737,1.08887,1.087,1.08848,1.08677128,1.087834888888889,1.0877833333333298,1.0878748888888832,1.0884515000000041,1.0887072000000007,1.0881992999999996,1.087269150000005,1.0879871371030134,1.0879603555104904,3473,-301895,-304747.6,-0.062379421221526926,-290.5738086929798,0.02940744008232943
2023-07-07T05:45:00-04:00,1.08848,1.08877,1.08796,1.08803,1.0868552288,1.0878842222222223,1.0877644444444412,1.0878148888888832,1.088398000000004,1.0886912000000006,1.0882155999999998,1.087266000000005,1.0879957096824107,1.0879586844083917,-2966,-304861,-304040.2,-0.05727770763134666,-291.80001404356,-0.015622128285242003
2023-07-07T06:00:00-04:00,1.08803,1.08825,1.08784,1.08817,1.086935819648,1.0879653333333332,1.0878277777777743,1.0878004444444387,1.0883330000000042,1.0886770000000008,1.0882301999999997,1.0872683500000049,1.0880305677459285,1.0879729475267128,2619,-302242,-303366.4,-0.05348674513104741,-291.4630196592139,0.05240897388747531
2023-07-07T06:15:00-04:00,1.08817,1.0883,1.08778,1.08829,1.0870131868620798,1.0880577777777776,1.087954444444441,1.0878155555555498,1.088285500000004,1.0886646000000006,1.0882512999999998,1.0872693000000049,1.0880824541967429,1.08799195802137,2058,-300184,-302910,-0.04198652808218687,-291.2360698260079,0.10486133468241905
2023-07-07T06:30:00-04:00,1.08829,1.08963,1.08827,1.08944,1.0870874593875965,1.0883548888888888,1.088137777777774,1.0878935555555498,1.088295500000004,1.0886738000000005,1.0882796999999997,1.087270300000005,1.0883539633573942,1.0880899664170953,2481,-297703,-301377,-0.021820027433296304,-288.6143881051431,0.1516836889473087
2023-07-07T06:45:00-04:00,1.08944,1.08954,1.08909,1.08923,1.0872400118243408,1.0885733333333332,1.0883211111111075,1.0880011111111052,1.0883200000000042,1.0886786000000006,1.0883104999999997,1.087272500000005,1.0885291706859153,1.0881983731336757,-2297,-300000,-300998,-0.008545123766113884,-289.05715686707595,0.15171297743613613
2023-07-07T07:00:00-04:00,1.08923,1.08934,1.08889,1.08913,1.0873834111148803,1.088735111111111,1.0884711111111072,1.0881424444444385,1.0882895000000041,1.0886794000000004,1.0883323999999996,1.0872776000000048,1.0886493365487322,1.0883290985069398,-1926,-301926,-300411,0.003990281564611181,-289.2339790258486,0.12410597731158528
2023-07-07T07:15:00-04:00,1.08913,1.0893,1.08885,1.08911,1.0875182064479876,1.088862888888889,1.0885833333333297,1.0882935555555495,1.088285500000004,1.0886794000000006,1.0883365999999997,1.087278400000005,1.0887414692389858,1.0884712788055515,-2406,-304332,-300829,0.018967486184921778,-289.2781610794141,0.09282235088686291
2023-07-07T07:30:00-04:00,1.08911,1.08969,1.0891,1.08931,1.0876449140611084,1.0890082222222222,1.088798888888885,1.0884624444444384,1.0882880000000041,1.0886774000000008,1.0883439999999998,1.087278350000005,1.0888551753911886,1.0886258230444406,2081,-302251,-301242.4,0.02956024540814675,-288.89601418883376,0.17841213202498257
2023-07-07T07:45:00-04:00,1.08931,1.08967,1.08873,1.0887499999999999,1.0878085209362198,1.0889984444444445,1.088828888888885,1.0886006666666606,1.088311000000004,1.0886672000000006,1.0883447999999998,1.0872750000000049,1.088834140312951,1.088721858435552,-2794,-305045,-302710.8,0.0444726226905868,-290.3323729847691,0.024805232985446908
2023-07-07T08:00:00-04:00,1.0887499999999999,1.08928,1.08848,1.08852,1.0879590392613223,1.0889366666666667,1.0888833333333294,1.088713111111105,1.088309500000004,1.0886550000000006,1.0883428999999998,1.087273750000005,1.0887713122503606,1.088770286748441,-3799,-308844,-304479.6,0.0438333579821283,-291.13491718683554,0.045035522917555526
2023-07-07T08:15:00-04:00,1.08852,1.08946,1.08743,1.08874,1.08969,1.088908,1.0889466666666627,1.0888082222222162,1.0883385000000039,1.0886508000000006,1.0883359999999997,1.087274950000005,1.0887650498002885,1.0887934293987525,4175,-304669,-305028.2,0.04952541968004569,-290.2911109177725,0.05238152126965082
2023-07-07T08:30:00-04:00,1.08874,1.09314,1.08871,1.09104,1.08743,1.0893266666666668,1.0892522222222185,1.088941999999994,1.088480500000004,1.0886974000000007,1.0883502999999997,1.0872887500000048,1.0892200398402307,1.0888891435190013,19796,-284873,-301136.4,0.06328690281387221,-248.4713927114061,0.2526899999081155
2023-07-07T08:45:00-04:00,1.09104,1.09249,1.09036,1.09115,1.08743,1.0897062222222225,1.0894422222222184,1.0890706666666605,1.088658000000004,1.0887482000000006,1.0883664999999998,1.087305500000005,1.0896060318721845,1.0890393148152004,11664,-273209,-295328,0.07664662067260697,-247.29541382887143,0.15696137465120616
2023-07-07T09:00:00-04:00,1.09115,1.09129,1.08951,1.09083,1.0875442,1.0899837777777779,1.089619999999996,1.0892288888888828,1.088842000000004,1.0887960000000005,1.0883778999999998,1.0873200000000047,1.0898508254977477,1.0892426518521598,-10456,-283665,-291052,0.07527557526081649,-250.3618299953023,0.14689275910506008
2023-07-07T09:15:00-04:00,1.09083,1.09135,1.09042,1.09076,1.087656116,1.0902117777777778,1.0898011111111072,1.0894124444444384,1.088990500000004,1.0888410000000004,1.0884068999999996,1.0873338500000047,1.0900326603981982,1.0894949214817273,-6866,-290531,-287389.4,0.07352761111824017,-250.8024302721558,0.1496607383875222
2023-07-07T09:30:00-04:00,1.09076,1.09167,1.09049,1.09125,1.08776579368,1.0905015555555553,1.090038888888885,1.089630888888883,1.0891740000000039,1.0888876000000005,1.0884498999999996,1.0873491500000048,1.0902761283185587,1.0897971371853814,10562,-279969,-282449.4,0.07785384673941417,-246.0576834900946,0.19649071260019932
2023-07-07T09:45:00-04:00,1.09125,1.09248,1.09124,1.09161,1.0878732778064,1.0908157777777776,1.0902944444444407,1.0898393333333274,1.089365500000004,1.0889444000000006,1.0884921999999997,1.0873677000000048,1.090542902654847,1.0900617097483045,9806,-270163,-279507.4,0.08317344325237971,-242.8227144179304,0.2111428335368232
2023-07-07T10:00:00-04:00,1.09161,1.0923,1.09095,1.09195,1.087978612250272,1.0911468888888889,1.0906499999999963,1.090080888888883,1.089558000000004,1.0890078000000005,1.0885419999999997,1.0873879500000048,1.0908243221238776,1.0903053677986432,6193,-263970,-277659.6,0.08916372295290871,-240.89380207744244,0.29391504018370535
2023-07-07T10:15:00-04:00,1.09195,1.093,1.09165,1.09292,1.0880818400052665,1.0916008888888888,1.091138888888885,1.090384666666661,1.089835500000004,1.0890920000000006,1.0885851999999998,1.0874088000000048,1.0912434576991021,1.090583894238914,5357,-258613,-272649.2,0.10634904265359615,-236.1350768610868,0.40421857200602285
2023-07-07T10:30:00-04:00,1.09292,1.0948499999999999,1.09277,1.09482,1.0881830032051611,1.092337111111111,1.0918144444444406,1.0907873333333273,1.090152500000004,1.0892152000000006,1.0886570999999996,1.0874337000000047,1.0919587661592818,1.0909691153911307,7511,-251102,-264763.4,0.1315639452674459,-223.07748801652352,0.5584437055678916
2023-07-07T10:45:00-04:00,1.09482,1.09541,1.09428,1.09488,1.0884496830769548,1.0929502222222223,1.0922411111111077,1.0912277777777721,1.0904950000000038,1.0893438000000006,1.0887225999999999,1.087461000000005,1.0925430129274254,1.0914224923129041,6845,-244257,-257621,0.15988781518716053,-222.70235785814026,0.3519577650681978
2023-07-07T11:00:00-04:00,1.09488,1.09526,1.09445,1.09493,1.0888673020923374,1.0934879999999998,1.0926611111111078,1.0917011111111055,1.090833000000004,1.0894716000000004,1.0888159,1.0874875500000047,1.0930204103419403,1.0919179938503227,4926,-239331,-251454.6,0.16537996571063646,-222.47740169856166,0.34642349814415013
2023-07-07T11:15:00-04:00,1.09493,1.0951899999999999,1.0946,1.09489,1.0892598639667972,1.0939337777777778,1.0931122222222187,1.09219355555555,1.0911630000000039,1.0895974000000006,1.0889197999999998,1.087514300000005,1.0933943282735523,1.0924319950802577,-4152,-243483,-247357.2,0.17028092817851348,-222.6290826279363,0.37219365070633853
2023-07-07T11:30:00-04:00,1.09489,1.09576,1.09489,1.09568,1.0896288721287894,1.0944473333333333,1.0936588888888854,1.09269755555555,1.091475000000004,1.0897298000000006,1.0890368999999998,1.0875475000000048,1.0938514626188418,1.0929535960642056,3622,-239861,-243606.8,0.1824211765469165,-220.01568767501843,0.4510616450914991
2023-07-07T11:45:00-04:00,1.09568,1.09634,1.0955,1.0963,1.0901193623584864,1.0949755555555556,1.0942199999999964,1.0931786666666614,1.091828500000004,1.0898754000000006,1.0891318999999997,1.0875834000000046,1.0943411700950734,1.0934300768513638,3043,-236818,-240750,0.20319029216028386,-218.29377981870982,0.46277205040091624
2023-07-07T12:00:00-04:00,1.0963,1.09679,1.09628,1.09667,1.0907414261226378,1.0954655555555555,1.0947822222222188,1.0936868888888838,1.092205500000004,1.0900346000000005,1.0892319999999998,1.0876238500000048,1.0948069360760586,1.0938828614810905,3315,-233503,-238599.2,0.22031339662464816,-217.17497109846906,0.46353551176702895
2023-07-07T12:15:00-04:00,1.09667,1.09683,1.09648,1.09677,1.0914672549879212,1.095863111111111,1.0953177777777743,1.094218222222217,1.092588500000004,1.0901946000000007,1.0893392999999998,1.0876675000000047,1.0951995488608468,1.0943186891848717,2317,-231186,-236970.2,0.2341714877549548,-216.96369514490056,0.4414121525710927
2023-07-07T12:30:00-04:00,1.09677,1.09694,1.09656,1.09692,1.0922180392896121,1.0961835555555555,1.0957622222222188,1.0947482222222171,1.092969000000004,1.0903560000000005,1.0894397999999996,1.0877156500000047,1.0955436390886775,1.0947485513478967,2601,-228585,-233990.6,0.24553906998650335,-216.60796878477066,0.3659920213739344
2023-07-07T12:45:00-04:00,1.09692,1.09727,1.09672,1.09717,1.0929735530032743,1.0964651111111112,1.0960233333333298,1.0952211111111059,1.093390000000004,1.0905152000000007,1.0895391999999997,1.0877647000000048,1.0958689112709419,1.0951520410783169,2803,-225782,-231174.8,0.2500941996949891,-215.9691345944922,0.21464715661022582
2023-07-07T13:00:00-04:00,1.09717,1.09729,1.09663,1.09704,1.093746913462685,1.0966684444444443,1.0962633333333298,1.0956297777777724,1.0938160000000041,1.0906666000000005,1.0896319999999997,1.0878131000000046,1.0961031290167536,1.095504432862653,-2008,-227790,-229369.2,0.2342058555604444,-216.2070557917542,0.19728189390617598
2023-07-07T13:15:00-04:00,1.09704,1.09733,1.09696,1.09716,1.094455530770148,1.0968477777777779,1.0965111111111077,1.0959755555555504,1.0942370000000041,1.0908278000000007,1.0897321999999996,1.0878621500000047,1.0963145032134027,1.0958059462901217,1491,-226299,-227928.4,0.21735061470914135,-216.04396237674666,0.20366598778003656
2023-07-07T13:30:00-04:00,1.09716,1.09732,1.09677,1.0969,1.0950304246161184,1.0969255555555555,1.096734444444441,1.0962588888888836,1.094530000000004,1.0909764000000006,1.0898270999999997,1.0879135500000048,1.0964316025707221,1.096052357032097,-1662,-227961,-227283.4,0.1997681627598475,-216.43781559778998,0.1835800856707128
2023-07-07T13:45:00-04:00,1.0969,1.09726,1.09666,1.09674,1.0954903396928948,1.0969266666666666,1.0968522222222186,1.0964768888888838,1.0948095000000042,1.091126400000001,1.0899220999999997,1.0879637000000049,1.0964932820565778,1.096242285625677,-1625,-229586,-227483.6,0.19182297734353626,-216.6748472323965,0.0967435747663607
2023-07-07T14:00:00-04:00,1.09674,1.09695,1.09657,1.09673,1.0958582717543157,1.0969022222222224,1.0968999999999967,1.096652222222217,1.0951045000000041,1.0912762000000007,1.0900128999999996,1.088016100000005,1.0965406256452623,1.0963766285005412,-1719,-231305,-228588.2,0.1770979936435949,-216.6905209563421,0.03922284046337047
2023-07-07T14:15:00-04:00,1.09673,1.0969,1.09659,1.09686,1.0961526174034526,1.0968942222222222,1.0969211111111075,1.0967837777777727,1.0954095000000041,1.091438600000001,1.0901024,1.088068550000005,1.09660450051621,1.0964769028004322,1278,-230027,-229035.6,0.1559462497204286,-216.53903426408425,0.01732517530341055
2023-07-07T14:30:00-04:00,1.09686,1.0970199999999999,1.0966,1.0967,1.0963880939227622,1.0968499999999999,1.0969133333333296,1.0968642222222171,1.095682000000004,1.091577800000001,1.0901904999999998,1.088120650000005,1.096623600412968,1.0965387222403453,-1243,-231270,-230029.8,0.13035924101390203,-216.72035184335593,-0.006382377344385285
2023-07-07T14:45:00-04:00,1.0967,1.09699,1.09659,1.09673,1.0965764751382097,1.0968133333333334,1.0968922222222186,1.0968957777777726,1.0959380000000043,1.0917286000000006,1.0902759999999998,1.088173950000005,1.0966448803303743,1.0965813777922757,1966,-229304,-230298.4,0.1061477933648121,-216.66657232297666,-0.017321226707500317
2023-07-07T15:00:00-04:00,1.09673,1.09689,1.09654,1.09684,1.09733,1.096802888888889,1.096855555555552,1.0968964444444391,1.096182500000004,1.0918802000000007,1.0903659999999997,1.088227150000005,1.0966839042642995,1.0966195022338203,1703,-227601,-229901.4,0.0826700151205078,-216.49576455807545,-0.030077380898123486
2023-07-07T15:15:00-04:00,1.09684,1.09691,1.09654,1.09679,1.0973142,1.0967897777777778,1.096827777777774,1.0968819999999946,1.096376000000004,1.092050200000001,1.0904561999999998,1.0882810500000049,1.0967051234114396,1.0966524017870558,-1678,-229279,-229496.2,0.05816135573463222,-216.572257027351,-0.022788594764100077
2023-07-07T15:30:00-04:00,1.09679,1.09695,1.09648,1.0966,1.097298716,1.0967442222222221,1.0967655555555518,1.0968508888888835,1.096465000000004,1.0922112000000008,1.0905386999999997,1.0883345500000048,1.0966840987291517,1.0966683214296442,-1450,-230729,-229636.6,0.03815563852202035,-216.8234445837655,-0.051040869153076485
2023-07-07T15:45:00-04:00,1.0966,1.09676,1.09631,1.09665,1.09726596736,1.0967211111111108,1.096737777777774,1.0968157777777723,1.096553500000004,1.092381000000001,1.0906244999999999,1.088388050000005,1.0966772789833215,1.096679057143715,2237,-228492,-229081,0.02555377736889775,-216.72144750187627,-0.022791503327567096
2023-07-07T16:00:00-04:00,1.09665,1.09695,1.0965799999999999,1.09675,1.0972086093184,1.0967235555555555,1.0967388888888852,1.0967851111111055,1.096644500000004,1.092552000000001,1.0907096999999997,1.088441600000005,1.0966918231866571,1.0966884457149715,1420,-227072,-228634.6,0.016063179233104647,-216.59196225134056,0.0009117931323598543
2023-07-07T16:15:00-04:00,1.09675,1.0968,1.09656,1.09665,1.097154692759296,1.0967057777777778,1.0967299999999962,1.0967599999999944,1.096732500000004,1.0927330000000008,1.0907914999999997,1.088497650000005,1.0966834585493257,1.096688356571977,-466,-227538,-228622,0.007772625940765659,-216.63445142389583,-0.0072944115689440436
2023-07-07T16:30:00-04:00,1.09665,1.09665,1.09648,1.09654,1.0971040111937382,1.0966677777777778,1.0966944444444406,1.0967333333333278,1.0967755000000041,1.092920800000001,1.0908705999999997,1.0885525500000048,1.0966547668394606,1.0966782852575812,-451,-227989,-228364,-0.0011245619523971258,-216.67968919346671,-0.02917418813703444
2023-07-07T16:45:00-04:00,1.09654,1.09687,1.09652,1.09682,1.097056370522114,1.096692888888889,1.096707777777774,1.0967217777777722,1.0968015000000042,1.093101400000001,1.0909506,1.0886099000000047,1.0966878134715685,1.0966790282060646,571,-227418,-227701.8,-0.006438775407974424,-216.53388511883205,0.01094191665905881
2023-07-09T17:00:00-04:00,1.097,1.097,1.0957999999999999,1.0963,1.0970115882907872,1.0966113333333334,1.096659999999996,1.0967062222222166,1.0967830000000043,1.093275800000001,1.0910275999999999,1.0886642000000046,1.0966102507772548,1.0966656225648512,-69,-227487,-227500.8,-0.010085822840848893,-216.56659787024066,-0.03920746218302868
2023-07-09T17:15:00-04:00,1.0963,1.09655,1.09628,1.09654,1.097,1.0965873333333334,1.0966266666666629,1.0966837777777723,1.0967715000000042,1.093451000000001,1.0911046999999998,1.0887201000000046,1.096596200621804,1.0966464980518804,63,-227424,-227571.2,-0.011253809883218505,-216.55280602494284,-0.027351300098461668
2023-07-09T17:30:00-04:00,1.09654,1.09655,1.0961,1.09625,1.097,1.096512,1.0965666666666627,1.0966511111111057,1.0967380000000042,1.093614000000001,1.0911772,1.0887736000000048,1.0965269604974432,1.096615198441504,-110,-227534,-227570.4,-0.014375851001411533,-216.58189753095266,-0.049234584560397615
2023-07-09T17:45:00-04:00,1.09625,1.09645,1.09608,1.0964,1.0969039999999999,1.0964786666666666,1.0965444444444405,1.0966211111111057,1.0966995000000044,1.093794600000001,1.0912536,1.0888281000000049,1.0965015683979547,1.0965845587532028,71,-227463,-227465.2,-0.015674416746369088,-216.57218259366644,-0.01823819077147346
2023-07-09T18:00:00-04:00,1.0964,1.09687,1.09636,1.09673,1.0957999999999999,1.0965157777777779,1.0965533333333293,1.0965902222222168,1.0966840000000044,1.093959600000001,1.0913333999999997,1.0888844500000048,1.0965472547183637,1.096556447002562,874,-226589,-227299.4,-0.012578851203592378,-216.30912166699738,0.0072949436921606724
2023-07-09T18:15:00-04:00,1.09673,1.09697,1.09659,1.09688,1.0958214,1.0965811111111112,1.0965677777777738,1.0965717777777724,1.0966700000000045,1.094136600000001,1.0914138999999998,1.0889414500000048,1.0966138037746909,1.096557157602049,718,-225871,-226976.2,-0.009786996060533078,-216.21092065125052,0.011853202644192892
2023-07-09T18:30:00-04:00,1.09688,1.09688,1.0966,1.09671,1.095867344,1.0966095555555557,1.0965744444444405,1.096561333333328,1.0966605000000045,1.094307400000001,1.0914921999999998,1.0889980500000047,1.0966330430197526,1.0965645260816388,-775,-226646,-226820.6,-0.008197963448353092,-216.33103406383896,0.005471207769130628
2023-07-09T18:45:00-04:00,1.09671,1.09677,1.09663,1.09663,1.09591145024,1.0966206666666667,1.0965844444444406,1.0965648888888835,1.0966550000000044,1.094474200000001,1.0915693999999998,1.0890543000000048,1.096632434415802,1.0965856208653104,-442,-227088,-226731.4,-0.007208039656004052,-216.36327595093766,0.008207634924391584
2023-07-09T19:00:00-04:00,1.09663,1.09665,1.09633,1.0964,1.0959537922304001,1.0965837777777778,1.0965377777777736,1.0965635555555502,1.0966385000000043,1.094613400000001,1.0916435999999998,1.089109600000005,1.0965859475326416,1.0966024966922479,-818,-227906,-226820,-0.007008402266309925,-216.53483791805508,-0.03829251837127924
2023-07-09T19:15:00-04:00,1.0964,1.09642,1.09628,1.09629,1.0959944405411841,1.0965342222222223,1.0965366666666627,1.0965602222222166,1.0966100000000045,1.094754600000001,1.0917165999999998,1.0891634500000047,1.0965267580261133,1.0965983973537976,-488,-228394,-227181,-0.00993093074539441,-216.58379815154652,-0.0009121590805496225
2023-07-09T19:30:00-04:00,1.09629,1.09655,1.09622,1.0965,1.0960334629195367,1.0965268888888888,1.0965322222222182,1.0965531111111058,1.0966000000000045,1.094902000000001,1.0917906999999998,1.0892187500000048,1.0965214064208906,1.0965799178830378,706,-227688,-227544.4,-0.006544008128640387,-216.44856021267995,-0.003647837744180787
2023-07-09T19:45:00-04:00,1.0965,1.0968,1.09647,1.09667,1.0960709244027553,1.0965544444444446,1.0965788888888848,1.0965539999999945,1.0965970000000045,1.0950532000000008,1.0918662999999997,1.0892741500000047,1.0965511251367124,1.0965635343064297,720,-226968,-227608.8,-0.005228265461796775,-216.33693230570321,0.03831242873432949
2023-07-09T20:00:00-04:00,1.09667,1.09688,1.09596,1.09601,1.09697,1.0964406666666666,1.0965355555555514,1.0965442222222166,1.0965555000000045,1.095187200000001,1.0919322999999996,1.0893261500000049,1.0964429001093698,1.0965256274451434,-1669,-228637,-227918.6,-0.0042904383582687035,-217.34137302168904,-0.035570959503840975
2023-07-09T20:15:00-04:00,1.09601,1.09608,1.09566,1.09587,1.0969498,1.0963075555555555,1.0964399999999959,1.0965246666666613,1.0965095000000045,1.0953296000000008,1.0919983999999996,1.0893772000000048,1.0963283200874958,1.0964741019561142,-1334,-229971,-228331.6,-0.004911629748765474,-217.51177292679944,-0.07841492436607761
2023-07-09T20:30:00-04:00,1.09587,1.09614,1.09579,1.09602,1.096898208,1.0962235555555555,1.0963444444444403,1.0964862222222167,1.0964805000000044,1.0954796000000007,1.0920672999999996,1.0894298000000047,1.0962666560699967,1.0964220815648908,1490,-228481,-228349,-0.008043008380124792,-217.30782537827622,-0.0784042010064987
2023-07-09T20:45:00-04:00,1.09602,1.09659,1.09581,1.09643,1.09684867968,1.0962406666666669,1.0963133333333293,1.0964424444444387,1.0964695000000044,1.0956334000000008,1.0921420999999996,1.089485550000005,1.0962993248559973,1.0963776652519122,1964,-226517,-228114.8,-0.011408822359046026,-216.5731307559153,-0.025530906073625476
2023-07-09T21:00:00-04:00,1.09643,1.0969,1.09635,1.09662,1.09566,1.0963019999999999,1.096312222222218,1.0963891111111055,1.0964630000000046,1.0957450000000006,1.0922211999999996,1.0895416500000048,1.0963634598847978,1.0963401322015294,1978,-224539,-227629,-0.012099360679196204,-216.23036377580726,-0.0009118845918920248
2023-07-09T21:15:00-04:00,1.09662,1.09695,1.09654,1.09679,1.0956848000000001,1.0963975555555556,1.0963555555555515,1.0963531111111053,1.0964700000000045,1.0958578000000008,1.0923029999999998,1.089597600000005,1.0964487679078383,1.096341305761223,2235,-222304,-226362.4,-0.01081383910798877,-215.88389006567976,0.03557095950382073
2023-07-09T21:30:00-04:00,1.09679,1.09682,1.09571,1.09598,1.09695,1.0963224444444444,1.0963211111111069,1.0963293333333277,1.0964420000000046,1.0959608000000005,1.0923783999999996,1.089650800000005,1.0963550143262706,1.096346644608978,-2645,-224949,-225358,-0.01173487690507332,-217.83727220811355,-0.02827718942980712
2023-07-09T21:45:00-04:00,1.09598,1.0962399999999999,1.09593,1.09604,1.09695,1.0962662222222221,1.0962699999999959,1.0963144444444388,1.0964030000000045,1.0960664000000007,1.0924536999999996,1.089703400000005,1.0962920114610164,1.096351715687182,2167,-222782,-224218.2,-0.011843709934324091,-217.7186386564065,-0.04195166438669649
2023-07-09T22:00:00-04:00,1.09604,1.09633,1.09599,1.09608,1.0969252,1.096228222222222,1.0962044444444403,1.096292666666661,1.0963920000000045,1.0961630000000007,1.0925252999999997,1.089757250000005,1.0962496091688132,1.096341772549745,1789,-220993,-223113.4,-0.01246083458457689,-217.6533490684352,-0.053799228573781575
2023-07-09T22:15:00-04:00,1.09608,1.0962,1.09578,1.09581,1.096900896,1.0961493333333334,1.096182222222218,1.096266666666661,1.0963555000000045,1.0962470000000006,1.0925956999999997,1.089809800000005,1.0961616873350506,1.0963014180397956,-1669,-222662,-222738,-0.018176961515326606,-218.0644778181615,-0.018248008686050126
2023-07-09T22:30:00-04:00,1.09581,1.09607,1.0957,1.09572,1.09687707808,1.0960568888888889,1.0961655555555514,1.096228666666661,1.0963290000000043,1.0963224000000007,1.0926650999999996,1.089862200000005,1.0960733498680404,1.0962263344318361,-1774,-224436,-223164.4,-0.01726112732412993,-218.21017825893122,-0.013687754934424017
2023-07-09T22:45:00-04:00,1.09572,1.09611,1.09564,1.09604,1.0968299949568,1.0960317777777777,1.0961677777777734,1.0961979999999945,1.0963110000000045,1.0963848000000007,1.0927383999999996,1.089917950000005,1.0960666798944323,1.0961686675454683,1555,-222881,-222750.8,-0.014798489485222194,-217.7560476416204,0.0018247842192577672
2023-07-09T23:00:00-04:00,1.09604,1.09621,1.09574,1.09574,1.096758595259392,1.095946222222222,1.0960911111111067,1.0961622222222167,1.0962615000000044,1.0964032000000006,1.0928091999999996,1.089973500000005,1.0960013439155458,1.0961105340363742,-1587,-224468,-223088,-0.014486168857554235,-218.19042959848323,-0.06293151409575436
2023-07-09T23:15:00-04:00,1.09574,1.096,1.09545,1.09549,1.0966914795438283,1.095826,1.0959655555555512,1.096114444444439,1.0961920000000045,1.0964154000000006,1.0928795999999996,1.090029050000005,1.0958990751324367,1.0960404272290987,-1546,-226014,-224092.2,-0.01767538113455735,-218.54315926062918,-0.1030438985245439
2023-07-09T23:30:00-04:00,1.09549,1.09564,1.09528,1.09557,1.096592161180322,1.0957468888888888,1.0958299999999956,1.0960439999999942,1.0961350000000045,1.0964282000000005,1.0929498999999996,1.090082650000005,1.0958332601059493,1.0959747417832786,1524,-224490,-224457.8,-0.02156441020827119,-218.43186659707243,-0.11123369104386427
2023-07-09T23:45:00-04:00,1.09557,1.0956299999999999,1.09541,1.09559,1.0964609450622897,1.0956988888888888,1.0957866666666622,1.0959682222222165,1.0960830000000046,1.0964422000000005,1.0930197999999995,1.0901356000000049,1.0957846080847595,1.0959169934266224,1180,-223310,-224232.6,-0.027647579381087743,-218.41032529893525,-0.03558459095967905
2023-07-10T00:00:00-04:00,1.09559,1.09573,1.09542,1.09571,1.0963428505560608,1.0956835555555557,1.0957499999999956,1.0958846666666608,1.0960485000000044,1.0964428000000006,1.0930862999999997,1.090188200000005,1.0957696864678077,1.0958575947412974,1018,-222292,-224114.8,-0.026115060060807417,-218.29882373356872,-0.030108390204731713
2023-07-10T00:15:00-04:00,1.09571,1.09578,1.0956299999999999,1.0957,1.0962365655004547,1.0956735555555557,1.0957077777777733,1.0958079999999941,1.0960190000000045,1.0964308000000005,1.0931530999999997,1.090240450000005,1.0957557491742462,1.0958084757930375,-871,-223163,-223853.8,-0.026176679771294294,-218.30677291720312,-0.03466900226261285
2023-07-10T00:30:00-04:00,1.0957,1.09581,1.09559,1.09565,1.0961409089504093,1.095662,1.0956899999999956,1.095752888888883,1.0959765000000048,1.0964104000000006,1.0932224999999995,1.0902945000000048,1.095734599339397,1.0957755806344296,-1310,-224473,-223545.6,-0.027320089519856462,-218.36655205382797,-0.014601071353604911
2023-07-10T00:45:00-04:00,1.09565,1.09566,1.09524,1.09529,1.0960548180553684,1.095582,1.0956422222222177,1.0957153333333276,1.0959075000000045,1.0963808000000004,1.0932876999999994,1.0903474000000049,1.0956456794715177,1.0957380645075434,-1345,-225818,-223811.2,-0.02680881275592791,-218.8084815021006,-0.039243602380163764
2023-07-10T01:00:00-04:00,1.09529,1.09562,1.09526,1.09538,1.0959570398887242,1.0955295555555555,1.0955688888888844,1.0956717777777718,1.0958760000000045,1.0963500000000004,1.0933529999999996,1.090402400000005,1.0955925435772143,1.0956996516060342,1400,-224418,-224032.8,-0.024307440014260908,-218.69344347564194,-0.060216780409463426
2023-07-10T01:15:00-04:00,1.09538,1.09548,1.0951899999999999,1.09522,1.0958709951020773,1.0954597777777777,1.0955111111111067,1.0956239999999942,1.0958435000000046,1.0963110000000007,1.0934130999999996,1.0904568000000048,1.0955180348617715,1.095649321284827,-1191,-225609,-224696.2,-0.02835820506342566,-218.86741050078385,-0.047456513406451704
2023-07-10T01:30:00-04:00,1.09522,1.09542,1.09497,1.09521,1.0957756557877865,1.0953995555555556,1.0954799999999956,1.0955784444444387,1.0958030000000047,1.0962744000000004,1.0934704999999996,1.090510150000005,1.0954564278894172,1.0955894570278613,-1921,-227530,-225569.6,-0.03032754970394833,-218.88495035579027,-0.02555933874339866
2023-07-10T01:45:00-04:00,1.09521,1.0955,1.09459,1.09461,1.0956467508617407,1.0952255555555557,1.0953733333333289,1.0955151111111054,1.0957120000000047,1.0962234000000004,1.0935255999999993,1.090563100000005,1.0952871423115338,1.0954999656222886,-2636,-230166,-226708.2,-0.032232872836449156,-220.3290569654814,-0.08762561954049945
2023-07-10T02:00:00-04:00,1.09461,1.0954,1.09449,1.09495,1.0955,1.095140888888889,1.0953022222222177,1.0954471111111055,1.0956285000000046,1.0961844000000005,1.0935803999999996,1.0906195500000049,1.095219713849227,1.0954147724978305,3569,-226597,-226864,-0.03146134218506051,-219.22047948126325,-0.05841601328964064
2023-07-10T02:15:00-04:00,1.09495,1.09526,1.09467,1.09525,1.0955,1.0951304444444445,1.0952511111111065,1.0953835555555496,1.0955515000000047,1.0961546000000006,1.0936404999999996,1.090678800000005,1.0952257710793816,1.0953414179982641,2350,-224247,-226829.8,-0.02861201104633243,-218.5766144645959,-0.0419819112721345
2023-07-10T02:30:00-04:00,1.09525,1.09533,1.09488,1.0950199999999999,1.09449,1.0950842222222223,1.0951755555555511,1.0953164444444385,1.0955035000000046,1.0961204000000004,1.0936982999999996,1.0907359000000048,1.0951846168635053,1.0952747343986107,-2252,-226499,-227007.8,-0.027218927194875762,-219.04952932421736,-0.06206078306105813
2023-07-10T02:45:00-04:00,1.0950199999999999,1.09547,1.09491,1.09503,1.0945068,1.0950551111111113,1.0951066666666622,1.0952417777777719,1.0954530000000047,1.0960838000000006,1.0937611999999994,1.0907894500000048,1.0951536934908042,1.0952141875188883,2570,-223929,-226287.6,-0.029206567239084557,-219.0260594332563,-0.056587413863922326
2023-07-10T03:00:00-04:00,1.09503,1.09654,1.095,1.09594,1.094545328,1.095221777777778,1.0951788888888843,1.095202888888883,1.0954460000000048,1.0960686000000006,1.0938231999999994,1.0908460500000048,1.0953109547926434,1.0952189500151104,3973,-219956,-224245.6,-0.02612475548758441,-215.72438733294868,0.05934501364933646
2023-07-10T03:15:00-04:00,1.09594,1.09616,1.09491,1.09501,1.09466500832,1.0951879999999998,1.095137777777773,1.0951699999999942,1.0954060000000048,1.0960342000000005,1.0938813999999994,1.090898900000005,1.0952507638341147,1.0952251600120877,-3480,-223436,-223613.4,-0.024030676497085658,-218.67746870601616,-0.03377823221165088
2023-07-10T03:30:00-04:00,1.09501,1.0955,1.095,1.09504,1.0947775078208,1.0951684444444443,1.0951177777777732,1.0951433333333274,1.0953720000000047,1.0959982000000006,1.0939391999999994,1.0909512500000047,1.0952086110672918,1.0952217280096697,2788,-220648,-222893.6,-0.02378803607816289,-218.6010858419328,-0.016435054144379117
2023-07-10T03:45:00-04:00,1.09504,1.09553,1.09483,1.09544,1.09654,1.0952328888888887,1.0951433333333287,1.095136888888883,1.0953420000000047,1.0959712000000004,1.0940106999999994,1.0910008000000047,1.0952548888538334,1.0952357824077352,2825,-217823,-221158.4,-0.020562642590477388,-217.56916006753195,0.0210005387094669
2023-07-10T04:00:00-04:00,1.09544,1.09604,1.09527,1.09591,1.0965058,1.0953862222222222,1.0952877777777732,1.0951731111111052,1.0953505000000046,1.0959574000000005,1.0940842999999996,1.0910510000000047,1.0953859110830666,1.0952822259261878,3033,-214790,-219330.6,-0.01360706871967302,-216.26784735300637,0.11876376060878822
2023-07-10T04:15:00-04:00,1.09591,1.09598,1.09537,1.09581,1.096472284,1.0954906666666666,1.0953833333333287,1.0952139999999941,1.0953665000000048,1.0959406000000005,1.0941607999999996,1.091097250000005,1.0954707288664534,1.0953141807409499,-2516,-217306,-218800.6,-0.0029561592879156877,-216.49742824924783,0.07854239919629762
2023-07-10T04:30:00-04:00,1.09581,1.09608,1.09534,1.09608,1.09643943832,1.0956299999999999,1.095475555555551,1.0952815555555497,1.0953920000000046,1.0959272000000007,1.0942395999999994,1.0911458500000046,1.0955925830931628,1.0953825445927594,2777,-214529,-217019.2,0.004794941272125427,-215.81319466860887,0.07578178498058766
2023-07-10T04:45:00-04:00,1.09608,1.09655,1.09591,1.09647,1.09483,1.0958288888888887,1.0956366666666622,1.0953853333333274,1.0954360000000047,1.0959236000000006,1.0943282999999995,1.0911945500000046,1.0957680664745302,1.0954944356742071,2125,-212404,-215370.4,0.012019486783511673,-215.0570910995261,0.13241767273658686
2023-07-10T05:00:00-04:00,1.09647,1.09684,1.09623,1.09673,1.0948644,1.0960475555555556,1.095825555555551,1.095521777777772,1.0954870000000045,1.0959274000000006,1.0944240999999995,1.0912484000000047,1.095960453179624,1.0956355485393652,2053,-210351,-213876,0.022672888381165865,-214.57027431475328,0.1552468882131115
2023-07-10T05:15:00-04:00,1.09673,1.09733,1.09642,1.09716,1.094943424,1.0963144444444444,1.0959611111111065,1.0956564444444385,1.0955600000000048,1.0959342000000007,1.0945177999999995,1.0913003500000047,1.0962003625436993,1.0957984388314919,2856,-207495,-212417,0.035810995832049546,-213.450509194806,0.11131996277168449
2023-07-10T05:30:00-04:00,1.09716,1.0972,1.09677,1.09701,1.09508661856,1.096524222222222,1.0961833333333286,1.0958164444444385,1.0956280000000045,1.0959484000000008,1.0946120999999995,1.0913542000000047,1.0963622900349594,1.095976751065193,-2354,-209849,-210925.6,0.03988141624267835,-213.77234010369776,0.18264673381978264
2023-07-10T05:45:00-04:00,1.09701,1.09707,1.09607,1.09619,1.0952212214463999,1.0965255555555555,1.0963111111111066,1.0959835555555497,1.0956730000000046,1.0959414000000007,1.0946961999999996,1.0914073500000046,1.0963278320279675,1.096123800852154,-2873,-212722,-210564.2,0.04830336285148323,-215.91986838511735,0.10501899473991674
2023-07-10T06:00:00-04:00,1.09619,1.0965,1.09603,1.09618,1.0953477481596159,1.0964993333333333,1.0963933333333287,1.0961348888888829,1.0957130000000046,1.0959400000000008,1.0947769999999997,1.0914615500000047,1.0962982656223739,1.0962298406817228,-2282,-215004,-211084.2,0.05483788533889146,-215.9406859441173,0.0675527641860771
2023-07-10T06:15:00-04:00,1.09618,1.09632,1.09588,1.09596,1.0954666832700388,1.0964126666666667,1.0963988888888843,1.0962495555555496,1.0957500000000044,1.0959312000000008,1.0948628999999996,1.0915150500000046,1.096230612497899,1.0962838725453776,-1886,-216890,-212392,0.0570616013236408,-216.3192004216664,0.004562418446779892
2023-07-10T06:30:00-04:00,1.09596,1.09601,1.09545,1.09576,1.09733,1.0962848888888888,1.0963933333333287,1.096335999999994,1.0957775000000045,1.095911800000001,1.0949356999999997,1.0915675000000045,1.0961364899983193,1.0962710980363017,-2219,-219109,-214714.8,0.05334460921801391,-216.72414220786294,-0.004562834797992669
2023-07-10T06:45:00-04:00,1.09576,1.09594,1.09557,1.09593,1.0972924,1.0961922222222222,1.096376666666662,1.0963746666666605,1.0958435000000044,1.0958928000000008,1.0950146999999995,1.0916151500000046,1.0960951919986555,1.096217678429041,2002,-217107,-216166.4,0.05130917263945759,-216.41354499679483,-0.013685132472070694
2023-07-10T07:00:00-04:00,1.09593,1.09621,1.09578,1.09586,1.097255552,1.096088888888889,1.0963088888888841,1.096374222222216,1.0958890000000043,1.0958758000000008,1.0950915999999997,1.0916609000000046,1.0960481535989244,1.0961617427432322,-2200,-219307,-217483.4,0.04386702490358785,-216.55406492051262,-0.05563307705637176
2023-07-10T07:15:00-04:00,1.09586,1.0959699999999999,1.09532,1.09576,1.09721944096,1.0959791111111112,1.0962011111111065,1.0963357777777714,1.0959145000000043,1.095858400000001,1.0951662999999996,1.0917088000000046,1.0959905228791396,1.0961001941945854,-2218,-221525,-218787.6,0.033867019155219995,-216.7564630370603,-0.08844474027335036
2023-07-10T07:30:00-04:00,1.09576,1.09605,1.09565,1.0959699999999999,1.0971434633216,1.0959328888888888,1.096068888888884,1.0962697777777712,1.0959620000000043,1.0958498000000008,1.0952315999999995,1.0917556500000047,1.0959864183033117,1.096051355355668,1930,-219595,-219328.6,0.023802633671889655,-216.386582771309,-0.1084618469503103
2023-07-10T07:45:00-04:00,1.0959699999999999,1.09608,1.09536,1.09538,1.097070524788736,1.095795111111111,1.0958877777777731,1.0961686666666601,1.0959795000000043,1.0958316000000008,1.0952930999999997,1.0918018000000047,1.0958651346426493,1.0959970842845341,-2688,-222283,-219963.4,0.005996188510148349,-217.83362967952698,-0.14858570113308175
2023-07-10T08:00:00-04:00,1.09538,1.09581,1.09537,1.09545,1.0970005037971866,1.0957075555555553,1.095805555555551,1.096054444444438,1.0959550000000045,1.0958106000000007,1.0953562999999997,1.0918443500000048,1.0957821077141194,1.0959344674276268,2813,-219470,-220436,-0.010062984899894697,-217.65386557939732,-0.06750654539814839
2023-07-10T08:15:00-04:00,1.09545,1.09565,1.09481,1.0951899999999999,1.0969332836452992,1.0955844444444445,1.095695555555551,1.0959317777777715,1.0959640000000044,1.0957810000000008,1.0954170999999997,1.0918768500000047,1.0956636861712956,1.095857573942101,-3391,-222861,-221146.8,-0.01592923353232957,-218.45870377374715,-0.09031363462205536
2023-07-10T08:30:00-04:00,1.0951899999999999,1.0951899999999999,1.09449,1.09479,1.0968058866265813,1.0954033333333333,1.0955655555555512,1.0958046666666603,1.0959515000000044,1.0957566000000007,1.0954719,1.0919079500000046,1.0954889489370365,1.0957572591536804,-4139,-227000,-222241.8,-0.027656994177514584,-219.9704049397547,-0.10675572101172628
2023-07-10T08:45:00-04:00,1.09479,1.09479,1.09433,1.09469,1.0966206156964549,1.095228222222222,1.095446666666662,1.0956802222222162,1.0959140000000045,1.095733000000001,1.0955312999999998,1.0919380500000047,1.0953291591496293,1.095625807322944,-4201,-231201,-224563,-0.037725322111774734,-220.35413149918614,-0.09764912024532073
2023-07-10T09:00:00-04:00,1.09469,1.09553,1.09469,1.09544,1.0963915541268094,1.095226888888889,1.0953922222222174,1.095581111111105,1.0958905000000043,1.0957214000000008,1.0956004999999998,1.0919717000000047,1.0953513273197033,1.0955230458583547,3776,-227425,-225591.4,-0.04064531940037185,-217.76709772706792,-0.04471088481929516
2023-07-10T09:15:00-04:00,1.09544,1.09607,1.0952,1.09599,1.0961853987141286,1.0953464444444443,1.095406666666662,1.0955013333333272,1.0958995000000047,1.0957126000000008,1.0956729999999997,1.0920045000000045,1.0954790618557626,1.0954624366866832,3721,-223704,-226438.2,-0.04044529803816908,-215.89885300348635,0.011862829193506787
2023-07-10T09:30:00-04:00,1.09599,1.09643,1.09534,1.09576,1.09433,1.095417111111111,1.0954066666666622,1.0954435555555497,1.0958835000000047,1.095695400000001,1.0957201999999997,1.0920352500000048,1.09553524948461,1.0954367493493462,-5676,-229380,-227742,-0.04114062245356741,-217.08999525843367,0
2023-07-10T09:45:00-04:00,1.09576,1.09711,1.09567,1.09669,1.0943720000000001,1.0956737777777779,1.095486666666662,1.095427777777772,1.0958945000000047,1.095693400000001,1.0957755999999998,1.0920710500000046,1.095766199587688,1.0954921994794766,6217,-223163,-226974.6,-0.03530404495241521,-211.81346572642008,0.06569522888400722
2023-07-10T10:00:00-04:00,1.09669,1.09803,1.09663,1.09797,1.0944815200000002,1.0961704444444444,1.09577444444444,1.0954933333333277,1.0959565000000047,1.0957332000000009,1.0958469999999998,1.0921124500000048,1.0962069596701502,1.0956677595835806,5461,-217702,-224274.8,-0.023570702984418712,-205.4396682084344,0.23644762548155618
2023-07-10T10:15:00-04:00,1.09797,1.09801,1.09724,1.0974599999999999,1.0946944288000002,1.0965075555555555,1.0959977777777732,1.0956144444444387,1.0959715000000045,1.0957616000000008,1.0959139999999998,1.0921604500000048,1.0964575677361201,1.0958890076668641,-4313,-222015,-223192.8,-0.00776396503525524,-207.44302895599586,0.18348623853209595
2023-07-10T10:30:00-04:00,1.0974599999999999,1.09752,1.09665,1.09707,1.0948945630720002,1.096722,1.096206666666662,1.0957744444444386,1.0959745000000045,1.0957814000000008,1.0959721999999998,1.0922110500000048,1.0965800541888961,1.096109206133491,-4316,-226331,-223718.2,0.007407729238116583,-208.97678872856116,0.1716597120134501
2023-07-10T10:45:00-04:00,1.09707,1.09799,1.09697,1.09747,1.0950826892876802,1.0969746666666667,1.09650444444444,1.0959939999999941,1.0960385000000046,1.0958146000000009,1.0960307999999999,1.0922615000000049,1.0967580433511168,1.0963537649067923,4750,-221581,-222158.4,0.026211106940678547,-207.24490288718386,0.24479580558828778
2023-07-10T11:00:00-04:00,1.09747,1.09825,1.09747,1.09809,1.0952595279304194,1.0972917777777775,1.0968822222222177,1.096273111111105,1.0961340000000046,1.095862000000001,1.0960922,1.092317100000005,1.0970244346808935,1.0966054119254334,4392,-217189,-220963.6,0.04806059031635006,-204.76370522346613,0.3105902127543021
2023-07-10T11:15:00-04:00,1.09809,1.09837,1.09795,1.09833,1.0954987656959858,1.0975813333333333,1.0972033333333289,1.0965588888888829,1.0962525000000045,1.0959078000000009,1.0961463,1.092365750000005,1.0972855477447148,1.0968211295403463,3078,-214111,-220245.4,0.07192125801647303,-204.09097348016635,0.2638209304024008
2023-07-10T11:30:00-04:00,1.09833,1.09869,1.09823,1.09867,1.0957858891263872,1.0978746666666668,1.0975011111111066,1.0968595555555496,1.0963980000000044,1.095966400000001,1.0961847999999998,1.0924209500000048,1.0975624381957718,1.0970421036322766,2688,-211423,-218127,0.08960324395924939,-203.2588738379823,0.24452777853812677
2023-07-10T11:45:00-04:00,1.09867,1.09928,1.09858,1.09899,1.0961343824312206,1.0981724444444445,1.0978599999999956,1.0971902222222163,1.0965510000000045,1.096036400000001,1.0962258999999999,1.0924742500000049,1.0978479505566174,1.097295682905821,2815,-208608,-214582.4,0.10292287949594692,-202.43897341292322,0.2947725779367602
2023-07-10T12:00:00-04:00,1.09899,1.09905,1.0982399999999999,1.09844,1.0965747688908498,1.0982884444444443,1.09805444444444,1.0975002222222163,1.0966800000000045,1.096093800000001,1.0962609999999997,1.092538450000005,1.097966360445294,1.0975373463246565,-2472,-211080,-212482.2,0.11645084166149267,-203.67610932862726,0.15957107295590736
2023-07-10T12:15:00-04:00,1.09844,1.09889,1.09837,1.09879,1.096953501246131,1.0984355555555558,1.098145555555551,1.097752888888883,1.0968315000000044,1.096157800000001,1.0962999999999998,1.092609900000005,1.0981310883562352,1.0977586770597247,1827,-209253,-210895,0.12286176119843328,-203.09396556110266,0.07468327914242129
2023-07-10T12:30:00-04:00,1.09879,1.0991,1.09871,1.09872,1.0972792110716725,1.0985504444444445,1.098285555555551,1.0979693333333274,1.0969690000000045,1.0962180000000008,1.0963304,1.092683650000005,1.0982488706849882,1.0979513416477795,-1882,-211135,-210299.8,0.11683347550650953,-203.2138610825399,0.11481056257176016
2023-07-10T12:45:00-04:00,1.09872,1.09912,1.09872,1.0989,1.0975593215216384,1.0986733333333332,1.0984888888888844,1.098166888888883,1.0971450000000043,1.0962820000000009,1.0963564,1.0927441500000048,1.0983790965479905,1.0981146733182232,1938,-209197,-209854.6,0.11722663323861805,-202.89636435907974,0.16680795209056837
2023-07-10T13:00:00-04:00,1.0989,1.09899,1.09873,1.09892,1.097800216508609,1.0987595555555554,1.0986499999999957,1.098324888888883,1.0973185000000043,1.0963474000000009,1.0963789,1.0928054500000048,1.0984872772383925,1.0982425386545782,2156,-207041,-209541.2,0.11870590083633219,-202.85712511984067,0.13212206256207015
2023-07-10T13:15:00-04:00,1.09892,1.09925,1.0988499999999999,1.09922,1.0980073861974038,1.0988735555555555,1.0987755555555512,1.0984691111111051,1.0975200000000043,1.0964260000000008,1.0964034,1.092871350000005,1.098633821790714,1.0983760309236623,1966,-205075,-208340.2,0.11827425550870918,-202.32041635123116,0.10290595488530771
2023-07-10T13:30:00-04:00,1.09922,1.09966,1.09919,1.0996,1.0981855521297672,1.0990384444444445,1.0989166666666623,1.0986233333333275,1.0977605000000044,1.0965104000000008,1.0964301999999997,1.0929350000000049,1.0988270574325711,1.0985152247389296,1820,-203255,-207140.6,0.11287635574875868,-201.69124293735615,0.11563009295930024
2023-07-10T13:45:00-04:00,1.0996,1.09964,1.09941,1.09952,1.0984214637890044,1.099159111111111,1.0990111111111067,1.0987684444444386,1.0980020000000044,1.0965964000000008,1.0964536999999999,1.092996450000005,1.0989656459460568,1.0986585797911435,-1339,-204594,-205832.4,0.10317622457557642,-201.78866017998968,0.07736627012660921
2023-07-10T14:00:00-04:00,1.09952,1.09959,1.09912,1.09947,1.0986196295827637,1.099250888888889,1.09906444444444,1.0988835555555496,1.0982035000000043,1.0966816000000008,1.0964779999999998,1.093055000000005,1.0990665167568454,1.0987960638329144,-1630,-206224,-205237.8,0.08971135986884572,-201.8627834337733,0.04367646657385745
2023-07-10T14:15:00-04:00,1.09947,1.09966,1.09937,1.09965,1.0987860888495216,1.0993680000000001,1.0991988888888846,1.0989933333333277,1.0983865000000044,1.0967824000000008,1.0965029,1.093117550000005,1.0991832134054764,1.098935251066331,1414,-204810,-204791.6,0.0774506454296882,-201.63129007788356,0.11015622155055654
2023-07-10T14:30:00-04:00,1.09965,1.09971,1.09941,1.09947,1.0989259146335981,1.0994222222222223,1.09927444444444,1.0990931111111055,1.0985720000000043,1.0968728000000008,1.0965285999999999,1.093177850000005,1.099240570724381,1.0990566008530647,-1612,-206422,-205061,0.0717295553864124,-201.89515585335766,0.0618862567005537
2023-07-10T14:45:00-04:00,1.09947,1.09994,1.0994599999999999,1.09988,1.0990670499995505,1.0995433333333333,1.0994033333333288,1.0991904444444387,1.0987315000000044,1.0969654000000009,1.0965599999999998,1.093241050000005,1.0993684565795048,1.0991648806824512,1658,-204764,-205362.8,0.06378048590240054,-201.2768761367669,0.10557739915538536
2023-07-10T15:00:00-04:00,1.09988,1.10003,1.09962,1.09993,1.0992416399996403,1.0996486666666667,1.0995177777777734,1.0992917777777722,1.0988295000000046,1.097063600000001,1.0965919999999998,1.0933024500000048,1.0994807652636038,1.0992679045459606,1553,-203211,-205086.2,0.060742220003749875,-201.20627752600922,0.09373009373010159
2023-07-10T15:15:00-04:00,1.09993,1.09997,1.09976,1.09984,1.0993993119997123,1.0997131111111114,1.0996199999999956,1.0994028888888832,1.0989485000000045,1.097159800000001,1.0966217999999999,1.0933621000000049,1.099552612210883,1.099365123636768,-1346,-204557,-204752.8,0.061187974050118735,-201.31641180728184,0.0837185600407702
2023-07-10T15:30:00-04:00,1.09984,1.10001,1.09972,1.0997999999999999,1.09952544959977,1.099749111111111,1.09968444444444,1.0994999999999941,1.0990850000000045,1.0972370000000007,1.0966527999999998,1.093421650000005,1.0996020897687064,1.099448898909414,-1421,-205978,-204986.4,0.05904994070347622,-201.3680920516811,0.052764687687615115
2023-07-10T15:45:00-04:00,1.0997999999999999,1.09996,1.09965,1.09979,1.099626359679816,1.0997702222222223,1.099705555555551,1.0995862222222166,1.0992010000000045,1.0973326000000008,1.0966833999999996,1.093479700000005,1.0996396718149652,1.099528719127531,-1520,-207498,-205201.6,0.05244462120983788,-201.38191274635264,0.017279010549302885
2023-07-10T16:00:00-04:00,1.09979,1.10001,1.0997,1.09999,1.10003,1.099827111111111,1.0997577777777734,1.0996571111111053,1.0992960000000047,1.0974316000000008,1.0967148999999998,1.093540450000005,1.0997097374519722,1.0995969753020245,1321,-206177,-205484.2,0.045070158954580795,-201.14168506652288,0.04274592549475866
2023-07-10T16:15:00-04:00,1.09999,1.10003,1.09993,1.09997,1.09965,1.0998695555555553,1.0998133333333289,1.0997162222222165,1.0993780000000046,1.097522200000001,1.0967466999999997,1.093601450000005,1.0997617899615777,1.0996531802416192,-547,-206724,-206186.8,0.04101639572955255,-201.15163061148246,0.04547645683828981
2023-07-10T16:30:00-04:00,1.09997,1.10014,1.09992,1.10005,1.0996576,1.0999168888888888,1.0998577777777734,1.099763777777772,1.0994470000000045,1.0976050000000008,1.0967811999999997,1.093659950000005,1.0998194319692622,1.099706544193295,453,-206271,-206529.6,0.03883901365313681,-201.11868425840007,0.036375210294180504
2023-07-10T16:45:00-04:00,1.10005,1.10012,1.09999,1.10006,1.099676896,1.0999573333333332,1.099923333333329,1.0998115555555499,1.0995005000000047,1.097690000000001,1.0968152999999998,1.093719900000005,1.0998675455754099,1.0997596353546357,490,-205781,-206490.2,0.03654554116716318,-201.11422991541562,0.05366221906919611
2023-07-10T17:00:00-04:00,1.10006,1.10013,1.09999,1.1001,1.09969542016,1.0999926666666666,1.0999477777777733,1.0998599999999943,1.0995835000000045,1.0977704000000008,1.0968487999999998,1.093779250000005,1.099914036460328,1.099814508283708,39,-205742,-206139,0.037466257198821344,-201.11281181094859,0.020002182056234226
2023-07-10T17:15:00-04:00,1.1001,1.10015,1.10008,1.10015,1.0997132033536,1.1000331111111112,1.0999722222222177,1.099902888888883,1.0996515000000047,1.097844000000001,1.0968837999999999,1.0938376500000049,1.0999612291682623,1.0998648066269663,43,-205699,-206043.4,0.03251367800409934,-201.11085744316384,0.02000127280825934
2023-07-10T17:30:00-04:00,1.10015,1.10017,1.09935,1.09991,1.10017,1.1000206666666665,1.0999799999999955,1.0999362222222164,1.0997110000000048,1.097907600000001,1.0969174999999998,1.093894050000005,1.09995098333461,1.0999026453015728,-165,-205864,-205871.4,0.027480260201133585,-201.14685253474227,0.006364562118127591
2023-07-10T17:45:00-04:00,1.09991,1.09996,1.09979,1.09995,1.10017,1.1000146666666666,1.0999966666666618,1.099963999999994,1.0997635000000048,1.097963400000001,1.0969487999999998,1.093949700000005,1.0999507866676879,1.0999289162412578,72,-205792,-205775.6,0.023153029531181462,-201.14423413869167,0.013638843426086063
2023-07-10T18:00:00-04:00,1.09995,1.10011,1.09989,1.10003,1.10017,1.1000213333333333,1.1000233333333287,1.099983999999994,1.0998190000000048,1.0980238000000009,1.0969860999999999,1.0940068500000049,1.0999666293341503,1.0999487329930058,571,-205221,-205663.6,0.02035046091666301,-201.10270497827526,0.021822347902783073
2023-07-10T18:15:00-04:00,1.10003,1.1001,1.09993,1.10002,1.1001536,1.1000206666666668,1.100026666666662,1.099999777777772,1.0998590000000048,1.0981004000000008,1.0970208999999997,1.094062800000005,1.0999773034673204,1.0999613863944042,-449,-205670,-205649.2,0.017678079701118322,-201.10678668513782,0.0027272975208842347
2023-07-10T18:30:00-04:00,1.10002,1.10012,1.10001,1.10008,1.100137528,1.1000313333333331,1.1000388888888843,1.1000131111111053,1.0998830000000048,1.098178400000001,1.0970592,1.094118200000005,1.0999978427738564,1.099968709115523,269,-205401,-205589.6,0.014772314984908306,-201.0921142246371,0.010000272734715902
2023-07-10T18:45:00-04:00,1.10008,1.10029,1.1000699999999999,1.10013,1.09935,1.1000495555555554,1.1000477777777733,1.1000266666666607,1.0999135000000047,1.0982618000000008,1.0970965,1.094175050000005,1.100024274219085,1.0999833672924182,345,-205056,-205428,0.01393206882601073,-201.07643354686817,0.0072723967092477625
2023-07-10T19:00:00-04:00,1.10013,1.10028,1.10013,1.10026,1.0993688000000001,1.100092,1.1000699999999954,1.1000413333333274,1.0999530000000048,1.098351800000001,1.0971317999999999,1.0942326000000049,1.100071419375268,1.1000074938339341,399,-204657,-205201,0.012637167820143812,-201.02928457356504,0.018180826500370704
2023-07-10T19:15:00-04:00,1.10026,1.10042,1.10025,1.10039,1.0993872240000002,1.100156,1.1001022222222177,1.1000571111111053,1.099990000000005,1.0984410000000009,1.0971669,1.0942904000000049,1.1001351355002145,1.100041195067147,462,-204195,-204995.8,0.011653957129215246,-200.97469747596995,0.026361239887274013
2023-07-10T19:30:00-04:00,1.10039,1.1004099999999999,1.10023,1.10034,1.0994285350400002,1.1002035555555554,1.1001233333333287,1.1000764444444386,1.1000335000000048,1.0985306000000008,1.0972031999999998,1.0943477000000048,1.1001761084001715,1.1000809560537173,-518,-204713,-204804.4,0.010848419100856065,-200.99823458554013,0.01727037222198196
2023-07-10T19:45:00-04:00,1.10034,1.10059,1.10029,1.10052,1.0994681936384,1.100282888888889,1.1001911111111065,1.100106888888883,1.1000655000000048,1.0986258000000007,1.0972420999999997,1.0944057500000048,1.1002448867201373,1.1001303648429732,714,-203999,-204524,0.0096661687129031,-200.88143432380295,0.05545908301588307
2023-07-10T20:00:00-04:00,1.10052,1.10057,1.10014,1.1005,1.099535502020096,1.1003446666666667,1.1002522222222175,1.100147777777772,1.100094000000005,1.098716400000001,1.0972830999999998,1.094463350000005,1.1002959093761098,1.1001846918743783,-1636,-205635,-204639.8,0.012345353026815765,-200.91116572350478,0.05000227283058779
2023-07-10T20:15:00-04:00,1.1005,1.10087,1.10049,1.10074,1.0995987718988902,1.1004422222222223,1.1003311111111063,1.100199999999994,1.1001390000000049,1.0988236000000007,1.0973275999999996,1.094522100000005,1.1003847275008878,1.1002473534995023,1557,-204078,-204524,0.01601982805448182,-200.57161097566288,0.06454369426288269
2023-07-10T20:30:00-04:00,1.10074,1.10077,1.10039,1.10064,1.099700470146979,1.100504,1.1003999999999954,1.1002595555555494,1.100181000000005,1.0989274000000009,1.0973689999999998,1.094579850000005,1.1004357820007102,1.1003074827996013,-1485,-205563,-204797.6,0.01810121618393992,-200.70652021853584,0.056362611588886107
2023-07-10T20:45:00-04:00,1.10064,1.10076,1.10046,1.10066,1.0997940325352207,1.100556,1.1004644444444398,1.1003277777777716,1.1002245000000048,1.099036800000001,1.0974088999999998,1.0946376000000049,1.1004806256005681,1.1003683862396807,1535,-204028,-204660.6,0.020195392369229064,-200.67862735620133,0.05272343829539897
2023-07-10T21:00:00-04:00,1.10066,1.1010199999999999,1.10064,1.1008,1.099880109932403,1.100623111111111,1.100538888888884,1.1003973333333272,1.100265000000005,1.099157000000001,1.0974567999999998,1.094694550000005,1.1005445004804546,1.100428308991744,1576,-202452,-204351.2,0.022367172193390385,-200.47816581494422,0.060901893412592
2023-07-10T21:15:00-04:00,1.1008,1.10118,1.10065,1.10113,1.0999940989391626,1.1007413333333331,1.100635555555551,1.100473999999994,1.1003230000000048,1.099285800000001,1.0975093999999999,1.094753900000005,1.1006616003843637,1.100501447193395,1475,-200977,-203419.6,0.026520756343928954,-200.03598739924664,0.07907221929361481
2023-07-10T21:30:00-04:00,1.10113,1.1013,1.10058,1.10095,1.100136407066463,1.1008042222222223,1.1006977777777731,1.1005473333333273,1.100368000000005,1.099396000000001,1.0975586999999998,1.094813000000005,1.100719280307491,1.1005683577547154,-2160,-203137,-203231.4,0.028549283541842697,-200.38907922310003,0.05089104771945546
2023-07-10T21:45:00-04:00,1.10095,1.10124,1.1008499999999999,1.10093,1.100299310077158,1.1008506666666666,1.1007633333333287,1.100619999999994,1.1004115000000048,1.0994948000000009,1.0976036999999998,1.094872900000005,1.1007614242459929,1.1006334862037719,-1575,-204712,-203061.2,0.029647368974846874,-200.41769087667214,0.05361979024663907
2023-07-10T22:00:00-04:00,1.10093,1.10099,1.10061,1.10083,1.1004394066663559,1.100864,1.100797777777773,1.1006866666666606,1.1004480000000048,1.0995962000000008,1.0976458,1.094933500000005,1.1007751393967944,1.1006923889630171,-1886,-206598,-203575.2,0.030767153662141784,-200.58900058755293,0.028168502162616987
2023-07-10T22:15:00-04:00,1.10083,1.10118,1.10082,1.10107,1.100559889733066,1.1009184444444444,1.1008611111111064,1.1007511111111052,1.1004940000000047,1.0996838000000009,1.0976886000000001,1.0949958000000048,1.1008341115174356,1.100750311170413,1193,-205405,-204165.8,0.03156638048532358,-200.32890593170234,0.05179463880054152
2023-07-10T22:30:00-04:00,1.10107,1.10145,1.1010199999999999,1.10143,1.10061,1.101032222222222,1.1009377777777731,1.1008115555555495,1.1005700000000047,1.099753000000001,1.0977431,1.0950607500000051,1.1009532892139484,1.10080864893633,2102,-203303,-204631,0.03447662637936678,-199.64164717431197,0.06268510274904676
2023-07-10T22:45:00-04:00,1.10143,1.10202,1.10133,1.10187,1.1007444000000002,1.1012186666666666,1.10107444444444,1.100886888888883,1.1006660000000048,1.099841200000001,1.0978014,1.095127550000005,1.1011366313711588,1.1008921191490635,2551,-200752,-204154,0.03626055508404626,-198.6225719720749,0.11175316179675845
2023-07-10T23:00:00-04:00,1.10187,1.10192,1.10139,1.10158,1.1009740080000001,1.101319777777778,1.101176666666662,1.1009695555555497,1.100743500000005,1.099931400000001,1.0978564,1.095190850000005,1.101225305096927,1.1009848953192505,-2324,-203076,-203826.8,0.03774621564475929,-199.23422307429183,0.08358621190922101
2023-07-10T23:15:00-04:00,1.10158,1.10169,1.10136,1.10143,1.1011622865600001,1.1013704444444445,1.101246666666662,1.1010593333333272,1.1008140000000048,1.100010600000001,1.0979126,1.095254150000005,1.1012662440775416,1.1010831162554,-1487,-204563,-203419.8,0.0386826611528351,-199.43670496394137,0.05723110465115447
2023-07-10T23:30:00-04:00,1.10143,1.10157,1.1012,1.10132,1.10202,1.1013851111111113,1.101267777777773,1.1011406666666606,1.100876000000005,1.100075200000001,1.0979686,1.095316850000005,1.1012769952620334,1.1011716930043196,-1502,-206065,-203551.8,0.037780738485288505,-199.58670995744959,0.017255001680104486
2023-07-10T23:45:00-04:00,1.10132,1.10177,1.10128,1.10173,1.1020036,1.1014775555555556,1.1013544444444399,1.1012239999999938,1.100956000000005,1.1001432000000009,1.0980254999999999,1.095381950000005,1.1013675962096268,1.101254554403455,1207,-204858,-203862.8,0.036091136174705066,-199.1373673503962,0.07084790408283781
2023-07-11T00:00:00-04:00,1.10173,1.10178,1.1016,1.10167,1.101987528,1.1015406666666667,1.101436666666662,1.1012964444444384,1.101026500000005,1.100203200000001,1.0980847999999999,1.095447000000005,1.1014280769677014,1.1013128435227637,-1126,-205984,-204909.2,0.035967629134107934,-199.19868908984253,0.06721589928514646
2023-07-11T00:15:00-04:00,1.10167,1.1018,1.1015,1.10167,1.10197177744,1.1015873333333335,1.1015299999999952,1.101367111111105,1.1010905000000049,1.100256800000001,1.0981466,1.095513100000005,1.101476461574161,1.1013630748182106,0,-205984,-205490.8,0.036588213924583564,-199.19868908984253,0.07630605997292515
2023-07-11T00:30:00-04:00,1.10167,1.10201,1.10157,1.10183,1.1012,1.1016473333333332,1.1016144444444396,1.1014406666666605,1.1011650000000048,1.100324600000001,1.0982092,1.095579550000005,1.1015471692593288,1.101419259854568,1542,-204442,-205466.6,0.039440157345782864,-198.97473817895246,0.06902376778952236
2023-07-11T00:45:00-04:00,1.10183,1.10199,1.10162,1.10198,1.1012161999999999,1.1017204444444444,1.1016755555555509,1.101522222222216,1.1012380000000048,1.100388400000001,1.0982731,1.095646450000005,1.101633735407463,1.101490607883654,1529,-202913,-204836.2,0.04060923802900677,-198.76658447103037,0.0499350843902972
2023-07-11T01:00:00-04:00,1.10198,1.10217,1.10191,1.10206,1.1012320759999998,1.1017973333333333,1.1016966666666619,1.1015906666666606,1.1013160000000048,1.100455200000001,1.0983365999999999,1.095711450000005,1.1017189883259704,1.1015608863069226,1399,-201514,-204167.4,0.03966822935482096,-198.66502182924003,0.017243413469840773
2023-07-11T01:15:00-04:00,1.10206,1.10221,1.10167,1.10179,1.1012695929599998,1.1018160000000001,1.1017199999999954,1.1016473333333274,1.101368500000005,1.1005130000000012,1.0983975,1.0957753000000048,1.1017331906607764,1.1016219090455377,-1799,-203313,-203633.2,0.03336199974868093,-199.10576915697172,0.019063526934044145
2023-07-11T01:30:00-04:00,1.10179,1.102,1.1016,1.1016299999999999,1.1013260173823998,1.101798,1.1017422222222175,1.1016897777777719,1.101418000000005,1.100567200000001,1.0984573,1.0958399000000048,1.101712552528621,1.1016691272364298,-1880,-205193,-203475,0.029966708461574218,-199.3787794402383,0.018158212505558956
2023-07-11T01:45:00-04:00,1.1016299999999999,1.10182,1.1006,1.10069,1.10221,1.1015875555555557,1.1016722222222175,1.1017013333333274,1.1014195000000049,1.1005966000000011,1.0985113000000002,1.095899500000005,1.1015080420228969,1.1016613017891435,-3202,-208395,-204265.6,0.023031642026253237,-202.11098535329424,-0.05720408237389046
2023-07-11T02:00:00-04:00,1.10069,1.10191,1.10069,1.10159,1.1021778,1.101571111111111,1.101656666666662,1.1016975555555497,1.101459000000005,1.100636400000001,1.0985734,1.0959632000000048,1.1015244336183174,1.1016394414313142,4490,-203905,-204464,0.021461324221088873,-198.43965191699468,-0.012707287629458122
2023-07-11T02:15:00-04:00,1.10159,1.10271,1.10149,1.10232,1.1006,1.1017037777777778,1.1017288888888843,1.101703999999994,1.101518500000005,1.1006924000000011,1.0986444000000002,1.0960287500000048,1.101683546894654,1.101632353145051,3498,-200407,-204242.6,0.02024512029082292,-196.12160255198626,0.059001334337872455
2023-07-11T02:30:00-04:00,1.10232,1.10236,1.1016,1.1018,1.1006422,1.101718,1.1017433333333289,1.1017086666666607,1.1015610000000051,1.100739000000001,1.0987103,1.0960904000000047,1.101706837515723,1.1016270825160404,-3285,-203692,-204318.4,0.018528309276974447,-197.6712433096612,0.01180026686757046
2023-07-11T02:45:00-04:00,1.1018,1.10229,1.10149,1.10214,1.1006835560000001,1.1017973333333333,1.101777777777773,1.101715777777772,1.101621500000005,1.100788800000001,1.0987856,1.0961556000000048,1.1017934700125784,1.101643266012832,3103,-200589,-203397.6,0.017649835562494016,-196.71370110599446,0.028135011753157056
2023-07-11T03:00:00-04:00,1.10214,1.10229,1.10122,1.1012899999999999,1.1007240848800002,1.1016997777777777,1.1017011111111064,1.1017215555555497,1.1016445000000048,1.100825200000001,1.0988490000000002,1.0962147000000046,1.1016927760100628,1.101680212810265,-5399,-205988,-202916.2,0.011191455589840752,-200.87755506284213,-0.06261456650756633
2023-07-11T03:15:00-04:00,1.1012899999999999,1.1016,1.10096,1.10139,1.1007638031824,1.1016375555555555,1.1016266666666619,1.1017155555555498,1.101660500000005,1.100855400000001,1.0989104,1.0962754500000047,1.1016322208080502,1.1017017702482117,4026,-201962,-202527.6,0.003414845848145906,-200.51198377825693,-0.060795238008815165
2023-07-11T03:30:00-04:00,1.10139,1.10161,1.10106,1.10132,1.1008027271187522,1.1015762222222223,1.1015744444444397,1.1016846666666609,1.101655000000005,1.100883200000001,1.0989734,1.0963358500000047,1.1015697766464403,1.101679016198569,-3243,-205205,-203487.2,-0.004383058570517385,-200.71809605456238,-0.04265785676036
2023-07-11T03:45:00-04:00,1.10132,1.10152,1.10074,1.1008,1.10271,1.1014213333333331,1.1014822222222174,1.1016324444444385,1.1016015000000048,1.1009024000000012,1.0990311000000001,1.0963961500000048,1.1014158213171523,1.1016208129588547,-3906,-209111,-204571,-0.010646713264565346,-202.56235567029648,-0.07534290097400093
2023-07-11T04:00:00-04:00,1.1008,1.1014,1.10072,1.10106,1.1026706000000002,1.101336888888889,1.1015233333333285,1.1015815555555495,1.101575500000005,1.100927600000001,1.0990823,1.0964527500000047,1.1013446570537218,1.1015310503670832,3100,-206011,-205655.4,-0.01232001431677632,-201.83016090285483,0.033615277689447665
2023-07-11T04:15:00-04:00,1.10106,1.1014,1.10099,1.10122,1.1025925760000002,1.1012762222222223,1.1014822222222174,1.1015377777777717,1.1015650000000048,1.100956200000001,1.0991444000000001,1.0965129000000047,1.1013197256429774,1.1014564402936662,2504,-203507,-205159.2,-0.005952604815402367,-201.46629335703497,-0.033587813977975604
2023-07-11T04:30:00-04:00,1.10122,1.10156,1.10059,1.10067,1.1025176729600001,1.1011137777777777,1.1012988888888842,1.1014722222222162,1.101532500000005,1.100969800000001,1.0992007000000001,1.0965699500000048,1.101189780514382,1.1013679522349324,-3245,-206752,-206117.2,-0.01101938140122656,-203.08699585063312,-0.14968430219899206
2023-07-11T04:45:00-04:00,1.10067,1.10092,1.1002,1.10026,1.1024020125824001,1.100906,1.101127777777773,1.1013828888888828,1.1014590000000049,1.100975600000001,1.0992489,1.0966298000000048,1.1010038244115057,1.1012547617879456,-2503,-209255,-206927.2,-0.025139521099317687,-204.01936431711266,-0.13977128335449945
2023-07-11T05:00:00-04:00,1.10026,1.10076,1.09969,1.09993,1.102225851575808,1.1006664444444447,1.1008822222222174,1.1012628888888827,1.1013720000000047,1.100973200000001,1.0992891000000002,1.0966867000000047,1.1007890595292045,1.101129409430356,-3174,-212429,-207590.8,-0.034337680956634586,-204.97133930484267,-0.2005189903278915
2023-07-11T05:15:00-04:00,1.09993,1.10037,1.09973,1.10032,1.1019722664182272,1.100554,1.1007744444444396,1.101113111111105,1.1013045000000046,1.1009784000000011,1.0993342000000002,1.0967475000000049,1.1006952476233636,1.1009995275442843,2271,-210158,-208420.2,-0.04502813934383991,-204.1661153360449,-0.08807852609212065
2023-07-11T05:30:00-04:00,1.10032,1.10069,1.10017,1.10052,1.1017440397764044,1.100503111111111,1.100677777777773,1.1009522222222161,1.1012390000000045,1.1009868000000012,1.0993786,1.0968091000000049,1.1006601980986908,1.100867622035427,2958,-207200,-209158.8,-0.04704969729636204,-203.62845356492383,-0.07899109307331176
2023-07-11T05:45:00-04:00,1.10052,1.10086,1.10043,1.10062,1.101538635798764,1.1004915555555557,1.1005999999999954,1.1008124444444385,1.1011710000000046,1.100996200000001,1.0994201000000003,1.0968742000000047,1.1006521584789526,1.100760097628341,2500,-204700,-208748.4,-0.048812128654684726,-203.40128822490277,-0.06356009152654496
2023-07-11T06:00:00-04:00,1.10062,1.10106,1.10051,1.10087,1.1013537722188875,1.1005455555555557,1.100607777777773,1.1007084444444384,1.1011115000000045,1.1010154000000012,1.0994615,1.0969428000000048,1.100695726783162,1.1006984781026723,2558,-202142,-207325.8,-0.04810093628783144,-202.82025208163788,0.006359011627908293
2023-07-11T06:15:00-04:00,1.10087,1.1010199999999999,1.10064,1.10071,1.1011873949969988,1.100566,1.1005688888888843,1.1006457777777718,1.1010575000000045,1.1010306000000012,1.0994970000000002,1.0970074000000047,1.1006985814265298,1.1006803824821376,-1751,-203893,-205618.6,-0.04308275677707494,-203.07474171256604,-0.031787550178904916
2023-07-11T06:30:00-04:00,1.10071,1.10126,1.1007,1.10084,1.09969,1.1006202222222223,1.100526666666662,1.1005962222222165,1.1010180000000045,1.101046800000001,1.0995353000000003,1.0970737000000046,1.1007268651412239,1.1006867059857097,2125,-201768,-203940.6,-0.04097398191033459,-202.82376734147834,-0.03450718294255888
2023-07-11T06:45:00-04:00,1.10084,1.10087,1.10039,1.10059,1.0997214,1.1006328888888888,1.100517777777773,1.1005642222222165,1.1010130000000045,1.101058200000001,1.0995793000000003,1.0971377500000046,1.1006994921129791,1.1006945647885673,-2128,-203896,-203279.8,-0.04219982310374343,-203.30703466461355,-0.007268300217147737
2023-07-11T07:00:00-04:00,1.10059,1.10064,1.10019,1.1003,1.0997521719999999,1.1005893333333334,1.1005222222222173,1.1005486666666608,1.1009485000000043,1.101062600000001,1.0996205000000003,1.0971987500000047,1.1006195936903833,1.1006880518308535,-2061,-205957,-203531.2,-0.043874369824527484,-203.85009793067974,0.0036355043353425557
2023-07-11T07:15:00-04:00,1.1003,1.10043,1.09997,1.10003,1.09978232856,1.100490888888889,1.1005333333333285,1.100533777777772,1.1008340000000045,1.101060600000001,1.0996612000000003,1.0972620500000048,1.1005016749523067,1.1006492414646825,-1569,-207526,-204608,-0.03921882434322031,-204.23511110890385,0.009091487640121552
2023-07-11T07:30:00-04:00,1.10003,1.10005,1.0988499999999999,1.09888,1.10126,1.1001602222222222,1.1003733333333285,1.1004946666666608,1.1006880000000046,1.1010330000000008,1.0996924000000003,1.0973140500000047,1.1001773399618453,1.1005449931717455,-2300,-209826,-205794.6,-0.03388193926474784,-206.63959098672532,-0.13087101933981804
2023-07-11T07:45:00-04:00,1.09888,1.09896,1.0983,1.09837,1.1012118,1.0997595555555557,1.1001344444444396,1.1004162222222162,1.1004995000000046,1.100992600000001,1.0997168000000004,1.0973657500000047,1.0998158719694762,1.100362794537396,-3601,-213427,-208126.4,-0.03676424457592631,-208.31084717484416,-0.1953621924181182
2023-07-11T08:00:00-04:00,1.09837,1.09903,1.09835,1.09888,1.101095328,1.0995086666666667,1.0999411111111062,1.1003008888888828,1.1003790000000044,1.100963400000001,1.0997470000000005,1.0974193000000048,1.099628697575581,1.1001486356299164,3468,-209959,-209339,-0.037565662015917635,-206.70057012794734,-0.15809271138084469
2023-07-11T08:15:00-04:00,1.09888,1.09898,1.09827,1.09846,1.10098351488,1.0992124444444444,1.0996733333333286,1.100131111111105,1.1002325000000046,1.100922200000001,1.0997740000000005,1.0974701500000048,1.0993949580604647,1.0999037085039327,-2739,-212698,-210687.2,-0.04495361385983823,-207.74743602777284,-0.21891776504037927
2023-07-11T08:30:00-04:00,1.09846,1.0986,1.098,1.09818,1.1008207039872,1.0989137777777778,1.0993922222222174,1.099902888888883,1.1000755000000044,1.100875800000001,1.0997961000000003,1.0975138500000048,1.0991519664483718,1.0996337668031457,-3376,-216074,-212396.8,-0.05551700808904489,-208.60798625263328,-0.22985164121341162
2023-07-11T08:45:00-04:00,1.09818,1.09843,1.09768,1.09819,1.100595047668224,1.0986733333333334,1.0990977777777728,1.0996477777777716,1.0999450000000044,1.100824800000001,1.0998242000000005,1.0975586500000047,1.0989595731586974,1.0993902134425162,4074,-212000,-212831.6,-0.06488395953152085,-208.57088850909372,-0.2407252643435959
2023-07-11T09:00:00-04:00,1.09819,1.0987,1.09793,1.09855,1.1003035429014016,1.0985637777777777,1.0988711111111062,1.099395111111105,1.0998195000000044,1.1007830000000012,1.0998552000000004,1.0976057500000047,1.098877658526958,1.0992025707540127,4493,-207507,-211647.6,-0.0759694251958695,-207.09802862146077,-0.18535512770423518
2023-07-11T09:15:00-04:00,1.09855,1.09904,1.09831,1.09897,1.1000411886112615,1.0985835555555554,1.0987233333333284,1.0991515555555496,1.0997070000000044,1.1007492000000012,1.0998930000000005,1.0976550500000046,1.0988961268215665,1.09905605660321,3180,-204327,-210521.2,-0.08165709475798705,-205.88224417833095,-0.12087612469327032
2023-07-11T09:30:00-04:00,1.09897,1.09937,1.0982,1.09821,1.0998050697501354,1.0984808888888888,1.098521111111106,1.098921111111105,1.0995840000000043,1.1006974000000012,1.0999272000000004,1.0976995500000049,1.0987589014572532,1.0989288452825676,-4607,-208934,-209768.4,-0.08763941305196078,-209.0682456160412,-0.16545003318092733
2023-07-11T09:45:00-04:00,1.09821,1.09892,1.098,1.09871,1.0995925627751217,1.0985186666666666,1.0985022222222172,1.0987431111111052,1.0995065000000044,1.1006490000000013,1.0999674000000006,1.0977493500000046,1.0987491211658025,1.0988482762260539,4175,-204759,-207505.4,-0.09116346670585207,-207.16742519007468,-0.015470297029703286
2023-07-11T10:00:00-04:00,1.09871,1.09876,1.09783,1.09834,1.0994013064976096,1.0984862222222223,1.0984988888888838,1.0986233333333275,1.0994270000000044,1.100596800000001,1.0999964000000007,1.0977984500000046,1.098667296932642,1.0987898209808429,-4273,-209032,-206911.8,-0.08776675110955715,-208.60639452684228,-0.002731320046976382
2023-07-11T10:15:00-04:00,1.09834,1.09922,1.0982399999999999,1.09898,1.0992291758478485,1.0985824444444445,1.0985099999999948,1.098551111111105,1.0993600000000046,1.1005578000000011,1.1000263000000006,1.0978496500000048,1.0987298375461136,1.098760256784674,3143,-205889,-206588.2,-0.07810713320399659,-206.77497620464703,0.009100174723353685
2023-07-11T10:30:00-04:00,1.09898,1.09916,1.09874,1.09915,1.09768,1.0987104444444444,1.0985866666666615,1.0985237777777717,1.0992915000000045,1.1005242000000013,1.1000602000000006,1.0978902000000048,1.098813870036891,1.0987438054277388,3091,-202798,-206282.4,-0.0705871651426046,-206.29683283534095,0.06281521402691763
2023-07-11T10:45:00-04:00,1.09915,1.09933,1.09839,1.09898,1.0977096,1.098789111111111,1.0986755555555503,1.0985546666666604,1.0992095000000044,1.1004824000000013,1.1000831000000004,1.097929350000005,1.098847096029513,1.0987614443421907,-4711,-207509,-205997.4,-0.059190437347763226,-207.02545950140112,0.07284780272816241
2023-07-11T11:00:00-04:00,1.09898,1.09936,1.0986799999999999,1.09935,1.097774416,1.0989239999999998,1.0988044444444391,1.0986151111111047,1.0991335000000044,1.1004408000000012,1.1000969000000005,1.097971950000005,1.0989476768236104,1.0988011554737525,3979,-203530,-205751.6,-0.04304799003923783,-205.6858263870588,0.10562835210665275
2023-07-11T11:15:00-04:00,1.09935,1.0994599999999999,1.09893,1.09911,1.09786955104,1.098985111111111,1.0988666666666613,1.0986886666666602,1.0990535000000043,1.1003856000000012,1.1001134000000006,1.0980137000000048,1.0989801414588882,1.0988637243790016,-2434,-205964,-205138,-0.02705597228592286,-206.2171949230119,0.050976286923682675
2023-07-11T11:30:00-04:00,1.09911,1.09931,1.09874,1.09895,1.0979967869568001,1.099001777777778,1.098864444444439,1.098759555555549,1.0989590000000047,1.1003330000000013,1.1001322000000004,1.0980522000000048,1.0989741131671107,1.0989125795032009,-2050,-208014,-205563,-0.015792880594990705,-206.5156181927482,-0.001819885893146217
2023-07-11T11:45:00-04:00,1.09895,1.09925,1.09862,1.09917,1.098113844000256,1.099062888888889,1.0989711111111058,1.0988364444444378,1.0988880000000045,1.1002878000000011,1.1001492000000006,1.098090000000005,1.0990132905336885,1.0989524636025605,2307,-205707,-206144.8,-0.0067379167050487,-206.05377734466617,0.08741497527795886
2023-07-11T12:00:00-04:00,1.09917,1.09945,1.09909,1.09935,1.0982215364802355,1.0991386666666667,1.099042222222217,1.0989097777777714,1.0988405000000045,1.1002484000000012,1.1001618000000006,1.098127000000005,1.0990806324269509,1.0989991708820483,2123,-203584,-205359.8,0.009008927028121871,-205.70611501763747,0.05825012969755203
2023-07-11T12:15:00-04:00,1.09935,1.0996299999999999,1.09922,1.09945,1.0983206135618166,1.0992202222222223,1.0991655555555502,1.0989819999999937,1.0988115000000047,1.1002028000000015,1.1001730000000007,1.0981596500000048,1.0991545059415606,1.0990405367056382,1681,-201903,-205034.4,0.019426891533106786,-205.5532064807748,0.1010616020540037
2023-07-11T12:30:00-04:00,1.09945,1.09966,1.09934,1.09966,1.098451552205635,1.0993191111111111,1.0992411111111058,1.0990568888888825,1.0988505000000046,1.1001626000000015,1.1001829000000007,1.098183850000005,1.0992556047532485,1.0990956293645104,1890,-200013,-203844.2,0.03304314589859475,-205.19220779961597,0.061875557334984614
2023-07-11T12:45:00-04:00,1.09966,1.10032,1.09962,1.10025,1.098596565940959,1.0995208888888888,1.099363333333328,1.0991566666666601,1.0989445000000047,1.1001342000000014,1.1001955000000008,1.0982107000000048,1.0994544838025988,1.0991917034916079,2184,-197829,-201807.2,0.03866143554348308,-204.0204274311387,0.1000773324841813
2023-07-11T13:00:00-04:00,1.10025,1.10066,1.10022,1.10056,1.0988378467092246,1.0997602222222223,1.0995388888888833,1.0992702222222157,1.0990285000000044,1.1001088000000012,1.1002167000000005,1.0982388500000049,1.0996755870420791,1.0993241627932862,1993,-195836,-199833,0.04199840117551267,-203.4588914165965,0.14376967733715942
2023-07-11T13:15:00-04:00,1.10056,1.10092,1.10036,1.1006799999999999,1.0991293912357487,1.0999884444444445,1.099686666666661,1.0993991111111043,1.0991395000000044,1.1000828000000014,1.1002356000000006,1.0982678000000048,1.0998764696336634,1.0994833302346287,1614,-194222,-197960.6,0.04966368805893439,-203.28290828073852,0.12098057943328615
2023-07-11T13:30:00-04:00,1.1006799999999999,1.10078,1.10056,1.10072,1.099451700813314,1.1001951111111112,1.0998655555555499,1.0995391111111044,1.0992665000000046,1.1000560000000013,1.1002556000000008,1.0982930000000046,1.1000451757069307,1.0996614641877025,1282,-192940,-196168,0.05233172944714403,-203.23631889962863,0.14648215374256346
2023-07-11T13:45:00-04:00,1.10072,1.10073,1.10032,1.10066,1.0997159946669175,1.100354,1.10005555555555,1.099701999999993,1.0993900000000045,1.1000334000000014,1.1002732000000006,1.098314800000005,1.1001681405655446,1.0998439713501618,-1362,-194302,-195025.8,0.05568312210178922,-203.31056121375022,0.1556030756631219
2023-07-11T14:00:00-04:00,1.10066,1.10076,1.10029,1.10031,1.0999327156268723,1.1004048888888889,1.1001822222222166,1.099865777777771,1.0994780000000044,1.1000070000000013,1.1002871000000005,1.0983330000000047,1.1001965124524355,1.0999923770801292,-1007,-195309,-194521.8,0.058865797157485585,-203.63077817448294,0.10371462103222603
2023-07-11T14:15:00-04:00,1.10031,1.10031,1.0997999999999999,1.09984,1.10092,1.1003364444444446,1.100236666666661,1.1000053333333262,1.0995215000000045,1.0999900000000014,1.1002933000000008,1.0983483500000049,1.1001252099619485,1.100082301664103,-1129,-196438,-194642.2,0.05936923436772218,-204.11303317534632,0.04457179242278432
2023-07-11T14:30:00-04:00,1.09984,1.10012,1.09974,1.10002,1.1008976,1.1002931111111112,1.1002999999999943,1.1001279999999931,1.0996120000000045,1.0999586000000015,1.1002975000000006,1.0983638500000048,1.100104167969559,1.100127841331282,1498,-194940,-194785.8,0.06091262838144825,-203.867870242556,0.051844103870113185
2023-07-11T14:45:00-04:00,1.10002,1.1001,1.09991,1.09991,1.1008512959999999,1.100215111111111,1.100327777777772,1.1002204444444375,1.0996720000000044,1.0999104000000015,1.1003014000000007,1.0983775500000048,1.100065334375647,1.1001318730650254,-1553,-196493,-195496.4,0.057729574769362926,-204.02316741897104,0.022734299692619666
2023-07-11T15:00:00-04:00,1.09991,1.10013,1.09989,1.10005,1.1008068441599999,1.1001595555555554,1.1003055555555497,1.1002704444444373,1.0997575000000044,1.0998754000000013,1.1003072000000007,1.0983926000000048,1.1000622675005176,1.1001106984520201,1270,-195223,-195680.6,0.05547017795966695,-203.86151782945913,-0.018177686889341328
2023-07-11T15:15:00-04:00,1.10005,1.1004099999999999,1.10003,1.10035,1.1007641703935998,1.1001684444444442,1.1002822222222166,1.1002904444444375,1.0998260000000044,1.0998396000000015,1.1003142000000008,1.098408550000005,1.100119814000414,1.1000953587616158,1176,-194047,-195428.2,0.04767162434283198,-203.54080513458166,-0.019081195027989703
2023-07-11T15:30:00-04:00,1.10035,1.10065,1.1003,1.10042,1.1007232035778558,1.100196,1.1002533333333275,1.1002937777777708,1.0998895000000046,1.0998222000000013,1.1003237000000008,1.098426150000005,1.1001798512003311,1.1001062870092924,1216,-192831,-194706.8,0.04016116420658983,-203.46344793005582,-0.02362176109313579
2023-07-11T15:45:00-04:00,1.10042,1.10073,1.10035,1.10061,1.09974,1.1002673333333333,1.1002411111111055,1.100281999999993,1.0999710000000045,1.0998066000000015,1.1003310000000008,1.0984455000000048,1.100265880960265,1.1001386296074336,1829,-191002,-193919.2,0.033201433865959244,-203.1476503255046,-0.009993458826934412
2023-07-11T16:00:00-04:00,1.10061,1.10073,1.1005,1.10051,1.0997598,1.100321111111111,1.1002244444444387,1.1002613333333264,1.1000290000000044,1.0997904000000016,1.100336800000001,1.0984644000000048,1.100314704768212,1.1001885036859467,-892,-191894,-192999.4,0.02466674141480806,-203.22869629092378,-0.013628186724317452
2023-07-11T16:15:00-04:00,1.10051,1.10063,1.10048,1.10053,1.0997792039999998,1.1003822222222222,1.1002488888888833,1.1002499999999933,1.1001000000000043,1.0997850000000016,1.1003437000000007,1.098482750000005,1.1003577638145696,1.100247602948757,538,-191356,-192226,0.01837574038692116,-203.2189190058469,0.019994365224355774
2023-07-11T16:30:00-04:00,1.10053,1.10079,1.10053,1.10078,1.0997982199199998,1.1004884444444445,1.1003533333333275,1.1002642222222154,1.1001915000000044,1.0997794000000016,1.1003535000000009,1.0985031500000049,1.1004422110516556,1.1003120823590051,500,-190856,-191587.8,0.015418057913819035,-203.1053373679088,0.08546697701485334
2023-07-11T16:45:00-04:00,1.10078,1.10089,1.10067,1.10084,1.0998378911231999,1.1005857777777777,1.1004444444444386,1.1003024444444376,1.1002750000000046,1.0997718000000016,1.1003640000000008,1.098523700000005,1.1005217688413245,1.1003804658872038,691,-190165,-191054.6,0.016325703851640873,-203.06767316616097,0.07454409919820029
2023-07-11T17:00:00-04:00,1.10084,1.1008499999999999,1.10005,1.10067,1.099901017655808,1.100630888888889,1.1005288888888831,1.1003599999999931,1.1003410000000045,1.0997718000000014,1.1003708000000008,1.098542850000005,1.1005514150730595,1.1004375727097628,-119,-190284,-190911,0.01574038449515732,-203.08605004200123,0.06909656244602685
2023-07-11T17:15:00-04:00,1.10067,1.1008499999999999,1.10045,1.1007,1.0999603565964595,1.1006651111111112,1.1006011111111054,1.1004353333333265,1.1004035000000045,1.0997806000000014,1.1003781000000008,1.098562400000005,1.1005811320584475,1.10049085816781,208,-190076,-190547.4,0.01707669191721965,-203.08038076783185,0.05908822326258256
2023-07-11T17:30:00-04:00,1.1007,1.10088,1.10067,1.10084,1.1000161352006719,1.1007128888888889,1.1006555555555497,1.1005166666666597,1.1004625000000043,1.0997988000000014,1.100386000000001,1.0985836000000049,1.100632905646758,1.1005458865342477,407,-189669,-190210,0.01823971792744968,-203.0286137105047,0.044531285500077386
2023-07-11T17:45:00-04:00,1.10084,1.10084,1.10057,1.1006799999999999,1.1000685670886317,1.100717777777778,1.1006844444444388,1.100582888888882,1.1004840000000045,1.0998060000000016,1.1003922000000008,1.098603750000005,1.1006423245174064,1.1005859092273977,-438,-190107,-190060.2,0.016823936723750953,-203.09227418795834,0.023627342287483595
2023-07-11T18:00:00-04:00,1.1006799999999999,1.1009,1.10064,1.10084,1.1001178530633138,1.1007488888888888,1.1007099999999943,1.100635999999993,1.1004980000000046,1.0998124000000016,1.1003996000000007,1.0986242000000048,1.1006818596139252,1.100617927381918,400,-189707,-189968.6,0.018087001071820617,-203.03412831449825,0.020897502294177996
2023-07-11T18:15:00-04:00,1.10084,1.10101,1.10084,1.10097,1.1001804248182487,1.100800888888889,1.1007611111111055,1.1006824444444376,1.1005125000000047,1.0998194000000014,1.1004078000000008,1.0986458000000048,1.10073948769114,1.100655541905534,360,-189347,-189781.2,0.019583807315859004,-202.99161532441795,0.041798802373436396
2023-07-11T18:30:00-04:00,1.10097,1.10105,1.10094,1.10101,1.1002633823364238,1.1008506666666666,1.1008144444444388,1.1007251111111043,1.1005270000000047,1.0998222000000015,1.1004188000000008,1.0986681500000048,1.100793590152912,1.1006980335244267,365,-188982,-189562.4,0.02269889222873082,-202.97835429096563,0.04361534896822767
2023-07-11T18:45:00-04:00,1.10101,1.10122,1.10099,1.10121,1.100357776456053,1.1009297777777778,1.1008622222222166,1.1007664444444376,1.1005545000000048,1.0998322000000014,1.1004314000000006,1.0986901000000049,1.1008768721223297,1.100746826819541,420,-188562,-189341,0.02675695263278197,-202.90206070598458,0.03906320972400756
2023-07-11T19:00:00-04:00,1.10121,1.10125,1.10117,1.10119,1.1004784877522056,1.1009953333333335,1.1009011111111053,1.100809777777771,1.1005985000000047,1.0998392000000015,1.1004430000000007,1.0987145500000048,1.1009394976978637,1.1008062614556327,-408,-188970,-189113.6,0.02818847816009769,-202.90947073676895,0.03179390283781934
2023-07-11T19:15:00-04:00,1.10119,1.10131,1.10111,1.10115,1.1006019297118528,1.101045111111111,1.1009544444444386,1.1008586666666598,1.1006640000000047,1.0998504000000016,1.1004543000000007,1.0987376000000049,1.1009815981582909,1.1008662091645056,-513,-189483,-189068.8,0.027369736323381917,-202.92810512320537,0.04360980130284608
2023-07-11T19:30:00-04:00,1.10115,1.10143,1.10114,1.1014,1.1007293823637192,1.1011342222222222,1.1010322222222164,1.1009128888888822,1.1007330000000048,1.0998724000000015,1.1004675000000008,1.098763350000005,1.1010652785266326,1.1009313673316041,499,-188984,-188996.2,0.02725108026631738,-202.81481447252204,0.06359589352229698
2023-07-11T19:45:00-04:00,1.1014,1.10143,1.10126,1.10136,1.1008695058909754,1.1011997777777778,1.1010899999999941,1.100967999999993,1.1008055000000048,1.0998990000000015,1.100479800000001,1.098788150000005,1.101124222821306,1.100997493865283,-763,-189747,-189149.2,0.027448496757253953,-202.84252465955674,0.047236655644767075
2023-07-11T20:00:00-04:00,1.10136,1.10148,1.10117,1.10139,1.1009816047127803,1.101259777777778,1.1011688888888829,1.1010293333333263,1.1008725000000048,1.0999492000000013,1.1004911000000008,1.0988114500000048,1.1011773782570449,1.101057595092226,1629,-188118,-189060.4,0.026040878123087325,-202.7981522472662,0.06450557836975421
2023-07-11T20:15:00-04:00,1.10139,1.10202,1.10136,1.10199,1.1010812837702242,1.1014240000000002,1.1012966666666608,1.1011084444444375,1.1009545000000047,1.1000216000000014,1.1005071000000008,1.098837000000005,1.1013399026056359,1.1011376760737803,1947,-186171,-188500.6,0.029546563412012415,-201.73749253544761,0.1044656807528782
2023-07-11T20:30:00-04:00,1.10199,1.10215,1.10173,1.10188,1.10117,1.1015406666666665,1.1013977777777721,1.1011971111111043,1.1010275000000047,1.1000816000000013,1.100522500000001,1.098862850000005,1.1014479220845086,1.101230940859024,-2936,-189107,-188425.4,0.03237320925593945,-202.03056234551863,0.08265438658637078
2023-07-11T20:45:00-04:00,1.10188,1.10216,1.10169,1.10187,1.10136,1.1016351111111111,1.1014933333333277,1.1012893333333265,1.1010905000000046,1.1001498000000014,1.1005360000000008,1.0988890500000048,1.101532337667607,1.1013243526872187,-2193,-191300,-188888.6,0.034274094148057155,-202.05046469423186,0.07811009890917074
2023-07-11T21:00:00-04:00,1.10187,1.10278,1.10185,1.10276,1.1015199999999998,1.1018884444444446,1.1016655555555497,1.1014044444444377,1.1012030000000048,1.1002414000000014,1.100558600000001,1.098920850000005,1.1017778701340855,1.1014550821497746,2332,-188968,-188732.8,0.040865624745039,-200.16686681063385,0.14075426122174156
2023-07-11T21:15:00-04:00,1.10276,1.10316,1.10255,1.1026,1.10169,1.1020753333333333,1.1018222222222163,1.1015351111111045,1.1013065000000046,1.1003296000000014,1.100577200000001,1.0989524000000048,1.1019422961072685,1.1016080657198193,-2581,-191549,-189419,0.0444465391894081,-200.5413453916486,0.12804329861333044
2023-07-11T21:30:00-04:00,1.1026,1.10288,1.10223,1.10287,1.10185,1.1022848888888888,1.1020133333333275,1.1016784444444379,1.1014110000000046,1.1004160000000016,1.100599500000001,1.0989842500000049,1.1021278368858147,1.101765652575855,2490,-189059,-189996.6,0.04957845129536665,-199.9316047785523,0.15620033601234562
2023-07-11T21:45:00-04:00,1.10287,1.10291,1.10252,1.10271,1.102112,1.1024242222222222,1.102158888888883,1.10183066666666,1.1015045000000048,1.1004908000000015,1.100620000000001,1.0990144500000048,1.1022442695086518,1.1019249220606837,-1919,-190978,-190370.8,0.05539336291323194,-200.21000567802358,0.11893953150536994
2023-07-11T22:00:00-04:00,1.10271,1.10296,1.10253,1.10271,1.10223,1.1025344444444445,1.102308888888883,1.1019937777777709,1.1016065000000048,1.1005808000000015,1.100639100000001,1.0990479500000048,1.1023374156069214,1.1020859376485466,0,-190978,-190306.4,0.059197330198282154,-200.21000567802358,0.12257572455874415
2023-07-11T22:15:00-04:00,1.10271,1.10335,1.10271,1.10313,1.102416,1.1026986666666667,1.1025022222222163,1.1021611111111043,1.1017280000000047,1.1006692000000016,1.1006591000000012,1.0990842500000049,1.1024959324855372,1.1022295501188368,1916,-189062,-190325.2,0.06462430074314585,-199.48023991912075,0.1579821861465832
2023-07-11T22:30:00-04:00,1.10313,1.10326,1.10278,1.10297,1.10253,1.1027922222222222,1.1026111111111052,1.1023188888888822,1.1018345000000047,1.1007618000000015,1.100679300000001,1.0991190000000048,1.1025907459884299,1.102359240095069,-2118,-191180,-190251.4,0.06914739818862252,-199.787438526719,0.08893002658826131
2023-07-11T22:45:00-04:00,1.10297,1.10316,1.10284,1.1031,1.102694,1.10289,1.1027466666666608,1.1024655555555487,1.1019555000000048,1.1008442000000014,1.100701000000001,1.0991523500000049,1.102692596790744,1.102472192076055,1386,-189794,-190398.4,0.06944747553937146,-199.62407959583243,0.11071986060188033
2023-07-11T23:00:00-04:00,1.1031,1.10314,1.1027,1.10296,1.10335,1.1029326666666668,1.1028677777777718,1.1026073333333266,1.1020615000000047,1.1009204000000015,1.100722300000001,1.099184050000005,1.1027460774325952,1.1025725536608437,-1783,-191577,-190518.2,0.0693887798287228,-199.85036914347094,0.09892274043217761
2023-07-11T23:15:00-04:00,1.10296,1.10304,1.10269,1.10271,1.103337,1.102901111111111,1.1028622222222164,1.1027179999999932,1.1021485000000046,1.1009950000000013,1.100738700000001,1.0992136500000047,1.1027388619460763,1.1026528429286746,-1218,-192795,-190881.6,0.06892517004496247,-200.12644443178587,-0.004534078131223791
2023-07-11T23:30:00-04:00,1.10271,1.10311,1.10265,1.10274,1.10331112,1.1028766666666667,1.102877777777772,1.1027931111111042,1.1022350000000047,1.1010628000000013,1.100751800000001,1.099247450000005,1.102739089556861,1.1027014743429393,1557,-191238,-191316.8,0.061091234618020386,-200.08408515328114,0.012697261019411299
2023-07-11T23:45:00-04:00,1.10274,1.10298,1.10271,1.10295,1.1032714528,1.102891111111111,1.102886666666661,1.1028482222222153,1.1023220000000047,1.1011396000000016,1.100762600000001,1.0992820000000048,1.1027812716454888,1.1027395794743513,1187,-190051,-191091,0.05588040254672378,-199.85803912248508,0.0072538014453271925
2023-07-12T00:00:00-04:00,1.10295,1.10337,1.1029,1.10321,1.10265,1.1029557777777779,1.1029422222222165,1.1028873333333267,1.1024230000000048,1.1012248000000016,1.100778900000001,1.0993176500000048,1.102867017316391,1.1027744635794805,1390,-188661,-190864.4,0.050320415211925346,-199.53037241048554,0.04534283719200378
2023-07-12T00:15:00-04:00,1.10321,1.1034,1.10304,1.10322,1.1026643999999999,1.1030113333333333,1.102998888888883,1.1029135555555487,1.1025265000000046,1.1013058000000016,1.100796800000001,1.0993547000000048,1.1029376138531128,1.1028127708635842,1256,-187405,-190030,0.04617375499360733,-199.518987452046,0.0462496939358499
2023-07-12T00:30:00-04:00,1.10322,1.10342,1.10321,1.10342,1.102693824,1.1030955555555557,1.1030311111111055,1.1029473333333266,1.1026275000000045,1.1013872000000016,1.100817800000001,1.0993932000000048,1.1030340910824903,1.1028718166908669,1048,-186357,-188742.4,0.04280479140752953,-199.32899814800874,0.026288832685188827
2023-07-12T00:45:00-04:00,1.10342,1.10368,1.10338,1.10361,1.1027373945599999,1.1032113333333333,1.1031022222222167,1.1029922222222157,1.1027400000000047,1.1014704000000015,1.1008366000000012,1.0994310500000046,1.1031492728659922,1.1029538533526932,1304,-185053,-187505.4,0.03760986277563668,-199.1044598942161,0.05802515027607042
2023-07-12T01:00:00-04:00,1.10361,1.10362,1.1031199999999999,1.10332,1.1028128029951998,1.1032548888888887,1.103126666666661,1.1030402222222155,1.1028365000000047,1.1015436000000016,1.100853100000001,1.0994689500000048,1.1031834182927938,1.1030342826821542,-1504,-186557,-186806.6,0.0323169583718519,-199.49967197094597,0.019943794760231077
2023-07-12T01:15:00-04:00,1.10332,1.10354,1.103,1.10321,1.1028821787555838,1.103271555555556,1.103154444444439,1.1030826666666602,1.1028975000000047,1.1016028000000015,1.1008685000000011,1.0995075500000047,1.103188734634235,1.1030986261457232,-2108,-188665,-186807.4,0.025453433817640397,-199.70983765270657,0.022666279828831827
2023-07-12T01:30:00-04:00,1.10321,1.10324,1.10266,1.10299,1.10368,1.1032386666666667,1.1031855555555499,1.1031199999999937,1.102953000000005,1.1016514000000015,1.100880100000001,1.0995446500000048,1.1031489877073881,1.1031409009165782,-2049,-190714,-187469.2,0.021406730469918266,-200.11844526141226,0.025391988827510037
2023-07-12T01:45:00-04:00,1.10299,1.10309,1.10254,1.1026,1.1036596,1.1031215555555556,1.1031699999999942,1.1031477777777714,1.102989500000005,1.1016898000000017,1.100886300000001,1.0995797000000047,1.1030391901659105,1.1031419207332624,-1995,-192709,-188739.6,0.01730014170016504,-200.82384603567112,-0.012695649019717158
2023-07-12T02:00:00-04:00,1.1026,1.10322,1.1026,1.10305,1.103614816,1.1030975555555556,1.1031811111111056,1.103163555555549,1.103004000000005,1.1017364000000016,1.100896200000001,1.0996164000000048,1.1030413521327285,1.1031203365866096,2601,-190108,-189750.6,0.015015429887286916,-199.76230966708764,0.009066594133912595
2023-07-12T02:15:00-04:00,1.10305,1.10354,1.10304,1.10305,1.10357182336,1.1030713333333333,1.1031633333333277,1.1031708888888825,1.1030265000000048,1.1017842000000015,1.1009088000000011,1.0996531500000046,1.1030430817061827,1.1030922692692873,0,-190108,-190460.8,0.014669865428808318,-199.76230966708764,-0.014503131770010965
2023-07-12T02:30:00-04:00,1.10305,1.10315,1.10261,1.10264,1.10354,1.1029666666666669,1.1030988888888833,1.1031597777777713,1.103015000000005,1.1018308000000017,1.100918900000001,1.0996881000000045,1.1029624653649461,1.1030470154154295,-1896,-192004,-191128.6,0.00932946569965546,-200.46704653305022,-0.0525733761171865
2023-07-12T02:45:00-04:00,1.10264,1.10308,1.10203,1.10227,1.10354,1.1028008888888892,1.1029711111111056,1.1031168888888825,1.102993000000005,1.1018794000000016,1.1009347000000012,1.0997230000000047,1.1028239722919568,1.1029820123323433,-2847,-194851,-191956,0.0033070596229192516,-201.42238100304945,-0.10422142067390334
2023-07-12T03:00:00-04:00,1.10227,1.1026799999999999,1.10216,1.10249,1.1034494,1.1027046666666667,1.1028466666666612,1.1030522222222159,1.1029820000000048,1.1019288000000016,1.100943700000001,1.0997585500000047,1.1027571778335654,1.1029256098658744,3220,-191631,-191740.4,-0.004174878627997701,-200.7797072479807,-0.10148512608620888
2023-07-12T03:15:00-04:00,1.10249,1.10297,1.10235,1.10276,1.103364236,1.1026873333333334,1.1027844444444388,1.1029728888888826,1.1029635000000049,1.1019858000000016,1.100948100000001,1.0997962500000047,1.1027577422668524,1.1028688878926993,2990,-188641,-191447,-0.012097192000380147,-200.04745570828422,-0.05075590037342892
2023-07-12T03:30:00-04:00,1.10276,1.10292,1.1022399999999999,1.10249,1.10328418184,1.1026284444444445,1.1027044444444387,1.1028811111111048,1.1029395000000048,1.1020346000000014,1.1009550000000012,1.0998326500000046,1.1027041938134818,1.1028011103141588,-2769,-191410,-191707.4,-0.01685968596468353,-200.72541827493515,-0.06526409296507953
2023-07-12T03:45:00-04:00,1.10249,1.10279,1.10229,1.10273,1.1032089309296,1.1026335555555555,1.1026755555555499,1.1027964444444378,1.102921000000005,1.1020822000000015,1.1009609000000011,1.0998732500000046,1.1027093550507854,1.1027504882513268,2566,-188844,-191075.4,-0.020175705220966143,-200.16682817434463,-0.023572289866628616
2023-07-12T04:00:00-04:00,1.10273,1.103,1.10227,1.10297,1.103138195073824,1.1026924444444446,1.102716666666661,1.102745555555549,1.1029215000000048,1.1021332000000015,1.1009777000000012,1.0999133500000047,1.1027614840406283,1.1027379906010613,2828,-186016,-189308.4,-0.019795875808401264,-199.55133752840223,0.033557046979864086
2023-07-12T04:15:00-04:00,1.10297,1.10305,1.1024,1.10242,1.1030717033693944,1.102633111111111,1.102646666666661,1.102705555555549,1.102907000000005,1.1021694000000015,1.1009880000000012,1.0999492000000048,1.1026931872325028,1.1027251924808488,-2097,-188113,-188604.8,-0.01909688115892182,-200.59701420138526,-0.05711436471602651
2023-07-12T04:30:00-04:00,1.10242,1.10274,1.10216,1.10253,1.10305,1.102609777777778,1.1025888888888833,1.1026664444444378,1.1028965000000048,1.1022098000000016,1.1010001000000011,1.099986750000005,1.1026605497860023,1.1027057539846787,2229,-185884,-188053.4,-0.023034739495450915,-200.3746035049174,-0.04714201532116186
2023-07-12T04:45:00-04:00,1.10253,1.10271,1.10216,1.10222,1.10305,1.102536,1.1025422222222165,1.1026339999999935,1.1028600000000048,1.1022436000000015,1.101014300000001,1.1000227000000047,1.1025724398288017,1.1026794031877425,-2022,-187906,-187352.6,-0.028315878782760318,-200.9431322524345,-0.03809040121890073
2023-07-12T05:00:00-04:00,1.10222,1.10234,1.10182,1.10231,1.1029888,1.1024895555555554,1.1025466666666608,1.1026082222222156,1.1028150000000048,1.1022742000000014,1.101026800000001,1.1000545500000047,1.1025199518630413,1.1026415225501938,2526,-185380,-186659.8,-0.028545508950342836,-200.73687578820795,0.003628874958024618
2023-07-12T05:15:00-04:00,1.10231,1.10272,1.10205,1.10263,1.102895296,1.1025062222222222,1.1025622222222167,1.1025773333333269,1.1027855000000049,1.1023100000000015,1.101040900000001,1.1000926500000048,1.102541961490433,1.1025976180401547,1941,-183439,-186144.4,-0.022777390837593333,-200.17340453239046,0.012698527877806511
2023-07-12T05:30:00-04:00,1.10263,1.10272,1.1021,1.10247,1.10280927232,1.1024877777777777,1.1025299999999942,1.1025539999999934,1.1027380000000049,1.1023460000000016,1.101058900000001,1.1001298000000048,1.1025275691923464,1.1025644944321233,-2017,-185456,-185613,-0.019720893437672048,-200.46608657441715,-0.026297653161150337
2023-07-12T05:45:00-04:00,1.10247,1.10278,1.10239,1.10248,1.10182,1.1024777777777777,1.1025288888888831,1.1025419999999935,1.102681500000005,1.1023816000000015,1.101081100000001,1.1001650000000047,1.1025180553538771,1.1025359955456984,1935,-183521,-185140.4,-0.01820165097351143,-200.44853507641747,-0.0009070377055633623
2023-07-12T06:00:00-04:00,1.10248,1.10249,1.10214,1.10244,1.1018392000000001,1.10246,1.1024966666666611,1.1025328888888821,1.102637500000005,1.1024136000000015,1.101106200000001,1.1001976500000048,1.1025024442831017,1.1025219964365582,-2261,-185782,-184715.6,-0.013603344608560067,-200.53056831058007,-0.02629836859429792
2023-07-12T06:15:00-04:00,1.10244,1.10253,1.1022,1.10248,1.1018580160000002,1.1024566666666666,1.1024422222222166,1.1025119999999933,1.1026010000000048,1.1024496000000017,1.101127800000001,1.1002310000000048,1.1024979554264813,1.1025175971492465,1631,-184151,-184469.8,-0.012243454286125995,-200.4713904868439,-0.044425505680127424
2023-07-12T06:30:00-04:00,1.10248,1.10252,1.10184,1.10197,1.10278,1.1023622222222222,1.1023922222222167,1.1024779999999936,1.1025500000000048,1.1024722000000016,1.101142300000001,1.1002604500000048,1.102392364341185,1.1024876777193968,-1753,-185904,-184962.8,-0.01595837261699445,-201.2823167621505,-0.0408192884744527
2023-07-12T06:45:00-04:00,1.10197,1.10236,1.10185,1.10219,1.1027612,1.1023217777777778,1.1023544444444389,1.1024428888888824,1.1025295000000048,1.1024966000000016,1.101158000000001,1.1002890500000049,1.102351891472948,1.1024525421755171,1652,-184252,-184722,-0.014589782228262974,-200.9525074206982,-0.03083816313388361
2023-07-12T07:00:00-04:00,1.10219,1.10228,1.1017,1.10197,1.102742776,1.102244888888889,1.1023266666666611,1.1024024444444382,1.1024755000000048,1.1025158000000017,1.101169000000001,1.1003152500000049,1.1022755131783584,1.1024040337404135,-1987,-186239,-185265.6,-0.016948449760621164,-201.3491178054778,-0.022681497341736086
2023-07-12T07:15:00-04:00,1.10197,1.10214,1.10169,1.10196,1.10270106496,1.1021715555555553,1.1022877777777722,1.1023606666666603,1.1024210000000048,1.1025308000000016,1.101181500000001,1.1003392500000049,1.1022124105426867,1.1023460269923304,-2193,-188432,-185795.6,-0.01459950491219308,-201.36901852872765,-0.03175150366048121
2023-07-12T07:30:00-04:00,1.10196,1.10237,1.10165,1.10234,1.1026404010624,1.102182,1.10225555555555,1.102323333333327,1.1024060000000049,1.1025538000000017,1.101196500000001,1.1003659000000048,1.1022379284341495,1.102294021593864,2341,-186091,-186183.6,-0.011260969401871766,-200.5617478473961,-0.026300753652621592
2023-07-12T07:45:00-04:00,1.10234,1.10247,1.10136,1.10149,1.102561168977408,1.1020288888888887,1.102146666666661,1.102274222222216,1.102367000000005,1.1025606000000017,1.101205500000001,1.100392400000005,1.1020883427473196,1.1022332172750908,-3229,-189320,-186866.8,-0.01663526944902653,-203.0515876427406,-0.08889130769998103
2023-07-12T08:00:00-04:00,1.10149,1.10246,1.10148,1.10246,1.10136,1.1020915555555557,1.1021444444444386,1.1022322222222158,1.102365500000005,1.1025818000000016,1.101227100000001,1.1004238000000048,1.1021626741978556,1.1021953738200725,2871,-186449,-187306.2,-0.01754658787505568,-200.52331230660522,-0.0018140918656038188
2023-07-12T08:15:00-04:00,1.10246,1.10271,1.10186,1.10212,1.10136,1.1020866666666669,1.102108888888883,1.1021886666666603,1.102333500000005,1.1025970000000016,1.101248000000001,1.1004546000000048,1.1021541393582845,1.1021710990560576,-3887,-190336,-188125.6,-0.019214295988720393,-201.72206781700925,-0.029026522985386775
2023-07-12T08:30:00-04:00,1.10212,1.10717,1.1021,1.1062,1.101414,1.1029048888888888,1.1025222222222166,1.102235555555549,1.102519000000005,1.1026932000000016,1.1013212000000008,1.100506800000005,1.1029633114866277,1.1023212792448458,20271,-170065,-184452.2,0.00003455295217557801,-126.67971308249604,0.3374210870038611
2023-07-12T08:45:00-04:00,1.1062,1.10677,1.1043,1.10581,1.10175936,1.1035624444444445,1.1029488888888832,1.1023742222222157,1.102673000000005,1.1027696000000018,1.1013956000000007,1.1005562000000049,1.1035326491893023,1.1025802233958761,-11381,-181446,-183523.2,0.01589639746478234,-130.6921791826599,0.34846683666525097
2023-07-12T09:00:00-04:00,1.10581,1.10775,1.10563,1.10767,1.1020839984,1.1045066666666665,1.103557777777772,1.1026564444444378,1.1029080000000049,1.1028854000000017,1.1014835000000007,1.1006152500000048,1.1043601193514418,1.1030345787167009,8820,-172626,-180184.4,0.046245584736572,-115.85671920309764,0.49719195420026757
2023-07-12T09:15:00-04:00,1.10767,1.10843,1.10737,1.10821,1.1025372785279999,1.105437111111111,1.1042511111111055,1.1030777777777714,1.1031975000000047,1.1030122000000018,1.1015810000000008,1.100677500000005,1.1051300954811534,1.1036280629733601,7301,-165325,-175959.6,0.07818661274985989,-112.29741002256563,0.5662586095810253
2023-07-12T09:30:00-04:00,1.10821,1.10926,1.10814,1.10837,1.1031265506752,1.106260888888889,1.1049633333333277,1.10364866666666,1.103489500000005,1.1031244000000018,1.1016829000000008,1.1007395000000049,1.1057780763849228,1.1043528503786877,9020,-156305,-169153.4,0.11048958412490772,-110.9951297688218,0.5816908054738853
2023-07-12T09:45:00-04:00,1.10837,1.11005,1.1083,1.10978,1.103862564594176,1.1072242222222222,1.1057899999999943,1.1043022222222159,1.1038675000000047,1.1032680000000017,1.1017988000000007,1.1008115000000052,1.1065784611079381,1.10507588030295,7774,-148531,-164846.6,0.15002435334260245,-101.10552611661242,0.6749278806901583
2023-07-12T10:00:00-04:00,1.10978,1.11028,1.10888,1.10989,1.1047288055509914,1.1080442222222222,1.1067233333333277,1.1050571111111045,1.1042465000000048,1.1034084000000017,1.1019122000000008,1.1008837000000051,1.1072407688863506,1.1058175042423595,10508,-138023,-156162,0.18527431466656452,-100.06398635197387,0.7626033826907155
2023-07-12T10:15:00-04:00,1.10989,1.11064,1.1095,1.10996,1.1056169966628329,1.1086915555555557,1.1075566666666612,1.1058568888888824,1.1046130000000047,1.1035534000000018,1.102022100000001,1.100957550000005,1.1077846151090804,1.1065024033938873,6620,-131403,-147917.4,0.2289168002094207,-99.64646749875409,0.6802967908132778
2023-07-12T10:30:00-04:00,1.10996,1.1117299999999999,1.10984,1.11169,1.1065211372635229,1.1095182222222222,1.1086199999999946,1.1067306666666603,1.1050740000000048,1.1037330000000019,1.1021569000000009,1.101042050000005,1.1085656920872644,1.1071895227151096,5703,-125700,-139992.4,0.2733155346400001,-90.75768772290627,0.8683264980220011
2023-07-12T10:45:00-04:00,1.11169,1.1123399999999999,1.11136,1.11204,1.1075629098108182,1.1102022222222223,1.1092688888888835,1.1075917777777713,1.1055520000000048,1.1039112000000018,1.102290200000001,1.1011288000000052,1.1092605536698115,1.1078860181720873,5577,-120123,-132756,0.3217176886577379,-89.001847515655,0.5279334659193495
2023-07-12T11:00:00-04:00,1.11204,1.11223,1.11106,1.11121,1.1085183278486546,1.1105904444444443,1.1098688888888835,1.1084075555555493,1.1059905000000048,1.1040760000000018,1.1024189000000009,1.1012076500000052,1.1096504429358491,1.1085004145376696,-5311,-125434,-128136.6,0.32930917546792804,-92.96585060906837,0.4883298215787587
2023-07-12T11:15:00-04:00,1.11121,1.11253,1.11121,1.11253,1.1092826622789236,1.1111226666666665,1.1104088888888834,1.1091446666666602,1.1064930000000048,1.1042646000000018,1.1025544000000012,1.101290350000005,1.1102263543486792,1.1090975316301352,4057,-121377,-124807.4,0.3464782281943886,-88.14656352561884,0.4387588361154574
2023-07-12T11:30:00-04:00,1.11253,1.11253,1.11161,1.11176,1.1099321298231388,1.1113928888888889,1.1108033333333278,1.1097939999999937,1.1069825000000049,1.1044406000000018,1.102680500000001,1.1013703500000052,1.1105330834789433,1.1096472253041079,-4386,-125763,-123679.4,0.34336677047512565,-91.18218503694862,0.32033639833607025
2023-07-12T11:45:00-04:00,1.11176,1.1125099999999999,1.11164,1.11221,1.110451703858511,1.1116742222222222,1.1112299999999944,1.1103159999999936,1.1074835000000047,1.104630600000002,1.102812800000001,1.101447950000005,1.1108684667831545,1.110107780243286,3772,-121991,-122937.6,0.3353022080818459,-89.65541666967566,0.3464547037541474
2023-07-12T12:00:00-04:00,1.11221,1.11287,1.11202,1.11271,1.110867363086809,1.1119702222222223,1.11155555555555,1.1107733333333267,1.1080205000000047,1.104830000000002,1.102946400000001,1.101521650000005,1.1112367734265236,1.1105030241946285,3529,-118462,-122605.4,0.3291064800768372,-88.06893569935478,0.2640162915172466
2023-07-12T12:15:00-04:00,1.11271,1.11308,1.11248,1.11304,1.111267890469447,1.112267111111111,1.11190555555555,1.1111806666666602,1.1085745000000047,1.105031800000002,1.1030857000000012,1.101599550000005,1.111597418741219,1.1108924193557024,3303,-115159,-120550.4,0.3108005044378778,-87.08935431696422,0.2838119092883066
2023-07-12T12:30:00-04:00,1.11304,1.11334,1.11264,1.1127799999999999,1.1116303123755578,1.1124420000000002,1.1122188888888835,1.1115426666666601,1.1090965000000046,1.105223200000002,1.103224000000001,1.101678100000005,1.1118339349929751,1.1112139354845616,-3576,-118735,-120022,0.29025174506264806,-87.92468817738302,0.2540632094850105
2023-07-12T12:45:00-04:00,1.1127799999999999,1.11327,1.11263,1.1132,1.1119722499004463,1.1126382222222222,1.1123866666666613,1.1118593333333269,1.1096820000000045,1.1054228000000021,1.103364300000001,1.1017567500000052,1.11210714799438,1.111528748387649,3186,-115549,-117979.2,0.27270506754028817,-86.7221863351498,0.13582923296961386
2023-07-12T13:00:00-04:00,1.1132,1.11325,1.11267,1.11281,1.112245799920357,1.112722888888889,1.1124722222222168,1.1121077777777715,1.1101995000000047,1.1056106000000019,1.103498900000001,1.101830350000005,1.112247718395504,1.1118045987101188,-2894,-118443,-117269.6,0.23409399543945741,-87.73607422591488,0.06924211359305056
2023-07-12T13:15:00-04:00,1.11281,1.11304,1.11244,1.11262,1.11334,1.1127524444444445,1.1126288888888833,1.1123224444444382,1.1107245000000046,1.105790800000002,1.1036306000000011,1.1019018000000051,1.1123221747164032,1.1120216789680948,-2637,-121080,-117793.2,0.19564164773567513,-88.18631281111841,0.12688870690507748
2023-07-12T13:30:00-04:00,1.11262,1.11289,1.11248,1.11267,1.113322,1.1127606666666667,1.112644444444439,1.1124702222222163,1.1110480000000047,1.105977800000002,1.1037607000000014,1.1019718000000052,1.1123917397731224,1.1121805431744753,2078,-119002,-118561.8,0.163470392452833,-88.0929296254843,0.012583930320982714
2023-07-12T13:45:00-04:00,1.11267,1.113,1.11246,1.11296,1.1133043599999999,1.1128237777777776,1.112777777777772,1.1125819999999937,1.1114055000000045,1.1061728000000022,1.1038878000000012,1.1020416500000052,1.112505391818498,1.1123148345395801,1847,-117155,-118245.8,0.13832223646989572,-87.6115380179099,0.10793696481253758
2023-07-12T14:00:00-04:00,1.11296,1.11315,1.1127799999999999,1.11313,1.1132870728,1.1128942222222222,1.1128799999999943,1.1126806666666602,1.1116785000000047,1.106375600000002,1.1040135000000013,1.1021151000000053,1.1126303134547983,1.1124194676316637,2428,-114727,-118081.4,0.1192438790745426,-87.24067114039407,0.08271819170840326
2023-07-12T14:15:00-04:00,1.11313,1.11334,1.11313,1.1133,1.11244,1.1129782222222222,1.1129455555555499,1.112775333333327,1.1119330000000045,1.1065896000000022,1.1041397000000013,1.1021876500000054,1.1127642507638387,1.1125227741053307,1777,-112950,-116982.8,0.10490485448411173,-86.96928325218694,0.05302369889727497
2023-07-12T14:30:00-04:00,1.1133,1.11401,1.11328,1.11358,1.1124580000000002,1.1131051111111112,1.1130055555555498,1.1128506666666604,1.1121935000000047,1.106800200000002,1.104268300000001,1.1022619500000053,1.112927400611071,1.1126438192842643,2161,-110789,-114924.6,0.08970873886228661,-86.42578194975262,0.04851577661180056
2023-07-12T14:45:00-04:00,1.11358,1.11386,1.11336,1.11382,1.1125200800000001,1.113268,1.1131211111111052,1.1129459999999936,1.1123955000000045,1.107015600000002,1.1043999000000013,1.1023365500000053,1.1131059204888567,1.112786655427411,2322,-108467,-112817.6,0.073367700316646,-85.92534192748207,0.09345962364529845
2023-07-12T15:00:00-04:00,1.11382,1.11382,1.11351,1.1137,1.1125796768,1.1133837777777778,1.113176666666661,1.1130257777777715,1.1125860000000045,1.107236800000002,1.1045338000000013,1.1024104500000051,1.1132247363910854,1.1129305243419285,-2102,-110569,-111500.4,0.06484570198756745,-86.15180580854027,0.0449155587495459
2023-07-12T15:15:00-04:00,1.1137,1.11372,1.11333,1.1135599999999999,1.1126368897280001,1.1134604444444443,1.1132599999999941,1.1131017777777712,1.1127660000000046,1.1074626000000019,1.104671000000001,1.1024821500000053,1.1132917891128684,1.1130628194735426,-1709,-112278,-111010.6,0.05236402046152578,-86.36663924662957,0.06739695006333572
2023-07-12T15:30:00-04:00,1.1135599999999999,1.11404,1.1135,1.11398,1.1126918141388802,1.1136044444444444,1.1134111111111054,1.1131948888888823,1.1128805000000044,1.107692400000002,1.104810600000001,1.1025540500000053,1.1134294312902948,1.1131958555788337,1622,-110656,-110551.8,0.0456667508230662,-85.75487158256105,0.12223400621955635
2023-07-12T15:45:00-04:00,1.11398,1.11398,1.11355,1.11369,1.1127727052905474,1.113660222222222,1.1135244444444388,1.1132986666666602,1.1129630000000046,1.107911000000002,1.1049484000000012,1.1026249000000052,1.113481545032236,1.1133066844630668,-1316,-111972,-110788.4,0.046719694668654985,-86.09746301149144,0.09167138504678124
2023-07-12T16:00:00-04:00,1.11369,1.11379,1.11344,1.11346,1.1128487429731146,1.1136473333333334,1.1135799999999942,1.113390444444438,1.1130755000000045,1.108130400000002,1.105082500000001,1.1026948500000053,1.1134772360257887,1.113380947570453,-1170,-113142,-111723.4,0.047739415866446554,-86.33909219016792,0.04492524439332456
2023-07-12T16:15:00-04:00,1.11346,1.11365,1.1133,1.11355,1.1129202183947278,1.1136413333333335,1.113626666666661,1.113480444444438,1.1131265000000046,1.1083468000000019,1.105214500000001,1.1027643500000053,1.113491788820631,1.1134343580563622,941,-112201,-112049.8,0.043024488493725546,-86.26303198144903,0.03773144196994843
2023-07-12T16:30:00-04:00,1.11355,1.11359,1.11309,1.11318,1.112987405291044,1.1135519999999999,1.1136133333333276,1.1135511111111045,1.1131975000000047,1.1085510000000018,1.1053421000000012,1.1028329000000052,1.113429431056505,1.1134618864450894,-1042,-113243,-112242.8,0.04069181214217323,-86.6092580153047,-0.01077876583130315
2023-07-12T16:45:00-04:00,1.11318,1.11321,1.11266,1.11279,1.11404,1.1133873333333333,1.1135255555555499,1.1135739999999934,1.1132265000000046,1.108758400000002,1.1054639000000013,1.1028974500000053,1.113301544845204,1.1134363091560713,-1145,-114388,-112989.2,0.031702452951523456,-87.0104060776128,-0.07094236606261503
2023-07-12T17:00:00-04:00,1.11279,1.11315,1.11272,1.11304,1.1140124,1.113290222222222,1.1134388888888833,1.113556888888882,1.1132430000000046,1.1089686000000019,1.1055892000000014,1.1029630000000052,1.1132492358761632,1.1133898473248567,176,-114212,-113437.2,0.023300112030884983,-86.9708658229376,-0.07002926864304851
2023-07-12T17:15:00-04:00,1.11304,1.11329,1.11302,1.11323,1.113985352,1.1132484444444444,1.1133866666666612,1.1135182222222155,1.1132525000000044,1.109188800000002,1.1057162000000014,1.1030299500000051,1.1132453887009306,1.113343477859885,200,-114012,-113611.2,0.01577545471037694,-86.93672509124782,-0.0422016701086442
2023-07-12T17:30:00-04:00,1.11323,1.11327,1.11291,1.11298,1.11395884496,1.1131671111111112,1.1133222222222168,1.1134573333333266,1.1132625000000043,1.109402200000002,1.1058382000000013,1.1030958500000052,1.1131923109607444,1.1132835822879077,-152,-114164,-114003.8,0.009564535592180817,-86.97085999598447,-0.05208520420990364
2023-07-12T17:45:00-04:00,1.11298,1.11298,1.11266,1.11286,1.1139328680608,1.1130746666666667,1.1131977777777722,1.1133742222222156,1.1132455000000046,1.109606800000002,1.1059584000000013,1.1031612000000053,1.1131258487685955,1.1132228658303258,-502,-114666,-114288.4,0.0029343689464426874,-87.02498495779875,-0.1005404046751297
2023-07-12T18:00:00-04:00,1.11286,1.1136,1.1127799999999999,1.11351,1.113907410699584,1.1131371111111112,1.1131777777777723,1.1133046666666602,1.1132805000000043,1.1098276000000018,1.1060868000000013,1.1032288000000052,1.1132026790148764,1.1132030926642602,800,-113866,-114184,-0.002613521358167988,-86.55772043216207,-0.016162486867985614
2023-07-12T18:15:00-04:00,1.11351,1.11362,1.11344,1.1135,1.1138824624855923,1.1132015555555557,1.1131822222222165,1.113253333333327,1.1133245000000043,1.1100480000000017,1.1062148000000014,1.1032964500000053,1.113262143211901,1.1132056741314078,-628,-114494,-114240.4,-0.007271448741643948,-86.56336025578291,0.003592405654450093
2023-07-12T18:30:00-04:00,1.1135,1.1137,1.11345,1.11355,1.1138580132358804,1.1132751111111112,1.1131822222222167,1.113212444444438,1.1133685000000044,1.1102702000000015,1.1063419000000012,1.1033639500000052,1.1133197145695208,1.113220539305126,525,-113969,-114231.8,-0.010440529613719853,-86.53978594056059,0
2023-07-12T18:45:00-04:00,1.11355,1.11361,1.11337,1.11352,1.1138340529711628,1.1133426666666666,1.1132199999999943,1.1131919999999933,1.1133965000000043,1.1104910000000017,1.1064703000000013,1.1034312500000052,1.1133597716556167,1.1132540314441006,-549,-114518,-114302.6,-0.014345048455808425,-86.55457647533675,0.030543128694371705
2023-07-12T19:00:00-04:00,1.11352,1.11362,1.1134,1.11348,1.1138105719117395,1.1133946666666668,1.113296666666661,1.1132117777777712,1.1134140000000043,1.1107212000000017,1.1065967000000014,1.1034981500000054,1.1133838173244934,1.1133056251552802,-620,-115138,-114397,-0.013874270199686617,-86.57684819025881,0.062006308467912136
2023-07-12T19:15:00-04:00,1.11348,1.11377,1.11348,1.1135599999999999,1.1137875604735048,1.1134473333333332,1.1133544444444388,1.1132471111111044,1.1134270000000044,1.1109486000000017,1.1067226000000014,1.1035652000000054,1.1134190538595947,1.1133489001242238,663,-114475,-114518.8,-0.008797425694047869,-86.52921374689215,0.04671889599653686
2023-07-12T19:30:00-04:00,1.1135599999999999,1.11383,1.1135,1.11379,1.11266,1.1135344444444446,1.1134166666666612,1.1132939999999933,1.1134375000000043,1.1111850000000016,1.1068504000000012,1.1036346000000055,1.1134932430876758,1.1133951200993788,711,-113764,-114372.8,-0.004156985210193847,-86.38236041164294,0.05030407013825678
2023-07-12T19:45:00-04:00,1.11379,1.11406,1.11379,1.11405,1.1126833999999999,1.1136611111111112,1.11353555555555,1.11336466666666,1.1134490000000044,1.1114268000000018,1.1069788000000012,1.1037051000000053,1.1136045944701407,1.1134520960795027,1089,-112675,-114114,0.001197461382297054,-86.12814731940838,0.0961382953871502
2023-07-12T20:00:00-04:00,1.11405,1.11418,1.11391,1.11409,1.112738464,1.1137720000000002,1.1136722222222166,1.1134551111111046,1.1134685000000046,1.1116618000000018,1.1071078000000014,1.1037754000000053,1.1137016755761127,1.113520476863602,1590,-111085,-113427.4,0.010011516879953731,-86.07105831981225,0.1105260320255975
2023-07-12T20:15:00-04:00,1.11409,1.11451,1.11402,1.11403,1.1128249561599999,1.1138435555555557,1.1137299999999943,1.1135417777777712,1.1134920000000046,1.111912600000002,1.1072366000000013,1.1038454500000054,1.11376734046089,1.1135971814908816,-1801,-112886,-112977,0.01910757203871524,-86.16805227900757,0.04669917647799086
2023-07-12T20:30:00-04:00,1.11403,1.11438,1.11397,1.1143,1.1129597596671998,1.1139575555555556,1.1138188888888836,1.1136346666666601,1.1135080000000044,1.1121494000000018,1.1073656000000014,1.1039165500000054,1.113873872368712,1.113688145192705,1212,-111674,-112416.8,0.023036981475915565,-85.87430794537204,0.0718455321059842
2023-07-12T20:45:00-04:00,1.1143,1.11435,1.11375,1.11383,1.113083778893824,1.1139597777777777,1.1138499999999947,1.1137213333333267,1.1135150000000045,1.1123836000000018,1.1074903000000014,1.1039850500000055,1.1138650978949696,1.1137625161541638,-1984,-113658,-112395.6,0.026642159871393845,-86.71113824241947,0.025144807148314668
2023-07-12T21:00:00-04:00,1.11383,1.11427,1.11376,1.11416,1.113197876582318,1.1140217777777779,1.1139211111111058,1.113798444444438,1.1135500000000045,1.112542800000002,1.1076180000000013,1.1040545500000054,1.1139240783159756,1.1138264129233306,1670,-111988,-112258.2,0.030109739545442573,-86.21635896730575,0.05747539334722088
2023-07-12T21:15:00-04:00,1.11416,1.11422,1.11361,1.11408,1.1133028464557326,1.1140535555555555,1.1139877777777722,1.1138615555555489,1.1135765000000046,1.112708200000002,1.1077389000000013,1.1041230000000055,1.1139552626527804,1.1138771303386643,-1914,-113902,-112821.6,0.03248652559710998,-86.35378985694472,0.05388511693069781
2023-07-12T21:30:00-04:00,1.11408,1.11438,1.11393,1.11422,1.113399418739274,1.1141,1.1140611111111058,1.1139277777777714,1.1136285000000048,1.112839200000002,1.1078623000000014,1.1041924000000056,1.1140082101222244,1.1139253042709314,2271,-111631,-112570.6,0.036265674610009534,-86.0684064015375,0.05926937030785095
2023-07-12T21:45:00-04:00,1.11422,1.11456,1.11413,1.11449,1.1134882652401321,1.114185777777778,1.1141388888888837,1.1139917777777713,1.1137135000000045,1.1129648000000019,1.1079885000000014,1.1042622500000057,1.1141045680977795,1.1139714434167447,2026,-109605,-112156.8,0.039013026862322955,-85.57746206379451,0.06284847233319772
2023-07-12T22:00:00-04:00,1.11449,1.11453,1.1139,1.11424,1.1135954387161189,1.114206,1.1141599999999945,1.1140537777777713,1.1137735000000046,1.1130822000000018,1.1081033000000013,1.1043309500000056,1.1141316544782236,1.1140247547333952,-2101,-111706,-111766.4,0.036851428330031605,-86.04875386542591,0.017054889816427672
2023-07-12T22:15:00-04:00,1.11424,1.11443,1.11414,1.11436,1.113691894844507,1.114246,1.1141899999999945,1.1141075555555489,1.1138300000000045,1.113173800000002,1.1082209000000014,1.1043990500000056,1.114177323582579,1.1140754037867162,1581,-110125,-111393.8,0.033989131174167096,-85.87848534158886,0.02423502589557329
2023-07-12T22:30:00-04:00,1.11436,1.11437,1.11396,1.11423,1.1137787053600563,1.114254,1.1142122222222168,1.114152444444438,1.1138925000000044,1.113260600000002,1.1083345000000013,1.1044670000000056,1.1141878588660632,1.1141219230293724,-1560,-111685,-110950.4,0.03096940125728157,-86.06047320906431,0.01795283789484825
2023-07-12T22:45:00-04:00,1.11423,1.11475,1.11419,1.1146,1.1138568348240507,1.1143315555555555,1.11424555555555,1.1141893333333266,1.1139795000000046,1.113353400000002,1.1084534000000015,1.1045367000000055,1.1142702870928505,1.114174338423498,1561,-110124,-110649,0.02915898078274011,-85.54211523988383,0.026922731759846268
2023-07-12T23:00:00-04:00,1.1146,1.11477,1.11449,1.11474,1.11396,1.1144304444444446,1.114346666666661,1.114230888888882,1.1140410000000045,1.113414400000002,1.1085737000000015,1.1046064000000055,1.1143642296742804,1.114226270738798,1248,-108876,-110503.2,0.02507017726135788,-85.38535945305443,0.08170007990447073
2023-07-12T23:15:00-04:00,1.11474,1.11487,1.11458,1.11466,1.1140734,1.1144931111111112,1.1144022222222167,1.1142793333333265,1.1140990000000046,1.1134668000000019,1.1086890000000014,1.1046740500000056,1.1144233837394244,1.114284616591038,-1413,-110289,-110219.8,0.027603622580566742,-85.48676426493893,0.0448768579019122
2023-07-12T23:30:00-04:00,1.11466,1.11487,1.11435,1.11441,1.114200856,1.1144946666666666,1.1144388888888832,1.1143291111111042,1.1141420000000046,1.113530800000002,1.1088034000000015,1.1047413500000056,1.1144207069915395,1.1143332932728303,-1408,-111697,-110534.2,0.025956995930181765,-85.80255562732756,0.029620853080563465
2023-07-12T23:45:00-04:00,1.11441,1.11459,1.11422,1.11456,1.11487,1.114518888888889,1.114476666666661,1.114381999999993,1.1141940000000046,1.113571400000002,1.1089180000000014,1.1048095000000056,1.1144485655932317,1.114385434618264,1374,-110323,-110261.8,0.025947327481303503,-85.61761471689053,0.030514620092980466
2023-07-13T00:00:00-04:00,1.11456,1.11464,1.11441,1.11456,1.11487,1.1145355555555556,1.1144844444444388,1.114429777777771,1.1142480000000046,1.113627400000002,1.1090340000000014,1.1048781500000056,1.1144708524745854,1.1144255476946108,0,-110323,-110301.6,0.024552918912991238,-85.61761471689053,0.006280899783758894
2023-07-13T00:15:00-04:00,1.11456,1.11465,1.1144,1.1146,1.114857,1.1145586666666665,1.1145244444444389,1.1144653333333265,1.1143000000000045,1.113675200000002,1.1091529000000013,1.1049458000000056,1.1144966819796684,1.1144520381556884,1039,-109284,-110383.2,0.020752526971067865,-85.580326459641,0.03230901780587109
2023-07-13T00:30:00-04:00,1.1146,1.11485,1.11459,1.1148,1.11422,1.1146137777777776,1.1145733333333279,1.1144995555555488,1.1143505000000045,1.1137170000000018,1.1092735000000014,1.1050126500000055,1.1145573455837348,1.1144788305245505,1279,-108005,-109926.4,0.02047793237885993,-85.35082708766902,0.03948454718403352
2023-07-13T00:45:00-04:00,1.1148,1.1148,1.11404,1.11408,1.11485,1.114515111111111,1.114556666666661,1.1145231111111042,1.1143520000000047,1.1137378000000018,1.1093848000000015,1.1050737000000053,1.1144618764669878,1.11448706441964,-1305,-109310,-109449,0.016725716623083652,-86.19366885300815,-0.013462211572125548
2023-07-13T01:00:00-04:00,1.11408,1.11432,1.11396,1.11409,1.11485,1.1144217777777776,1.1144999999999945,1.1145277777777711,1.1143520000000047,1.113764000000002,1.1094936000000013,1.1051362500000055,1.1143875011735902,1.1144748515357117,1887,-107423,-108869,0.015298406530417025,-86.17673111065561,-0.045756325139064274
2023-07-13T01:15:00-04:00,1.11409,1.1143,1.11392,1.11395,1.1148144,1.1143117777777778,1.1144122222222166,1.1145133333333266,1.1143480000000046,1.1137790000000019,1.1096009000000016,1.1051988500000054,1.1143000009388722,1.1144406812285692,-1443,-108866,-108577.6,0.010063676793662763,-86.35806295996764,-0.07086854333746599
2023-07-13T01:30:00-04:00,1.11395,1.11432,1.11388,1.11412,1.114760736,1.1142533333333335,1.1143522222222169,1.1144788888888821,1.1143390000000046,1.1138052000000018,1.1097079000000014,1.1052628500000055,1.1142640007510978,1.114394144982855,1750,-107116,-108144,0.004115194683806425,-86.09099531779339,-0.04844526582096648
2023-07-13T01:45:00-04:00,1.11412,1.11414,1.11297,1.1131,1.11469027712,1.1140028888888889,1.114206666666661,1.1144055555555485,1.1143025000000046,1.1138148000000019,1.1098028000000015,1.1053197000000055,1.1140312006008781,1.1142889159862834,-3122,-110238,-108590.6,-0.0047564346478719466,-88.94925116097012,-0.11755099110739517
2023-07-13T02:00:00-04:00,1.1131,1.11409,1.11307,1.11393,1.114518249408,1.1139475555555556,1.114136666666661,1.1143215555555486,1.1142910000000046,1.113840000000002,1.1099089000000015,1.1053810000000055,1.1140109604807025,1.1141987327890264,4763,-105475,-107823.6,-0.009491461103300607,-85.39764753146646,-0.056524547803609354
2023-07-13T02:15:00-04:00,1.11393,1.11475,1.11384,1.11471,1.11297,1.114062222222222,1.114153333333328,1.1142522222222153,1.1143225000000045,1.113875000000002,1.1100239000000014,1.1054462000000056,1.114150768384562,1.114151386231221,3574,-101901,-106719.2,-0.010495488776888075,-82.89504862489242,0.013458225667536471
2023-07-13T02:30:00-04:00,1.11471,1.11475,1.11398,1.11442,1.1130056,1.1141155555555555,1.1141333333333279,1.1141964444444374,1.1143325000000046,1.113900800000002,1.1101382000000015,1.1055091500000054,1.1142046147076496,1.1141323089849764,-3543,-105444,-106034.8,-0.013204637262992137,-83.81678611715537,-0.016149291225557957
2023-07-13T02:45:00-04:00,1.11442,1.115,1.11412,1.11482,1.113040488,1.114252888888889,1.11413555555555,1.114153111111104,1.1143490000000045,1.113931200000002,1.1102604000000016,1.1055733500000053,1.1143276917661198,1.1141450471879808,3459,-101985,-105008.6,-0.013794005247882523,-82.57524343127406,0.001794043774659937
2023-07-13T03:00:00-04:00,1.11482,1.11578,1.11454,1.11563,1.11311886848,1.1145517777777778,1.1143077777777723,1.1141733333333264,1.1144185000000044,1.113972200000002,1.1103862000000015,1.1056412000000053,1.1145881534128959,1.1142564377503843,4499,-97486,-102458.2,-0.011216697624227834,-79.30638388444147,0.13912824931781742
2023-07-13T03:15:00-04:00,1.11563,1.11564,1.11367,1.11408,1.1132785363712,1.114506222222222,1.1143066666666612,1.1142073333333264,1.1144045000000042,1.113977400000002,1.1104965000000016,1.1057026500000053,1.1144865227303167,1.1143515502003072,-4072,-101558,-101674.8,-0.010533085210640721,-84.96381511164024,-0.0008975935516938049
2023-07-13T03:30:00-04:00,1.11408,1.11455,1.11361,1.11429,1.113428624188928,1.114502888888889,1.114344444444439,1.1142455555555486,1.1144075000000044,1.113989200000002,1.1106130000000014,1.1057659500000054,1.1144472181842533,1.1144108401602455,4400,-97158,-100726.2,-0.008439312582240378,-84.13443122538415,0.030522016248485745
2023-07-13T03:45:00-04:00,1.11429,1.11558,1.11428,1.11554,1.1135697067375923,1.114742,1.114502222222217,1.1143193333333266,1.1144545000000043,1.114028800000002,1.1107457000000016,1.1058402000000054,1.1146657745474027,1.114503072128196,3588,-93570,-98351.4,0.0002307328464904068,-80.10944670609392,0.12745485226007763
2023-07-13T04:00:00-04:00,1.11554,1.11582,1.1151,1.11566,1.11361,1.1149735555555556,1.1147866666666613,1.1144495555555487,1.1145005000000041,1.114062400000002,1.1108774000000015,1.1059105500000053,1.1148646196379222,1.1146104577025564,3502,-90068,-95968,0.009519435157901322,-79.73273228975707,0.2299883209055896
2023-07-13T04:15:00-04:00,1.11566,1.1165,1.11502,1.11631,1.1137868,1.1152782222222222,1.1150511111111059,1.1145982222222153,1.1145830000000043,1.114114800000002,1.1110129000000015,1.1059805000000056,1.1151536957103376,1.114723566162045,3664,-86404,-93751.6,0.031611120415854656,-77.59803175375207,0.213657949781389
2023-07-13T04:30:00-04:00,1.11631,1.11691,1.11595,1.11689,1.11405812,1.1156459999999997,1.115293333333328,1.1147955555555487,1.1147070000000041,1.114183400000002,1.1111569000000014,1.1060559500000056,1.11550095656827,1.1149264529296357,3935,-82469,-89933.8,0.048636075280701,-75.55352798687719,0.19556655991243002
2023-07-13T04:45:00-04:00,1.11689,1.117,1.11605,1.11608,1.1144003456,1.1158033333333333,1.1154777777777722,1.1150222222222155,1.114783000000004,1.114234000000002,1.1112904000000015,1.1061256500000056,1.115616765254616,1.1151603623437083,-3898,-86367,-87775.6,0.05378847358170653,-78.38046707667108,0.14895640781751895
2023-07-13T05:00:00-04:00,1.11608,1.11641,1.1155,1.11631,1.114764297216,1.1159697777777777,1.115643333333328,1.1152504444444378,1.114870500000004,1.1142966000000019,1.1114238000000014,1.1062007500000055,1.1157554122036928,1.1153782898749662,3399,-82968,-85655.2,0.06326251058805299,-77.68000653620818,0.13365386340395682
2023-07-13T05:15:00-04:00,1.11631,1.11679,1.11601,1.11655,1.11507729560576,1.1161511111111109,1.1157455555555502,1.1154422222222153,1.1149680000000042,1.1143718000000018,1.1115651000000013,1.1062765500000056,1.1159143297629541,1.1155882318999726,2795,-80173,-83676.2,0.07027431498184969,-77.079098186377,0.0824646164050834
2023-07-13T05:30:00-04:00,1.11655,1.11743,1.11624,1.11738,1.1153464742209536,1.1164779999999999,1.1161122222222168,1.1156544444444376,1.1150970000000042,1.1144586000000019,1.1117136000000014,1.1063568500000056,1.1162074638103634,1.1157989855199777,2767,-77406,-81876.6,0.07408802420885298,-75.02221761676498,0.2962085308056945
2023-07-13T05:45:00-04:00,1.11738,1.11745,1.11677,1.11727,1.115679838345601,1.1167095555555555,1.1164433333333281,1.1158844444444376,1.115256500000004,1.114539400000002,1.1118641000000014,1.1064392000000056,1.1164199710482907,1.1159827884159816,-2735,-80141,-81411,0.09213803539966725,-75.29146353131522,0.2674348688402465
2023-07-13T06:00:00-04:00,1.11727,1.11735,1.1159999999999999,1.11638,1.115998467443393,1.116696888888889,1.1165366666666612,1.1160962222222155,1.115371000000004,1.114607400000002,1.1120048000000013,1.1065158000000057,1.1164119768386325,1.116141830732785,-2665,-82806,-80698.8,0.10104813908293406,-77.41436130893402,0.07529985477884718
2023-07-13T06:15:00-04:00,1.11638,1.11659,1.11595,1.11649,1.11745,1.1166875555555555,1.1166288888888836,1.1162933333333265,1.1154980000000043,1.1146800000000021,1.1121434000000014,1.1065921500000055,1.116427581470906,1.1162762645862279,2626,-80180,-80141.2,0.09930878320537427,-77.15561428731043,0.07439542512950956
2023-07-13T06:30:00-04:00,1.11649,1.11692,1.11595,1.11651,1.11742,1.1166637777777777,1.1166511111111057,1.1164744444444374,1.1156175000000044,1.114740000000002,1.1122838000000013,1.1066713500000056,1.1164440651767247,1.1163822116689819,2398,-77782,-79663,0.09598970737001451,-77.11265823754752,0.017916170239447644
2023-07-13T06:45:00-04:00,1.11651,1.11714,1.1163399999999999,1.11713,1.1173906,1.1167595555555556,1.1166777777777723,1.1165875555555487,1.1158190000000043,1.1148126000000018,1.1124303000000013,1.1067557000000057,1.1165812521413798,1.1164569693351851,2200,-75582,-79298.2,0.0904800277262722,-75.89099430260727,0.021488239665501348
2023-07-13T07:00:00-04:00,1.11713,1.11742,1.117,1.11734,1.11595,1.1168920000000002,1.1168177777777724,1.1166624444444377,1.1159895000000044,1.114888400000002,1.1125793000000013,1.1068427500000058,1.1167330017131039,1.1165195754681476,2291,-73291,-77928.2,0.07640272223157825,-75.46032822077248,0.11289513296538231
2023-07-13T07:15:00-04:00,1.11734,1.11743,1.11694,1.11704,1.1159794,1.1169364444444443,1.1168988888888836,1.1167348888888822,1.1161060000000043,1.114958800000002,1.1127249000000012,1.1069263500000057,1.1167944013704831,1.116596060374518,-1694,-74985,-76364,0.07172471703779092,-75.91515844254916,0.0653940213740018
2023-07-13T07:30:00-04:00,1.11704,1.11779,1.11702,1.11738,1.1160374240000002,1.1170326666666668,1.1169911111111057,1.1168073333333264,1.1162540000000045,1.115036800000002,1.1128790000000013,1.1070106500000056,1.1169115210963865,1.1166928482996141,2089,-72896,-74907.2,0.06991190085168875,-75.27931729093416,0.07433612466975133
2023-07-13T07:45:00-04:00,1.11738,1.11747,1.11684,1.11742,1.11614257856,1.1171184444444444,1.1169955555555502,1.1168762222222155,1.1163840000000045,1.1151140000000017,1.1130313000000014,1.1070946500000056,1.1170132168771092,1.116806678639691,3034,-69862,-73323.2,0.06489922149996301,-75.17070607541203,0.0035798027528718968
2023-07-13T08:00:00-04:00,1.11742,1.11831,1.11742,1.11798,1.1162414238464,1.1173153333333334,1.117074444444439,1.1169555555555488,1.1165015000000045,1.1151978000000018,1.1131914000000014,1.1071802000000057,1.1172065735016874,1.1169317429117525,4094,-65768,-71360.4,0.05678662916772817,-73.11897977733291,0.06354775479516933
2023-07-13T08:15:00-04:00,1.11798,1.11856,1.11746,1.11784,1.116406909938688,1.1174684444444445,1.117236666666661,1.1170393333333268,1.1166895000000043,1.1152736000000016,1.1133502000000015,1.1072658500000054,1.1173332588013498,1.1170517943294018,-5069,-70837,-70869.6,0.052461055098494386,-73.75374963010321,0.13077984198928833
2023-07-13T08:30:00-04:00,1.11784,1.11897,1.11615,1.11742,1.11897,1.117505111111111,1.1173399999999942,1.1171275555555489,1.1168460000000044,1.115340200000002,1.1135010000000014,1.1073487500000054,1.11735060704108,1.1171630354635211,-15096,-85933,-73059.2,0.04752420024434117,-79.42568836909803,0.08329676038299469
2023-07-13T08:45:00-04:00,1.11742,1.11797,1.11641,1.11795,1.11897,1.1176271111111111,1.1174999999999944,1.1172293333333265,1.1169665000000042,1.115418600000002,1.1136656000000016,1.1074355500000055,1.1174704856328639,1.1172748283708163,6443,-79490,-74378,0.04498426126482843,-76.36972910579553,0.12897331864471506
2023-07-13T09:00:00-04:00,1.11795,1.11847,1.11761,1.11827,1.11897,1.1177811111111111,1.117626666666661,1.1173555555555488,1.1170970000000042,1.1154980000000017,1.1138237000000015,1.1075254000000054,1.117630388506291,1.1173982626966528,6962,-72528,-74911.2,0.04909709433243666,-74.37693873055453,0.1020472102620233
2023-07-13T09:15:00-04:00,1.11827,1.1185,1.11781,1.11798,1.1189136,1.1178517777777779,1.117697777777772,1.1174802222222153,1.1171805000000041,1.1155810000000017,1.1139823000000013,1.1076151500000053,1.1177003108050327,1.1174970101573218,-6155,-78683,-77494.2,0.046811753834316086,-75.97310960163286,0.05727889451733348
2023-07-13T09:30:00-04:00,1.11798,1.11943,1.11798,1.11934,1.11615,1.1181802222222224,1.1179533333333276,1.1176235555555487,1.1173030000000042,1.1156846000000018,1.1141137000000014,1.1077174500000053,1.1180282486440263,1.1176360081258572,7412,-71271,-77581,0.051792293808439076,-66.95656189952709,0.20590131060660036
2023-07-13T09:45:00-04:00,1.11934,1.1195,1.1187799999999999,1.11941,1.1162155999999999,1.1184715555555556,1.118178888888883,1.1177913333333263,1.1174695000000041,1.1157912000000016,1.1142497000000013,1.1078226500000055,1.118304598915221,1.1178268065006853,5073,-66198,-73634,0.06225743613969887,-66.63931244895794,0.18167498970806495
2023-07-13T10:00:00-04:00,1.11941,1.11944,1.11869,1.11895,1.1163469759999998,1.1186257777777777,1.1183488888888828,1.117961111111104,1.1176015000000041,1.1158858000000016,1.1143625000000015,1.1079230000000055,1.1184336791321767,1.118019445200548,-5847,-72045,-72145,0.06406929505932077,-69.0420245919625,0.13692255373984796
2023-07-13T10:15:00-04:00,1.11895,1.11898,1.1181,1.11811,1.1164730969599999,1.118578,1.1183633333333272,1.1181084444444374,1.1176795000000042,1.1159582000000017,1.1144615000000015,1.1080212500000055,1.1183689433057413,1.1181671561604378,-4640,-76685,-72976.4,0.06256886409762716,-72.52529015342617,0.011628114993109312
2023-07-13T10:30:00-04:00,1.11811,1.119,1.11804,1.11865,1.1165941730815998,1.1186353333333332,1.118453333333327,1.1182595555555483,1.117743000000004,1.1160464000000017,1.1145643000000014,1.1081236000000054,1.1184251546445931,1.11831212492835,4544,-72141,-71668,0.05961084242547175,-70.3307296897867,0.07246117512345035
2023-07-13T10:45:00-04:00,1.11865,1.1196,1.11806,1.11959,1.1167104061583357,1.1188626666666666,1.1186944444444384,1.1184077777777706,1.1178590000000042,1.1161510000000014,1.1146624000000014,1.1082306000000055,1.1186581237156745,1.1184380999426797,5522,-66619,-70737.6,0.06584605816162747,-65.6906009631958,0.19419734746111625
2023-07-13T11:00:00-04:00,1.11959,1.11966,1.11856,1.11898,1.1168837817888355,1.1189197777777777,1.118808888888883,1.1185337777777706,1.117989000000004,1.1162460000000016,1.1147533000000014,1.1083327500000055,1.1187224989725397,1.1185216799541435,-5089,-71708,-71839.6,0.072511858839469,-68.4633034703636,0.09213292186592302
2023-07-13T11:15:00-04:00,1.11898,1.11945,1.11898,1.11911,1.1171058792457287,1.11898,1.118902222222216,1.118644444444437,1.118120000000004,1.1163362000000017,1.1148448000000015,1.1084334500000055,1.1187999991780317,1.1185949439633143,3465,-68243,-71079.2,0.07125123887936821,-68.06074935858334,0.07511602743523048
2023-07-13T11:30:00-04:00,1.11911,1.11942,1.11875,1.11903,1.1173102089060705,1.1190055555555556,1.1190188888888828,1.118775555555548,1.1182460000000038,1.1164220000000016,1.1149182000000013,1.1085375500000056,1.1188459993424253,1.118690355170651,-3068,-71311,-70004.4,0.06722333350280074,-68.28006649452193,0.0939193903289858
2023-07-13T11:45:00-04:00,1.11903,1.11947,1.11871,1.11928,1.117498192193585,1.119057777777778,1.1190122222222163,1.118887333333326,1.1183535000000038,1.1165144000000016,1.1149906000000014,1.1086404000000056,1.1189327994739402,1.1187918841365205,3024,-68287,-69233.6,0.06704507711622755,-67.60448138956474,-0.005360301606299157
2023-07-13T12:00:00-04:00,1.11928,1.12033,1.11916,1.12012,1.117671136818098,1.1192793333333333,1.119091111111105,1.1189666666666596,1.1184925000000039,1.1166286000000016,1.1150797000000015,1.1087493000000057,1.119170239579152,1.118894307309216,3445,-64842,-68878.2,0.06128021274627851,-65.01906933896093,0.06342626919537868
2023-07-13T12:15:00-04:00,1.12012,1.12064,1.12004,1.12049,1.1179370231362882,1.119559111111111,1.119262222222216,1.119057333333326,1.1186650000000038,1.1167472000000016,1.1151593000000013,1.1088568500000058,1.1194341916633217,1.1190366458473724,2885,-61957,-66928,0.05751726028708228,-64.06609108663088,0.13762902721302087
2023-07-13T12:30:00-04:00,1.12049,1.1209,1.12019,1.12047,1.1182613803599335,1.1198006666666667,1.119524444444438,1.1191817777777704,1.1188195000000039,1.1168654000000016,1.1152464000000015,1.1089634500000058,1.1196413533306573,1.1192049166778975,-2488,-64445,-66168.4,0.05649582846907914,-64.11050022905944,0.211070467127576
2023-07-13T12:45:00-04:00,1.12047,1.12071,1.12029,1.12057,1.118630787109543,1.1200097777777778,1.1197377777777717,1.1193255555555484,1.1189770000000037,1.1169848000000016,1.1153300000000015,1.1090714000000057,1.1198270826645258,1.1194011333423177,2285,-62160,-64338.2,0.06489775698694525,-63.906567950640586,0.17163545344836578
2023-07-13T13:00:00-04:00,1.12057,1.12083,1.1202,1.1204399999999999,1.1189484769142068,1.1201502222222222,1.1198322222222161,1.1194895555555484,1.1191000000000038,1.1170976000000017,1.1154073000000015,1.1091768500000057,1.1199496661316206,1.1196045066738538,-3076,-65236,-63728,0.06803410045507459,-64.26342205167896,0.075920649523468
2023-07-13T13:15:00-04:00,1.1204399999999999,1.12074,1.12042,1.12064,1.119221690146218,1.1203117777777778,1.1200166666666604,1.1196746666666593,1.1192400000000038,1.1172288000000017,1.1154833000000013,1.1092845000000056,1.1200877329052965,1.1197880053390827,1868,-63368,-63433.2,0.06609044771193415,-63.929981617563456,0.14834938962269162
2023-07-13T13:30:00-04:00,1.12064,1.12136,1.12064,1.12136,1.1194566535257475,1.1205804444444445,1.1202666666666605,1.1198755555555482,1.1194370000000038,1.1173742000000015,1.1155691000000012,1.1093965500000058,1.120342186324237,1.1199696042712657,2246,-61122,-63266.2,0.07236826431933108,-62.486949064736834,0.20105262217296452
2023-07-13T13:45:00-04:00,1.12136,1.1218299999999999,1.12133,1.12156,1.119761188961628,1.1208391111111111,1.120547777777772,1.120080222222215,1.1196175000000037,1.1175264000000016,1.1156527000000014,1.1095085000000056,1.1205857490593896,1.1201584834170124,2044,-59078,-62192.8,0.07663024291532985,-62.12239174148654,0.22608866607686312
2023-07-13T14:00:00-04:00,1.12156,1.12175,1.1213,1.12161,1.1201335749485348,1.1210515555555556,1.1208066666666607,1.1202939999999928,1.1197845000000037,1.1176762000000016,1.1157407000000013,1.1096198000000055,1.1207905992475116,1.1203511867336096,1884,-57194,-61199.6,0.08409472500644462,-62.038401584918724,0.20816953755985482
2023-07-13T14:15:00-04:00,1.12161,1.12177,1.12131,1.1216,1.1204389314577985,1.1212102222222222,1.1209711111111051,1.1205217777777707,1.1199655000000037,1.1178462000000016,1.1158305000000015,1.1097305500000054,1.1209524793980092,1.1205517493868873,-2183,-59377,-60027.8,0.09063969530556071,-62.0578646781509,0.13212870049636877
2023-07-13T14:30:00-04:00,1.1216,1.12212,1.12145,1.12209,1.1206893237953948,1.1214339999999998,1.121148888888883,1.1207482222222154,1.1201030000000036,1.1180094000000016,1.1159247000000014,1.1098427000000055,1.1211799835184073,1.1207701995095094,2367,-57010,-58756.2,0.09073864650966726,-61.02377944277266,0.1427946701889393
2023-07-13T14:45:00-04:00,1.12209,1.1222699999999999,1.12195,1.12223,1.120975459036316,1.1216502222222222,1.1213444444444385,1.120963777777771,1.1202440000000038,1.1181598000000015,1.1160174000000014,1.1099526000000055,1.121389986814726,1.1209797596076072,2095,-54915,-57514.8,0.09397520605352346,-60.762392210019435,0.157076940926574
2023-07-13T15:00:00-04:00,1.12223,1.12223,1.12193,1.12205,1.1212343672290528,1.1217913333333334,1.121508888888883,1.1211559999999932,1.120399000000004,1.1183124000000015,1.1161066000000013,1.1100600500000055,1.1215219894517807,1.1211670076860856,-1765,-56680,-57035.2,0.09684646488141856,-61.04548925786179,0.1320756400760261
2023-07-13T15:15:00-04:00,1.12205,1.12271,1.12198,1.12236,1.1214414937832422,1.1219615555555555,1.1217222222222163,1.1213391111111042,1.1206115000000039,1.1184632000000017,1.116197200000001,1.1101684500000055,1.1216895915614247,1.121346806148868,1957,-54723,-56541,0.09831562144928101,-60.50480925251438,0.1713612509371447
2023-07-13T15:30:00-04:00,1.12236,1.12259,1.12231,1.12252,1.1216951950265939,1.1221211111111111,1.1219311111111052,1.1215311111111042,1.1208050000000038,1.1186010000000015,1.1162866000000013,1.1102774500000054,1.1218556732491398,1.1215274449190944,1616,-53107,-55287,0.09811873931158055,-60.27443753577474,0.16776127926897857
2023-07-13T15:45:00-04:00,1.12252,1.12269,1.1225,1.1226099999999999,1.121898156021275,1.122256888888889,1.1220699999999941,1.1217153333333265,1.1209560000000036,1.1187716000000016,1.1163745000000012,1.1103872000000055,1.1220065385993119,1.1216927559352752,2056,-51051,-54095.2,0.09885418529786735,-60.109594147683794,0.11147178426196525
2023-07-13T16:00:00-04:00,1.1226099999999999,1.12272,1.12241,1.1227,1.1220605248170201,1.122382888888889,1.1221966666666607,1.121885777777771,1.1211420000000039,1.1189398000000015,1.116464500000001,1.1104991500000054,1.1221452308794495,1.12184380474822,1170,-49881,-53088.4,0.09758378918932165,-60.015794876342746,0.10164413852135784
2023-07-13T16:15:00-04:00,1.1227,1.12278,1.12255,1.12258,1.1221924198536162,1.1224595555555557,1.1223044444444386,1.122044888888882,1.1213155000000037,1.1190806000000015,1.1165547000000011,1.1106128500000054,1.1222321847035597,1.121985843798576,-561,-50442,-51840.8,0.09137658194301737,-60.07575746652718,0.08648282379792578
2023-07-13T16:30:00-04:00,1.12258,1.12266,1.12254,1.12255,1.122309935882893,1.1225086666666666,1.1224099999999941,1.1221824444444377,1.1214915000000036,1.1192184000000014,1.1166404000000012,1.1107255000000054,1.1222957477628477,1.1221070750388606,-446,-50888,-51073.8,0.0851378792864079,-60.08767643889439,0.08470042796005764
2023-07-13T16:45:00-04:00,1.12255,1.12265,1.12249,1.12262,1.1224039487063144,1.1225506666666665,1.122468888888883,1.1222899999999936,1.1216585000000037,1.1193446000000016,1.1167297000000012,1.1108390500000056,1.1223605982102782,1.1222080600310882,744,-50144,-50481.2,0.0789769217220401,-60.041282068933135,0.04723328788242649
2023-07-13T17:00:00-04:00,1.12262,1.12262,1.12167,1.1221,1.12278,1.122476888888889,1.1224544444444386,1.1223668888888825,1.1217575000000037,1.1194488000000016,1.116816100000001,1.1109493000000055,1.1223084785682227,1.1222684480248704,-101,-50245,-50320,0.0670847755093747,-60.088065486296074,-0.011584078130148319
2023-07-13T17:15:00-04:00,1.1221,1.1224,1.12193,1.12235,1.1227577999999998,1.122456,1.122487777777772,1.1224251111111045,1.1218505000000036,1.1195742000000015,1.116904100000001,1.1110593000000055,1.1223167828545781,1.1223027584198961,173,-50072,-50358.2,0.058681948424613745,-60.0495216844959,0.026736776435984756
2023-07-13T17:30:00-04:00,1.12235,1.12242,1.12179,1.12242,1.1227360439999998,1.1224424444444443,1.122494444444439,1.1224631111111047,1.1219480000000037,1.1196964000000016,1.116996500000001,1.1111693000000056,1.1223374262836625,1.1223238067359167,419,-49653,-50200.4,0.05378313482172145,-60.02338901643335,0.005345878327804713
2023-07-13T17:45:00-04:00,1.12242,1.12255,1.12181,1.12242,1.1227147231199999,1.1224275555555556,1.1224833333333275,1.1224777777777715,1.1220405000000038,1.1198138000000015,1.117092800000001,1.1112783500000056,1.12235394102693,1.122335445388733,0,-49653,-49953.4,0.04603720155665161,-60.02338901643335,-0.008908527242275326
2023-07-13T18:00:00-04:00,1.12242,1.1228799999999999,1.12232,1.12285,1.12167,1.1225008888888888,1.1225099999999943,1.1224859999999937,1.1221610000000035,1.1199232000000017,1.117190900000001,1.1113900500000056,1.122453152821544,1.1223539563109863,748,-48905,-49705.6,0.03929780008763182,-59.73682961799074,0.021378751302769262
2023-07-13T18:15:00-04:00,1.12285,1.12298,1.12258,1.12259,1.1216941999999999,1.1225168888888888,1.122497777777772,1.1224946666666604,1.1222585000000036,1.1200296000000016,1.1172845000000011,1.1115003500000056,1.1224805222572352,1.122388365048789,-754,-49659,-49588.4,0.02999260369209161,-59.91142105941208,-0.009797808853661218
2023-07-13T18:30:00-04:00,1.12259,1.12268,1.12253,1.12262,1.1217456319999999,1.1225413333333332,1.1225022222222165,1.1224975555555492,1.1223215000000035,1.1201544000000017,1.1173809000000012,1.1116095500000056,1.122508417805788,1.1224266920390307,431,-49228,-49419.6,0.02087594976079138,-59.899903051947206,0.0035632204386359997
2023-07-13T18:45:00-04:00,1.12262,1.12263,1.12238,1.12245,1.12179500672,1.1225308888888887,1.1224911111111053,1.1224968888888827,1.1223660000000035,1.1202736000000018,1.117476800000001,1.1117176000000055,1.1224967342446304,1.1224585536312244,-619,-49847,-49458.4,0.015091934789109555,-59.99363913361331,-0.008908289163065252
2023-07-13T19:00:00-04:00,1.12245,1.1227,1.12238,1.12241,1.1218424064512,1.1225146666666665,1.1224677777777723,1.1224937777777715,1.1224060000000036,1.1203916000000016,1.117565800000001,1.1118263000000055,1.1224793873957042,1.1224836429049792,-846,-50693,-49666.4,0.010237707432898544,-60.02378746984212,-0.018706240758230165
2023-07-13T19:15:00-04:00,1.12241,1.1226099999999999,1.12231,1.1226,1.121887910193152,1.1225411111111112,1.1225233333333275,1.122496444444438,1.1224560000000035,1.1205010000000017,1.1176568000000011,1.1119358000000055,1.1225035099165634,1.122493714323983,712,-49981,-49881.6,0.005858964003313242,-59.903261102471824,0.04455930843952811
2023-07-13T19:30:00-04:00,1.1226,1.1228,1.12251,1.12252,1.121931593785426,1.1225404444444445,1.1225422222222163,1.122505333333327,1.1224775000000036,1.1206046000000016,1.117746500000001,1.1120442000000055,1.1225068079332507,1.1224989714591862,-921,-50902,-50130.2,0.005697524653048189,-59.968894453621004,0.015146790216955806
2023-07-13T19:45:00-04:00,1.12252,1.12253,1.12216,1.12233,1.121973530034009,1.122498,1.1225322222222165,1.122511333333327,1.1224825000000034,1.1207104000000017,1.117834600000001,1.1121524500000055,1.1224714463466006,1.1224915771673487,-1220,-52122,-50709,0.004501125918349846,-60.17539411509687,-0.00801838883839592
2023-07-13T20:00:00-04:00,1.12233,1.12247,1.12177,1.12212,1.12298,1.1224155555555557,1.1224988888888832,1.1225128888888825,1.1224860000000034,1.1208052000000017,1.117921000000001,1.1122588500000055,1.1224011570772805,1.1224724617338786,-2963,-55085,-51756.6,0.0022951182712240797,-60.729803246101234,-0.026727962794672846
2023-07-13T20:15:00-04:00,1.12212,1.12217,1.12133,1.12142,1.1229558000000002,1.122199777777778,1.1223399999999943,1.1224873333333272,1.1224390000000033,1.1208852000000016,1.117999600000001,1.1123611000000053,1.1222049256618245,1.1224175693871028,-2418,-57503,-53118.6,-0.003941260371301723,-62.238198070184055,-0.12735449971054197
2023-07-13T20:30:00-04:00,1.12142,1.12184,1.1214,1.12174,1.1228907680000002,1.1220797777777778,1.12224555555555,1.1224317777777713,1.1224000000000036,1.1209604000000015,1.118079100000001,1.1124647500000053,1.1221119405294595,1.122339255509682,1799,-55704,-54263.2,-0.011200431725217497,-61.724848923566576,-0.0757177598232674
2023-07-13T20:45:00-04:00,1.12174,1.12235,1.1216,1.12226,1.12282833728,1.1220826666666668,1.1222055555555501,1.1223644444444383,1.1223825000000036,1.1210488000000014,1.118161200000001,1.1125700000000054,1.1221415524235676,1.1222662044077454,2657,-53047,-54692.2,-0.013037616046189696,-60.49315530472424,-0.03206784129980902
2023-07-13T21:00:00-04:00,1.12226,1.12252,1.1222,1.12248,1.1227684037888002,1.1221375555555555,1.1222088888888833,1.1222997777777715,1.1223715000000036,1.1211500000000014,1.118245100000001,1.1126764500000055,1.122209241938854,1.1222137635261962,2398,-50649,-54397.6,-0.013733483862355629,-60.02306815914324,0.002672724842975143
2023-07-13T21:15:00-04:00,1.12248,1.12299,1.12242,1.12295,1.12133,1.1222857777777777,1.1222688888888834,1.1222537777777717,1.1223900000000036,1.1212500000000014,1.118334300000001,1.1127854500000054,1.1223573935510833,1.1222050108209567,2840,-47809,-52942.4,-0.01033924781818394,-58.83391556845128,0.04811076166463102
2023-07-13T21:30:00-04:00,1.12295,1.12336,1.12266,1.1232199999999999,1.1213632,1.122476,1.1223377777777719,1.1222533333333273,1.1224235000000036,1.1213490000000015,1.118423500000001,1.1128945500000054,1.1225299148408667,1.1222700086567652,3742,-44067,-50255.2,-0.005837676943475141,-57.934196079604966,0.055228932834477364
2023-07-13T21:45:00-04:00,1.1232199999999999,1.12333,1.1228799999999999,1.1233,1.121443072,1.1226684444444446,1.1224244444444387,1.122289111111105,1.1224575000000034,1.1214554000000014,1.118518200000001,1.1130042500000055,1.1226839318726933,1.1223844069254119,2904,-41163,-47347,-0.002782989991346401,-57.72736215570739,0.06948651248975546
2023-07-13T22:00:00-04:00,1.1233,1.12356,1.12323,1.12343,1.12151974912,1.1228695555555557,1.1225466666666608,1.1223573333333272,1.1225240000000036,1.1215372000000015,1.1186109000000009,1.1131144500000054,1.1228331454981546,1.1225227255403292,1949,-39214,-44580.4,0.0018877865728549497,-57.50180353378989,0.09801038910123393
2023-07-13T22:15:00-04:00,1.12343,1.12386,1.1234,1.12361,1.1216421641728,1.123082222222222,1.1227122222222166,1.122457999999994,1.1225870000000038,1.1216212000000014,1.118706200000001,1.1132225500000055,1.1229885163985236,1.1226785804322632,1871,-37343,-41919.2,0.006884677203300797,-57.202025176437736,0.13278437243788466
2023-07-13T22:30:00-04:00,1.12361,1.12367,1.12312,1.12337,1.121819591038976,1.1232137777777778,1.1229288888888833,1.122589999999994,1.1226345000000035,1.1217096000000015,1.118797700000001,1.1133300000000055,1.1230648131188188,1.1228200643458102,-2153,-39496,-40256.6,0.01369240695001975,-57.661900044051976,0.173886679388623
2023-07-13T22:45:00-04:00,1.12337,1.12375,1.12334,1.12352,1.121982823755858,1.123332,1.1231266666666608,1.1227477777777717,1.122689500000004,1.1218178000000014,1.118888000000001,1.1134382500000057,1.123155850495055,1.1229452514766478,1595,-37901,-39023.4,0.02773134443626222,-57.44892479992034,0.15868204753330672
2023-07-13T23:00:00-04:00,1.12352,1.12365,1.12335,1.12358,1.1221329978553893,1.1234226666666667,1.1232733333333274,1.1229175555555493,1.1227260000000037,1.1219164000000015,1.118981400000001,1.1135423500000057,1.123240680396044,1.123056601181318,1614,-36287,-38048.2,0.039198604424986426,-57.36273140772446,0.11761980289772316
2023-07-13T23:15:00-04:00,1.12358,1.1241,1.12349,1.12388,1.1222711580269582,1.123544,1.1234288888888833,1.1230939999999936,1.1227905000000038,1.1220022000000016,1.119076600000001,1.1136487500000056,1.123368544316835,1.123163680945054,1904,-34383,-37082,0.049256947036745095,-56.8543563921493,0.12472382581427446
2023-07-13T23:30:00-04:00,1.12388,1.1243,1.12388,1.12412,1.1224540422242624,1.1236822222222222,1.123558888888883,1.1232633333333268,1.1228655000000036,1.1221050000000017,1.119175500000001,1.1137550000000056,1.123518835453468,1.123269744756043,1832,-32551,-36123.6,0.057370823408365995,-56.46314024807695,0.10418985707289866
2023-07-13T23:45:00-04:00,1.12412,1.1242699999999999,1.12403,1.12413,1.1226755571573508,1.1237964444444446,1.123659999999994,1.1234095555555492,1.1229495000000036,1.1222054000000017,1.1192708000000011,1.1138621000000057,1.1236410683627744,1.1233849958048343,1698,-30853,-34395,0.06147207295277583,-56.448035099160364,0.08101707590678482
2023-07-14T00:00:00-04:00,1.12413,1.12413,1.12332,1.12336,1.1228704902984687,1.1237364444444444,1.1236666666666608,1.1235175555555492,1.1229970000000036,1.1222920000000018,1.119357000000001,1.1139653500000057,1.1235848546902196,1.123470796643867,-1818,-32671,-33349,0.058857577807590114,-57.69331811802854,0.0053414047894550865
2023-07-14T00:15:00-04:00,1.12336,1.12349,1.12326,1.12334,1.1230420314626526,1.1236711111111113,1.123656666666661,1.123594222222216,1.1230340000000036,1.1223732000000017,1.1194438000000009,1.1140664000000056,1.1235358837521756,1.1235298373150935,-1175,-33846,-32860.8,0.05526796951107118,-57.71423750273148,-0.008011180046814085
2023-07-14T00:30:00-04:00,1.12334,1.12374,1.1233,1.12372,1.1231929876871343,1.1236837777777777,1.123668888888883,1.1236422222222158,1.1230940000000036,1.1224452000000018,1.1195369000000008,1.1141701500000059,1.1235727070017405,1.1235706698520744,1291,-32555,-32495.2,0.053098658435719065,-57.27752199362465,0.009789873710633983
2023-07-14T00:45:00-04:00,1.12372,1.12377,1.12326,1.12329,1.1243,1.123608,1.123659999999994,1.123662444444438,1.1231420000000036,1.1225012000000019,1.119624200000001,1.1142711000000056,1.1235161656013923,1.1235701358816592,-1741,-34296,-32844.2,0.046982913415984186,-57.94372887790211,-0.007121429270861783
2023-07-14T01:00:00-04:00,1.12329,1.12352,1.12311,1.12327,1.1242792000000001,1.12353,1.1236322222222164,1.1236568888888825,1.1231995000000037,1.122557200000002,1.119711300000001,1.1143726500000057,1.123466932481114,1.1235353087053273,-1723,-36019,-33877.4,0.04210528993596854,-57.974406619179824,-0.02225149530049162
2023-07-14T01:15:00-04:00,1.12327,1.1233899999999999,1.12303,1.12332,1.1242324320000001,1.1234675555555556,1.1236033333333275,1.1236442222222158,1.1232945000000036,1.1226122000000018,1.119798500000001,1.1144757000000056,1.123437545984891,1.1235058469642616,1570,-34449,-34233,0.03523504799875802,-57.90452137342398,-0.02314031933640034
2023-07-14T01:30:00-04:00,1.12332,1.12338,1.12268,1.12277,1.1241602860800002,1.123300888888889,1.1234799999999943,1.1236088888888824,1.1233460000000037,1.1226588000000017,1.1198782000000012,1.1145758500000056,1.1233040367879128,1.123459477571409,-2267,-36716,-34807,0.022298850380300182,-59.01449003774057,-0.09876499270384244
2023-07-14T01:45:00-04:00,1.12277,1.123,1.12184,1.12192,1.1240418631936002,1.1229888888888888,1.1232355555555498,1.1235222222222159,1.1233290000000036,1.1226844000000016,1.1199566000000012,1.1146707000000056,1.1230272294303303,1.123350382057127,-3183,-39899,-36275.8,0.004086678277154628,-61.42419995161434,-0.19570864320534995
2023-07-14T02:00:00-04:00,1.12192,1.12256,1.12192,1.12233,1.1238216768742402,1.1228077777777778,1.1230355555555498,1.1233973333333271,1.1233215000000036,1.1227038000000018,1.1200390000000011,1.1147663000000056,1.1228877835442643,1.1232247056457012,3670,-36229,-36662.4,-0.012145537881513829,-60.08301697956635,-0.16012382909450185
2023-07-14T02:15:00-04:00,1.12233,1.12239,1.12145,1.12159,1.123623509186816,1.1225186666666667,1.1228388888888832,1.1232386666666605,1.1232535000000037,1.1227044000000017,1.120115400000001,1.1148581500000057,1.1226282268354115,1.1230569645165607,-2728,-38957,-37250,-0.030986068351151145,-61.881703640352306,-0.15756302521006868
2023-07-14T02:30:00-04:00,1.12159,1.12189,1.12151,1.12169,1.123362688084398,1.122288888888889,1.1226555555555497,1.1230491111111047,1.1231770000000036,1.1227060000000018,1.120191100000001,1.1149495000000058,1.1224405814683291,1.1228575716132483,2565,-36392,-37638.6,-0.040514254606757616,-61.6530104458695,-0.14688340128544602
2023-07-14T02:45:00-04:00,1.12169,1.1217,1.12055,1.12101,1.1231331655142702,1.121959777777778,1.1223544444444387,1.1228239999999936,1.1230625000000036,1.1226942000000018,1.120270200000001,1.1150365000000058,1.1221544651746633,1.1226276572905984,-4418,-40810,-38457.4,-0.05189414256318444,-64.33132620155963,-0.24116327910867388
2023-07-14T03:00:00-04:00,1.12101,1.1217,1.12085,1.12117,1.1227715223422723,1.1217228888888888,1.122118888888883,1.1226006666666604,1.1229495000000038,1.1226758000000017,1.120342600000001,1.1151257500000056,1.1219575721397306,1.1224137258324787,3524,-37286,-37934.8,-0.06557427100308333,-63.82835120579708,-0.18873131604482368
2023-07-14T03:15:00-04:00,1.12117,1.12128,1.1204,1.12077,1.1224605092143543,1.1214531111111112,1.121841111111105,1.1223617777777712,1.122807500000004,1.1226466000000017,1.120403200000001,1.1152135500000058,1.1217200577117845,1.1221801806659826,-3847,-41133,-38915.6,-0.07674378365127339,-65.20084601033147,-0.22256447692896159
2023-07-14T03:30:00-04:00,1.12077,1.12113,1.12052,1.12099,1.1221308277400577,1.1212828888888888,1.1215822222222163,1.1221104444444379,1.1226885000000038,1.1226254000000018,1.120468900000001,1.1153035500000057,1.1215740461694277,1.1219693445327859,3086,-38047,-38733.6,-0.08594765946968451,-64.59508390035383,-0.20742085959478734
2023-07-14T03:45:00-04:00,1.12099,1.12216,1.12099,1.12215,1.1204,1.1213964444444444,1.1215133333333274,1.1218819999999936,1.1226200000000037,1.1226212000000018,1.120542200000001,1.1154013000000058,1.1216892369355422,1.1218190756262285,3030,-35017,-38458.6,-0.09119898608363033,-61.45964112209519,-0.055220570553191205
2023-07-14T04:00:00-04:00,1.12215,1.12272,1.12212,1.12252,1.1204352,1.1215977777777777,1.1215799999999938,1.1217271111111047,1.1225670000000039,1.1226212000000018,1.1206111000000012,1.1154986500000057,1.1218553895484338,1.1217592605009825,3428,-31589,-36614.4,-0.08918800148586169,-60.32934659819024,0.05347974900170546
2023-07-14T04:15:00-04:00,1.12252,1.12323,1.12235,1.12303,1.120526592,1.1218877777777778,1.1216577777777716,1.1216348888888823,1.122524500000004,1.1226296000000018,1.120700600000001,1.1155985500000059,1.122090311638747,1.121785808400786,2851,-28738,-34904.8,-0.07696918305724262,-59.034037828635995,0.06237024760987614
2023-07-14T04:30:00-04:00,1.12303,1.12357,1.12278,1.12303,1.12068879648,1.122162222222222,1.1218177777777718,1.1216302222222159,1.1224700000000039,1.1226362000000016,1.120788000000001,1.1157005000000058,1.1222782493109977,1.1218974467206286,0,-28738,-32425.8,-0.06713040733794168,-59.034037828635995,0.12838916181491328
2023-07-14T04:45:00-04:00,1.12303,1.12325,1.12286,1.12312,1.1209192927616,1.1224226666666666,1.1219766666666606,1.1217091111111046,1.122419500000004,1.1226470000000017,1.120863800000001,1.115804750000006,1.1224465994487982,1.1220719573765028,2802,-25936,-30003.6,-0.04926074938058864,-58.80948461100175,0.12748620385309847
2023-07-14T05:00:00-04:00,1.12312,1.12448,1.1231,1.12428,1.121131349340672,1.1228833333333332,1.1223399999999937,1.121874444444438,1.122465500000004,1.1226816000000017,1.120950000000001,1.115913700000006,1.1228132795590386,1.122296765901202,3363,-22573,-27514.8,-0.026823435783467006,-55.336053454936355,0.2917012337088772
2023-07-14T05:15:00-04:00,1.12428,1.12438,1.12337,1.12353,1.1214662144066048,1.1231213333333332,1.122602222222216,1.1220788888888822,1.1224750000000039,1.1226998000000017,1.121022200000001,1.1160175500000058,1.1229566236472308,1.1225170127209616,-2496,-25069,-26210.8,-0.005094846441495463,-57.001119096947306,0.21049439424885769
2023-07-14T05:30:00-04:00,1.12353,1.12363,1.1229,1.12328,1.1217675929659443,1.123256888888889,1.1228811111111048,1.122323555555549,1.122453000000004,1.1227234000000017,1.121086100000001,1.1161215000000058,1.1230212989177846,1.122703210176769,-2459,-27528,-25968.8,0.013956775569537479,-57.54827849633999,0.22395317504929754
2023-07-14T05:45:00-04:00,1.12328,1.12337,1.1226099999999999,1.12267,1.1220388336693499,1.1232146666666667,1.1230677777777716,1.122573555555549,1.122422000000004,1.1227298000000017,1.121152000000001,1.1162212000000058,1.1229510391342277,1.122837768141415,-2701,-30229,-26267,0.03533894202971604,-59.015063269504296,0.1498675278102504
2023-07-14T06:00:00-04:00,1.12267,1.12267,1.12205,1.12209,1.12448,1.1230191111111112,1.123061111111105,1.122790444444438,1.122363000000004,1.1227232000000018,1.121209800000001,1.1163168000000059,1.122778831307382,1.1229042145131318,-3017,-33246,-27729,0.05023221794378342,-60.57372253714312,-0.005346878759519581
2023-07-14T06:15:00-04:00,1.12209,1.12242,1.12174,1.12175,1.1244314,1.1227568888888888,1.1229755555555494,1.1229175555555493,1.1222845000000041,1.1227098000000018,1.121261800000001,1.1164134500000058,1.1225730650459056,1.1228561716105052,-2993,-36239,-30462.2,0.05312060201129074,-61.480619488368085,-0.06859565976552198
2023-07-14T06:30:00-04:00,1.12175,1.1223,1.12153,1.12154,1.124323744,1.1224697777777777,1.1228099999999939,1.1229591111111048,1.122223000000004,1.1226836000000018,1.121303400000001,1.116508500000006,1.1223664520367245,1.122738137288404,-2480,-38719,-33192.2,0.0519450100843746,-61.94489405935102,-0.1326767762214715
2023-07-14T06:45:00-04:00,1.12154,1.12213,1.12154,1.12202,1.12415611936,1.1223117777777778,1.1226977777777718,1.1229224444444381,1.122228000000004,1.1226722000000018,1.121350900000001,1.116607500000006,1.1222971616293795,1.122593309830723,2210,-36509,-34988.4,0.046129078250557454,-60.99905173540352,-0.0899352644185779
2023-07-14T07:00:00-04:00,1.12202,1.12281,1.12192,1.12277,1.1239985521984,1.1223262222222221,1.1226588888888829,1.1228406666666606,1.122250000000004,1.122675200000002,1.121414800000001,1.116709800000006,1.1223917293035037,1.1224814478645782,2777,-33732,-35689,0.04020396031328124,-59.142801401184805,-0.031163188261258856
2023-07-14T07:15:00-04:00,1.12277,1.12325,1.1226099999999999,1.12325,1.1238504390664958,1.1224444444444446,1.1225444444444386,1.1227373333333273,1.122333000000004,1.1226912000000018,1.121482400000001,1.116812900000006,1.122563383442803,1.1224383582916624,2301,-31431,-35326,0.03745717225549138,-58.15909146949792,-0.09161418863627072
2023-07-14T07:30:00-04:00,1.12325,1.12343,1.12253,1.12284,1.1237112127225062,1.1225035555555556,1.122467777777772,1.1226357777777718,1.1223905000000038,1.122699800000002,1.121545700000001,1.1169147500000058,1.1226187067542424,1.1224474866333296,-2616,-34047,-34887.6,0.019321580857049582,-59.11396349264509,-0.061413580411725316
2023-07-14T07:45:00-04:00,1.12284,1.12343,1.12226,1.12242,1.1235803399591557,1.1224939999999999,1.1223722222222163,1.1225482222222163,1.1224610000000037,1.1226962000000018,1.1215986000000011,1.1170144500000059,1.122578965403394,1.1224899893066635,-2239,-36286,-34401,0.006334261481982862,-59.95146482854352,-0.07656149846877741
2023-07-14T08:00:00-04:00,1.12242,1.12259,1.12175,1.12179,1.1234573195616064,1.1223775555555555,1.1222744444444386,1.1224635555555496,1.1224920000000038,1.122681600000002,1.1216431000000011,1.1171112000000059,1.122421172322715,1.1225147914453308,-2854,-39140,-34927.2,-0.010249878982250037,-61.55337855067939,-0.07838456536649166
2023-07-14T08:15:00-04:00,1.12179,1.12237,1.12153,1.12186,1.12343,1.1222946666666667,1.122248888888883,1.1223815555555496,1.1225465000000039,1.122672200000002,1.121691300000001,1.117208100000006,1.122308937858172,1.1224982331562645,3662,-35478,-35276.4,-0.020393098503266743,-61.32486875829396,-0.02049746455275
2023-07-14T08:30:00-04:00,1.12186,1.12238,1.12099,1.12134,1.123316,1.122112888888889,1.1222033333333274,1.1223133333333275,1.1225640000000037,1.1226566000000018,1.121730900000001,1.1173049500000058,1.1221151502865376,1.1224085865250113,-5366,-40844,-37159,-0.029492280547838288,-63.81209532845459,-0.03655003342991054
2023-07-14T08:45:00-04:00,1.12134,1.12271,1.12134,1.12257,1.12312992,1.1221862222222223,1.122317777777772,1.1222833333333275,1.122585000000004,1.1226796000000019,1.121782400000001,1.117406850000006,1.1222061202292302,1.122326069220009,4527,-36317,-37613,-0.0288879415110135,-58.84642033246739,0.09183800845267101
2023-07-14T09:00:00-04:00,1.12257,1.12262,1.12175,1.1224,1.1229587264,1.1222026666666667,1.1223599999999943,1.122280888888883,1.122579000000004,1.1226928000000018,1.1218266000000012,1.117509000000006,1.1222448961833842,1.122259255376007,-4784,-41101,-38576,-0.022287171089850268,-59.57090076575887,0.033867488993070266
2023-07-14T09:15:00-04:00,1.1224,1.1228799999999999,1.12211,1.12281,1.12099,1.1222926666666666,1.1223644444444387,1.122298888888883,1.122568000000004,1.1227038000000018,1.121876300000001,1.117613250000006,1.1223579169467073,1.1222466043008053,3494,-37607,-38269.4,-0.016479747725794316,-58.29458216276522,0.003562617455047784
2023-07-14T09:30:00-04:00,1.12281,1.12337,1.12267,1.12332,1.1210278,1.1224837777777776,1.1223722222222166,1.1223235555555497,1.122582500000004,1.1227206000000018,1.1219353000000012,1.1177181500000062,1.1225503335573659,1.1222948834406439,6232,-31375,-37448.8,-0.012810354159179315,-55.46389843176882,0.006231916314267927
2023-07-14T09:45:00-04:00,1.12332,1.12439,1.12298,1.12397,1.121121488,1.1228033333333334,1.122497777777772,1.1223824444444386,1.122625000000004,1.1227410000000018,1.121995500000001,1.117830550000006,1.1228342668458926,1.122438706752515,4873,-26502,-34580.4,-0.010383608150670904,-52.64417653596076,0.10063766876846686
2023-07-14T10:00:00-04:00,1.12397,1.12398,1.12151,1.12308,1.12131759872,1.1229197777777777,1.1225711111111054,1.1224331111111052,1.1225650000000038,1.122738200000002,1.122043600000001,1.117933650000006,1.122883413476714,1.1225741654020118,-12261,-38763,-35069.6,-0.00807615337520052,-62.35287872551918,0.05880151814829609
2023-07-14T10:15:00-04:00,1.12308,1.12374,1.12217,1.12342,1.1215019427967998,1.1230895555555556,1.1227522222222166,1.1225115555555496,1.122559500000004,1.122740600000002,1.122098000000001,1.1180401500000061,1.1229907307813713,1.1227233323216093,7644,-31119,-33073.2,0.0044793745168623025,-60.03874259986468,0.14530348817515046
2023-07-14T10:30:00-04:00,1.12342,1.12372,1.12263,1.12365,1.12151,1.1232691111111113,1.1229511111111055,1.122628888888883,1.1225780000000039,1.1227450000000019,1.122141100000001,1.118127400000006,1.1231225846250972,1.1228762658572873,7910,-23209,-30193.6,0.020538845651145828,-58.41931264490605,0.1595564508940472
2023-07-14T10:45:00-04:00,1.12365,1.12443,1.12308,1.12416,1.1216828,1.123510888888889,1.1232644444444386,1.1228073333333275,1.122652500000004,1.1227560000000019,1.122188600000001,1.118219150000006,1.1233300677000777,1.1230322126858294,6252,-16957,-27310,0.03729260442567669,-55.58166747069694,0.25148483064904886
2023-07-14T11:00:00-04:00,1.12416,1.12443,1.12363,1.12407,1.121902576,1.123672,1.1234311111111053,1.1229939999999938,1.122751500000004,1.1227700000000018,1.122239800000001,1.1183011500000062,1.1234780541600622,1.1231609701486633,-4295,-21252,-26260,0.05566837679964565,-55.92552421706812,0.13362195675992006
2023-07-14T11:15:00-04:00,1.12407,1.12414,1.12365,1.12379,1.1221047699200002,1.123743777777778,1.1235855555555498,1.123196888888883,1.1228535000000037,1.1227754000000016,1.122296600000001,1.1183790500000061,1.1235404433280498,1.1232923761189304,-2993,-24245,-23356.4,0.05932018650678251,-56.671064975205525,0.12384176764076998
2023-07-14T11:30:00-04:00,1.12379,1.12432,1.12373,1.12376,1.1222907883264002,1.123778666666667,1.1236911111111054,1.1233846666666607,1.122964500000004,1.122779000000002,1.1223477000000008,1.1184560000000061,1.1235843546624398,1.1234111008951442,-2633,-26878,-22508.2,0.06290279010578033,-56.741353908191165,0.0846091502569452
2023-07-14T11:45:00-04:00,1.12376,1.12382,1.12348,1.12355,1.122461925260288,1.1237504444444444,1.1237166666666611,1.1235377777777718,1.123041000000004,1.1227724000000017,1.1223873000000009,1.1185248500000062,1.123577483729952,1.1235020807161151,-2858,-29736,-23813.6,0.060963819455560744,-57.275435918584954,0.02047502047501624
2023-07-14T12:00:00-04:00,1.12355,1.12405,1.1233899999999999,1.12371,1.122619371239465,1.123749111111111,1.1236877777777723,1.1236224444444383,1.123088000000004,1.1227642000000018,1.122434600000001,1.1185939500000062,1.1236039869839616,1.1235568645728917,2377,-27359,-25894,0.05726635213886073,-56.93693740939546,-0.023132290007733924
2023-07-14T12:15:00-04:00,1.12371,1.1239999999999999,1.12363,1.12375,1.1227642215403077,1.1237615555555556,1.1237622222222166,1.1236886666666606,1.123113000000004,1.1227566000000018,1.1224810000000007,1.1186629000000061,1.1236331895871692,1.1235878916583133,2109,-25250,-26693.6,0.05115004933157488,-56.86186465930862,0.059657370801719234
2023-07-14T12:30:00-04:00,1.12375,1.12399,1.12328,1.12389,1.122897483817083,1.123787111111111,1.123814444444439,1.1237344444444384,1.1231655000000038,1.1227672000000017,1.1225296000000007,1.1187239000000062,1.1236845516697354,1.1236167133266504,2260,-22990,-26442.6,0.05564706406132391,-56.580307373435375,0.041836534866743554
2023-07-14T12:45:00-04:00,1.12389,1.1243,1.12372,1.12394,1.1230200851117165,1.1238122222222222,1.123846666666661,1.1237655555555495,1.1232415000000038,1.1227792000000019,1.1225762000000008,1.118783400000006,1.1237356413357882,1.12364697066132,2000,-20990,-25265,0.05561055231154188,-56.4913306942232,0.025808748275699858
2023-07-14T13:00:00-04:00,1.12394,1.12396,1.12287,1.12289,1.12443,1.1236208888888888,1.1237055555555502,1.1237633333333272,1.123296500000004,1.122762600000002,1.1226039000000008,1.1188418000000062,1.1235665130686305,1.1236447765290556,-1947,-22937,-23905.2,0.04685064940615351,-58.31024451524567,-0.11297324224310634
2023-07-14T13:15:00-04:00,1.12289,1.12313,1.12263,1.12308,1.1243988,1.1234957777777779,1.1235955555555501,1.1237448888888828,1.123357500000004,1.122758400000002,1.1226298000000008,1.118894550000006,1.1234692104549044,1.1236178212232442,2224,-20713,-22576,0.0317647921642865,-57.93392982725281,-0.08807280685365008
2023-07-14T13:30:00-04:00,1.12308,1.12361,1.12308,1.12338,1.124328048,1.1234526666666667,1.1235499999999945,1.1237024444444383,1.1234595000000038,1.1227606000000019,1.1226589000000007,1.1189526500000062,1.1234513683639236,1.1235814569785951,1662,-19051,-21336.2,0.01917718677835599,-57.489972139465706,-0.03648368467418481
2023-07-14T13:45:00-04:00,1.12338,1.1236,1.1232199999999999,1.1234,1.12426012608,1.1234226666666667,1.1235099999999947,1.1236415555555497,1.1235010000000039,1.122762200000002,1.1226872000000008,1.1190086000000061,1.1234410946911388,1.1235327655828757,1686,-17365,-20211.2,0.006972528239200087,-57.45995558229018,-0.03203531003062379
2023-07-14T14:00:00-04:00,1.1234,1.1235,1.12325,1.12333,1.1241949210368,1.1233866666666665,1.12348555555555,1.1235693333333274,1.123547500000004,1.1227734000000018,1.1227161000000008,1.119061700000006,1.123418875752911,1.1234694124663005,-1668,-19033,-19819.8,-0.00007629268373192799,-57.56389006689052,-0.019580793022127094
2023-07-14T14:15:00-04:00,1.12333,1.12357,1.12313,1.12349,1.124132324195328,1.1233875555555555,1.123461111111106,1.1235204444444384,1.1235815000000038,1.1228048000000017,1.1227446000000008,1.119113950000006,1.1234331006023288,1.12344272997304,1596,-17437,-18719.8,-0.005230045722175969,-57.336565950201525,-0.019578005001280308
2023-07-14T14:30:00-04:00,1.12349,1.12367,1.12325,1.12334,1.1240722312275149,1.1233633333333333,1.1234155555555503,1.1234844444444385,1.123582500000004,1.1228250000000017,1.1227644000000008,1.119166750000006,1.123414480481863,1.1234317839784318,-1656,-19093,-18395.8,-0.01076924446141785,-57.55766271118752,-0.036484983314796125
2023-07-14T14:45:00-04:00,1.12334,1.12362,1.12324,1.1234,1.1240145419784142,1.123360222222222,1.1233611111111057,1.1234466666666607,1.1235540000000037,1.1228612000000018,1.1227828000000009,1.119217750000006,1.1234115843854904,1.123423827182745,2148,-16945,-17974.6,-0.014223322264176386,-57.4429334217472,-0.04359857281407446
2023-07-14T15:00:00-04:00,1.1234,1.1234,1.12293,1.12313,1.1239591602992776,1.1233140000000001,1.1232711111111058,1.123398888888883,1.1235565000000038,1.1228900000000017,1.1227980000000009,1.1192693500000062,1.1233552675083922,1.123406661746196,-1705,-18650,-18231.6,-0.01742800458202234,-57.85271622395477,-0.07206790398063753
2023-07-14T15:15:00-04:00,1.12313,1.12331,1.12295,1.12299,1.1239059938873064,1.1232577777777777,1.123282222222217,1.1233582222222165,1.1235350000000037,1.1229296000000017,1.122811900000001,1.1193212000000061,1.1232822140067138,1.1233793293969563,-1456,-20106,-18446.2,-0.02550211662861958,-58.03420901641873,0.008905591821103492
2023-07-14T15:30:00-04:00,1.12299,1.12308,1.12278,1.12278,1.1238549541318141,1.1231573333333333,1.1232488888888836,1.123315777777772,1.1234915000000039,1.1229618000000017,1.1228188000000008,1.1193717500000062,1.123181771205371,1.123329063517565,-1235,-21341,-19227,-0.023769278630779527,-58.26515497319488,-0.026712255582878243
2023-07-14T15:45:00-04:00,1.12278,1.12297,1.12257,1.12259,1.1238059559665416,1.1230255555555555,1.123161111111106,1.1232648888888832,1.1234130000000038,1.1229982000000016,1.1228224000000009,1.1194199000000062,1.1230634169642968,1.1232588508140515,-1653,-22994,-20007.2,-0.023638948441469368,-58.54488029783538,-0.07032348804501312
2023-07-14T16:00:00-04:00,1.12259,1.12264,1.1224399999999999,1.12251,1.123731798608549,1.1228953333333331,1.123062222222217,1.1232051111111054,1.1233350000000037,1.1230286000000016,1.122827000000001,1.1194668000000063,1.1229527335714373,1.123167080651241,-1278,-24272,-21472.6,-0.024390895252232127,-58.63595540094524,-0.07922378493858442
2023-07-14T16:15:00-04:00,1.12251,1.12271,1.12251,1.12263,1.1236284547198652,1.1228088888888887,1.1229844444444395,1.1231477777777723,1.1232770000000039,1.1230382000000017,1.1228297000000007,1.1195134500000061,1.1228881868571499,1.1230736645209927,1394,-22878,-22318.2,-0.025142723425782314,-58.48693222965932,-0.06231472496950344
2023-07-14T16:30:00-04:00,1.12263,1.12274,1.12249,1.12254,1.1235333783422758,1.12272,1.1228788888888837,1.1230671111111055,1.1232160000000035,1.1230386000000017,1.1228299000000008,1.119558250000006,1.12281854948572,1.122980931616794,-475,-23353,-22967.6,-0.02687798243815933,-58.525012451994336,-0.08455793999056567
2023-07-14T16:45:00-04:00,1.12254,1.12289,1.1224,1.12251,1.1234459080748938,1.1226462222222222,1.1227866666666615,1.1229746666666611,1.1231640000000036,1.1230282000000016,1.122828900000001,1.1196017000000063,1.1227568395885759,1.1228959452934348,-1071,-24424,-23584.2,-0.030305047350124372,-58.55363504005375,-0.07388680185875234
2023-07-16T17:00:00-04:00,1.12315,1.1235,1.12219,1.12298,1.12219,1.122684888888889,1.1227399999999947,1.122890444444439,1.1231275000000036,1.1230272000000017,1.1228317000000008,1.119648100000006,1.1228014716708608,1.1228435562347476,135,-24289,-23843.2,-0.03109437443620999,-58.49710993114601,-0.03738650525190181
2023-07-16T17:15:00-04:00,1.12298,1.12298,1.12242,1.12259,1.12219,1.122654888888889,1.1226799999999946,1.1228139999999942,1.1230695000000037,1.1230166000000017,1.1228318000000008,1.119693250000006,1.1227591773366885,1.1228048449877979,-65,-24354,-23859.6,-0.03355926655466381,-58.519683797109785,-0.04807991951065192
2023-07-16T17:30:00-04:00,1.12259,1.12272,1.12259,1.12272,1.12219,1.1226628888888888,1.1226499999999946,1.1227471111111051,1.1230110000000038,1.1229854000000017,1.122833500000001,1.119736950000006,1.1227513418693509,1.122777475990238,30,-24324,-24148.8,-0.03284414802971575,-58.516209688129656,-0.024042956749391577
2023-07-16T17:45:00-04:00,1.12272,1.12294,1.1227,1.12293,1.1222162,1.1227188888888888,1.1226666666666612,1.1227046666666607,1.1229605000000036,1.1229734000000016,1.122836600000001,1.1197831500000062,1.1227870734954808,1.1227711807921903,60,-24264,-24331,-0.029309061766098512,-58.50498694336694,0.013359696467704673
2023-07-16T18:00:00-04:00,1.12293,1.12317,1.1226,1.1226099999999999,1.122241876,1.1227075555555557,1.1226688888888834,1.1226811111111052,1.1229465000000034,1.1229600000000017,1.1228417000000008,1.1198289000000061,1.1227516587963846,1.122770144633752,-667,-24931,-24432.4,-0.025184654958334624,-58.69506112430437,0.0017815943487746175
2023-07-16T18:15:00-04:00,1.1226099999999999,1.1228,1.12259,1.12272,1.12226703848,1.1227177777777777,1.1226922222222167,1.1226715555555495,1.1229285000000035,1.1229610000000017,1.1228454000000008,1.1198747500000061,1.1227453270371077,1.1227589157070015,658,-24273,-24429.2,-0.023306257195320253,-58.63058637350041,0.018708073870169845
2023-07-16T18:30:00-04:00,1.12272,1.12278,1.12246,1.12248,1.1222916977104,1.1226753333333332,1.12267555555555,1.1226706666666606,1.1228835000000035,1.1229688000000015,1.122846000000001,1.1199212500000062,1.1226922616296862,1.122745532565601,-513,-24786,-24515.6,-0.021029597918237112,-58.7402486223247,-0.013361481521079474
2023-07-16T18:45:00-04:00,1.12248,1.12257,1.12245,1.12254,1.122315863756192,1.122648222222222,1.12267555555555,1.1226757777777718,1.1228405000000037,1.1229846000000017,1.1228472000000007,1.119970000000006,1.122661809303749,1.1227276260524806,466,-24320,-24514.8,-0.018269557395338684,-58.71533949254058,0
2023-07-16T19:00:00-04:00,1.12254,1.12264,1.12233,1.12262,1.1235,1.122637111111111,1.1226877777777724,1.1226799999999941,1.1228050000000036,1.1230062000000016,1.1228449000000007,1.1200179000000061,1.1226534474429992,1.1227009008419844,951,-23369,-24335.8,-0.014249708325822315,-58.647564624829975,0.009799467265329886
2023-07-16T19:15:00-04:00,1.12262,1.12282,1.1226099999999999,1.12282,1.1234766,1.1226635555555555,1.1226699999999947,1.1226802222222163,1.1227715000000038,1.1230222000000016,1.1228472000000007,1.120065850000006,1.1226867579543993,1.1226879206735874,835,-22534,-23856.4,-0.00932612689595776,-58.49880547213362,-0.014247804947564516
2023-07-16T19:30:00-04:00,1.12282,1.12293,1.12273,1.12287,1.123453668,1.1227035555555556,1.1227011111111058,1.1226819999999944,1.1227480000000036,1.1230242000000015,1.1228497000000006,1.1201153000000061,1.1227234063635194,1.1226835365388694,866,-21668,-23335.4,-0.0076765500476764,-58.460241855525354,0.024942320882963324
2023-07-16T19:45:00-04:00,1.12287,1.12293,1.12266,1.12272,1.12343119464,1.1227073333333333,1.1227011111111058,1.1226871111111054,1.1227140000000033,1.1230136000000015,1.1228524000000006,1.120164600000006,1.1227227250908156,1.1226896292310955,-868,-22536,-22885.4,-0.0038892715478609534,-58.576194726294084,0
2023-07-16T20:00:00-04:00,1.12272,1.12297,1.12241,1.1226099999999999,1.1234091707472,1.122689111111111,1.12266555555555,1.1226851111111054,1.1226880000000035,1.1230090000000015,1.1228544000000007,1.120210100000006,1.1227001800726524,1.122697303384876,-1519,-24055,-22832.4,-0.001518436061270893,-58.72502079156422,-0.028496878701263478
2023-07-16T20:15:00-04:00,1.1226099999999999,1.12272,1.1223,1.12234,1.123387587332256,1.1226239999999998,1.12263555555555,1.122674666666661,1.1226555000000036,1.1230074000000017,1.1228518000000007,1.120254300000006,1.1226281440581218,1.1226922427079007,-1165,-25220,-23202.6,-0.003422957995120679,-59.00521605082611,-0.024051095215612946
2023-07-16T20:30:00-04:00,1.12234,1.12276,1.12234,1.12269,1.123344083838966,1.122634888888889,1.1226322222222167,1.1226671111111053,1.1226510000000034,1.1230254000000015,1.1228535000000006,1.120300000000006,1.1226405152464976,1.1226829941663203,929,-24291,-23554,-0.0014379151498012622,-58.715508831979704,-0.002672082086359421
2023-07-16T20:45:00-04:00,1.12269,1.12278,1.12232,1.1224399999999999,1.1233023204854073,1.1225964444444443,1.1226277777777725,1.1226524444444386,1.1226435000000035,1.1230370000000016,1.1228546000000008,1.1203446000000061,1.122600412197198,1.122658395333056,-1350,-25641,-24348.6,-0.002489877185373569,-59.016126099435645,-0.003563537880411233
2023-07-16T21:00:00-04:00,1.1224399999999999,1.12272,1.12232,1.12238,1.1232622276659912,1.1225468888888888,1.1226099999999946,1.122634222222216,1.1226370000000034,1.1230578000000015,1.1228572000000008,1.1203891000000061,1.1225563297577583,1.1226251162664445,-1906,-27547,-25350.8,-0.0024898993643398667,-59.118011278153354,-0.014253389634236642
2023-07-16T21:15:00-04:00,1.12238,1.12269,1.12228,1.12238,1.1232237385593515,1.1225008888888888,1.122583333333328,1.1226177777777717,1.1226245000000037,1.1230540000000016,1.1228668000000006,1.1204332000000061,1.1225210638062066,1.1225892930131554,0,-27547,-26049.2,-0.0033637156455210084,-59.118011278153354,-0.021378560866545937
2023-07-16T21:30:00-04:00,1.12238,1.1224399999999999,1.12186,1.12199,1.1231671142457904,1.1223822222222222,1.1224911111111058,1.122588888888883,1.1225970000000034,1.1230458000000014,1.1228693000000007,1.120474200000006,1.1224148510449654,1.1225466344105242,-1903,-29450,-26895.2,-0.006261007665449658,-59.779257914764656,-0.0739210202881928
2023-07-16T21:45:00-04:00,1.12199,1.1222,1.1217,1.12178,1.1230625451061271,1.12224,1.1223699999999948,1.1225364444444386,1.1225605000000036,1.1230252000000016,1.1228645000000008,1.120512850000006,1.1222878808359724,1.122476107528419,-1702,-31152,-28267.4,-0.01230183441514999,-60.097816903704015,-0.09707267982936897
2023-07-16T22:00:00-04:00,1.12178,1.1224,1.12143,1.12217,1.1229262905955144,1.1222,1.1223088888888837,1.122472666666661,1.1225200000000037,1.1230022000000015,1.1228614000000008,1.1205532500000062,1.122264304668778,1.1224088860227348,2310,-28842,-28907.6,-0.01709555439183167,-59.29471825691075,-0.0489881715833022
2023-07-16T22:15:00-04:00,1.12217,1.1225,1.12203,1.12243,1.1227467357240526,1.122224222222222,1.1222888888888838,1.1224084444444387,1.1225120000000035,1.1229714000000015,1.1228562000000009,1.120595250000006,1.1222974437350224,1.1223571088181878,1218,-27624,-28923,-0.017346241413907837,-59.012515025671114,-0.01603406347706211
2023-07-16T22:30:00-04:00,1.12243,1.12245,1.12208,1.12236,1.1225887274371662,1.1222384444444446,1.1222911111111058,1.1223499999999942,1.1224940000000037,1.1229570000000013,1.122847600000001,1.120635550000006,1.122309954988018,1.12231488705455,-1288,-28912,-29196,-0.018597863620870653,-59.092840747542425,0.0017819911969751614
2023-07-16T22:45:00-04:00,1.12236,1.1228,1.12232,1.12264,1.12143,1.1223082222222223,1.1222855555555502,1.122308888888883,1.1224795000000036,1.1229414000000013,1.1228410000000009,1.120679600000006,1.1223759639904145,1.1223071096436397,1290,-27622,-28830.4,-0.015585944989733952,-58.77101887220824,-0.004453589147483586
2023-07-16T23:00:00-04:00,1.12264,1.12284,1.12243,1.12253,1.1214574,1.122357111111111,1.1222955555555503,1.1222939999999941,1.1224755000000037,1.1229190000000013,1.122832000000001,1.120721450000006,1.1224067711923316,1.1223308877149116,-1165,-28787,-28357.4,-0.01531470228339986,-58.88516944585612,0.008018245964162497
2023-07-16T23:15:00-04:00,1.12253,1.12279,1.12247,1.12257,1.121512704,1.122412,1.1223166666666613,1.1222955555555496,1.1224680000000036,1.1228872000000014,1.122821600000001,1.120763900000006,1.1224394169538652,1.1223659101719292,1101,-27686,-28126.2,-0.01398688618014178,-58.8459366413876,0.016928313049068455
2023-07-16T23:30:00-04:00,1.12257,1.12282,1.12251,1.1226,1.1215657958399998,1.1224686666666668,1.1223411111111057,1.122305999999994,1.1224740000000035,1.1228578000000013,1.1228139000000008,1.1208058000000058,1.1224715335630921,1.122400728137543,1464,-26222,-27845.8,-0.011517922140927403,-58.80681213244833,0.01960120458312773
2023-07-16T23:45:00-04:00,1.1226,1.12284,1.12259,1.12265,1.1216167640063999,1.1225304444444446,1.122414444444439,1.1223306666666606,1.1224795000000036,1.1228350000000014,1.122805200000001,1.1208466000000061,1.1225072268504737,1.1224401825100343,1055,-25167,-27096.8,-0.009833646767962929,-58.759823000077155,0.05882405369030766
2023-07-17T00:00:00-04:00,1.12265,1.12265,1.12221,1.12237,1.121665693446144,1.1225215555555554,1.1224799999999948,1.1223695555555495,1.1224670000000037,1.1228072000000013,1.122793100000001,1.120887250000006,1.1224797814803789,1.122460946008027,-1125,-26292,-26830.8,-0.005727143605754195,-59.04040911329126,0.05259498297349663
2023-07-17T00:15:00-04:00,1.12237,1.12247,1.12224,1.12242,1.1217126657082983,1.1225095555555555,1.1225077777777726,1.122411999999994,1.1224470000000037,1.1227846000000015,1.122778500000001,1.120927550000006,1.122467825184303,1.1224731568064212,753,-25539,-26181.2,0.000823018731364912,-59.006864025664264,0.022278264434094967
2023-07-17T00:30:00-04:00,1.12242,1.12254,1.1223,1.1225,1.1217577590799663,1.1225079999999998,1.1225155555555502,1.1224517777777716,1.1224285000000038,1.1227604000000015,1.1227623000000009,1.120968900000006,1.1224742601474424,1.1224801254451369,986,-24553,-25554.6,0.0051206035783590495,-58.936587302156056,0.006236469089387711
2023-07-17T00:45:00-04:00,1.1225,1.12275,1.12243,1.12268,1.1218010487167678,1.1225408888888886,1.1225511111111057,1.122493777777772,1.1224265000000038,1.1227390000000015,1.1227478000000009,1.121009300000006,1.122515408117954,1.122488900356109,791,-23762,-25062.6,0.008154001167151124,-58.80974543133211,0.02851135108163833
2023-07-17T01:00:00-04:00,1.12268,1.12283,1.12259,1.12273,1.121842606768097,1.1225766666666668,1.122561111111106,1.1225231111111051,1.1224325000000037,1.1227158000000015,1.122741500000001,1.1210492500000062,1.1225583264943633,1.1224991202848869,1217,-22545,-24538.2,0.0114079603725246,-58.75554476863203,0.008016817501596546
2023-07-17T01:15:00-04:00,1.12273,1.12284,1.12252,1.12259,1.1218825024973733,1.1225824444444445,1.1225677777777725,1.1225406666666609,1.1224450000000037,1.1226888000000015,1.122734000000001,1.1210889000000062,1.1225646611954907,1.1225160962279093,-1056,-23601,-24000,0.011047361106597927,-58.88722380099068,0.005345068728670858
2023-07-17T01:30:00-04:00,1.12259,1.12289,1.12228,1.12229,1.1219208023974785,1.1225268888888889,1.1225366666666614,1.1225464444444389,1.1224250000000038,1.1226768000000016,1.1227197000000009,1.121128300000006,1.1225097289563926,1.122524476982327,-1417,-25018,-23895.8,0.009121304440310438,-59.26590167982441,-0.024942765261859658
2023-07-17T01:45:00-04:00,1.12229,1.12346,1.12221,1.12324,1.1219789542536298,1.1226675555555554,1.1226077777777723,1.122564888888883,1.1224650000000036,1.1226800000000017,1.122719200000001,1.121171700000006,1.122655783165114,1.1225607815858614,2313,-22705,-23526.2,0.012756801153012998,-57.30798527675567,0.05701051131302101
2023-07-17T02:00:00-04:00,1.12324,1.12324,1.12254,1.12268,1.1220974379133395,1.122682,1.122611111111106,1.1225768888888832,1.1224800000000037,1.1226660000000015,1.122713300000001,1.1212123000000063,1.1226606265320913,1.122589825268689,-2510,-25215,-23816.8,0.01245122386878752,-58.559365213367876,0.002672248697276488
2023-07-17T02:15:00-04:00,1.12268,1.12296,1.12224,1.12285,1.1222064428802723,1.1227297777777776,1.1226644444444391,1.1225975555555496,1.1225035000000037,1.1226550000000015,1.1227086000000008,1.1212535500000063,1.122698501225673,1.1226178602149506,2102,-23113,-23930.4,0.012238863589080306,-58.24107326909167,0.04276664558031789
2023-07-17T02:30:00-04:00,1.12285,1.12337,1.12265,1.12336,1.12224,1.122868888888889,1.1227688888888834,1.1226377777777719,1.1225720000000035,1.1226556000000014,1.122714500000001,1.1212963500000062,1.1228308009805383,1.1226710881719604,2404,-20709,-23352,0.016900383186086613,-57.14917319339142,0.08374761675664555
2023-07-17T02:45:00-04:00,1.12336,1.12401,1.1232,1.12333,1.12224,1.122981111111111,1.1228611111111055,1.1227026666666606,1.1226495000000036,1.1226524000000015,1.1227286000000007,1.1213426000000062,1.1229306407844306,1.1227552705375679,-2640,-23349,-23018.2,0.0193215034551844,-57.2196759707735,0.07394209354119255
2023-07-17T03:00:00-04:00,1.12333,1.1243,1.12295,1.12407,1.122417,1.1232228888888889,1.12301555555555,1.1227842222222162,1.1227445000000036,1.1226670000000016,1.1227460000000007,1.1213925000000062,1.1231585126275445,1.1228558164300542,3368,-19981,-22473.4,0.023590727597517708,-55.0009868945449,0.12381088110592532
2023-07-17T03:15:00-04:00,1.12407,1.12433,1.12359,1.12428,1.12264296,1.1234757777777777,1.1231877777777723,1.1228995555555494,1.1228370000000036,1.1226846000000017,1.1227729000000009,1.1214441500000063,1.1233828101020356,1.1230002531440428,3080,-16901,-20810.6,0.02888990579440598,-54.4255778897675,0.13805634480239598
2023-07-17T03:30:00-04:00,1.12428,1.12434,1.12323,1.1233899999999999,1.1228791456,1.1235162222222221,1.1232766666666611,1.123021999999994,1.1228885000000035,1.1226898000000016,1.1227899000000008,1.1214905000000064,1.1233842480816285,1.1231374025152339,-2488,-19389,-20065.8,0.03069533543751637,-56.39512284298213,0.07126377395130118
2023-07-17T03:45:00-04:00,1.1233899999999999,1.12451,1.12327,1.12447,1.123112882304,1.1237548888888886,1.1235188888888834,1.1231719999999938,1.1229800000000036,1.1227194000000016,1.1228245000000008,1.1215473500000064,1.1236013984653028,1.1232915220121868,2389,-17000,-19324,0.03848658990878252,-54.098395971636954,0.1942456940719485
2023-07-17T04:00:00-04:00,1.12447,1.12448,1.12393,1.12435,1.12323,1.1239211111111111,1.1236422222222169,1.123328222222216,1.1230710000000035,1.1227508000000015,1.122856300000001,1.1215994500000062,1.1237511187722422,1.1234556176097492,-3012,-20012,-18656.6,0.049576088823557934,-54.419827401555374,0.09882126704888931
2023-07-17T04:15:00-04:00,1.12435,1.12446,1.12363,1.12389,1.12327,1.1239706666666665,1.123776666666661,1.1234804444444382,1.1231370000000036,1.1227768000000016,1.1228875000000007,1.121645350000006,1.1237788950177938,1.123579694087799,-2648,-22660,-19192.4,0.04959442975356349,-55.503191122816325,0.10777781736560334
2023-07-17T04:30:00-04:00,1.12389,1.1248799999999999,1.1238,1.12462,1.1234932,1.1241393333333334,1.1239733333333275,1.1236375555555493,1.1232380000000037,1.1228190000000016,1.1229238000000008,1.1216963500000063,1.1239471160142351,1.123692555270239,2573,-20087,-19829.6,0.05817098649491926,-53.83195105483838,0.15763459055083487
2023-07-17T04:45:00-04:00,1.12462,1.12483,1.12367,1.12379,1.1248799999999999,1.1241026666666667,1.1240211111111056,1.123786444444438,1.1232950000000037,1.1228422000000016,1.1229402000000008,1.1217412000000062,1.123915692811388,1.1237988442161906,-2689,-22776,-20507,0.061491698303245954,-55.81650583778701,0.03827802307364981
2023-07-17T05:00:00-04:00,1.12379,1.12443,1.12374,1.12425,1.1248799999999999,1.1241484444444445,1.1241233333333276,1.1239073333333272,1.1233890000000035,1.1228764000000018,1.122957500000001,1.121784300000006,1.1239825542491104,1.1238750753729523,2829,-19947,-21096.4,0.06262783407527557,-54.65851368622869,0.08189935281707351
2023-07-17T05:15:00-04:00,1.12425,1.1242699999999999,1.12359,1.12368,1.1248558,1.1240597777777779,1.1240799999999944,1.1239948888888827,1.1234520000000034,1.1228998000000017,1.122964000000001,1.121832300000006,1.1239220433992883,1.1239092602983614,-2170,-22117,-21517.4,0.060187033783002504,-55.75871381965089,-0.03469534815446462
2023-07-17T05:30:00-04:00,1.12368,1.12424,1.12354,1.12405,1.124805168,1.1240537777777777,1.1240544444444387,1.1240504444444381,1.1235295000000036,1.1229212000000017,1.122974200000001,1.1218811000000062,1.1239476347194306,1.123943008238689,1729,-20388,-21063,0.053096054819894135,-55.18939693228085,-0.020457537268291928
2023-07-17T05:45:00-04:00,1.12405,1.12448,1.12345,1.12432,1.12472925792,1.124106888888889,1.1241577777777723,1.124087333333327,1.1236115000000035,1.1229558000000017,1.1229862000000008,1.1219250000000063,1.1240221077755446,1.1239580065909507,3335,-17053,-20456.2,0.0457344401826783,-54.38832046771079,0.08278514140237117
2023-07-17T06:00:00-04:00,1.12432,1.12434,1.1239,1.12399,1.1246269172863999,1.1240733333333333,1.1241044444444386,1.1241039999999936,1.1236745000000035,1.122981200000002,1.122983300000001,1.1219666500000063,1.1240156862204356,1.1239780052727604,-2110,-19163,-19733.6,0.04552000278059133,-55.0076281381248,-0.04268677688155628
2023-07-17T06:15:00-04:00,1.12399,1.12407,1.12365,1.12388,1.1245327639034879,1.1240284444444444,1.1240522222222167,1.1240897777777714,1.1237390000000036,1.123000200000002,1.122986800000001,1.1220045000000063,1.1239885489763484,1.1239792042182082,-1698,-20861,-19916.4,0.035393774815214246,-55.17380399378196,-0.041801930003999684
2023-07-17T06:30:00-04:00,1.12388,1.12398,1.1233,1.12335,1.124446142791209,1.123888,1.1239922222222165,1.124072222222216,1.1237920000000035,1.1230150000000017,1.122987500000001,1.1220368000000063,1.1238608391810787,1.1239669633745661,-1953,-22814,-20055.8,0.02327303053295966,-56.09480089736583,-0.04804740677468301
2023-07-17T06:45:00-04:00,1.12335,1.12359,1.12306,1.12312,1.124331528512088,1.1237135555555555,1.12382555555555,1.124026444444438,1.1237860000000033,1.1230230000000019,1.1229920000000009,1.1220720000000062,1.1237126713448629,1.1239199706996525,-1889,-24703,-20918.8,0.012903110984992036,-56.4815637050396,-0.1333783855880259
2023-07-17T07:00:00-04:00,1.12312,1.12364,1.1229,1.12357,1.1241789450906374,1.1236624444444445,1.1238011111111055,1.1239551111111048,1.1238305000000033,1.1230448000000017,1.1230068000000009,1.122108300000006,1.1236841370758903,1.123852376559722,1753,-22950,-22098.2,0.002161081965197227,-55.7791899604708,-0.019576611288595645
2023-07-17T07:15:00-04:00,1.12357,1.12377,1.12336,1.12361,1.1239998927779482,1.1236242222222224,1.1237299999999943,1.123880222222216,1.1238685000000033,1.1230662000000018,1.1230254000000008,1.1221436000000062,1.1236693096607122,1.1237831012477772,1646,-21304,-22526.4,-0.003381324410926608,-55.72059103027503,-0.056926840115630324
2023-07-17T07:30:00-04:00,1.12361,1.12375,1.12349,1.12351,1.1238459077890355,1.1235802222222222,1.1237111111111053,1.1238119999999938,1.1238760000000032,1.123084000000002,1.1230451000000006,1.1221742500000063,1.1236374477285698,1.1237128809982215,-1433,-22737,-22901.6,-0.012762235983966539,-55.84812638506894,-0.015128862309554632
2023-07-17T07:45:00-04:00,1.12351,1.1237,1.12291,1.12338,1.12377,1.1235140000000001,1.1236366666666608,1.1237408888888827,1.1238785000000033,1.1230952000000018,1.1230587000000005,1.122204800000006,1.1235859581828558,1.1236579047985769,-2532,-25269,-23392.6,-0.015516357426605286,-56.14110108044317,-0.05960588941772594
2023-07-17T08:00:00-04:00,1.12338,1.1237,1.12263,1.12316,1.12263,1.1234186666666668,1.123507777777772,1.123677333333327,1.1238330000000034,1.123101000000002,1.1230626000000006,1.1222387000000063,1.1235007665462846,1.1236155238388612,-2870,-28139,-24079.8,-0.022715399057133785,-56.70315488236266,-0.10317347374413423
2023-07-17T08:15:00-04:00,1.12316,1.12336,1.12251,1.12287,1.1237,1.1232911111111112,1.1233833333333276,1.1235937777777714,1.1237625000000033,1.123104000000002,1.1230588000000006,1.1222706000000062,1.1233746132370277,1.1235536190710884,-3941,-32080,-25905.8,-0.030534506407119605,-57.72072139114112,-0.0996450146353624
2023-07-17T08:30:00-04:00,1.12287,1.123,1.12228,1.12268,1.1237,1.1231504444444442,1.1232499999999943,1.1234977777777715,1.1237270000000035,1.123105400000002,1.1230572000000008,1.1223014500000061,1.1232356905896221,1.1234668952568705,-5724,-37804,-29205.8,-0.03541412318750186,-58.68927518632736,-0.10677296508524842
2023-07-17T08:45:00-04:00,1.12268,1.12358,1.12206,1.12354,1.1236431999999998,1.1232084444444443,1.1232711111111056,1.1234097777777714,1.1236805000000034,1.123129400000002,1.1230684000000006,1.1223335000000063,1.1232965524716978,1.1233987162054961,5697,-32107,-31079.8,-0.03907521289824422,-54.32523556684498,0.016913695642490092
2023-07-17T09:00:00-04:00,1.12354,1.12357,1.12279,1.12286,1.12206,1.123126222222222,1.1232422222222165,1.1233308888888827,1.1236060000000034,1.1231328000000018,1.1230791000000007,1.1223611000000062,1.1232092419773583,1.1233233729643968,-4584,-36691,-33364.2,-0.03661564632294878,-57.09960942091343,-0.023149796994081397
2023-07-17T09:15:00-04:00,1.12286,1.12315,1.12199,1.12219,1.12358,1.1229157777777778,1.1230888888888833,1.1232471111111049,1.1235210000000033,1.1231278000000018,1.1230824000000006,1.122386850000006,1.1230053935818867,1.1232242983715168,-3434,-40125,-35761.4,-0.03574166822381226,-59.148644919550684,-0.12282278807728374
2023-07-17T09:30:00-04:00,1.12219,1.12229,1.12074,1.12091,1.12357,1.12248,1.1227888888888833,1.1231282222222159,1.1233355000000036,1.123098400000002,1.1230781000000007,1.1224045000000062,1.1225863148655093,1.1230666386972132,-7189,-47314,-38808.2,-0.046792614065832544,-67.34861105719193,-0.2402969001699811
2023-07-17T09:45:00-04:00,1.12091,1.12226,1.12033,1.12213,1.1234568,1.1223482222222223,1.1226355555555498,1.123005333333327,1.1232525000000033,1.123093400000002,1.1230737000000008,1.1224280500000061,1.1224950518924075,1.1229185109577702,4591,-42723,-39792,-0.0494174363804809,-62.35176028415931,-0.12282934731332493
2023-07-17T10:00:00-04:00,1.12213,1.12264,1.12198,1.12246,1.123269192,1.122313111111111,1.1225333333333276,1.1228577777777713,1.1231630000000035,1.1231028000000018,1.1230743000000007,1.122450450000006,1.122488041513926,1.122756808766216,3924,-38799,-41130.4,-0.053129813193060635,-61.19777634290494,-0.0818957075967199
2023-07-17T10:15:00-04:00,1.12246,1.12271,1.12192,1.12205,1.12309284048,1.1222164444444442,1.1224099999999941,1.1226913333333268,1.1230815000000034,1.1231082000000019,1.1230667000000008,1.122471500000006,1.1224004332111408,1.1225950470129726,-3065,-41864,-42165,-0.05564904595229031,-62.31732626005127,-0.09882830585134303
2023-07-17T10:30:00-04:00,1.12205,1.12304,1.12175,1.12298,1.12033,1.1223304444444444,1.1224222222222164,1.1225579999999937,1.1230280000000035,1.1231244000000018,1.1230633000000005,1.122499300000006,1.1225163465689127,1.122497237610378,3322,-38542,-41848.4,-0.05428540052134169,-59.563919549120094,0.009796325487372047
2023-07-17T10:45:00-04:00,1.12298,1.12333,1.12275,1.12319,1.1203842,1.122484,1.122478888888883,1.1224959999999935,1.1229715000000033,1.1231396000000018,1.1230555000000007,1.122525500000006,1.1226510772551301,1.122510190088302,4012,-34530,-39291.6,-0.047791381777286306,-58.813665760095105,0.04542701393095187
2023-07-17T11:00:00-04:00,1.12319,1.1233,1.12252,1.12306,1.1205020319999999,1.1226002222222224,1.1224255555555498,1.1224539999999936,1.1229250000000035,1.1231536000000018,1.1230553000000005,1.122549450000006,1.1227328618041041,1.1225577520706413,-2742,-37272,-38201.4,-0.039067121410389136,-59.13102969673975,-0.04272211047226053
2023-07-17T11:15:00-04:00,1.12306,1.1235,1.12293,1.12344,1.12061515072,1.122803111111111,1.1224899999999944,1.122445333333327,1.1229030000000035,1.1231696000000018,1.1230555000000007,1.1225767500000061,1.1228742894432833,1.1226350016565128,1932,-35340,-37509.6,-0.037626251274933145,-58.4773157366663,0.05165381258572083
2023-07-17T11:30:00-04:00,1.12344,1.12379,1.12329,1.12334,1.1207882416768,1.122973111111111,1.122617777777772,1.1224868888888826,1.1229025000000035,1.123185800000002,1.1230524000000006,1.122596750000006,1.1229674315546265,1.1227484013252098,-2309,-37649,-36666.6,-0.031062617146980654,-58.6828451819415,0.10247818996782937
2023-07-17T11:45:00-04:00,1.12334,1.12359,1.12313,1.12351,1.1210283823426561,1.1231515555555556,1.122906666666661,1.1225837777777716,1.1229220000000035,1.123204600000002,1.1230459000000006,1.122617250000006,1.1230759452437011,1.1228603210601673,1841,-35808,-36119.8,-0.019985955127235167,-58.40423852678811,0.23195439419756586
2023-07-17T12:00:00-04:00,1.12351,1.12382,1.12332,1.12349,1.1212493117552436,1.1232682222222221,1.123057777777772,1.1226995555555492,1.1229180000000034,1.123222400000002,1.1230401000000005,1.122639950000006,1.123158756194961,1.1229618568481334,-1557,-37365,-36686.8,0.001420579232039619,-58.43195523602956,0.12119807865399088
2023-07-17T12:15:00-04:00,1.12349,1.12351,1.12327,1.12338,1.1215063805797192,1.1233326666666668,1.1231599999999942,1.1228464444444382,1.1229065000000034,1.1232370000000018,1.1230360000000008,1.122666300000006,1.1232030049559687,1.1230558854785067,-1575,-38940,-37020.4,0.013357792936822733,-58.58616221606506,0.08196283163765586
2023-07-17T12:30:00-04:00,1.12338,1.12347,1.12299,1.1232,1.1217377425217472,1.1233406666666668,1.123287777777772,1.1230059999999935,1.1228910000000034,1.123253600000002,1.1230304000000007,1.122689050000006,1.123202403964775,1.1231215083828048,-1255,-40195,-37991.4,0.02168664786973978,-58.78725178504447,0.10249097633795146
2023-07-17T12:45:00-04:00,1.1232,1.12341,1.12319,1.12329,1.1219459682695725,1.1233411111111113,1.1233222222222166,1.1231468888888823,1.1228865000000035,1.123271000000002,1.1230278000000005,1.1227075500000059,1.12321992317182,1.1231720067062436,1180,-39015,-38264.6,0.03366253751455163,-58.69270050299327,0.02760512208586176
2023-07-17T13:00:00-04:00,1.12329,1.12355,1.1232,1.12347,1.1221333714426152,1.1233706666666665,1.1233533333333279,1.1232362222222156,1.1229020000000034,1.123290400000002,1.1230254000000006,1.122730000000006,1.123269938537456,1.1232108053649947,1188,-37827,-38668.4,0.03764439468770762,-58.50233114156382,0.024928996874977342
2023-07-17T13:15:00-04:00,1.12347,1.1236,1.12336,1.12341,1.1223020342983536,1.1233819999999999,1.1233922222222164,1.1233031111111047,1.1229290000000034,1.1233050000000018,1.1230220000000006,1.1227515000000061,1.1232979508299648,1.1232386442919953,-1377,-39204,-39036.2,0.038543007321848455,-58.57587115598337,0.03116485316902681
2023-07-17T13:30:00-04:00,1.12341,1.12418,1.12326,1.12417,1.1224538308685184,1.1235375555555556,1.1234733333333276,1.1233657777777712,1.1230035000000034,1.1233338000000017,1.1230248000000005,1.122777200000006,1.1234723606639718,1.123292515433596,1259,-37945,-38837.2,0.04291272222321933,-57.72414293565434,0.06497899309263488
2023-07-17T13:45:00-04:00,1.12417,1.12445,1.12377,1.12404,1.122660971164296,1.123650888888889,1.1235511111111054,1.1234184444444382,1.1230285000000033,1.1233628000000018,1.1230258000000006,1.1228010000000062,1.1235858885311774,1.1233692123468764,-1329,-39274,-38653,0.0424862333159612,-57.87782965563437,0.06231417024230624
2023-07-17T14:00:00-04:00,1.12404,1.12426,1.1239999999999999,1.12412,1.1229114352012945,1.1237646666666667,1.1236188888888834,1.1234777777777716,1.1230915000000035,1.1233994000000016,1.1230381000000005,1.122821000000006,1.123692710824942,1.123463769877501,1301,-37973,-38444.6,0.046971149504596424,-57.78523508604601,0.054294131783428665
2023-07-17T14:15:00-04:00,1.12412,1.12415,1.12391,1.12399,1.1231268342731133,1.1238388888888888,1.1236744444444389,1.1235419999999938,1.1231815000000034,1.1234144000000017,1.1230472000000007,1.122838500000006,1.1237521686599536,1.1235602159020004,-1148,-39121,-38703.4,0.04645163916325376,-57.917996712918544,0.04450417894239778
2023-07-17T14:30:00-04:00,1.12399,1.12426,1.12394,1.12425,1.1233120774748775,1.123954,1.1237711111111053,1.1236177777777716,1.1233485000000036,1.1234458000000016,1.1230559000000007,1.1228574000000062,1.1238517349279629,1.1236709727215999,1181,-37940,-38450.6,0.04448047047929543,-57.644809229044206,0.07744485392297587
2023-07-17T14:45:00-04:00,1.12425,1.1244,1.12402,1.1243,1.1234713866283947,1.1240597777777777,1.1238933333333274,1.1237017777777716,1.1234570000000035,1.1234748000000017,1.1230649000000006,1.1228760500000061,1.1239413879423703,1.1237647781772797,1318,-36622,-38186,0.03829382648789012,-57.586192373362515,0.09793447293448192
2023-07-17T15:00:00-04:00,1.1243,1.1246099999999999,1.12425,1.12445,1.1236083925004194,1.124171111111111,1.1240222222222165,1.1237959999999938,1.1235565000000036,1.1234966000000015,1.1230761000000007,1.1228961000000062,1.1240431103538961,1.1238562225418234,1076,-35546,-37440.4,0.03958278498563526,-57.442636382968615,0.10326807859057323
2023-07-17T15:15:00-04:00,1.12445,1.1246099999999999,1.12443,1.12452,1.1237686497003523,1.1242706666666666,1.124138888888883,1.1238999999999937,1.1236800000000036,1.1235204000000016,1.1230864000000007,1.1229155000000062,1.124138488283117,1.1239453780334583,1086,-34460,-36737.8,0.04179583948773399,-57.37502999762466,0.09346043953109522
2023-07-17T15:30:00-04:00,1.12452,1.12452,1.12434,1.12443,1.123903265748296,1.124328888888889,1.1242522222222162,1.1240155555555493,1.1237525000000037,1.1235276000000016,1.1230973000000006,1.1229308500000061,1.1241967906264936,1.1240343024267663,-871,-35331,-35979.8,0.04024912249068214,-57.444739740448206,0.09079499025289262
2023-07-17T15:45:00-04:00,1.12443,1.12443,1.12413,1.12438,1.1240163432285686,1.1243544444444444,1.1242755555555497,1.124116444444438,1.1238120000000036,1.1235296000000015,1.1231071000000008,1.1229449500000062,1.124233432501195,1.1241106419414126,-1362,-36693,-35730.4,0.04294595250854941,-57.505303759551346,0.01868044868659042
2023-07-17T16:00:00-04:00,1.12438,1.1244,1.12367,1.12374,1.1246099999999999,1.1242473333333332,1.1242422222222164,1.1241862222222159,1.1238460000000035,1.1235366000000016,1.1231132000000008,1.1229556000000063,1.1241347460009559,1.12414931355313,-1499,-38192,-36044.4,0.03678816676998783,-58.35853843110363,-0.0266894416568776
2023-07-17T16:15:00-04:00,1.12374,1.1239,1.1236599999999999,1.12387,1.1245911999999998,1.1241728888888889,1.1242144444444384,1.1242246666666602,1.1238675000000036,1.1235246000000014,1.1231220000000008,1.1229669500000061,1.1240817968007646,1.1241570508425034,691,-37501,-36435.4,0.031842154436705405,-58.27860001118446,-0.022239618546070126
2023-07-17T16:30:00-04:00,1.12387,1.12408,1.12384,1.12407,1.1245539519999999,1.124144,1.1242233333333274,1.124241555555549,1.1239040000000036,1.1235190000000015,1.1231349000000008,1.1229768500000061,1.1240794374406116,1.1241452406740025,539,-36962,-36935.8,0.028727085065569678,-58.18268144409041,0.007117501045370329
2023-07-17T16:45:00-04:00,1.12407,1.12409,1.12314,1.12314,1.12451819392,1.1239273333333333,1.124099999999994,1.1242111111111046,1.1238855000000034,1.1235040000000014,1.1231404000000007,1.1229814000000062,1.1238915499524893,1.1240841925392018,-742,-37704,-37410.4,0.022011573978302758,-58.79657559658973,-0.09873248832554542
2023-07-17T17:00:00-04:00,1.12314,1.12387,1.1231,1.12387,1.1244355022848,1.1238813333333333,1.1240522222222162,1.124166444444438,1.1239045000000034,1.1234890000000015,1.1231540000000007,1.122990500000006,1.1238872399619915,1.1240149540313609,63,-37641,-37600,0.017104787052753784,-58.75562789639208,-0.038246019745633054
2023-07-17T17:15:00-04:00,1.12387,1.12396,1.12353,1.1236,1.124328662102016,1.1237908888888888,1.123957777777772,1.124109555555549,1.1239155000000034,1.1234852000000017,1.1231637000000005,1.122996700000006,1.1238297919695932,1.1239539632250886,-115,-37756,-37512.8,0.010410271468216763,-58.783255646932616,-0.07559251189470563
2023-07-17T17:30:00-04:00,1.1236,1.12386,1.1236,1.12375,1.1242303691338549,1.1237493333333333,1.1238722222222164,1.1240411111111046,1.1239430000000035,1.1234752000000017,1.1231758000000007,1.1230028500000062,1.1238138335756747,1.1239003705800703,228,-37528,-37518.2,0.002614178593248114,-58.75281776868411,-0.06847365987265121
2023-07-17T17:45:00-04:00,1.12375,1.12389,1.12357,1.1236599999999999,1.1241399396031464,1.123706888888889,1.123786666666661,1.1239537777777713,1.1239615000000034,1.1234748000000017,1.1231873000000008,1.123008100000006,1.1237830668605397,1.1238410964640562,-483,-38011,-37728,-0.006986542114636105,-58.79150074977427,-0.0684791405423334
2023-07-17T18:00:00-04:00,1.1236599999999999,1.1239999999999999,1.1236599999999999,1.12389,1.1240567444348948,1.1237275555555555,1.1237322222222164,1.1238802222222157,1.1239825000000034,1.1234716000000016,1.1231964000000005,1.123014050000006,1.1238044534884317,1.1238236771712447,422,-37589,-37705,-0.01433285091086254,-58.70512230789677,-0.0435795727423006
2023-07-17T18:15:00-04:00,1.12389,1.12393,1.12379,1.12385,1.1239999999999999,1.123751111111111,1.1237444444444387,1.12381866666666,1.1240045000000034,1.1234622000000016,1.1232090000000006,1.123020400000006,1.1238135627907453,1.1238089417369952,-426,-38015,-37779.8,-0.02065795326927855,-58.720283934034576,0.00978874116789066
2023-07-17T18:30:00-04:00,1.12385,1.1239999999999999,1.12381,1.12391,1.1231,1.1237842222222223,1.1237488888888831,1.1237768888888824,1.1239915000000036,1.1234606000000016,1.1232209000000006,1.123027200000006,1.1238328502325963,1.123809553389596,350,-37665,-37761.6,-0.021263345195363076,-58.701598166360974,0.0035591305044213304
2023-07-17T18:45:00-04:00,1.12391,1.12397,1.12388,1.12393,1.123118,1.1238204444444442,1.1237333333333277,1.1237491111111044,1.1239860000000035,1.1234616000000015,1.1232309000000007,1.123033750000006,1.123852280186077,1.1238172427116764,174,-37491,-37754.2,-0.019712960985516576,-58.69850183302466,-0.01245474036312747
2023-07-17T19:00:00-04:00,1.12393,1.12402,1.12388,1.12398,1.12313564,1.1238697777777777,1.123826666666661,1.1237571111111044,1.1239790000000036,1.1234742000000015,1.1232446000000005,1.123043150000006,1.1238778241488616,1.1238361941693409,558,-36933,-37538.6,-0.020259535580914634,-58.67367822301342,0.07479031999572198
2023-07-17T19:15:00-04:00,1.12398,1.1239999999999999,1.12386,1.12387,1.1231710144,1.1238784444444443,1.1238266666666612,1.1237759999999937,1.1239730000000037,1.1234892000000016,1.1232561000000005,1.1230507500000062,1.1238762593190892,1.1238505553354723,-506,-37439,-37508.6,-0.012705769707028393,-58.72319867711405,0
2023-07-17T19:30:00-04:00,1.12387,1.12396,1.12382,1.1239,1.123204973824,1.123893111111111,1.1238599999999943,1.1237991111111048,1.1239555000000037,1.1234958000000015,1.1232703000000006,1.123058150000006,1.1238810074552714,1.1238640442683774,417,-37022,-37310,-0.012057605357500768,-58.71206749646149,0.02669989320042426
2023-07-17T19:45:00-04:00,1.1239,1.12395,1.12368,1.12371,1.12323757487104,1.1238631111111113,1.12385555555555,1.1238204444444382,1.1239260000000038,1.1234978000000018,1.1232820000000006,1.1230646000000062,1.123846805964217,1.1238668354147017,-890,-37912,-37359.4,-0.008791322392452849,-58.86252572228223,-0.0035595105673005565
2023-07-17T20:00:00-04:00,1.12371,1.12374,1.12344,1.1236599999999999,1.1232688718761983,1.123824,1.1238555555555498,1.1238448888888826,1.1238865000000038,1.1235008000000015,1.1232924000000006,1.1230686500000062,1.1238094447713736,1.1238582683317608,-1788,-39700,-37801.2,-0.006880720339858085,-58.9420836153331,0
2023-07-17T20:15:00-04:00,1.1236599999999999,1.12411,1.12351,1.1239999999999999,1.1232989170011503,1.1238528888888888,1.1238677777777724,1.123853111111105,1.1238605000000037,1.1235132000000017,1.1233042000000004,1.123075700000006,1.1238475558170988,1.1238522146654082,1205,-38495,-38113.6,-0.0019490096696601878,-58.57747154406598,0.00978743471334672
2023-07-17T20:30:00-04:00,1.1239999999999999,1.12459,1.12396,1.12445,1.1233475819810812,1.1239693333333332,1.123934444444439,1.1238746666666604,1.1238615000000036,1.1235390000000016,1.1233200000000005,1.1230848500000061,1.123968044653679,1.123870571732326,1530,-36965,-38018.8,0.0033302742268744787,-57.96492706008013,0.053387907638913906
2023-07-17T20:45:00-04:00,1.12445,1.12466,1.12414,1.12418,1.1234469754225946,1.1240184444444443,1.1239644444444388,1.1238955555555494,1.1238515000000038,1.1235652000000016,1.1233346000000004,1.123093500000006,1.1240104357229432,1.1238964573858605,-2120,-39085,-38431.4,0.007325833499342295,-58.47397592841575,0.024023275885079097
2023-07-17T21:00:00-04:00,1.12418,1.1242699999999999,1.12387,1.1242,1.123568277880335,1.1240655555555557,1.123994444444439,1.1239233333333272,1.1238745000000039,1.1235956000000016,1.1233505000000004,1.123102450000006,1.1240483485783546,1.1239367659086883,2155,-36930,-38235,0.010668935475383392,-58.435636872392436,0.024022848398031232
2023-07-17T21:15:00-04:00,1.1242,1.1256,1.1242,1.12547,1.1236774500923015,1.1243606666666666,1.1241599999999945,1.1239842222222163,1.123954500000004,1.1236342000000017,1.1233818000000004,1.123116800000006,1.1243326788626837,1.1240414127269502,2673,-34257,-37146.4,0.017040235631897643,-55.41596955341033,0.1325646363814295
2023-07-17T21:30:00-04:00,1.12547,1.12547,1.12409,1.12431,1.12387,1.1243906666666665,1.1242088888888833,1.1240524444444384,1.1239665000000039,1.1236632000000017,1.1233980000000003,1.123125750000006,1.124328143090147,1.12413753018156,-3429,-37686,-36984.6,0.018111797453332745,-58.95017304173091,0.03915043554859512
2023-07-17T21:45:00-04:00,1.12431,1.12459,1.12422,1.12453,1.1240776,1.1244548888888888,1.1242788888888835,1.1241213333333273,1.124036000000004,1.1237100000000018,1.1234189000000003,1.1231367500000062,1.1243685144721176,1.1242176241452477,2636,-35050,-36601.6,0.02203453164057692,-58.43437223946082,0.05605480914673285
2023-07-17T22:00:00-04:00,1.12453,1.1248799999999999,1.12435,1.12477,1.12409,1.1245531111111111,1.1243966666666612,1.124207777777772,1.124081000000004,1.1237872000000018,1.1234428000000003,1.123150000000006,1.124448811577694,1.1243052993161977,2190,-32860,-35356.6,0.022867561741381767,-57.966976972104646,0.09433038773349538
2023-07-17T22:15:00-04:00,1.12477,1.12487,1.12442,1.12442,1.12422,1.1245577777777778,1.1244811111111055,1.1243051111111053,1.1241220000000038,1.1238330000000016,1.1234632000000004,1.123165000000006,1.1244430492621553,1.124384239452958,-1694,-34554,-34881.4,0.02685329686849358,-58.49410696312514,0.06763611768685314
2023-07-17T22:30:00-04:00,1.12442,1.12464,1.12436,1.12462,1.1256,1.1245855555555555,1.1245499999999944,1.1243831111111053,1.124165500000004,1.1238762000000015,1.1234895000000005,1.123179400000006,1.1244784394097243,1.124413391562366,1729,-32825,-34595,0.031071213442495596,-58.18657063328401,0.05516014234876023
2023-07-17T22:45:00-04:00,1.12462,1.12483,1.12452,1.12476,1.1255751999999999,1.1246275555555554,1.1245844444444388,1.1244582222222164,1.1242205000000038,1.1239304000000017,1.1235193000000003,1.1231919000000061,1.1245347515277795,1.1244547132498925,1463,-31362,-33330.2,0.03355208621499898,-58.00444689370972,0.02756903374983614
2023-07-17T23:00:00-04:00,1.12476,1.12484,1.12443,1.12463,1.1255508959999998,1.1246366666666667,1.124634444444439,1.1245293333333275,1.1242575000000037,1.1239634000000016,1.1235439000000005,1.1232026500000059,1.1245538012222236,1.1244917705999138,-1771,-33133,-32946.8,0.031043193624565674,-58.20913945034397,0.040029176822222554
2023-07-17T23:15:00-04:00,1.12463,1.12529,1.12463,1.12528,1.1255270780799997,1.1247657777777778,1.1247544444444388,1.124600888888883,1.124329000000004,1.1240052000000018,1.1235724000000002,1.123214300000006,1.1246990409777788,1.1245418164799308,1472,-31661,-32707,0.03493794903395318,-57.358370753083484,0.09606831524639475
2023-07-17T23:30:00-04:00,1.12528,1.12543,1.12513,1.12538,1.1255037365183997,1.1248908888888889,1.124744444444439,1.1246535555555497,1.124402500000004,1.1240516000000016,1.1236026000000003,1.123225100000006,1.124835232782223,1.1246202531839444,1272,-30389,-31874,0.03895059961179479,-57.245332220451616,-0.007996659173494049
2023-07-17T23:45:00-04:00,1.12538,1.1254899999999999,1.12532,1.12539,1.12436,1.1250200000000001,1.124864444444439,1.1247164444444386,1.124475500000004,1.1240906000000017,1.1236301000000004,1.1232355500000057,1.1249461862257784,1.1247138025471553,956,-29433,-31195.6,0.031969082014742176,-57.23683731206525,0.09605891613522693
2023-07-18T00:00:00-04:00,1.12539,1.12563,1.12536,1.12546,1.1243826000000001,1.1251391111111113,1.1249677777777722,1.1247931111111054,1.1245495000000039,1.1241330000000016,1.1236594000000004,1.123245700000006,1.1250489489806226,1.124816642037724,1153,-28280,-30579.2,0.03571463355704905,-57.165119951861215,0.08270121739747942
2023-07-18T00:15:00-04:00,1.12546,1.12558,1.12533,1.12546,1.124432496,1.1252375555555556,1.125044444444439,1.1248751111111053,1.1246290000000039,1.1241720000000015,1.1236883000000004,1.123254950000006,1.1251311591844981,1.1249321136301786,0,-28280,-29608.6,0.03771523662574422,-57.165119951861215,0.06134587515668602
2023-07-18T00:30:00-04:00,1.12546,1.12557,1.1252199999999999,1.12529,1.12448039616,1.1252866666666665,1.1251411111111056,1.1249524444444385,1.124698500000004,1.1242080000000017,1.1237152000000004,1.1232645500000058,1.1251629273475985,1.1250248909041427,-1316,-29596,-29195.6,0.03632419011579235,-57.36390089476456,0.07737322352856818
2023-07-18T00:45:00-04:00,1.12529,1.1253,1.12504,1.12516,1.1245263803136,1.1252904444444445,1.1252011111111058,1.125043777777772,1.124771000000004,1.1242436000000016,1.1237403000000006,1.1232727500000057,1.1251623418780787,1.1250903127233136,-1555,-31151,-29348,0.037567006067134895,-57.54354347578807,0.04801621881168617
2023-07-18T01:00:00-04:00,1.12516,1.12579,1.12508,1.12576,1.124570525101056,1.1254022222222224,1.125312222222217,1.1251333333333275,1.124876000000004,1.1242948000000017,1.1237742000000006,1.1232836500000056,1.125281873502463,1.1251574501786508,1386,-29765,-29414.4,0.03902006589042519,-56.80444859150475,0.08890785589815711
2023-07-18T01:15:00-04:00,1.12576,1.12604,1.12575,1.12581,1.1246436935949926,1.1255017777777776,1.125443333333328,1.125228444444439,1.1249665000000042,1.1243452000000016,1.1238081000000006,1.1232933000000056,1.1253874988019703,1.1252251601429202,1602,-28163,-29391,0.03924933529735067,-56.733296658588486,0.10492339702835234
2023-07-18T01:30:00-04:00,1.12581,1.12602,1.12574,1.12594,1.1247553981073932,1.1256011111111113,1.1255166666666614,1.1253228888888835,1.125041000000004,1.1243946000000016,1.1238425000000005,1.1233024000000058,1.1254979990415763,1.1252985281143357,1576,-26587,-29052.4,0.042678877321197795,-56.5513121318922,0.058652068818417
2023-07-18T01:45:00-04:00,1.12594,1.1264,1.12492,1.12499,1.1248581662588018,1.1254957777777777,1.125473333333328,1.125389333333328,1.125081500000004,1.1244262000000018,1.1238656000000007,1.1233067000000057,1.125396399233261,1.1253452224914682,-2202,-28789,-28891,0.03781457651655123,-58.409226407963764,-0.034654960990964156
2023-07-18T02:00:00-04:00,1.12499,1.12514,1.1247,1.12472,1.1264,1.125345111111111,1.1253988888888837,1.1254288888888837,1.125107500000004,1.1244372000000018,1.1238855000000005,1.1233135000000056,1.1252611193866087,1.1253649779931743,-2789,-31578,-28976.4,0.029661797104070634,-59.0785923578833,-0.05953491678439905
2023-07-18T02:15:00-04:00,1.12472,1.12511,1.12403,1.12477,1.1264,1.1252193333333331,1.125322222222217,1.1254308888888835,1.125072500000004,1.1244518000000017,1.1239073000000004,1.1233206500000057,1.125162895509287,1.125341182394539,5102,-26476,-28318.6,0.021737915903126827,-58.851780351338974,-0.061308265064938555
2023-07-18T02:30:00-04:00,1.12477,1.1253,1.12473,1.12517,1.1263052,1.1251888888888888,1.1252899999999948,1.125400222222217,1.125115500000004,1.1244728000000017,1.1239361000000005,1.1233279000000056,1.1251643164074296,1.125296545915631,2042,-24434,-27572.8,0.020430345094233363,-58.12558744078845,-0.02576724183888379
2023-07-18T02:45:00-04:00,1.12517,1.12571,1.12511,1.12562,1.126214192,1.125254888888889,1.1253266666666615,1.125362222222217,1.125170000000004,1.1245054000000017,1.1239599000000007,1.1233395500000056,1.1252554531259438,1.1252480367325044,2181,-22253,-26706,0.01630697229974402,-57.253319250203795,0.029325773800545952
2023-07-18T03:00:00-04:00,1.12562,1.1272,1.12532,1.12718,1.12403,1.1256255555555559,1.1255511111111058,1.1253777777777727,1.1252905000000042,1.1245640000000017,1.1240049000000005,1.1233591000000056,1.125640362500755,1.1252968293860033,4349,-17904,-24529,0.02188689401658114,-51.22602762425541,0.1795300223968265
2023-07-18T03:15:00-04:00,1.12718,1.1272199999999999,1.12643,1.12679,1.1240934,1.1258733333333333,1.1256655555555504,1.125431111111106,1.125409000000004,1.1246138000000017,1.1240443000000007,1.1233764500000056,1.125870290000604,1.1254186635088022,-3084,-20988,-22411,0.027821737769444254,-52.293079914040845,0.09149374644683274
2023-07-18T03:30:00-04:00,1.12679,1.12757,1.12595,1.12633,1.124218464,1.1260062222222222,1.125723333333328,1.1255113333333282,1.125494500000004,1.1246514000000019,1.1240740000000005,1.1233942500000056,1.1259622320004832,1.1255785308070414,-4174,-25162,-22148.2,0.02480271433636355,-53.99707089727605,0.04618896616658903
2023-07-18T03:45:00-04:00,1.12633,1.12658,1.1243,1.12539,1.12757,1.1259395555555556,1.1256622222222168,1.1255857777777727,1.1255260000000038,1.1246688000000018,1.1240946000000005,1.1234116000000056,1.1258477856003866,1.1257152246456328,-8333,-33495,-23960.4,0.017812355089939762,-60.95153362134569,-0.04884807360961068
2023-07-18T04:00:00-04:00,1.12539,1.12541,1.1246,1.12476,1.12757,1.1257591111111112,1.1256366666666613,1.1256477777777725,1.1255325000000038,1.1246754000000019,1.1241015000000005,1.1234237500000055,1.1256302284803092,1.125790179716506,-4486,-37981,-27106,0.007328028270047443,-63.46282304101317,-0.02044462617445066
2023-07-18T04:15:00-04:00,1.12476,1.12561,1.12453,1.12478,1.1275046,1.1255877777777776,1.125643333333328,1.125666222222217,1.1255075000000039,1.1246834000000019,1.1241065000000006,1.1234397000000056,1.1254601827842474,1.1257541437732044,3318,-34663,-30457.8,0.004827498378911941,-63.40382378783943,0.005334661071195407
2023-07-18T04:30:00-04:00,1.12478,1.1248,1.12348,1.12395,1.127440508,1.1252491111111111,1.125552222222217,1.1256435555555502,1.1254360000000039,1.1246876000000017,1.1241121000000005,1.1234510000000055,1.1251581462273978,1.1256117150185632,-4109,-38772,-34014.6,0.003613422978261835,-66.43594562499828,-0.07290379366448634
2023-07-18T04:45:00-04:00,1.12395,1.12411,1.12279,1.1237,1.12728208768,1.1248786666666666,1.1253888888888837,1.1255766666666613,1.1253515000000038,1.1246842000000017,1.1241044000000004,1.1234644500000055,1.1248665169819183,1.12539257201485,-3319,-42091,-37400.4,0.0012144333932174404,-67.17419020883233,-0.13064692446475487
2023-07-18T05:00:00-04:00,1.1237,1.1244399999999999,1.1237,1.12413,1.1270125624192,1.1246268888888888,1.1252233333333281,1.1254888888888837,1.1252850000000039,1.1246854000000017,1.1241022000000005,1.1234792500000055,1.1247192135855346,1.1251668576118796,2832,-39259,-38553.2,-0.002695593444832405,-66.09048459345418,-0.13237149304383283
2023-07-18T05:15:00-04:00,1.12413,1.1244399999999999,1.1237,1.12442,1.126759208674048,1.1244662222222221,1.1249166666666612,1.1253448888888835,1.1252330000000037,1.1247110000000018,1.1241075000000005,1.1234975000000056,1.1246593708684276,1.1249726860895035,2702,-36557,-38268.4,-0.00895890499033531,-65.39342998233293,-0.2448588512926148
2023-07-18T05:30:00-04:00,1.12442,1.12468,1.12369,1.12398,1.1265210561536052,1.1242788888888888,1.1246044444444392,1.1251371111111057,1.1251675000000039,1.1247132000000017,1.1241011000000005,1.1235124500000055,1.1245234966947422,1.1247853488716024,-2388,-38945,-39124.8,-0.031135943498652084,-66.32788507918285,-0.24938098492176708
2023-07-18T05:45:00-04:00,1.12398,1.12494,1.12392,1.1248799999999999,1.126297192784389,1.124334,1.124443333333328,1.124915333333328,1.1251535000000037,1.1247388000000018,1.1241120000000004,1.1235261000000054,1.1245947973557937,1.1246726790972814,2353,-36592,-38688.8,-0.04637672817598969,-64.44377682102899,-0.1287366935090225
2023-07-18T06:00:00-04:00,1.1248799999999999,1.12513,1.12475,1.12483,1.1260867612173258,1.1244113333333332,1.1243811111111057,1.1247137777777723,1.1251070000000039,1.1247604000000018,1.1241178000000005,1.1235376500000054,1.124641837884635,1.1246277432778249,-2371,-38963,-38063.2,-0.058312418792617185,-64.54916584030191,-0.049760527461581675
2023-07-18T06:15:00-04:00,1.12483,1.12511,1.12469,1.12504,1.1258889555442861,1.1245431111111113,1.1244122222222168,1.12455155555555,1.1250685000000036,1.124788000000002,1.1241314000000004,1.1235477000000054,1.124721470307708,1.1246281946222596,1507,-37456,-37702.6,-0.05837768197430909,-64.26781665864773,0.02489419965148636
2023-07-18T06:30:00-04:00,1.12504,1.12601,1.12493,1.12568,1.12279,1.1247966666666664,1.1245122222222168,1.1244706666666613,1.1250555000000035,1.124823800000002,1.1241477000000004,1.1235609500000054,1.1249131762461664,1.1246789556978072,2622,-34834,-37358,-0.04965071813832497,-62.77624302571029,0.0800156475044118
2023-07-18T06:45:00-04:00,1.12568,1.12586,1.12509,1.12573,1.1228544,1.125040222222222,1.1247099999999945,1.1244917777777723,1.1250925000000036,1.124861400000002,1.1241618000000004,1.1235740000000054,1.125076540996933,1.1247895645582455,2500,-32334,-36035.8,-0.04031855296730607,-62.665199034523006,0.15837003425418325
2023-07-18T07:00:00-04:00,1.12573,1.1258,1.12467,1.12489,1.1229175120000001,1.1250762222222221,1.124842222222217,1.12457155555555,1.125101000000004,1.1248810000000018,1.1241708000000004,1.1235770500000053,1.1250392327975465,1.124878451646596,-2111,-34445,-35606.4,-0.03154053415706608,-64.24039024378268,0.10590015128593258
2023-07-18T07:15:00-04:00,1.12489,1.12559,1.1248,1.12513,1.1229793617600001,1.1251337777777777,1.124953333333328,1.1246859999999945,1.1251190000000038,1.1249050000000018,1.1241833000000003,1.1235850500000053,1.125057386238037,1.1249615613172765,3343,-31102,-34034.2,-0.0205653242134767,-63.527147171126636,0.08895768283026784
2023-07-18T07:30:00-04:00,1.12513,1.12519,1.12417,1.12428,1.1230399745248,1.124999111111111,1.1249377777777725,1.1247911111111057,1.1250745000000035,1.1249110000000018,1.1241926000000002,1.1235900500000053,1.1249019089904297,1.1249976490538207,-2747,-33849,-33312.8,-0.017158582719283434,-65.60241847310957,-0.01245086355632495
2023-07-18T07:45:00-04:00,1.12428,1.12555,1.12422,1.12533,1.1230993750343041,1.1250775555555554,1.1250877777777726,1.1249062222222168,1.1250600000000035,1.124940200000002,1.1242147000000002,1.1236033500000053,1.1249875271923437,1.1250125192430562,2486,-31363,-32618.6,-0.009747397237152119,-63.28066588478638,0.12010889873484959
2023-07-18T08:00:00-04:00,1.12533,1.12577,1.12464,1.1248,1.123157587533618,1.1250200000000001,1.1250788888888836,1.1249799999999948,1.1249410000000035,1.124958200000002,1.1242270000000003,1.1236169000000054,1.124950021753875,1.1249872153944447,-3676,-35039,-33159.6,0.0010115973931178433,-65.01196248222864,-0.007111869710534276
2023-07-18T08:15:00-04:00,1.1248,1.12521,1.12451,1.12481,1.1232146357829456,1.1249662222222223,1.1250766666666614,1.1250268888888837,1.1248420000000035,1.124980200000002,1.1242390000000002,1.1236322000000054,1.1249220174031,1.1249637723155552,3517,-31522,-32575,0.0104217683738429,-64.98069470128961,-0.0017780464603459171
2023-07-18T08:30:00-04:00,1.12481,1.127,1.1223,1.12259,1.127,1.124468888888889,1.1248044444444392,1.124997111111106,1.1246550000000037,1.124958800000002,1.1242298000000004,1.1236374500000053,1.12445561392248,1.1248434178524438,-17171,-48693,-36093.2,0.008289785147603044,-98.870524983739,-0.2177700348432112
2023-07-18T08:45:00-04:00,1.12259,1.12425,1.12255,1.12395,1.127,1.124298,1.124612222222217,1.124931999999995,1.1245830000000034,1.124957800000002,1.1242355000000004,1.1236471000000054,1.124354491137984,1.1247339342819547,7072,-41621,-37647.6,0.008675935394521718,-90.30290902421665,-0.15368488380356846
2023-07-18T09:00:00-04:00,1.12395,1.12434,1.12311,1.12345,1.127,1.1240655555555554,1.1243588888888838,1.1247862222222171,1.1245175000000036,1.124937800000002,1.1242384000000003,1.1236505000000054,1.124173592910387,1.1245711474255633,-6105,-47726,-40920.2,-0.0029387963888790757,-93.01877716781703,-0.20253524379734375
2023-07-18T09:15:00-04:00,1.12345,1.12458,1.12301,1.12316,1.126906,1.1238257777777778,1.1241666666666614,1.1246037777777727,1.1244365000000036,1.124917400000002,1.1242413000000004,1.1236500500000053,1.1239708743283097,1.12437531794045,-7153,-54879,-44888.2,-0.019018773574544054,-94.86520558029724,-0.15379281529749658
2023-07-18T09:30:00-04:00,1.12316,1.12395,1.12216,1.12281,1.12681388,1.1235544444444445,1.1239088888888835,1.124370222222217,1.1243795000000036,1.124889600000002,1.1242426000000005,1.1236499000000053,1.1237386994626477,1.1241386543523597,-10524,-65403,-51664.4,-0.02917641119517445,-98.14470271338463,-0.20619839485213956
2023-07-18T09:45:00-04:00,1.12281,1.12324,1.12164,1.12263,1.1266277248,1.123298666666667,1.12372555555555,1.1241544444444393,1.1243260000000035,1.1248328000000019,1.1242335000000003,1.1236509500000054,1.1235169595701182,1.1239509234818876,-10502,-75905,-57106.8,-0.04582337648658162,-99.82830011632967,-0.14676059344646614
2023-07-18T10:00:00-04:00,1.12263,1.12398,1.12248,1.12333,1.1263284613120002,1.1232195555555555,1.1235033333333277,1.1239326666666614,1.1242860000000037,1.1248132000000017,1.1242382000000004,1.1236586500000054,1.1234795676560945,1.1237759387855095,9714,-66191,-62020.8,-0.052706815163621024,-93.7712733131984,-0.17772564492193418
2023-07-18T10:15:00-04:00,1.12333,1.12394,1.12303,1.12347,1.1260471536332801,1.1232128888888888,1.12335555555555,1.1237319999999946,1.1242385000000037,1.1247920000000018,1.1242510000000003,1.1236667000000053,1.1234776541248757,1.1236367510284073,6693,-59498,-64375.2,-0.06645717197375649,-92.93712840475636,-0.11824324324324799
2023-07-18T10:30:00-04:00,1.12347,1.12401,1.12335,1.12369,1.1257827244152834,1.1232797777777779,1.1232311111111057,1.1235448888888837,1.1242240000000037,1.1247704000000018,1.1242788000000004,1.1236784500000054,1.1235201232999006,1.1235466008227255,5551,-53947,-64188.8,-0.07324069422532241,-91.85012118604949,-0.09957237222286518
2023-07-18T10:45:00-04:00,1.12369,1.12399,1.12309,1.12368,1.1255341609503664,1.1233695555555556,1.1233522222222168,1.1234335555555501,1.1241640000000035,1.1247556000000016,1.1242943000000003,1.1236840000000055,1.1235520986399206,1.1235092806581801,-5544,-59491,-63006.4,-0.08202248713964808,-91.8994586367702,0.0970968920086617
2023-07-18T11:00:00-04:00,1.12368,1.12455,1.12332,1.12412,1.1253005112933445,1.123523111111111,1.1233711111111058,1.1233626666666612,1.1241285000000034,1.1247456000000016,1.1243109000000002,1.1236926000000054,1.1236656789119364,1.123539024526544,3657,-55834,-58992.2,-0.06519565898790107,-90.4674851211786,0.015125227990569284
2023-07-18T11:15:00-04:00,1.12412,1.12414,1.12281,1.12289,1.1250808806157437,1.1234268888888888,1.1233088888888834,1.1233237777777725,1.1240210000000035,1.1247082000000017,1.1243193000000002,1.1236930000000054,1.1235105431295491,1.1235452196212348,-4096,-59930,-57740,-0.06641260115205735,-94.94928421736074,-0.04984645511594783
2023-07-18T11:30:00-04:00,1.12289,1.12298,1.12216,1.12251,1.1248744277787992,1.123267111111111,1.123236666666661,1.1232999999999946,1.1238625000000035,1.1246658000000018,1.1243146000000004,1.1236889500000053,1.1233104345036393,1.1235117756969877,-3947,-63877,-58615.8,-0.06406408017948334,-96.28499831224109,-0.05787243135439648
2023-07-18T11:45:00-04:00,1.12251,1.12268,1.12211,1.12225,1.1246803621120713,1.1230697777777778,1.123174444444439,1.1232886666666613,1.1236885000000036,1.1246052000000017,1.1243052000000002,1.1236803500000054,1.1230983476029115,1.1234274205575896,-3443,-67320,-61290.4,-0.05763681433892312,-97.08247895829301,-0.04987486751989347
2023-07-18T12:00:00-04:00,1.12225,1.12251,1.1219999999999999,1.12241,1.124497940385347,1.1229168888888887,1.1231499999999945,1.1232482222222167,1.1235645000000036,1.1245458000000017,1.1242987000000002,1.1236770000000054,1.1229606780823291,1.1233091364460714,2875,-64445,-62281.2,-0.0471347480817202,-96.67258811400714,-0.019596839564247258
2023-07-18T12:15:00-04:00,1.12241,1.12284,1.12237,1.12268,1.1243264639622261,1.1228228888888887,1.1230777777777723,1.12318955555555,1.1234420000000038,1.1244916000000018,1.1242911000000002,1.1236733000000054,1.1229045424658632,1.1231569091568567,2359,-62086,-63531.6,-0.03732733405997691,-96.10512168017281,-0.057863673185977356
2023-07-18T12:30:00-04:00,1.12268,1.12268,1.12165,1.12172,1.1241652761244925,1.1225513333333332,1.122883333333328,1.123104444444439,1.1233140000000037,1.1244168000000017,1.1242749000000003,1.1236636500000055,1.1226676339726906,1.1229883273254853,-2143,-64229,-64391.4,-0.03720979917353386,-97.93759397860129,-0.15576739921848543
2023-07-18T12:45:00-04:00,1.12172,1.12173,1.12087,1.12144,1.124013759557023,1.1222626666666666,1.1226333333333278,1.1229837777777723,1.1231195000000036,1.1243364000000016,1.1242542000000002,1.1236500500000053,1.1224221071781526,1.122810661860388,-2900,-67129,-65041.8,-0.04324707941212238,-98.66148229297579,-0.20023316039121866
2023-07-18T13:00:00-04:00,1.12144,1.12167,1.12091,1.12161,1.1237622587924612,1.122058,1.1224033333333279,1.1228295555555499,1.1229600000000037,1.1242628000000017,1.1242354000000003,1.1236377500000052,1.122259685742522,1.12264292948831,2156,-64973,-64572.4,-0.04600152645822757,-98.33465250270613,-0.1842161469457511
2023-07-18T13:15:00-04:00,1.12161,1.12196,1.12155,1.12189,1.1235308780890643,1.1219553333333332,1.12215555555555,1.1226306666666612,1.1228140000000038,1.1241974000000017,1.1242205000000003,1.1236282500000052,1.1221857485940177,1.1224879435906479,1817,-63156,-64314.6,-0.04960754570676967,-97.88105454976339,-0.19837739743087518
2023-07-18T13:30:00-04:00,1.12189,1.12197,1.12167,1.1218299999999999,1.1233180078419391,1.121890222222222,1.1220377777777724,1.1224226666666612,1.1227760000000035,1.1241188000000017,1.1242068000000003,1.1236186000000052,1.1221145988752141,1.122329954872518,-1529,-64685,-64834.4,-0.05737101065313128,-97.96282727257959,-0.09439927330371282
2023-07-18T13:45:00-04:00,1.1218299999999999,1.1221,1.12176,1.12188,1.123122167214584,1.1218586666666666,1.1219677777777723,1.12223955555555,1.1226725000000037,1.1240402000000018,1.1241927,1.1236102500000051,1.1220676791001714,1.122209963898014,1353,-63332,-64655,-0.0633572828213051,-97.90252401807565,-0.05612422161048975
2023-07-18T14:00:00-04:00,1.12188,1.12232,1.12136,1.12228,1.1229419938374172,1.1219211111111111,1.1219711111111055,1.1221071111111056,1.1226140000000036,1.1239670000000017,1.1241808000000002,1.1236031000000053,1.122110143280137,1.1221475711184108,1831,-61501,-63529.4,-0.0583269319758512,-97.24969127304061,0.0026732011583848955
2023-07-18T14:15:00-04:00,1.12228,1.12265,1.12226,1.12245,1.122776234330424,1.1220168888888888,1.12197555555555,1.1220215555555502,1.1225785000000035,1.1239162000000016,1.1241712000000001,1.1235966000000053,1.1221781146241097,1.1221312568947284,1485,-60016,-62538,-0.052306007321872613,-97.02474740876431,0.0035637601233096646
2023-07-18T14:30:00-04:00,1.12245,1.12274,1.12234,1.12269,1.12087,1.1221597777777779,1.121976666666661,1.1219857777777724,1.1225725000000035,1.1238756000000016,1.1241564000000002,1.123590600000005,1.1222804916992877,1.1221502055157822,1586,-58430,-61592.8,-0.047819104395680004,-96.68563208068731,0.0008907257633578145
2023-07-18T14:45:00-04:00,1.12269,1.12311,1.1226099999999999,1.12289,1.1209074,1.1223424444444443,1.122106666666661,1.1219995555555502,1.1225855000000036,1.1238380000000017,1.1241449000000001,1.1235853500000053,1.12240239335943,1.1222077644126256,1515,-56915,-60038.8,-0.04628761611102524,-96.4157445783492,0.10430410441107346
2023-07-18T15:00:00-04:00,1.12289,1.1229,1.12241,1.12256,1.1209955040000001,1.122433111111111,1.1222311111111056,1.1220522222222167,1.1225470000000037,1.1237858000000016,1.1241293,1.123583700000005,1.122433914687544,1.1222810115301,-1696,-58611,-59094.6,-0.038508085297690994,-96.91417274139269,0.09987159366528837
2023-07-18T15:15:00-04:00,1.12256,1.12274,1.12252,1.1226,1.1210800838400001,1.122506888888889,1.1223411111111057,1.1221262222222168,1.1225035000000037,1.1237254000000017,1.1241154000000002,1.1235813000000052,1.1224671317500352,1.1223524092240798,1571,-57040,-58202.4,-0.02507896565350143,-96.85819355097074,0.08826597480408042
2023-07-18T15:30:00-04:00,1.1226,1.12282,1.12247,1.12274,1.1211612804864002,1.1225866666666668,1.1224355555555499,1.1222182222222168,1.1224560000000037,1.1236366000000015,1.1241003000000003,1.1235781000000051,1.1225217054000283,1.1224211273792633,1223,-55817,-57362.6,-0.0119162713308526,-96.70567261742359,0.07576500369911643
2023-07-18T15:45:00-04:00,1.12274,1.12308,1.12274,1.12301,1.1212392292669442,1.1227015555555555,1.122566666666661,1.1223362222222169,1.1224225000000037,1.1235610000000016,1.1240874,1.123576150000005,1.1226193643200226,1.1224889019034103,1641,-54176,-56511.8,0.0009460324548203937,-96.31103984402993,0.10518527762675102
2023-07-18T16:00:00-04:00,1.12301,1.12312,1.12287,1.123,1.1213140600962663,1.1227882222222223,1.1226911111111053,1.1224531111111056,1.1223665000000036,1.1234944000000016,1.1240729000000003,1.123574500000005,1.122695491456018,1.1225475215227279,-985,-55161,-56161,0.014254532496249861,-96.31981091463489,0.09983242414518576
2023-07-18T16:15:00-04:00,1.123,1.12316,1.12297,1.12307,1.1214224164904902,1.122864,1.1227788888888832,1.1225626666666613,1.1223755000000035,1.1234480000000016,1.1240584000000002,1.123572400000005,1.1227703931648145,1.122614817218182,977,-54184,-55275.6,0.029312188168608706,-96.25891153796523,0.07039241544000326
2023-07-18T16:30:00-04:00,1.12307,1.1231,1.12281,1.12293,1.121561423171251,1.1228942222222222,1.1228322222222165,1.1226608888888834,1.1223965000000036,1.1234114000000017,1.1240434000000001,1.1235703500000052,1.1228023145318515,1.1226818537745455,-497,-54681,-54803.8,0.03493358630594551,-96.32086671440126,0.04276359748764185
2023-07-18T16:45:00-04:00,1.12293,1.12293,1.12269,1.12281,1.1216893093175508,1.1228897777777778,1.1228455555555499,1.1227428888888833,1.1224245000000035,1.1233720000000016,1.1240277,1.123567400000005,1.1228038516254812,1.1227382830196362,-835,-55516,-54743.6,0.03686774365205995,-96.41009756583449,0.010688613953996206
2023-07-18T17:00:00-04:00,1.12281,1.12281,1.12238,1.12264,1.1218069645721467,1.1228486666666666,1.122817777777772,1.1227931111111054,1.1224360000000035,1.1233458000000016,1.1240167,1.1235649500000051,1.122771081300385,1.1227686264157086,-122,-55638,-55036,0.0347671070503973,-96.42856907926954,-0.02226397955274884
2023-07-18T17:15:00-04:00,1.12264,1.12302,1.12257,1.12287,1.121915207406375,1.1228591111111113,1.1228522222222166,1.1228253333333278,1.1224455000000035,1.1233292000000015,1.1240067,1.123564350000005,1.122790865040308,1.1227877011325664,152,-55486,-55101,0.03263674618511558,-96.39742819706332,0.02761545039909069
2023-07-18T17:30:00-04:00,1.12287,1.12289,1.12257,1.1228,1.122014790813865,1.1228486666666666,1.1228744444444387,1.1228444444444388,1.1224995000000035,1.1233026000000015,1.1239940000000002,1.123564450000005,1.1227926920322464,1.122792160906053,-621,-56107,-55485.6,0.034265651495349596,-96.43614149423931,0.01781578478531783
2023-07-18T17:45:00-04:00,1.1228,1.12296,1.12275,1.12291,1.1221064075487557,1.1228557777777777,1.1228933333333275,1.122856666666661,1.1225730000000036,1.1232724000000016,1.1239917000000001,1.123566050000005,1.1228161536257972,1.1227949287248422,240,-55867,-55722.8,0.031977397774941026,-96.41262884728525,0.015141528759998172
2023-07-18T18:00:00-04:00,1.12291,1.12318,1.12279,1.12316,1.1221906949448552,1.1229091111111111,1.1229099999999943,1.1228695555555501,1.1226505000000035,1.1232560000000016,1.1239846000000002,1.123569300000005,1.1228849229006377,1.1228111429798733,385,-55482,-55716,0.02842039447546491,-96.32691405268912,0.013356960312007235
2023-07-18T18:15:00-04:00,1.12316,1.12326,1.12303,1.12304,1.1222896254503698,1.1229351111111112,1.1229144444444386,1.1228888888888833,1.1227080000000036,1.1232192000000016,1.123979,1.123571350000005,1.12291593832051,1.1228401143838984,-259,-55741,-55736.6,0.022620413513261484,-96.35458597832748,0.0035618878005378453
2023-07-18T18:30:00-04:00,1.12304,1.12321,1.12297,1.12318,1.1224060703963255,1.1229882222222223,1.1229266666666609,1.1229037777777722,1.1227755000000035,1.1231862000000017,1.1239733,1.1235745500000052,1.122968750656408,1.1228756915071183,431,-55310,-55701.4,0.01875105503883406,-96.30085681462893,0.009794580925503709
2023-07-18T18:45:00-04:00,1.12318,1.12327,1.12301,1.12315,1.1225085419487664,1.123032888888889,1.1229511111111055,1.1229191111111054,1.1228390000000037,1.1231484000000016,1.1239682000000002,1.1235777500000053,1.1230050005251264,1.1229181532056944,-677,-55987,-55677.4,0.013864231470716403,-96.31893940156957,0.01959160410712235
2023-07-18T19:00:00-04:00,1.12315,1.12318,1.123,1.12302,1.122615146075939,1.1230466666666667,1.1229744444444387,1.1229353333333276,1.1228760000000035,1.1230952000000014,1.1239595000000002,1.1235779500000052,1.123008000420101,1.122956522564555,-762,-56749,-55853.8,0.009830448095805952,-96.40713777222365,0.01870307531994028
2023-07-18T19:15:00-04:00,1.12302,1.12302,1.1225,1.12256,1.12327,1.1229637777777777,1.1229655555555498,1.1229464444444388,1.1228815000000034,1.1230318000000015,1.1239466000000002,1.1235778000000052,1.1229184003360808,1.1229632180516438,-527,-57276,-56212.6,0.00641643285387318,-96.62300213795173,-0.007126060001432338
2023-07-18T19:30:00-04:00,1.12256,1.12272,1.12253,1.12269,1.1232546,1.1229086666666666,1.1229455555555496,1.1229526666666612,1.1228815000000034,1.1229878000000015,1.1239344000000002,1.1235776500000052,1.1228727202688646,1.1229545744413145,1137,-56139,-56292.2,0.005843856233059418,-96.49132988880696,-0.016030350797516097
2023-07-18T19:45:00-04:00,1.12269,1.1229,1.1226099999999999,1.12279,1.1232395080000002,1.1228775555555555,1.1229444444444383,1.1229562222222165,1.1228765000000036,1.1229410000000015,1.123923,1.123576950000005,1.1228561762150917,1.1229320595530514,1348,-54791,-56188.4,0.0047072952902953765,-96.37126112539053,-0.000890630566446875
2023-07-18T20:00:00-04:00,1.12279,1.12313,1.1227,1.12284,1.12322471784,1.1228566666666666,1.1229366666666607,1.1229533333333275,1.1228905000000036,1.1229122000000016,1.1239116000000002,1.1235781000000051,1.1228529409720733,1.1229016476424405,1995,-52796,-55550.2,0.005275574556681177,-96.28241993514105,-0.0062338032433600634
2023-07-18T20:15:00-04:00,1.12284,1.12328,1.12283,1.12327,1.1225,1.1229233333333333,1.1229488888888828,1.1229482222222165,1.1229240000000034,1.1228710000000015,1.1239056,1.123580850000005,1.1229363527776586,1.122887318113952,1422,-51374,-54475.2,0.005470487357196461,-95.73785436925463,0.009793796075363662
2023-07-18T20:30:00-04:00,1.12327,1.12327,1.12296,1.12323,1.1225156,1.1229795555555557,1.1229699999999938,1.1229491111111052,1.1229485000000037,1.1228396000000014,1.1238989000000001,1.1235846000000052,1.1229950822221269,1.1229026544911611,-1405,-52779,-53575.8,0.0034221436871745745,-95.78788686366832,0.016918364439371034
2023-07-18T20:45:00-04:00,1.12323,1.12324,1.12279,1.12296,1.122530888,1.1229775555555557,1.1229455555555494,1.1229491111111052,1.1229460000000036,1.1228026000000013,1.1238914,1.123586700000005,1.1229880657777014,1.1229257235929286,-1747,-54526,-53253.2,0.0017767841736753946,-96.2078275703802,-0.01958724336260519
2023-07-18T21:00:00-04:00,1.12296,1.12312,1.12263,1.12283,1.12254587024,1.1229544444444444,1.1229099999999939,1.1229422222222163,1.1229375000000035,1.1228074000000015,1.1238831,1.123587750000005,1.1229564526221611,1.1229457788743424,-1858,-56384,-53571.8,-0.000576717164373991,-96.42291982656023,-0.028491296799189596
2023-07-18T21:15:00-04:00,1.12283,1.12294,1.12217,1.1222,1.12328,1.1228124444444445,1.1228188888888826,1.1229186666666606,1.1228940000000036,1.1227724000000014,1.1238651,1.123584650000005,1.1228051620977288,1.1229362230994737,-2284,-58668,-54746.2,-0.005644386676152839,-97.70443172061347,-0.07301739951201412
2023-07-18T21:30:00-04:00,1.1222,1.12293,1.12218,1.12293,1.1232578,1.1228346666666664,1.1228599999999938,1.1229008888888832,1.1228940000000036,1.1227620000000014,1.1238499000000002,1.123584950000005,1.122830129678183,1.1229149784795784,2476,-56192,-55709.8,-0.00585221627209773,-96.0937740838288,0.03296037628278056
2023-07-18T21:45:00-04:00,1.12293,1.12297,1.12252,1.12252,1.123236044,1.1227666666666667,1.122841111111105,1.1228751111111053,1.1228795000000034,1.1227492000000014,1.1238333000000003,1.1235839500000049,1.1227681037425465,1.1228695827836626,-2362,-58554,-56864.8,-0.004469813912854955,-96.95617868607476,-0.015142203101479793
2023-07-18T22:00:00-04:00,1.12252,1.12255,1.12188,1.12217,1.12321472312,1.1226324444444444,1.122772222222216,1.1228404444444386,1.1228560000000034,1.1227364000000015,1.1238130000000002,1.123581750000005,1.1226484829940373,1.1228016662269298,-2812,-61366,-58232.8,-0.006386833453399903,-97.83295593725978,-0.05521958692187007
2023-07-18T22:15:00-04:00,1.12217,1.1222699999999999,1.12162,1.12177,1.1231613341952,1.1224319999999999,1.122653333333327,1.1227891111111052,1.1228010000000035,1.1227192000000015,1.1237760000000003,1.123578900000005,1.1224727863952297,1.1227049329815435,-1686,-63052,-59566.4,-0.01178172509354207,-98.43393439863367,-0.09529407573653649
2023-07-18T22:30:00-04:00,1.12177,1.12212,1.12167,1.12211,1.1230688541434881,1.1223233333333333,1.122524444444438,1.1227302222222162,1.1227665000000036,1.1226948000000017,1.1237540000000004,1.1235760000000048,1.1224002291161839,1.1226239463852346,1608,-61444,-60121.6,-0.015060566719719273,-97.94656176431468,-0.10326991729504481
2023-07-18T22:45:00-04:00,1.12211,1.12239,1.1219999999999999,1.12216,1.1229819228948787,1.1222504444444443,1.1224055555555492,1.1226393333333273,1.1227290000000036,1.1226686000000017,1.1237303000000003,1.1235746000000049,1.122352183292947,1.1225283571081874,1548,-59896,-60862.4,-0.022233070610623504,-97.87758456956536,-0.09526098839951785
2023-07-18T23:00:00-04:00,1.12216,1.12246,1.12201,1.12242,1.122900207521186,1.1222533333333333,1.122345555555549,1.1225402222222163,1.1226920000000036,1.1226432000000017,1.1237068000000003,1.123574800000005,1.1223657466343577,1.1224478856865496,1582,-58314,-60814.4,-0.027369894388234724,-97.5110414741067,-0.04808719811925491
2023-07-18T23:15:00-04:00,1.12242,1.12262,1.12237,1.1225,1.122823395069915,1.1222842222222222,1.1223088888888824,1.1224475555555498,1.1226650000000036,1.1226196000000015,1.1236876000000005,1.1235754000000049,1.1223925973074862,1.1223967085492395,1508,-56806,-59902.4,-0.028668571966285847,-97.40355942638827,-0.029390023422952848
2023-07-18T23:30:00-04:00,1.1225,1.12267,1.12229,1.12267,1.12275119136572,1.1223564444444445,1.1223611111111047,1.1223891111111053,1.1226395000000033,1.1225906000000017,1.1236681000000004,1.1235788000000049,1.1224480778459889,1.1223917668393912,1239,-55567,-58405.4,-0.028524807250414223,-97.21591577382702,0.04188201746568975
2023-07-18T23:45:00-04:00,1.12267,1.12268,1.12251,1.12262,1.122683319883777,1.1224082222222225,1.12232666666666,1.1223495555555496,1.1226130000000034,1.1225852000000016,1.1236467000000003,1.1235830000000049,1.122482462276791,1.1224082134715128,-1507,-57074,-57531.4,-0.022408942198309297,-97.28303255792223,-0.027606351241843435
2023-07-19T00:00:00-04:00,1.12262,1.12266,1.12237,1.12262,1.12162,1.122466888888889,1.1223377777777714,1.122335999999994,1.1225930000000033,1.1225874000000016,1.1236266000000006,1.123585250000005,1.122509969821433,1.1224397707772098,0,-57074,-56967,-0.022922704166132273,-97.28303255792223,0.008908527242275326
2023-07-19T00:15:00-04:00,1.12262,1.12262,1.12229,1.1225,1.1216408,1.1224993333333333,1.1223744444444381,1.122341777777772,1.1225900000000033,1.1225924000000016,1.1235988000000003,1.123585600000005,1.1225079758571463,1.1224682166217677,-1058,-58132,-56930.6,-0.02089558316713788,-97.39612514490615,0.029407309053010106
2023-07-19T00:30:00-04:00,1.1225,1.12254,1.12225,1.12238,1.121661184,1.1225004444444444,1.1224422222222157,1.1223684444444384,1.1225745000000034,1.1225918000000015,1.1235688000000004,1.1235857000000051,1.1224823806857172,1.1224861732974136,-1239,-59371,-57443.6,-0.018261504747675676,-97.5285794878907,0.05437834850281247
2023-07-19T00:45:00-04:00,1.12238,1.12238,1.12195,1.12215,1.1216811603199999,1.122442,1.1224466666666602,1.1223855555555495,1.1225425000000033,1.1225812000000017,1.1235364000000003,1.1235832500000051,1.1224159045485738,1.1224797386379308,-1305,-60676,-58465.4,-0.01258609192267766,-97.7960022858735,0.003564712906937823
2023-07-19T01:00:00-04:00,1.12215,1.12237,1.1219999999999999,1.12232,1.1217007371135999,1.1224166666666668,1.122464444444438,1.1224131111111053,1.1225165000000032,1.1225932000000016,1.1235050000000006,1.123582200000005,1.122396723638859,1.1224625909103445,1311,-59365,-58923.6,-0.008721779887560052,-97.59739247435097,0.014258216297135699
2023-07-19T01:15:00-04:00,1.12232,1.1226,1.12225,1.12251,1.121719922371328,1.1224257777777777,1.122474444444438,1.1224404444444385,1.1224785000000033,1.1226146000000015,1.1234755000000005,1.1235819000000051,1.1224193789110872,1.1224444727282752,1560,-57805,-59069.8,-0.004203990694041782,-97.33329667279716,0.00801838883839592
2023-07-19T01:30:00-04:00,1.12251,1.12318,1.12249,1.12296,1.1217387239239014,1.1225228888888887,1.122525555555549,1.1224706666666606,1.1224650000000032,1.1226416000000017,1.1234522000000005,1.123583700000005,1.1225275031288697,1.12244837818262,1769,-56036,-58650.6,0.0019217283850254498,-96.6241270440187,0.04097995545656168
2023-07-19T01:45:00-04:00,1.12296,1.12357,1.12276,1.12352,1.1217963749669453,1.1227217777777776,1.1226199999999933,1.1225062222222162,1.1224930000000035,1.1226742000000016,1.1234358000000004,1.123588050000005,1.1227260025030958,1.1224971025460957,2370,-53666,-57509.6,0.009778210668381547,-95.4422505746874,0.07571236427445441
2023-07-19T02:00:00-04:00,1.12352,1.12357,1.1217,1.1218,1.12357,1.1225577777777778,1.1225288888888822,1.1225226666666606,1.1224415000000034,1.1226736000000017,1.1233962000000006,1.123585200000005,1.1225408020024767,1.1225220820368762,-9271,-62937,-57961.8,0.0069490226826610406,-109.63525114432706,-0.0730434162940303
2023-07-19T02:15:00-04:00,1.1218,1.12188,1.1212,1.12169,1.12357,1.12239,1.122425555555549,1.1225148888888827,1.1224160000000034,1.1226698000000015,1.1233550000000005,1.123581550000005,1.1223706416019814,1.1225168656295008,-5027,-67964,-59681.6,0.003500134914644823,-110.1281821480703,-0.0828419233578482
2023-07-19T02:30:00-04:00,1.12169,1.12175,1.11959,1.11986,1.12357,1.1218768888888888,1.1221322222222154,1.1224464444444382,1.1222625000000035,1.1226214000000017,1.1232942000000006,1.123568350000005,1.121868513281585,1.1224066925036003,-5592,-73556,-62831.8,-0.011163356694984987,-119.25134451913537,-0.23518930957683523
2023-07-19T02:45:00-04:00,1.11986,1.12158,1.11986,1.12128,1.1233312,1.1217064444444445,1.1220099999999933,1.1223433333333273,1.1222005000000035,1.1225980000000018,1.1232571000000005,1.123561350000005,1.121750810625268,1.12225135400288,5007,-68549,-65334.4,-0.015034033436048314,-112.90239018555806,-0.09800602291557929
2023-07-19T03:00:00-04:00,1.12128,1.12291,1.12124,1.12269,1.123106728,1.1218424444444446,1.1220699999999932,1.1222333333333272,1.1222265000000036,1.1225980000000018,1.1232368000000006,1.123561150000005,1.1219386485002145,1.1220938832023037,5869,-62680,-67137.2,-0.0129929094863419,-105.52217293384619,0.04812190883571581
2023-07-19T03:15:00-04:00,1.12269,1.12341,1.12217,1.12308,1.11959,1.1220444444444446,1.1221544444444378,1.1221584444444384,1.1222920000000036,1.1226018000000015,1.1232199000000005,1.123563600000005,1.1221669188001717,1.1220191065618426,5282,-57398,-66029.4,-0.00856684237358461,-103.68731201943474,0.06771687219332222
2023-07-19T03:30:00-04:00,1.12308,1.12372,1.12282,1.1232,1.1196664,1.1222535555555555,1.1222311111111045,1.1221195555555492,1.1223465000000037,1.1226146000000017,1.1232002000000003,1.123568150000005,1.1223735350401374,1.122019685249474,4191,-53207,-63078,-0.006792809549844566,-103.23950776684403,0.06146938557340954
2023-07-19T03:45:00-04:00,1.1232,1.12346,1.12253,1.12269,1.119828544,1.1223453333333333,1.1222011111111045,1.1221333333333274,1.1223730000000036,1.1226164000000016,1.1231709000000003,1.123565400000005,1.12243682803211,1.1221333481995788,-3887,-57094,-59785.6,-0.00764967784768251,-105.00443832239962,-0.024043599059627455
2023-07-19T04:00:00-04:00,1.12269,1.12321,1.12231,1.1225,1.11998420224,1.1224051111111113,1.1220877777777711,1.1221488888888829,1.1223770000000035,1.1226116000000017,1.1231241000000005,1.123564500000005,1.122449462425688,1.1222730785596626,-4178,-61272,-58330.2,-0.013190518778652892,-105.71150794981203,-0.09078610082597736
2023-07-19T04:15:00-04:00,1.1225,1.12273,1.12208,1.1224,1.1201336341504,1.1224675555555557,1.1221544444444378,1.1221657777777718,1.1223720000000035,1.1225994000000017,1.1230802000000004,1.1235622500000049,1.1224395699405505,1.1223732628477299,-3523,-64795,-58753.2,-0.023084488123111573,-106.02536095649351,0.05348546978072348
2023-07-19T04:30:00-04:00,1.1224,1.1225,1.12199,1.12218,1.120277088784384,1.1224726666666667,1.1222088888888822,1.1221766666666606,1.1223475000000036,1.1225830000000019,1.1230387000000004,1.123556350000005,1.1223876559524404,1.1224174102781836,-3564,-68359,-60945.4,-0.018341407285823022,-106.72393543974404,0.04368408383776974
2023-07-19T04:45:00-04:00,1.12218,1.12323,1.12199,1.1232199999999999,1.1204148052330087,1.1226748888888889,1.1225822222222155,1.122246888888883,1.1223775000000036,1.1225860000000019,1.1230170000000004,1.123555800000005,1.1225541247619524,1.1224535282225467,4686,-63673,-63038.6,-0.007042800284951738,-102.38110273910807,0.30003750468806883
2023-07-19T05:00:00-04:00,1.1232199999999999,1.12361,1.12255,1.12351,1.1205470130236883,1.1228604444444445,1.1228299999999933,1.1223726666666607,1.1224220000000034,1.1225976000000017,1.1230045000000004,1.1235530000000051,1.122745299809562,1.122515222578037,3779,-59894,-63598.6,0.0217003393147252,-101.40541676485506,0.19887985159816943
2023-07-19T05:15:00-04:00,1.12351,1.12398,1.1233899999999999,1.12384,1.1206739325027408,1.1230624444444444,1.122957777777771,1.1225466666666608,1.1224890000000036,1.1226182000000018,1.1229951000000005,1.1235508000000052,1.1229642398476496,1.1226181780624294,2860,-57034,-62751,0.03933009450115492,-100.56537083736013,0.10243255039235981
2023-07-19T05:30:00-04:00,1.12384,1.1239999999999999,1.12344,1.12353,1.1208722965525764,1.123176888888889,1.123007777777771,1.1227173333333273,1.1225465000000034,1.1226360000000017,1.1229909000000005,1.1235515000000051,1.1230773918781196,1.122745742449943,-2131,-59165,-61625,0.04244206689715129,-101.15318582881805,0.04006838337427782
2023-07-19T05:45:00-04:00,1.12353,1.12355,1.12267,1.12295,1.1211225128283702,1.1231653333333333,1.1229799999999932,1.1228715555555495,1.1225865000000035,1.1226376000000018,1.1229834000000003,1.1235439000000051,1.1230519135024957,1.1228785939599542,-2431,-61596,-60272.4,0.038865048944312926,-102.40814119271582,-0.022257834757842192
2023-07-19T06:00:00-04:00,1.12295,1.12295,1.1219999999999999,1.12201,1.1213527118021005,1.1229713333333333,1.1229044444444376,1.122935999999994,1.1225710000000035,1.122621800000002,1.1229622000000006,1.123532200000005,1.1228435308019966,1.122936475167963,-2684,-64280,-60393.8,0.02885838225105676,-104.65486633631068,-0.06056881240591917
2023-07-19T06:15:00-04:00,1.12201,1.12246,1.1219999999999999,1.12232,1.1215644948579324,1.1228544444444446,1.1228844444444375,1.1229468888888827,1.1225615000000035,1.1226100000000019,1.1229412000000005,1.1235243500000052,1.1227388246415972,1.12293518013437,2217,-62063,-60827.6,0.025562341826409006,-104.04233168866932,-0.016035634743881425
2023-07-19T06:30:00-04:00,1.12232,1.12253,1.12185,1.12196,1.1217593352692978,1.1226695555555555,1.1228355555555487,1.1229224444444381,1.1225115000000034,1.1225860000000016,1.1229210000000005,1.123511050000005,1.1225830597132778,1.1228589441074956,-2588,-64651,-62351,0.02308554760755141,-104.87246926084106,-0.039201710620099424
2023-07-19T06:45:00-04:00,1.12196,1.12197,1.12155,1.12157,1.1239999999999999,1.1224164444444444,1.1227677777777711,1.1228744444444383,1.1224140000000036,1.1225566000000018,1.1228879000000005,1.1234999500000051,1.1223804477706223,1.122719555285996,-2956,-67607,-64039.4,0.02158935677405983,-105.89999252370278,-0.05435848081412959
2023-07-19T07:00:00-04:00,1.12157,1.1218299999999999,1.12099,1.12101,1.123951,1.122064888888889,1.1225222222222153,1.1227828888888827,1.1223745000000034,1.1225132000000015,1.1228497000000004,1.1234837500000052,1.1221063582164978,1.1225304442287964,-2563,-70170,-65754.2,0.021816524808649644,-107.1796986499363,-0.1967557557735638
2023-07-19T07:15:00-04:00,1.12101,1.12151,1.121,1.12134,1.1238325599999999,1.1218284444444444,1.1222811111111044,1.122658222222216,1.1223570000000034,1.1224770000000017,1.1228127000000003,1.1234720500000053,1.1219530865731984,1.1223523553830368,2570,-67600,-66418.2,0.007017743350311906,-106.42314875296852,-0.19314469831154196
2023-07-19T07:30:00-04:00,1.12134,1.12162,1.121,1.1216,1.1237188576,1.1216922222222223,1.1220322222222154,1.1224877777777718,1.1224440000000033,1.1224486000000018,1.1227719000000005,1.1234598000000053,1.1218824692585587,1.122181084306429,2364,-65236,-67052.8,-0.009618672868918121,-105.8750188369753,-0.1993166287015963
2023-07-19T07:45:00-04:00,1.1216,1.12203,1.12127,1.12132,1.123609703296,1.1215497777777779,1.1217866666666596,1.122277999999994,1.1224460000000034,1.1224238000000017,1.1227278000000005,1.1234448000000052,1.121769975406847,1.122018467445143,-3310,-68546,-67831.8,-0.03826441862996657,-106.70133838048409,-0.19670146769555094
2023-07-19T08:00:00-04:00,1.12132,1.12232,1.1213,1.12197,1.12350491516416,1.1215864444444443,1.1216777777777707,1.1220599999999938,1.1224100000000035,1.1224094000000016,1.1226986000000003,1.1234347000000051,1.1218099803254777,1.121904373956114,3467,-65079,-67326.2,-0.05508913749087049,-104.69160877608984,-0.08727013669352873
2023-07-19T08:15:00-04:00,1.12197,1.12238,1.12138,1.12144,1.1234043185575937,1.1215388888888889,1.1216144444444374,1.1218784444444383,1.1223280000000035,1.1223824000000018,1.1226617000000003,1.123422500000005,1.1217359842603822,1.121830299164891,-3726,-68805,-67053.2,-0.0632423745119678,-106.4517093135371,-0.05080168625947714
2023-07-19T08:30:00-04:00,1.12144,1.12191,1.12089,1.12156,1.12330774581529,1.121528,1.1215299999999928,1.121728222222216,1.1222460000000034,1.1223568000000017,1.1226345000000002,1.123413550000005,1.1217007874083058,1.1217798393319125,4654,-64151,-66363.4,-0.06080671686974664,-105.95370674541083,-0.06771687219332222
2023-07-19T08:45:00-04:00,1.12156,1.12195,1.12088,1.12171,1.1231626810663726,1.121564,1.121502222222215,1.1216222222222159,1.1221970000000032,1.1223256000000017,1.1225983000000002,1.123406500000005,1.1217026299266446,1.1217438714655297,4727,-59424,-65201,-0.05992371416670475,-105.32150695226517,-0.02228243431139109
2023-07-19T09:00:00-04:00,1.12171,1.12204,1.1215,1.12192,1.1229800665810628,1.1216475555555554,1.121541111111104,1.121573111111105,1.1221680000000034,1.1222994000000017,1.1225695000000002,1.1233982500000053,1.1217461039413157,1.1217390971724233,4212,-55212,-62534.2,-0.057014681407435444,-104.53296089312316,0.031206255516826636
2023-07-19T09:15:00-04:00,1.12192,1.12214,1.12138,1.12138,1.1228120612545778,1.1216153333333334,1.1215822222222152,1.1215539999999937,1.1221170000000034,1.1222678000000017,1.1225352000000002,1.123387100000005,1.1216728831530525,1.1217116777379381,-3210,-58422,-61202.8,-0.053957735158223996,-106.07799084178257,0.03300594999152384
2023-07-19T09:30:00-04:00,1.12138,1.12246,1.12132,1.12196,1.1226574963542115,1.1216908888888888,1.121651111111104,1.121561333333327,1.1221060000000034,1.1222504000000015,1.1225289,1.123379350000005,1.121730306522442,1.1217105421903502,5750,-52672,-57976.2,-0.04362531456448433,-103.10397668065954,0.05529099113561141
2023-07-19T09:45:00-04:00,1.12196,1.12217,1.12132,1.12135,1.1225152966458747,1.1216306666666669,1.1216233333333263,1.1215799999999938,1.1220125000000034,1.1222334000000016,1.1225029,1.123369200000005,1.1216542452179536,1.1217012337522796,-4822,-57494,-56644.8,-0.04001532881160429,-105.72565659794714,-0.022289586305265823
2023-07-19T10:00:00-04:00,1.12135,1.12143,1.11901,1.1193,1.12246,1.121166,1.121398888888882,1.1215593333333271,1.1218020000000033,1.1221608000000016,1.1224614,1.1233499000000051,1.121183396174363,1.1215973870018234,-5638,-63132,-57386.4,-0.043884539390270046,-116.03278639685078,-0.18014482930832704
2023-07-19T10:15:00-04:00,1.1193,1.11978,1.1187799999999999,1.1189,1.12217,1.1206662222222223,1.1210577777777708,1.1214626666666605,1.1215550000000032,1.1220884000000018,1.1224188,1.1233300500000052,1.1207267169394903,1.1213935096014584,-5609,-68741,-60092.2,-0.04589695409930597,-118.03725347448837,-0.27362585452373117
2023-07-19T10:30:00-04:00,1.1189,1.11925,1.11826,1.11876,1.1217632,1.1202066666666668,1.120759999999993,1.121298222222216,1.1213165000000034,1.1220202000000017,1.1223783,1.123310450000005,1.1203333735515923,1.1211256076811662,-6503,-75244,-63456.6,-0.05295997513325664,-118.85092761873734,-0.23897845627051076
2023-07-19T10:45:00-04:00,1.11876,1.1191,1.11743,1.11906,1.1212727519999999,1.1198666666666668,1.1204822222222155,1.1210644444444384,1.1211220000000033,1.1219660000000016,1.1223426,1.123288050000005,1.1200786988412739,1.1207952861449326,7674,-67570,-66436.2,-0.055212506566737485,-116.79311361037117,-0.22290381254680508
2023-07-19T11:00:00-04:00,1.11906,1.1198,1.11894,1.11965,1.12065791168,1.1197002222222223,1.1202533333333264,1.1207904444444385,1.1210040000000032,1.1219168000000017,1.1223058000000001,1.123272000000005,1.119992959073019,1.1204630289159456,5926,-61644,-67266.2,-0.0582403686330005,-113.66875924152541,-0.18364818001087185
2023-07-19T11:15:00-04:00,1.11965,1.11984,1.11947,1.11979,1.1201414458112,1.1196075555555558,1.12001666666666,1.120513999999994,1.1208775000000035,1.1218694000000016,1.122269,1.123260000000005,1.1199523672584153,1.1202168231327563,3553,-58091,-66258,-0.06594343978923795,-113.22449540907768,-0.1898531089560722
2023-07-19T11:30:00-04:00,1.11979,1.11992,1.11909,1.11944,1.11743,1.1194922222222223,1.1198011111111041,1.1202626666666606,1.1207515000000035,1.1218098000000014,1.1222265,1.123252650000005,1.1198498938067323,1.1200414585062048,-3771,-61862,-64882.2,-0.0758423230834354,-114.40315390754638,-0.17300112361554984
2023-07-19T11:45:00-04:00,1.11944,1.11994,1.11932,1.1194,1.1174798,1.119412,1.1195166666666596,1.120013999999994,1.1206430000000034,1.1217478000000014,1.1221837000000001,1.1232390000000052,1.1197599150453859,1.1199267668049635,-3419,-65281,-62889.6,-0.08264062482037632,-114.52532213451714,-0.22817212734857906
2023-07-19T12:00:00-04:00,1.1194,1.11951,1.11836,1.1186099999999999,1.1175782079999999,1.1192306666666665,1.1192122222222154,1.1197599999999939,1.1205230000000035,1.1216666000000015,1.1221286000000001,1.1232197500000052,1.1195299320363086,1.1198170134439704,-3794,-69075,-63190.6,-0.09996825527652457,-117.20288154134246,-0.244348330137797
2023-07-19T12:15:00-04:00,1.1186099999999999,1.11863,1.1179999999999999,1.11823,1.1176726796799998,1.119034222222222,1.1190933333333264,1.119527999999994,1.1203675000000033,1.1215788000000015,1.1220820000000002,1.1232006500000051,1.119269945629047,1.119672410755176,-2545,-71620,-65185.8,-0.11601155865422082,-118.06743665885398,-0.09559546144911145
2023-07-19T12:30:00-04:00,1.11823,1.11934,1.11822,1.11924,1.1177633724927998,1.1190635555555557,1.1191311111111042,1.1193508888888828,1.1202495000000035,1.1215112000000014,1.1220493000000002,1.123181950000005,1.1192639565032376,1.1195347286041406,2169,-69451,-67457.8,-0.10763140769622363,-116.10836741549626,0.03038698721959129
2023-07-19T12:45:00-04:00,1.11924,1.11947,1.11891,1.11921,1.1178504375930878,1.1190793333333333,1.119181111111104,1.1192268888888828,1.1201440000000034,1.1214454000000016,1.1220189000000003,1.123162050000005,1.11925316520259,1.1194153828833122,-2341,-71792,-69443.8,-0.09471522942295842,-116.1711153515957,0.040223104151029844
2023-07-19T13:00:00-04:00,1.11921,1.11952,1.11901,1.11945,1.1179340200893642,1.1191331111111111,1.1192244444444375,1.1191684444444383,1.1200180000000033,1.1213868000000013,1.1219893,1.123144000000005,1.1192925321620721,1.1193219063066493,2392,-69400,-70267.6,-0.08061276242580545,-115.65818212190686,0.03485067824782519
2023-07-19T13:15:00-04:00,1.11945,1.11952,1.11901,1.11921,1.1180142592857896,1.1191302222222224,1.1191755555555485,1.1191611111111048,1.1199065000000035,1.1213280000000014,1.1219546,1.123122850000005,1.1192760257296577,1.1192711250453193,-2094,-71494,-70751.4,-0.0675480036408594,-116.10711686664762,-0.03929799490912302
2023-07-19T13:30:00-04:00,1.11921,1.1198,1.11917,1.11976,1.118091288914358,1.119247111111111,1.1191722222222154,1.1191768888888827,1.1198165000000035,1.1212768000000013,1.1219350000000001,1.1231049500000048,1.1193728205837261,1.119291700036255,2577,-68917,-70210.8,-0.059427099964806156,-114.84073254198992,-0.0026790737548981944
2023-07-19T13:45:00-04:00,1.11976,1.11996,1.1197,1.11991,1.1181652373577837,1.1193946666666668,1.1192244444444372,1.1191955555555495,1.1197265000000036,1.1212248000000014,1.1219197,1.123086950000005,1.1194802564669808,1.1193349600290037,2009,-66908,-69702.2,-0.05134324194648639,-114.57161237338259,0.041985278353459804
2023-07-19T14:00:00-04:00,1.11991,1.11999,1.11967,1.11971,1.1182729231163167,1.1194917777777778,1.1192588888888817,1.1192111111111047,1.1196160000000035,1.1211598000000016,1.1219007000000003,1.1230680500000048,1.1195262051735846,1.1193895680232024,-2061,-68969,-69137.6,-0.04043081979224214,-114.93967766434344,0.027693407182422056
2023-07-19T14:15:00-04:00,1.11971,1.11991,1.11949,1.11988,1.1184102892670114,1.1196159999999997,1.1193999999999926,1.119246222222216,1.1195410000000035,1.1210870000000015,1.1218806000000001,1.123050550000005,1.1195969641388677,1.1194504544185617,1386,-67583,-68774.2,-0.02747084492270228,-114.72924817813718,0.1135337606493867
2023-07-19T14:30:00-04:00,1.11988,1.12004,1.11987,1.11999,1.1185366661256504,1.119734,1.1195955555555481,1.119330222222216,1.1194425000000032,1.1210508000000017,1.1218622000000003,1.1230345000000048,1.1196755713110942,1.119530363534849,1670,-65913,-67658,-0.00923405020888589,-114.56521274576934,0.15739159206960854
2023-07-19T14:45:00-04:00,1.11999,1.12022,1.11971,1.1201699999999999,1.1186869995130853,1.1198488888888891,1.1196988888888815,1.1194355555555493,1.1193835000000034,1.1210204000000015,1.1218451000000003,1.1230189000000048,1.1197744570488752,1.119610690827879,1813,-64100,-66694.6,0.015708864087440492,-114.27383514418386,0.08309209820948817
2023-07-19T15:00:00-04:00,1.1201699999999999,1.12038,1.11994,1.12018,1.118870959571515,1.1199451111111112,1.1198066666666595,1.1195519999999937,1.1194275000000034,1.1210268000000014,1.1218241,1.1230024500000046,1.1198555656391003,1.1196857526623027,1904,-62196,-65752.2,0.02908390176085724,-114.25683772414929,0.08666827494392611
2023-07-19T15:15:00-04:00,1.12018,1.1205,1.12015,1.12029,1.119082225231503,1.1200417777777778,1.119899999999993,1.119680222222216,1.119497000000003,1.1210070000000014,1.1218025000000003,1.1229868500000046,1.1199424525112802,1.1197690021298419,1383,-60813,-64121,0.03451892990080804,-114.12102919337738,0.0750368484523607
2023-07-19T15:30:00-04:00,1.12029,1.12037,1.11982,1.11989,1.1193090691944625,1.1200397777777775,1.1199755555555484,1.119795333333327,1.1195535000000032,1.1209510000000014,1.1217745000000001,1.1229654500000048,1.1199319620090242,1.1198360017038733,-1464,-62277,-63059.8,0.03423674267355636,-114.64375098862676,0.060757141197810415
2023-07-19T15:45:00-04:00,1.11989,1.1204,1.11985,1.12037,1.1194996181233485,1.1201186666666665,1.120043333333326,1.1198848888888826,1.1196190000000033,1.1208968000000015,1.1217493,1.1229471000000049,1.1200195696072195,1.1199048013630981,1971,-60306,-61938.4,0.03774758160320864,-113.79895373175326,0.05447595913410011
2023-07-19T16:00:00-04:00,1.12037,1.12047,1.12012,1.12015,1.1196596792236129,1.1201400000000001,1.1200699999999928,1.1199591111111047,1.1196440000000032,1.1208358000000016,1.1217252000000002,1.1229272500000047,1.1200456556857756,1.1199590410904785,-1550,-61856,-61489.6,0.03659325474582076,-114.10331746873315,0.021430293505729746
2023-07-19T16:15:00-04:00,1.12015,1.12018,1.12005,1.12016,1.1197941305478347,1.120158,1.120119999999993,1.1200217777777715,1.1196625000000031,1.1207852000000016,1.1217008000000002,1.1229081000000047,1.1200685245486206,1.1200016328723825,545,-61311,-61312.6,0.03665625542290134,-114.09845204892328,0.04018897750310897
2023-07-19T16:30:00-04:00,1.12016,1.12027,1.12015,1.1201699999999999,1.1199070696601812,1.120168,1.1201522222222149,1.1200722222222157,1.1196990000000029,1.1207386000000017,1.1216751,1.1228877000000048,1.1200888196388965,1.1200309062979057,568,-60743,-61298.6,0.03914785684125748,-114.09338134473825,0.025895631674813503
2023-07-19T16:45:00-04:00,1.1201699999999999,1.12027,1.11968,1.11972,1.1205,1.1200815555555554,1.120122222222215,1.1201015555555491,1.1197150000000031,1.1206850000000015,1.1216422,1.122864800000005,1.1200150557111173,1.1200475250383242,-708,-61451,-61133.4,0.03652764133288578,-114.37780245939038,-0.024107358101410948
2023-07-19T17:00:00-04:00,1.11972,1.11994,1.11957,1.11994,1.1204836,1.120045111111111,1.1200966666666594,1.120112222222216,1.119781500000003,1.1206402000000018,1.1216116,1.1228422500000048,1.1200000445688938,1.1200436200306592,96,-61355,-61343.2,0.03378378378416597,-114.35894060106867,-0.02053259773069735
2023-07-19T17:15:00-04:00,1.11994,1.12032,1.11932,1.11993,1.120447056,1.1200117777777778,1.1200688888888815,1.1201119999999936,1.1198665000000032,1.1205744000000017,1.1215802,1.1228193000000048,1.119986035655115,1.1200316960245271,-397,-61752,-61322.4,0.026025321106895673,-114.36248543382752,-0.02231784177541658
2023-07-19T17:30:00-04:00,1.11993,1.12009,1.11967,1.12007,1.12037943264,1.120012,1.1200444444444373,1.1200968888888823,1.1199080000000032,1.1205056000000015,1.1215516,1.122797500000005,1.120002828524092,1.1200185568196213,275,-61477,-61355.6,0.01721703929893754,-114.32810828525578,-0.019637772362523006
2023-07-19T17:45:00-04:00,1.12007,1.12019,1.11995,1.12005,1.12032,1.120013111111111,1.120062222222215,1.1200788888888824,1.1199500000000033,1.1204298000000017,1.121524,1.122775850000005,1.1200122628192735,1.1200032454556967,-2315,-63792,-61965.4,0.01162928641289109,-114.369444987426,0.014287117484747426
2023-07-19T18:00:00-04:00,1.12005,1.12013,1.11992,1.11992,1.12026,1.1199846666666666,1.120012222222215,1.1200568888888822,1.1199735000000033,1.1203576000000017,1.1214968,1.1227567500000049,1.1199938102554188,1.1199989963645571,-415,-64207,-62516.6,0.008877958682139113,-114.41761247994863,-0.04016530253398979
2023-07-19T18:15:00-04:00,1.11992,1.12012,1.11991,1.12009,1.1202036,1.120000222222222,1.1200055555555481,1.12003866666666,1.1200175000000034,1.1203004000000016,1.121469,1.122737850000005,1.1200130482043351,1.1200015970916453,529,-63678,-62981.2,0.0036565309899004635,-114.33731210135015,-0.005356425478725973
2023-07-19T18:30:00-04:00,1.12009,1.1201699999999999,1.11992,1.12013,1.11932,1.120025111111111,1.120002222222215,1.1200253333333265,1.1200360000000034,1.1202628000000017,1.1214423,1.122718150000005,1.120036438563468,1.120011677673316,593,-63085,-63247.8,-0.0004336646187025438,-114.3161352316343,-0.0026781888301648416
2023-07-19T18:45:00-04:00,1.12013,1.12039,1.11997,1.12035,1.119337,1.120094666666667,1.120022222222215,1.1200208888888823,1.1200580000000033,1.1202234000000018,1.1214167000000002,1.122704200000005,1.1200991508507745,1.1200309421386525,758,-62327,-63417.8,-0.001245691628466398,-114.16725965469242,0.016068989528381317
2023-07-19T19:00:00-04:00,1.12035,1.12038,1.12023,1.12027,1.11937912,1.1201442222222224,1.120083333333326,1.1200251111111044,1.1200860000000032,1.1201896000000016,1.1213878,1.1226862000000049,1.1201333206806197,1.1200551537109216,-726,-63053,-63270,-0.0018833888922599545,-114.21910059725492,0.049119422712825565
2023-07-19T19:15:00-04:00,1.12027,1.12036,1.12023,1.12036,1.1194195552000001,1.1201995555555555,1.120129999999993,1.12004866666666,1.1201100000000033,1.1201654000000016,1.121361,1.1226700000000047,1.1201786565444958,1.120092122968737,381,-62672,-62963,0.0010670825032581277,-114.18849190470762,0.03750200903620614
2023-07-19T19:30:00-04:00,1.12036,1.12046,1.12034,1.12046,1.1194583729920002,1.1202655555555554,1.1201888888888816,1.1200853333333267,1.1201335000000032,1.1201544000000017,1.1213338,1.1226535500000048,1.1202349252355965,1.1201364983749893,529,-62143,-62656,0.003243680774552431,-114.1412749387324,0.04732438634556797
2023-07-19T19:45:00-04:00,1.12046,1.12051,1.12043,1.12049,1.1195184706124803,1.120325777777778,1.1202355555555483,1.1201319999999935,1.1201495000000032,1.1201374000000017,1.1213072,1.1226377000000047,1.1202859401884773,1.1201863986999911,648,-61495,-62338,0.0061173753869884,-114.12392492177509,0.03749765639648299
2023-07-19T20:00:00-04:00,1.12049,1.12076,1.12039,1.12073,1.119597792963482,1.1204246666666668,1.120311111111104,1.1201897777777712,1.120177000000003,1.1201200000000018,1.1212843000000001,1.1226219000000048,1.1203747521507819,1.1202415189599926,1693,-59802,-61833,0.009628579153660414,-113.76129785683025,0.06071157537610052
2023-07-19T20:15:00-04:00,1.12073,1.12096,1.1206099999999999,1.12089,1.1197140136671337,1.1205404444444445,1.1204188888888817,1.1202568888888824,1.1202070000000033,1.1201114000000016,1.1212676000000001,1.1226071000000049,1.1204778017206254,1.1203104151679937,1355,-58447,-60911.8,0.014108737172721682,-113.5678525131704,0.08661332952352983
2023-07-19T20:30:00-04:00,1.12089,1.12138,1.12084,1.12132,1.1198635320270778,1.1207206666666667,1.1205555555555484,1.1203419999999933,1.1202785000000033,1.1200984000000016,1.1212539000000001,1.122594150000005,1.1206462413765004,1.1204039321343946,1846,-56601,-59697.6,0.022226983022130404,-112.85968311206923,0.1098126043442995
2023-07-19T20:45:00-04:00,1.12132,1.12202,1.12124,1.1218,1.1200758375432869,1.1209695555555554,1.1207411111111039,1.1204524444444377,1.1203500000000033,1.1201056000000016,1.1212440000000001,1.1225835000000048,1.1208769931012004,1.1205323457075154,2373,-54228,-58114.6,0.029370048586302808,-111.84388030823129,0.14908983778667104
2023-07-19T21:00:00-04:00,1.1218,1.12195,1.12156,1.1216599999999999,1.120386903536361,1.1211533333333334,1.1208866666666595,1.1205826666666598,1.1204255000000032,1.1201076000000016,1.1212322000000001,1.1225719000000047,1.1210335944809602,1.1206818765660118,-1779,-56007,-57017,0.037541449449645256,-112.06589849329106,0.11692774579371824
2023-07-19T21:15:00-04:00,1.1216599999999999,1.12253,1.12164,1.12223,1.1206481989705432,1.121422,1.1211044444444371,1.1207413333333265,1.1205290000000034,1.1201180000000017,1.1212218,1.1225637000000048,1.121272875584768,1.1208615012528091,2808,-53199,-55696.4,0.04547668284159167,-110.63894201806639,0.17495782266774632
2023-07-19T21:30:00-04:00,1.12223,1.12281,1.12217,1.12268,1.1209869231558454,1.121737111111111,1.1213622222222148,1.120929999999993,1.1206545000000034,1.1201332000000017,1.1212163000000002,1.1225576000000048,1.1215543004678143,1.121076801002247,4900,-48299,-53666.8,0.05626929715677162,-108.67410415060677,0.20707629690455548
2023-07-19T21:45:00-04:00,1.12268,1.12286,1.1224399999999999,1.12258,1.1213515385246764,1.1219806666666665,1.1215977777777704,1.1211384444444377,1.1207975000000032,1.1201572000000015,1.1212125000000002,1.1225519500000047,1.1217594403742515,1.121299440801797,-3114,-51413,-52629.2,0.06583199033670749,-108.95147615331454,0.18920800385555037
2023-07-19T22:00:00-04:00,1.12258,1.12291,1.12249,1.12254,1.121653230819741,1.1221691111111112,1.1218255555555483,1.1213553333333266,1.1209275000000032,1.1201688000000016,1.1212096000000003,1.1225463500000048,1.121915552299401,1.1215071526414373,-2374,-53787,-52541,0.07240056605194546,-109.03606700652729,0.1829556711795828
2023-07-19T22:15:00-04:00,1.12254,1.1228,1.12246,1.12259,1.121904584655793,1.122322,1.122032222222215,1.1215844444444376,1.1210605000000033,1.1201936000000017,1.1212135000000003,1.122539300000005,1.122050441839521,1.1217105221131494,1509,-52278,-51795.2,0.07986868945209159,-108.96885336603357,0.16596325609200901
2023-07-19T22:30:00-04:00,1.12259,1.1228,1.12228,1.1223,1.1221056677246344,1.1223755555555557,1.1221888888888814,1.1218013333333265,1.1211720000000032,1.1202536000000016,1.1212072000000002,1.1225285500000048,1.1221003534716167,1.1218760176905191,-1489,-53767,-51908.8,0.08379804030955362,-109.35350849390737,0.12579289671601437
2023-07-19T22:45:00-04:00,1.1223,1.12263,1.12211,1.12251,1.12291,1.122439777777778,1.1223211111111038,1.1219931111111046,1.121295000000003,1.1203258000000016,1.1212071000000001,1.122520200000005,1.1221822827772934,1.122001614152415,2515,-51252,-52499.4,0.08787498487033381,-108.88291239660758,0.10612492419646508
2023-07-19T23:00:00-04:00,1.12251,1.12255,1.12184,1.12229,1.122894,1.1224335555555558,1.1223755555555481,1.12214866666666,1.1214135000000032,1.1203964000000015,1.1212083000000002,1.122510650000005,1.1222038262218348,1.1220904913219316,-1877,-53129,-52842.6,0.08700456383306163,-109.2507843977477,0.04367980032092187
2023-07-19T23:15:00-04:00,1.12229,1.12272,1.12224,1.12255,1.12285184,1.1224684444444444,1.122474444444437,1.1222784444444378,1.1215365000000033,1.1204662000000014,1.1212161,1.122496050000005,1.1222730609774678,1.122161993057545,1588,-51541,-52393.4,0.0825151735696721,-108.88289374559906,0.07934668259544403
2023-07-19T23:30:00-04:00,1.12255,1.12256,1.12235,1.12255,1.1228113664000001,1.1224835555555555,1.1225099999999923,1.122373999999993,1.1216575000000033,1.1205242000000013,1.1212205,1.122487250000005,1.1223284487819742,1.1222175944460355,0,-51541,-52246,0.07999735068782088,-108.88289374559906,0.028514653858823586
2023-07-19T23:45:00-04:00,1.12255,1.12268,1.1224399999999999,1.12258,1.1227725117440002,1.1224975555555556,1.1224988888888816,1.1224359999999933,1.1217690000000033,1.1205800000000012,1.1212247,1.122477500000005,1.1223787590255794,1.122273275556828,1362,-50179,-51528.4,0.07270842381060773,-108.8464944760788,-0.008907257633518812
2023-07-20T00:00:00-04:00,1.12258,1.12268,1.12239,1.12246,1.1227352112742401,1.1224897777777776,1.1224855555555484,1.1224688888888823,1.1218785000000033,1.1206404000000014,1.1212251,1.122465950000005,1.1223950072204636,1.122315820445462,-1039,-51218,-51521.6,0.061784102447779626,-108.95756005715089,-0.01068966131588822
2023-07-20T00:15:00-04:00,1.12246,1.12246,1.12201,1.12234,1.1226994028232706,1.1224606666666666,1.122463333333326,1.1224864444444378,1.121977500000003,1.1206992000000013,1.1212235000000002,1.1224555500000049,1.1223840057763708,1.1223518563563692,-1214,-52432,-51382.2,0.05085333517860327,-109.08734641924855,-0.0178167370427958
2023-07-20T00:30:00-04:00,1.12234,1.12235,1.12204,1.1223,1.12268,1.122428,1.1224311111111038,1.122477777777771,1.1220695000000032,1.1207730000000016,1.1212198,1.1224439500000047,1.1223672046210966,1.122370685085095,-1430,-53862,-51846.4,0.040476448156985624,-109.13831136748148,-0.025833118057340742
2023-07-20T00:45:00-04:00,1.1223,1.12231,1.12204,1.12212,1.1226463999999998,1.1223657777777778,1.1224111111111037,1.1224579999999933,1.1221510000000032,1.1208508000000015,1.1212148,1.1224307500000048,1.1223177636968773,1.1223685480680756,-1146,-55008,-52539.8,0.029240125940831533,-109.32211249017601,-0.016038492381722266
2023-07-20T01:00:00-04:00,1.12212,1.12232,1.12189,1.12204,1.122614144,1.1222915555555557,1.1223588888888816,1.1224299999999934,1.1222165000000033,1.1209068000000015,1.1212090000000001,1.1224178000000047,1.1222622109575018,1.12234523845446,-1501,-56509,-53805.8,0.02034367831050955,-109.42912421797706,-0.04187045104274977
2023-07-20T01:15:00-04:00,1.12204,1.12229,1.12192,1.12196,1.12258317824,1.1222117777777776,1.1223222222222151,1.1223973333333268,1.1222700000000034,1.1209618000000015,1.1212036,1.1224012000000048,1.1222017687660015,1.1223065907635674,-1520,-58029,-55168,0.010222228446119141,-109.53749825098816,-0.02940416469895851
2023-07-20T01:30:00-04:00,1.12196,1.12196,1.1213899999999999,1.12144,1.1225534511104,1.1220353333333333,1.1221988888888816,1.122344444444438,1.1222760000000034,1.1210016000000014,1.1211942,1.1223815000000048,1.1220494150128013,1.1222396726108537,-1675,-59704,-56622.4,0.00031400051970320575,-110.31381826239688,-0.09888200971003024
2023-07-20T01:45:00-04:00,1.12144,1.12186,1.12132,1.12169,1.122483644043776,1.1219335555555554,1.1221033333333261,1.1222788888888826,1.1222705000000033,1.1210512000000015,1.1211896000000001,1.1223630000000049,1.121977532010241,1.1221617380886824,2541,-57163,-57282.6,-0.008919172018767199,-109.74735906707639,-0.07661128680235721
2023-07-20T02:00:00-04:00,1.12169,1.1218299999999999,1.12079,1.12091,1.122390552520274,1.121694888888889,1.1219177777777705,1.122180222222216,1.1222330000000034,1.1210742000000016,1.1211754999999999,1.1223402500000048,1.1217640256081929,1.1220509904709455,-2981,-60144,-58309.8,-0.01975700915511083,-111.82028474172803,-0.14876445331288982
2023-07-20T02:15:00-04:00,1.12091,1.1213,1.12055,1.12119,1.1222304972682466,1.1215493333333333,1.1217766666666593,1.1220637777777713,1.1221810000000034,1.1210998000000014,1.1211623,1.122318900000005,1.1216492204865542,1.121928392376756,2170,-57974,-58602.8,-0.030149559637908076,-111.27822516513433,-0.11314434367372596
2023-07-20T02:30:00-04:00,1.12119,1.12163,1.12081,1.12099,1.122028837596057,1.121392,1.1216266666666597,1.1219246666666602,1.1220965000000034,1.1211254000000013,1.1211426,1.122297400000005,1.1215173763892434,1.1217915139014045,-2331,-60305,-59058,-0.03798917104899113,-111.69403336891776,-0.12028440579503202
2023-07-20T02:45:00-04:00,1.12099,1.12111,1.12081,1.12106,1.1218513770845302,1.1212786666666665,1.1214888888888817,1.1217826666666602,1.1220205000000034,1.1211490000000015,1.121118,1.122276900000005,1.1214259011113947,1.121666811121123,2268,-58037,-58724.6,-0.04252431461340464,-111.55240855513705,-0.11048739196294483
2023-07-20T03:00:00-04:00,1.12106,1.12191,1.12081,1.12171,1.12055,1.1213228888888889,1.121443333333326,1.1216506666666601,1.1219790000000034,1.1211834000000014,1.1211171000000002,1.1222566500000049,1.1214827208891158,1.121567848896898,4053,-53984,-58088.8,-0.044091957769193474,-109.20244512766648,-0.036537981677540854
2023-07-20T03:15:00-04:00,1.12171,1.12208,1.12133,1.12144,1.1205771999999998,1.121322222222222,1.1213766666666594,1.121542444444438,1.1219215000000031,1.1212088000000013,1.1211146,1.1222348000000049,1.1214741767112926,1.1215098791175182,-3626,-57610,-57582,-0.04548614618522982,-110.07523756064825,-0.053474029446359664
2023-07-20T03:30:00-04:00,1.12144,1.12189,1.11981,1.1201699999999999,1.12208,1.1210808888888888,1.1211777777777705,1.12142266666666,1.1218150000000033,1.1212086000000014,1.1211177,1.1222059500000048,1.121213341369034,1.121422703294014,-3945,-61555,-58298.2,-0.05188763339048463,-114.54284171245344,-0.159542229669523
2023-07-20T03:45:00-04:00,1.1201699999999999,1.12056,1.1198,1.12054,1.12208,1.1209533333333332,1.1210777777777705,1.1213128888888821,1.1217165000000033,1.1212136000000015,1.1211103000000002,1.122183700000005,1.1210786730952271,1.121334962635211,3434,-58121,-57861.4,-0.05707896305247643,-113.40856745051043,-0.08025395919531146
2023-07-20T04:00:00-04:00,1.12054,1.12117,1.12049,1.12113,1.1219888,1.120963777777778,1.1210155555555483,1.1212182222222153,1.1216585000000034,1.1212384000000015,1.1210947,1.1221657500000048,1.1210889384761817,1.1212675701081682,3035,-55086,-57271.2,-0.053987483156484065,-111.81054328359127,-0.04992466724318804
2023-07-20T04:15:00-04:00,1.12113,1.12135,1.12053,1.12064,1.121901248,1.1208886666666666,1.1209855555555484,1.12112666666666,1.1215630000000032,1.1212438000000016,1.1210703000000002,1.122145100000005,1.1209991507809454,1.121170856086534,-2947,-58033,-58081,-0.056347571793856875,-113.0985562704881,-0.024087571705131764
2023-07-20T04:30:00-04:00,1.12064,1.12091,1.12009,1.12031,1.1218171980799998,1.1207535555555554,1.1208877777777704,1.1210288888888822,1.1214510000000035,1.1212470000000017,1.1210414,1.122120800000005,1.1208613206247562,1.121048284869227,-3114,-61147,-58788.4,-0.05219184963011902,-114.01555013113962,-0.07848803503420401
2023-07-20T04:45:00-04:00,1.12031,1.12098,1.12012,1.12085,1.1217365101567998,1.1207459999999998,1.120872222222215,1.120967777777771,1.1213645000000034,1.1212608000000015,1.121023,1.1220969500000049,1.1208590564998049,1.120977427895381,2761,-58386,-58154.6,-0.04800875758519671,-112.68472205676738,-0.01248896065085585
2023-07-20T05:00:00-04:00,1.12085,1.12101,1.12049,1.12083,1.1216590497505277,1.1207375555555554,1.1208466666666592,1.1209215555555487,1.1212830000000034,1.1212740000000017,1.1210063000000001,1.1220652000000049,1.1208532451998439,1.1209323423163045,-2722,-61108,-58752,-0.04200759975712355,-112.73329233824997,-0.02051629707597742
2023-07-20T05:15:00-04:00,1.12083,1.12124,1.12079,1.12103,1.1215846877605065,1.1207742222222221,1.1207711111111038,1.12087266666666,1.1212175000000033,1.1213002000000016,1.1209926000000001,1.1220364000000047,1.1208885961598751,1.1208922738530431,2178,-58930,-59520.8,-0.03620466400979757,-112.34465177723719,-0.06062172932397981
2023-07-20T05:30:00-04:00,1.12103,1.12141,1.12099,1.12109,1.121513300250086,1.120838,1.120732222222215,1.120821999999993,1.1211570000000033,1.1213232000000017,1.1209817000000002,1.1220102000000047,1.1209288769279,1.120878219082434,2248,-56682,-59250.6,-0.03642743563054761,-112.2243338553262,-0.031209873020408802
2023-07-20T05:45:00-04:00,1.12109,1.12142,1.12108,1.1212,1.1214447682400828,1.1209315555555557,1.1208466666666594,1.120813777777771,1.1211110000000033,1.1213486000000017,1.1209615000000002,1.1219892500000048,1.12098310154232,1.1209025752659465,2320,-54362,-57893.6,-0.033897743576292654,-111.99669825069131,0.09195032896793223
2023-07-20T06:00:00-04:00,1.1212,1.12127,1.12036,1.12084,1.12142,1.120930222222222,1.1208799999999928,1.1208153333333266,1.1210510000000036,1.1213640000000016,1.1209348,1.1219696500000047,1.1209544812338559,1.120921660212757,-2163,-56525,-57521.4,-0.022486456730484293,-112.69120413724127,0.026772805968547926
2023-07-20T06:15:00-04:00,1.12084,1.12124,1.12084,1.12109,1.12142,1.1209722222222223,1.1208755555555483,1.1208211111111042,1.1210075000000033,1.1213848000000017,1.1209073,1.121951200000005,1.1209815849870848,1.120947328170205,2049,-54476,-56195,-0.01354593959475238,-112.23418083329092,-0.003567828886930151
2023-07-20T06:30:00-04:00,1.12109,1.12167,1.12094,1.12125,1.1198,1.1210471111111113,1.1209433333333263,1.1208555555555488,1.1209980000000033,1.1214114000000017,1.1208845,1.1219377000000048,1.1210352679896678,1.1209766625361635,2153,-52323,-54873.6,-0.009459930165256068,-111.92690844659552,0.054433181039405996
2023-07-20T06:45:00-04:00,1.12125,1.12125,1.12014,1.12041,1.1198374,1.1209404444444444,1.1209544444444373,1.1208999999999931,1.1209340000000032,1.1214178000000017,1.1208590999999999,1.1219212500000049,1.1209102143917342,1.1209729300289304,-2702,-55025,-54542.2,-0.007136676271133676,-113.95114924927152,0.008926100811381581
2023-07-20T07:00:00-04:00,1.12041,1.12054,1.11999,1.11999,1.119874052,1.1207475555555555,1.1208588888888817,1.1209024444444378,1.1208880000000034,1.1214150000000016,1.1208388999999999,1.1219005500000048,1.1207261715133874,1.120921544023144,-2298,-57323,-55134.4,-0.002769910109310616,-114.81258390265707,-0.07672748360617933
2023-07-20T07:15:00-04:00,1.11999,1.1205,1.11985,1.1204,1.12167,1.120655777777778,1.1208111111111039,1.12088866666666,1.1208485000000032,1.1214160000000015,1.1208197,1.1218804500000048,1.12066093721071,1.1208628352185148,2239,-55084,-54846.2,-0.0046180330150138475,-113.99294265586018,-0.038364426362600075
2023-07-20T07:30:00-04:00,1.1204,1.12124,1.1203,1.12085,1.1216336,1.1206635555555557,1.120791111111104,1.120871777777771,1.1208415000000034,1.1214276000000016,1.1208086,1.1218648000000049,1.1206987497685679,1.1208062681748114,2211,-52873,-54525.6,-0.002995179672235347,-113.1049115955249,-0.016056662176754322
2023-07-20T07:45:00-04:00,1.12085,1.12127,1.12051,1.12069,1.121597928,1.1206433333333334,1.1207466666666595,1.1208324444444377,1.1208230000000035,1.1214342000000017,1.1207998000000001,1.121843850000005,1.1206969998148544,1.120738614539849,-2486,-55359,-55132.8,-0.004754111732813205,-113.45978512900382,-0.03567956185497649
2023-07-20T08:00:00-04:00,1.12069,1.12069,1.11932,1.11966,1.12156296944,1.120426,1.1205755555555486,1.1207566666666602,1.1207205000000033,1.1214182000000017,1.1207863,1.1218180000000049,1.1204895998518836,1.1206544916318788,-4229,-59588,-56045.4,-0.01156520276037074,-117.34656024076482,-0.13735283624686717
2023-07-20T08:15:00-04:00,1.11966,1.11994,1.1191,1.11947,1.1214732506624001,1.120204888888889,1.1204233333333262,1.120669555555549,1.1206220000000033,1.1213978000000018,1.1207676,1.121790150000005,1.1202856798815068,1.1205663933055026,-3686,-63274,-57235.6,-0.01748542951664732,-117.97205369413503,-0.12222975625424622
2023-07-20T08:30:00-04:00,1.11947,1.11947,1.11768,1.11794,1.121330855622656,1.1197082222222223,1.1200733333333264,1.1205219999999936,1.1205105000000033,1.1213420000000016,1.120731,1.121751450000005,1.1198165439052055,1.1203975146444018,-9483,-72757,-60770.2,-0.02849507742726922,-130.9326421869042,-0.2809765496079696
2023-07-20T08:45:00-04:00,1.11794,1.11859,1.11779,1.11825,1.1210387871728436,1.1193435555555555,1.119739999999993,1.1203117777777714,1.1203960000000035,1.1212892000000017,1.1207003,1.121714050000005,1.1195032351241643,1.120158411715521,5161,-67596,-63714.8,-0.045685097961927996,-129.50151887080477,-0.2675585284281038
2023-07-20T09:00:00-04:00,1.11825,1.11853,1.11719,1.11759,1.120770084199016,1.1189135555555556,1.1194266666666597,1.1200477777777713,1.1202190000000034,1.1212146000000016,1.1206565,1.121677550000005,1.1191205880993313,1.1198431293724165,-5696,-73292,-67301.4,-0.06582216496020797,-132.86334314981156,-0.251693576458602
2023-07-20T09:15:00-04:00,1.11759,1.1187,1.11759,1.11862,1.1204120757791145,1.1187522222222221,1.1192744444444376,1.1197875555555492,1.1201180000000035,1.1211510000000018,1.1206283000000001,1.121645000000005,1.119020470479465,1.119549303497933,3689,-69603,-69304.4,-0.07113888534596044,-129.46346484023513,-0.12232252073680062
2023-07-20T09:30:00-04:00,1.11862,1.1188,1.11787,1.11797,1.120089868201203,1.1184913333333333,1.1190044444444376,1.1195037777777714,1.1200010000000034,1.1210772000000018,1.1205923999999998,1.121613450000005,1.118810376383572,1.1192542427983458,-5225,-74828,-71615.2,-0.07783054064261931,-132.49957182920386,-0.2168868261335375
2023-07-20T09:45:00-04:00,1.11797,1.11849,1.11791,1.11832,1.1197998813810828,1.1183544444444444,1.1187233333333264,1.1192337777777717,1.1198745000000034,1.1209990000000016,1.1205585,1.1215784000000049,1.1187123011068576,1.1190333942386763,4183,-70645,-71192.8,-0.08794838411183005,-131.19001074974707,-0.22572155060890586
2023-07-20T10:00:00-04:00,1.11832,1.11886,1.11642,1.11662,1.1195388932429744,1.1179337777777776,1.118271111111104,1.1189399999999936,1.1196640000000033,1.1208778000000017,1.1205055,1.121537500000005,1.1182938408854861,1.1187915153909407,-7116,-77761,-73225.8,-0.10775232402984589,-142.00730812438067,-0.3631691190248881
2023-07-20T10:15:00-04:00,1.11662,1.11675,1.11485,1.11486,1.1191646260538175,1.1172515555555558,1.1177377777777706,1.118602222222216,1.1193555000000033,1.1207234000000017,1.1204402999999998,1.121487750000005,1.1176070727083889,1.118488812312752,-7306,-85067,-75580.8,-0.13446406223516302,-153.52291773194625,-0.4287015701195128
2023-07-20T10:30:00-04:00,1.11486,1.11503,1.11403,1.11432,1.11886,1.116568,1.1171655555555484,1.118180444444438,1.1190170000000035,1.1205590000000016,1.1203638999999999,1.1214464000000048,1.116949658166711,1.1180746498502014,-6234,-91301,-79920.4,-0.15366724492906164,-156.54245381719454,-0.46003912565767624
2023-07-20T10:45:00-04:00,1.11432,1.1147799999999999,1.11412,1.11468,1.1180872,1.1160708888888888,1.1168033333333263,1.1177402222222157,1.1186910000000032,1.1204008000000016,1.1202971999999998,1.1214000500000048,1.1164957265333688,1.1176117198801607,5974,-85327,-82020.2,-0.1692401198208489,-154.6124516634151,-0.2916077785927725
2023-07-20T11:00:00-04:00,1.11468,1.11525,1.11465,1.11484,1.117438048,1.1156782222222221,1.1164244444444373,1.1172804444444382,1.1183910000000032,1.1202516000000016,1.1202526,1.1213570000000048,1.1161645812266952,1.1171021759041284,3404,-81923,-84275.8,-0.16992455082549654,-154.12384506779972,-0.30494075564497325
2023-07-20T11:15:00-04:00,1.11484,1.11492,1.11414,1.11421,1.1168927603199998,1.1152353333333334,1.1160488888888818,1.1168359999999935,1.1180470000000033,1.1200856000000017,1.1202056999999999,1.1213122500000048,1.115773664981356,1.1165981407233023,-3411,-85334,-85790.4,-0.1778679270911704,-156.05141314931853,-0.3024364928104368
2023-07-20T11:30:00-04:00,1.11421,1.11429,1.11351,1.1136,1.1164347186688,1.1147455555555554,1.1154911111111039,1.1163866666666604,1.1176645000000032,1.1199118000000015,1.1201541,1.1212662000000049,1.1153389319850848,1.1161445125786416,-2554,-87888,-86354.6,-0.1817117609117358,-157.44965944041266,-0.4487672310525491
2023-07-20T11:45:00-04:00,1.1136,1.1137,1.11319,1.11347,1.115908269308416,1.1143413333333332,1.114991111111104,1.1159517777777714,1.1173175000000033,1.1197302000000016,1.1200982,1.1212204000000048,1.1149651455880678,1.1157476100629127,-3389,-91277,-86349.8,-0.19470519151313187,-157.84528623638957,-0.4025152732184181
2023-07-20T12:00:00-04:00,1.11347,1.11387,1.11332,1.11334,1.1153646154467327,1.114011111111111,1.1144377777777708,1.1154786666666603,1.1169850000000032,1.1195460000000017,1.1200351,1.1211704500000048,1.1146401164704542,1.1153764880503299,-2598,-93875,-88059.4,-0.20607262926289655,-158.14860828368307,-0.44531082337792266
2023-07-20T12:15:00-04:00,1.11334,1.11345,1.11267,1.11287,1.1149296923573861,1.1136975555555557,1.114021111111104,1.1149979999999935,1.116608500000003,1.1193518000000016,1.1199659,1.1211174500000047,1.1142860931763634,1.1150007904402635,-2998,-96873,-91049.4,-0.22457666686392358,-159.41422345964003,-0.3358349304149953
2023-07-20T12:30:00-04:00,1.11287,1.11292,1.11196,1.11201,1.114477753885909,1.113295333333333,1.1137044444444373,1.1145291111111046,1.1161665000000032,1.1191428000000017,1.1198915999999999,1.1210590500000048,1.1138308745410908,1.1146122323522105,-2414,-99287,-93840,-0.23016373360010778,-161.2797064001454,-0.2556374791453653
2023-07-20T12:45:00-04:00,1.11201,1.11243,1.11184,1.11241,1.1139742031087272,1.1130364444444443,1.113492222222215,1.1141293333333269,1.115752500000003,1.1189442000000016,1.1198217,1.1210027000000047,1.1135466996328727,1.1142537858817678,2299,-96988,-95660,-0.21618690086135464,-160.45273541966867,-0.17140498241080465
2023-07-20T13:00:00-04:00,1.11241,1.11265,1.11232,1.11241,1.1135473624869818,1.1128200000000001,1.113239999999993,1.1137791111111046,1.115390000000003,1.1187464000000016,1.1197597,1.1209441500000048,1.113319359706298,1.113924628705414,0,-96988,-96802.2,-0.1980411021934472,-160.45273541966867,-0.2036458894032363
2023-07-20T13:15:00-04:00,1.11241,1.11267,1.11218,1.11266,1.1132058899895854,1.112704,1.1129977777777706,1.1134911111111045,1.115049500000003,1.1185572000000017,1.1197039999999998,1.1208930000000048,1.1131874877650385,1.1136341029643309,2044,-94944,-97016,-0.1863242651934697,-159.99337241502096,-0.19554375515769712
2023-07-20T13:30:00-04:00,1.11266,1.11334,1.11244,1.11333,1.11184,1.1127704444444444,1.1128999999999931,1.1132668888888824,1.114819000000003,1.1183830000000017,1.1196449,1.1208471000000046,1.1132159902120309,1.1134200823714644,1999,-92945,-96230.4,-0.1736928512121264,-158.78965339932893,-0.078979725545453
2023-07-20T13:45:00-04:00,1.11333,1.11346,1.11301,1.11302,1.11187,1.1127944444444444,1.1128355555555485,1.1130931111111046,1.114557500000003,1.1182042000000016,1.1195829999999998,1.120800950000005,1.1131767921696247,1.1132892658971714,-1266,-94211,-95215.2,-0.16338735721518916,-159.14216343678416,-0.05208333333333558
2023-07-20T14:00:00-04:00,1.11302,1.11306,1.11275,1.11281,1.1119336,1.1127893333333332,1.112762222222215,1.1129471111111047,1.1143185000000029,1.1180316000000017,1.1195165999999999,1.1207529500000049,1.1131034337356998,1.1132006127177365,-1469,-95680,-94953.6,-0.14726994918779376,-159.41932826760458,-0.059274160956279284
2023-07-20T14:15:00-04:00,1.11281,1.11289,1.11241,1.11242,1.111994656,1.1127208888888889,1.112659999999993,1.1128311111111047,1.1140085000000028,1.1178462000000016,1.1194486999999997,1.1207016500000049,1.1129667469885598,1.113130090174189,-1534,-97214,-94998.8,-0.13463089330655767,-159.9569402588701,-0.08263423572314225
2023-07-20T14:30:00-04:00,1.11242,1.11275,1.11232,1.1127,1.11205326976,1.1127288888888889,1.112641111111104,1.1127597777777714,1.1137450000000029,1.1176820000000014,1.1193780999999998,1.1206565500000047,1.1129133975908478,1.1130752721393509,1698,-95516,-95113.2,-0.11510344818713,-159.52954772727225,-0.015275818379505555
2023-07-20T14:45:00-04:00,1.1127,1.11304,1.11258,1.11263,1.1121095389696,1.1127266666666666,1.112709999999993,1.1127217777777711,1.1134605000000029,1.1175108000000016,1.1193053,1.120612500000005,1.1128567180726783,1.1130034177114803,-1835,-97351,-95994.4,-0.09445204346047736,-159.64498764818535,0.05575489429052481
2023-07-20T15:00:00-04:00,1.11263,1.113,1.11262,1.11298,1.112163557410816,1.1127806666666666,1.1127733333333265,1.112709333333327,1.113278500000003,1.1173506000000015,1.119238,1.1205693500000047,1.1128813744581427,1.112944334169184,1562,-95789,-96310,-0.06292396050128563,-159.15362933499938,0.051240100322739054
2023-07-20T15:15:00-04:00,1.11298,1.11306,1.11284,1.1129,1.1122154151143833,1.112806,1.1128277777777709,1.1127224444444381,1.1131805000000028,1.1171874000000017,1.1191682,1.1205244000000047,1.1128850995665143,1.1129006673353468,-1168,-96957,-96565.4,-0.04262041100179453,-159.23758412304596,0.044048507294981304
2023-07-20T15:30:00-04:00,1.1129,1.11335,1.1129,1.11329,1.112265198509808,1.1128984444444445,1.1128977777777709,1.1127699999999936,1.113129000000003,1.1170190000000015,1.1191012,1.120481700000005,1.1129660796532115,1.1129005338682771,1714,-95243,-96171.2,-0.028002001975992404,-158.63693716464914,0.056621070228093796
2023-07-20T15:45:00-04:00,1.11329,1.11329,1.11294,1.1132,1.1123129905694156,1.112958888888889,1.1128833333333263,1.112818444444438,1.1130550000000028,1.1168542000000017,1.1190315,1.1204383000000049,1.1130128637225691,1.1129204270946214,-1590,-96833,-96434.6,-0.01836088464186913,-158.76547510175436,-0.011676681666708297
2023-07-20T16:00:00-04:00,1.1132,1.11323,1.11286,1.11288,1.112358870946639,1.1129582222222223,1.112867777777771,1.1128499999999937,1.1129570000000029,1.1167084000000016,1.1189585000000002,1.1203913000000048,1.1129862909780552,1.1129463416756968,-675,-97508,-96466,-0.014704384961118503,-158.95951031555234,-0.012578390325403583
2023-07-20T16:15:00-04:00,1.11288,1.11301,1.11286,1.1129499999999999,1.1124029161087734,1.1129746666666667,1.1128833333333263,1.1128719999999936,1.1128940000000027,1.1165566000000016,1.1188851000000002,1.1203438000000048,1.1129790327824443,1.1129658733405572,463,-97045,-96717.2,-0.007247961136268473,-158.93038767879014,0.01258076401180857
2023-07-20T16:30:00-04:00,1.1129499999999999,1.11299,1.11292,1.11293,1.1124451994644224,1.112984,1.1129399999999932,1.112894444444438,1.1128605000000027,1.1163926000000015,1.1188155000000002,1.120295000000005,1.1129692262259554,1.1129826986724454,-202,-97247,-96775.2,-0.0006931723801530403,-158.93401767115276,0.04584599341975247
2023-07-20T16:45:00-04:00,1.11293,1.11308,1.1128,1.11291,1.1124857914858455,1.112978,1.1129633333333266,1.112907555555549,1.1128325000000028,1.1162380000000016,1.1187409000000001,1.1202451000000047,1.1129573809807642,1.112980958937956,-1136,-98383,-97403.2,0.0066623534670186505,-158.95443225248303,0.018873011593425314
2023-07-20T17:00:00-04:00,1.11291,1.11325,1.11263,1.11323,1.1125247598264116,1.1130313333333333,1.1130299999999933,1.1129368888888824,1.1128270000000027,1.1160964000000015,1.1186717000000002,1.1201984500000046,1.1130119047846114,1.1129807671503644,206,-98177,-97672,0.012451925298967562,-158.8952001492582,0.05392628277144549
2023-07-20T17:15:00-04:00,1.11323,1.11325,1.11305,1.1131,1.1125621694333552,1.1130453333333332,1.1130433333333267,1.1129719999999934,1.1128385000000027,1.1159414000000014,1.1186011000000002,1.1201509500000046,1.113029523827689,1.1129894137202911,-55,-98232,-97816.8,0.01770245498031064,-158.90162290107048,0.010781864903223594
2023-07-20T17:30:00-04:00,1.1131,1.11334,1.1129499999999999,1.11311,1.112598082656021,1.1130586666666669,1.11306666666666,1.11300866666666,1.1128935000000026,1.1157870000000016,1.1185305,1.1201028000000048,1.1130456190621512,1.1130027309762327,601,-97631,-97934,0.017843480582943886,-158.89622356588043,0.018869619911945683
2023-07-20T17:45:00-04:00,1.11311,1.11352,1.1131,1.11349,1.1126325593497801,1.1131433333333334,1.1130888888888821,1.113038444444438,1.1129475000000026,1.1156362000000017,1.1184682000000001,1.1200552000000048,1.1131344952497209,1.1130357847809857,1675,-95956,-97675.8,0.016811174018363673,-158.32440227238735,0.017964771083922432
2023-07-20T18:00:00-04:00,1.11349,1.11368,1.11311,1.11365,1.1126858057887934,1.1132555555555554,1.1131388888888822,1.1130735555555489,1.1130095000000026,1.1154874000000017,1.1184053000000003,1.1200084500000047,1.1132375961997767,1.1130918278247883,768,-95188,-97036.8,0.01473948127318542,-158.21404654400186,0.04042400287460128
2023-07-20T18:15:00-04:00,1.11365,1.11365,1.1134,1.1135,1.11276534132569,1.1133277777777777,1.1132077777777711,1.1131091111111044,1.1130515000000025,1.1153334000000017,1.1183410000000003,1.1199606000000046,1.1132900769598213,1.11314746225983,-612,-95800,-96561.4,0.012770769185613613,-158.29647818769607,0.05571130759828938
2023-07-20T18:30:00-04:00,1.1135,1.11352,1.11329,1.1133,1.1128385140196349,1.1133462222222223,1.11324666666666,1.1131497777777712,1.1130500000000025,1.1151826000000016,1.1182733000000002,1.1199124500000048,1.113292061567857,1.1131999698078636,-508,-96308,-96176.6,0.013805743309260078,-158.38772201347064,0.031447953636737726
2023-07-20T18:45:00-04:00,1.1133,1.11353,1.11329,1.11351,1.112905832898064,1.1133988888888888,1.1133111111111045,1.1131986666666602,1.1130745000000029,1.1150310000000014,1.1182079000000003,1.1198659500000048,1.1133356492542856,1.1132579758462906,321,-95987,-95847.8,0.018066688884846645,-158.32717229641324,0.05211468825532827
2023-07-20T19:00:00-04:00,1.11351,1.11366,1.11345,1.1136,1.112967766266219,1.1134566666666668,1.113387777777771,1.113258444444438,1.1131140000000026,1.1148780000000016,1.1181447000000002,1.1198207500000048,1.1133885194034285,1.1133087806770323,651,-95336,-95723.8,0.021604194893197787,-158.2745548973778,0.061999622610979986
2023-07-20T19:15:00-04:00,1.1136,1.11362,1.11343,1.11346,1.1130247449649215,1.113471111111111,1.1134133333333265,1.113313333333327,1.1131660000000028,1.1147390000000015,1.1180784000000004,1.1197737000000048,1.113402815522743,1.1133418245416256,-382,-95718,-95829.8,0.023763953569194814,-158.32257932266518,0.020660600235346917
2023-07-20T19:30:00-04:00,1.11346,1.11368,1.11344,1.11367,1.1130771653677278,1.1135224444444445,1.1134766666666598,1.1133671111111045,1.1132145000000029,1.1146126000000016,1.1180138000000002,1.1197280500000049,1.1134562524181943,1.1133750596333,1193,-94525,-95574.8,0.022368149193134318,-158.09757797551302,0.05120833707662918
2023-07-20T19:45:00-04:00,1.11367,1.1138,1.11334,1.11345,1.1131253921383095,1.1135171111111113,1.1135144444444376,1.1134206666666602,1.1132555000000028,1.1144736000000015,1.1179448000000003,1.1196807500000048,1.1134550019345555,1.1134076477066397,-942,-95467,-95406.6,0.02230326798081421,-158.28366541613715,0.03054504945602923
2023-07-20T20:00:00-04:00,1.11345,1.1135,1.11298,1.1134,1.1138,1.1134942222222224,1.1135044444444373,1.1134593333333267,1.1132765000000027,1.1143246000000016,1.1178761000000002,1.119631950000005,1.1134440015476443,1.1134293181653114,-1894,-97361,-95681.4,0.02161386675223873,-158.36871638385028,-0.00808269495012488
2023-07-20T20:15:00-04:00,1.1134,1.11351,1.11332,1.11335,1.1138,1.1134633333333335,1.113471111111104,1.1134759999999935,1.113299000000003,1.1141778000000018,1.1178060000000003,1.119583500000005,1.1134252012381154,1.1134366545322487,-1214,-98575,-96329.2,0.01877335441243801,-158.42323407740145,-0.02693844565168293
2023-07-20T20:30:00-04:00,1.11335,1.11354,1.11298,1.11341,1.1137835999999999,1.1134511111111112,1.1134611111111041,1.113485555555549,1.1133050000000029,1.1140528000000018,1.1177355000000002,1.119534650000005,1.1134221609904924,1.1134405236257987,1656,-96919,-96569.4,0.01443579152431298,-158.3339899044101,-0.008082622361914996
2023-07-20T20:45:00-04:00,1.11341,1.11381,1.11333,1.11374,1.11298,1.1135068888888888,1.1135099999999931,1.1134922222222159,1.1133320000000029,1.1139382000000018,1.117668,1.119487600000005,1.1134857287923938,1.1134464189006388,1743,-95176,-96699.6,0.014666481892329592,-157.81738775425885,0.039522141381478124
2023-07-20T21:00:00-04:00,1.11374,1.11387,1.1131,1.1133899999999999,1.11298,1.1134828888888888,1.1134966666666597,1.1134886666666601,1.1133575000000029,1.1138472000000017,1.1175946000000003,1.1194394500000049,1.113466583033915,1.1134487351205105,-2614,-97790,-97164.2,0.014662085549297814,-158.63885416473184,-0.010776733033391708
2023-07-20T21:15:00-04:00,1.1133899999999999,1.11367,1.11321,1.11357,1.1130156,1.1134975555555555,1.1134933333333263,1.113486444444438,1.113388500000003,1.1137536000000017,1.1175214000000002,1.119394500000005,1.113487266427132,1.113457388096408,2673,-95117,-96715.4,0.012249408914929032,-158.20671448321846,-0.002693965517239089
2023-07-20T21:30:00-04:00,1.11357,1.11405,1.11354,1.11387,1.113049776,1.113572888888889,1.1135388888888818,1.1134999999999935,1.1134355000000031,1.1136792000000018,1.1174469000000002,1.1193504000000047,1.1135638131417056,1.1134851104771262,3660,-91457,-95291.8,0.010739195368924271,-157.22069654092488,0.036822157958078555
2023-07-20T21:45:00-04:00,1.11387,1.11394,1.11374,1.11392,1.11310978944,1.1136491111111113,1.1135666666666597,1.1135211111111043,1.113486000000003,1.1135852000000017,1.1173681000000004,1.119306050000005,1.1136350505133645,1.1135276883817005,1986,-89471,-93802.2,0.010636100387583385,-157.13154789700752,0.022448301561511355
2023-07-20T22:00:00-04:00,1.11392,1.11406,1.11374,1.11401,1.1131662020736,1.1137377777777777,1.113628888888882,1.1135448888888821,1.113525000000003,1.1135060000000017,1.1172916000000004,1.1192619000000048,1.1137100404106917,1.11357255070536,1893,-87578,-92282.6,0.008984879658015182,-156.97860154538455,0.05029413085454164
2023-07-20T22:15:00-04:00,1.11401,1.11406,1.11369,1.11374,1.1132377059077119,1.11376,1.1136666666666597,1.1135788888888822,1.1135570000000032,1.1134144000000017,1.1172067000000003,1.119214250000005,1.1137160323285533,1.1136224405642876,-1513,-89091,-90542.8,0.009408045760987057,-157.3453038191523,0.030537093587210972
2023-07-20T22:30:00-04:00,1.11374,1.1141,1.11358,1.11404,1.1133034894350948,1.1138346666666665,1.1137433333333262,1.1136288888888821,1.113603500000003,1.1133628000000015,1.1171203000000005,1.1191683000000048,1.1137808258628425,1.1136811524514296,1746,-87345,-88988.4,0.011135257458168903,-156.87499656611303,0.06197512013291933
2023-07-20T22:45:00-04:00,1.11404,1.11419,1.11381,1.11394,1.1133831404915853,1.113874,1.113802222222215,1.1136815555555486,1.1136260000000031,1.1133444000000017,1.1170339000000002,1.1191232000000049,1.113812660690274,1.1137309219611433,-1311,-88656,-88428.2,0.01288377110956551,-156.9926763621706,0.04760151247069089
2023-07-20T23:00:00-04:00,1.11394,1.11405,1.1137,1.11379,1.113479963632595,1.1138715555555556,1.1138077777777706,1.1137297777777708,1.1136330000000032,1.1133338000000017,1.1169464000000004,1.119078000000005,1.1138081285522192,1.1137655375689142,-1366,-90022,-88538.4,0.015013056784308578,-157.1766180466418,0.004489378131350721
2023-07-20T23:15:00-04:00,1.11379,1.11389,1.11368,1.11387,1.1135651679966836,1.113884,1.1138611111111039,1.1137762222222154,1.1136515000000031,1.1133176000000018,1.1168592000000004,1.119036350000005,1.1138205028417754,1.113787630055131,1132,-88890,-88800.8,0.01523954173643767,-157.09531008014918,0.043111578153211004
2023-07-20T23:30:00-04:00,1.11387,1.11398,1.11355,1.1136,1.11419,1.1138317777777778,1.1138644444444372,1.1138157777777709,1.113666500000003,1.1132928000000015,1.1167722000000004,1.1189897000000049,1.1137764022734202,1.1137997040441046,-998,-89888,-88960.2,0.01669757464009231,-157.33722340935276,0.0026940380936963542
2023-07-20T23:45:00-04:00,1.1136,1.1137,1.11347,1.11361,1.1141772,1.1137808888888887,1.1138355555555484,1.1138342222222153,1.113671500000003,1.1132808000000016,1.1166832000000004,1.118945150000005,1.1137431218187361,1.1137921632352832,1002,-88886,-89268.4,0.015731002003915875,-157.32822556452513,-0.023342041710426437
2023-07-21T00:00:00-04:00,1.11361,1.1137299999999999,1.11344,1.11371,1.114148912,1.1137557777777778,1.113812222222215,1.1138362222222153,1.1136770000000031,1.1132830000000016,1.1165974000000005,1.118902850000005,1.1137364974549888,1.1137769305882261,1103,-87783,-89093.8,0.01343900964400502,-157.22917832177407,-0.018852341281244925
2023-07-21T00:15:00-04:00,1.11371,1.11384,1.11365,1.1138,1.1141063772800002,1.1137533333333334,1.1137888888888818,1.1138324444444376,1.113694000000003,1.1132896000000017,1.1165099000000003,1.1188630000000048,1.113749197963991,1.1137651444705805,995,-86788,-88447,0.011506225163088487,-157.14877139357918,-0.018850818215280247
2023-07-21T00:30:00-04:00,1.1138,1.11386,1.11374,1.11385,1.1140663946432001,1.1137655555555557,1.113801111111104,1.1138204444444375,1.113703000000003,1.1132998000000016,1.1164229000000003,1.118821700000005,1.113769358371193,1.113754915576464,840,-85948,-87858.6,0.008401841478639316,-157.1110626487416,0.009876631888955637
2023-07-21T00:45:00-04:00,1.11385,1.11398,1.11365,1.11395,1.1140288109646082,1.1137953333333332,1.113791111111104,1.1138057777777708,1.1137280000000032,1.1133214000000018,1.1163366000000003,1.118780650000005,1.1138054866969544,1.113760732461171,1311,-84637,-86808.4,0.009090127805022146,-156.99336277892073,-0.008078704534839278
2023-07-21T01:00:00-04:00,1.11395,1.11416,1.11386,1.11389,1.11344,1.1138151111111112,1.1137855555555485,1.113795777777771,1.113752500000003,1.1133590000000018,1.1162509000000005,1.118738000000005,1.1138223893575636,1.1137765859689366,-1380,-86017,-86234.6,0.0058618677169817186,-157.06769286554933,-0.004488572095434537
2023-07-21T01:15:00-04:00,1.11389,1.1139,1.11359,1.11374,1.1134544,1.113806,1.1137799999999929,1.1137893333333264,1.113772000000003,1.1133856000000018,1.1161649000000005,1.118694200000005,1.1138059114860508,1.113790468775149,-1126,-87143,-86106.6,0.0026123625893063737,-157.21932363699005,-0.004489176595238376
2023-07-21T01:30:00-04:00,1.11374,1.11385,1.11338,1.11377,1.11416,1.1138039999999998,1.1137688888888817,1.1137853333333265,1.1137900000000032,1.1134128000000016,1.1160796000000004,1.118649700000005,1.1137987291888407,1.1138003750201189,1506,-85637,-85876.4,0.0006370458859112168,-157.1787576161953,-0.008977708350165549
2023-07-21T01:45:00-04:00,1.11377,1.11437,1.1137,1.1143,1.11338,1.1139102222222221,1.1138466666666595,1.1137944444444376,1.113818000000003,1.1134456000000017,1.1160014000000005,1.118608100000005,1.1138989833510726,1.1138263000160946,1826,-83811,-85449,0.0006926007159209158,-156.30983494813972,0.06285919540231187
2023-07-21T02:00:00-04:00,1.1143,1.11435,1.11369,1.11416,1.11338,1.1139728888888887,1.1139077777777706,1.1138177777777707,1.113856500000003,1.1134622000000016,1.1159226000000004,1.1185658000000052,1.113951186680858,1.1138554400128755,-3709,-87520,-86025.6,0.0039246669165672295,-156.77583153792713,0.04938892430923308
2023-07-21T02:15:00-04:00,1.11416,1.11448,1.11389,1.11443,1.1133998,1.1140773333333334,1.1139877777777707,1.113858222222215,1.113899500000003,1.1134904000000017,1.1158473000000004,1.1185254500000053,1.1140469493446865,1.1139003520103,2020,-85500,-85922.2,0.006840073941446292,-156.28631477193304,0.06464878648840847
2023-07-21T02:30:00-04:00,1.11443,1.11449,1.11418,1.11437,1.113443008,1.114153777777778,1.114051111111104,1.1139124444444373,1.1139245000000029,1.1135216000000017,1.1157766000000005,1.118485400000005,1.1141115594757491,1.1139614816082397,-2546,-88046,-86102.8,0.009344931422278125,-156.42338933022728,0.051176153708042876
2023-07-21T02:45:00-04:00,1.11437,1.11438,1.11353,1.11429,1.11350582752,1.1142015555555556,1.1140999999999928,1.1139786666666596,1.113943000000003,1.1135590000000015,1.1157026000000005,1.1184461000000052,1.1141472475805994,1.1140311852865914,-2503,-90549,-87085.2,0.011948131004752791,-156.60307830247186,0.039502626026843464
2023-07-21T03:00:00-04:00,1.11429,1.11447,1.11371,1.11379,1.11353,1.1141395555555555,1.114082222222215,1.1140257777777707,1.1139320000000028,1.1135808000000018,1.1156314000000007,1.118403450000005,1.1140757980644795,1.1140665482292729,-4138,-94687,-89260.4,0.011965296792181166,-158.45986603277527,-0.014363301763987429
2023-07-21T03:15:00-04:00,1.11379,1.11391,1.11344,1.11365,1.11449,1.114053111111111,1.1140555555555482,1.1140553333333263,1.113927500000003,1.1136012000000017,1.1155560000000007,1.118359150000005,1.1139906384515836,1.114074438583418,-3124,-97811,-91318.6,0.010811254477686437,-158.85254328791322,-0.021546113170961043
2023-07-21T03:30:00-04:00,1.11365,1.11369,1.11256,1.1129,1.11447,1.113822,1.113962222222215,1.114050222222215,1.1138705000000029,1.1135996000000017,1.1154751000000005,1.1183088500000051,1.1137725107612668,1.1140195508667339,-6568,-104379,-95094.4,0.005514835549133306,-163.27583606392022,-0.07542155260652862
2023-07-21T03:45:00-04:00,1.1129,1.11315,1.11248,1.1127799999999999,1.1143936,1.1135855555555556,1.1138522222222151,1.1140104444444372,1.113812500000003,1.1135972000000016,1.1153923000000006,1.118255150000005,1.1135740086090133,1.113912040693387,-3901,-108280,-99141.2,0.0022830083896681445,-163.6964668483577,-0.08888729270855261
2023-07-21T04:00:00-04:00,1.1127799999999999,1.11324,1.1125099999999999,1.11263,1.1142787840000001,1.1133411111111111,1.1136666666666595,1.1139237777777706,1.1137545000000029,1.1135840000000017,1.1153015000000004,1.118209300000005,1.1133852068872108,1.1137596325547094,-4557,-112837,-103598.8,-0.0023515448364307616,-164.31073921126807,-0.14986987346316613
2023-07-21T04:15:00-04:00,1.11263,1.11333,1.11213,1.1133,1.1141708569600002,1.1132677777777777,1.113571111111104,1.1138215555555484,1.1137260000000029,1.1135860000000017,1.1152201000000006,1.118167350000005,1.1133681655097687,1.113618106043767,4100,-108737,-106408.8,-0.009235351385604324,-161.84181423171532,-0.07718819559130492
2023-07-21T04:30:00-04:00,1.1133,1.11377,1.11323,1.1135,1.1140075884032001,1.1132535555555554,1.1134677777777706,1.1137039999999927,1.1137210000000028,1.1135984000000017,1.1151534000000007,1.118135550000005,1.113394532407815,1.1134988848350136,3484,-105253,-107897.2,-0.013579601864274963,-161.21592722911052,-0.08345073266154872
2023-07-21T04:45:00-04:00,1.1135,1.1135,1.11265,1.11281,1.113857381330944,1.113122,1.1132944444444373,1.1135704444444374,1.1136810000000028,1.1135956000000016,1.1150761000000005,1.1180932000000048,1.113277625926252,1.1133999078680106,-3561,-108814,-108784.2,-0.024748548673518507,-163.42256396013835,-0.13998941105736926
2023-07-21T05:00:00-04:00,1.11281,1.11321,1.11272,1.1127799999999999,1.11377,1.1130191111111112,1.1131266666666597,1.1134253333333262,1.1136345000000027,1.1135926000000014,1.1149926000000006,1.1180436500000048,1.1131781007410015,1.113320726294408,-3474,-112288,-109585.8,-0.03547788458220179,-163.516218761947,-0.1355122993116803
2023-07-21T05:15:00-04:00,1.1127799999999999,1.11314,1.11231,1.11288,1.1136388,1.1129697777777776,1.1130255555555484,1.113297111111104,1.1135885000000028,1.1135920000000015,1.1149150000000005,1.1179926500000048,1.1131184805928012,1.113267381035526,3597,-108691,-108756.6,-0.044591600717596956,-163.19297427516545,-0.08170301403316302
2023-07-21T05:30:00-04:00,1.11288,1.1131,1.1122,1.11239,1.113518096,1.1128426666666666,1.1128855555555484,1.113159999999993,1.1135155000000028,1.1135752000000014,1.1148358000000007,1.117938600000005,1.112972784474241,1.1131883048284206,-3358,-112049,-109419,-0.05113718003952607,-164.67149846465608,-0.11314147173708426
2023-07-21T05:45:00-04:00,1.11239,1.11281,1.11229,1.11279,1.11340704832,1.1128235555555555,1.112873333333326,1.113041111111104,1.1134575000000029,1.1135690000000016,1.1147552000000005,1.1178891000000049,1.1129362275793928,1.113096643862736,2820,-109229,-110214.2,-0.05432983650559244,-163.65746561646446,-0.009884086620545827
2023-07-21T06:00:00-04:00,1.11279,1.11292,1.11223,1.11247,1.1133048844544,1.1127428888888888,1.1128388888888816,1.112949999999993,1.1133865000000027,1.1135562000000017,1.1146716000000005,1.1178389500000048,1.1128429820635142,1.1130097150901885,-2414,-111643,-110780,-0.05186552514297615,-164.3516487058162,-0.0278581570480967
2023-07-21T06:15:00-04:00,1.11247,1.1127,1.11201,1.11235,1.113210893698048,1.112645111111111,1.1128077777777703,1.1128862222222151,1.1133170000000026,1.1135334000000014,1.1145848000000007,1.1177887000000049,1.1127443856508112,1.1129229720721505,-2288,-113931,-111108.6,-0.0491443998477965,-164.5984508667736,-0.025165598626682543
2023-07-21T06:30:00-04:00,1.11235,1.11271,1.1122,1.11263,1.1130908043282433,1.1126095555555555,1.112733333333326,1.1128277777777706,1.1132600000000026,1.1135130000000015,1.1145002000000008,1.1177409500000046,1.112721508520649,1.1128435776577201,2122,-111809,-111732.2,-0.044398876425848055,-164.0643024422668,-0.060181442558155794
2023-07-21T06:45:00-04:00,1.11263,1.11266,1.11233,1.11254,1.1129827238954189,1.112570888888889,1.1126266666666593,1.1127759999999929,1.1131720000000027,1.1134938000000014,1.1144136000000007,1.1176875500000047,1.1126852068165192,1.1127860621261756,-2387,-114196,-112161.6,-0.045966804318700705,-164.2573854977298,-0.08621463852715311
2023-07-21T07:00:00-04:00,1.11254,1.11272,1.11216,1.11237,1.112885451505877,1.1125195555555554,1.1125777777777703,1.1127168888888819,1.1130825000000026,1.1134752000000017,1.1143289000000007,1.1176318500000049,1.1126221654532154,1.11272324970094,-2653,-116849,-113685.6,-0.047865721016446455,-164.66277316918433,-0.03953954403716681
2023-07-21T07:15:00-04:00,1.11237,1.11266,1.11225,1.1125099999999999,1.1127979063552893,1.112506,1.1125477777777704,1.1126586666666596,1.1129865000000028,1.1134552000000015,1.1142431000000006,1.1175752000000048,1.1125997323625723,1.1126745997607514,1884,-114965,-114350,-0.04350530671448831,-164.4256578208743,-0.02426355613867903
2023-07-21T07:30:00-04:00,1.1125099999999999,1.11313,1.11242,1.11308,1.11201,1.1126124444444445,1.1125699999999925,1.1126111111111041,1.1129220000000029,1.1134448000000015,1.1141614000000006,1.1175229500000048,1.112695785890058,1.112664879808601,2213,-112752,-114114.2,-0.035036437638148475,-163.29181632731434,0.01797138954783786
2023-07-21T07:45:00-04:00,1.11308,1.11308,1.11172,1.11183,1.11313,1.1124644444444445,1.1125077777777703,1.1125659999999928,1.1127990000000028,1.1134122000000015,1.1140756000000007,1.1174673500000047,1.1125226287120464,1.1126251038468804,-2731,-115483,-114849,-0.03360680043464081,-166.358756708958,-0.050342056293196984
2023-07-21T08:00:00-04:00,1.11183,1.11262,1.11182,1.11246,1.11313,1.112454888888889,1.1124711111111036,1.112534888888882,1.112732500000003,1.1133880000000014,1.1140003000000007,1.1174196000000047,1.1125101029696371,1.1125900830775037,3450,-112033,-114416.4,-0.025149303932709425,-164.40387151967576,-0.029655191006384085
2023-07-21T08:15:00-04:00,1.11246,1.113,1.11194,1.1122,1.1131018,1.1124006666666668,1.1124411111111039,1.1125075555555486,1.112660000000003,1.1133630000000014,1.1139183000000008,1.1173690000000047,1.1124480823757097,1.1125552664620026,-3778,-115811,-114208.8,-0.023648887205317534,-165.28685158188,-0.0242703174018169
2023-07-21T08:30:00-04:00,1.1122,1.11277,1.11214,1.11244,1.113074164,1.1124004444444444,1.1124511111111037,1.1124882222222152,1.112637000000003,1.1133438000000013,1.1138342000000008,1.117321400000005,1.1124464659005677,1.1125246131696018,3995,-111816,-113579,-0.018741194334623953,-164.42477641554294,0.008090978558919902
2023-07-21T08:45:00-04:00,1.11244,1.11343,1.11239,1.11282,1.11172,1.1124742222222224,1.112472222222215,1.1124686666666599,1.1126390000000028,1.1133332000000014,1.1137555000000008,1.1172776500000048,1.1125211727204543,1.112489690535681,3789,-108027,-112634,-0.01417470841670689,-163.13048638641837,0.01707665621095175
2023-07-21T09:00:00-04:00,1.11282,1.11351,1.11269,1.11318,1.1117542,1.1126157777777776,1.1125433333333261,1.112475777777771,1.112666500000003,1.1133286000000013,1.1136907000000007,1.117238500000005,1.1126529381763635,1.1125157524285445,3742,-104285,-110394.4,-0.010943269610694728,-161.9199402064427,0.057526021536301965
2023-07-21T09:15:00-04:00,1.11318,1.1138,1.11302,1.11322,1.111824432,1.112751111111111,1.1126377777777705,1.1125091111111043,1.112662500000003,1.1133182000000015,1.1136282000000008,1.117197900000005,1.1127663505410907,1.112567001942835,3751,-100534,-108094.6,-0.007356670111462142,-161.78515517616893,0.07641342359107288
2023-07-21T09:30:00-04:00,1.11322,1.11354,1.11255,1.11262,1.11194296608,1.1127475555555555,1.1126499999999926,1.112550888888882,1.112618500000003,1.1133028000000014,1.113575000000001,1.1171530000000047,1.1127370804328727,1.112624801554268,-5713,-106247,-106181.8,-0.0021997896929579707,-164.8643309006447,0.009887551572575034
2023-07-21T09:45:00-04:00,1.11262,1.11273,1.11115,1.11187,1.1138,1.1125915555555557,1.1125155555555482,1.112563777777771,1.112571500000003,1.1132688000000015,1.113511200000001,1.1171057500000048,1.1125636643462982,1.112648241243414,-4772,-111019,-106022.4,-0.0009758502734575693,-168.08106257902557,-0.10870737053941813
2023-07-21T10:00:00-04:00,1.11187,1.11187,1.11089,1.11135,1.1137469999999998,1.1123584444444443,1.112462222222215,1.112561777777771,1.112500000000003,1.1132184000000016,1.113448800000001,1.1170526500000049,1.1123209314770386,1.1126081929947307,-4149,-115168,-107450.6,-0.010277030387350852,-170.02146928124742,-0.04317206767221931
2023-07-21T10:15:00-04:00,1.11135,1.11158,1.11102,1.11153,1.1136327199999998,1.1121720000000002,1.1123588888888816,1.112524888888882,1.112432500000003,1.1131706000000015,1.1133779000000008,1.117003100000005,1.112162745181631,1.1125101543957843,3323,-111845,-108962.6,-0.007623644512708987,-169.4832589964591,-0.08359851140716047
2023-07-21T10:30:00-04:00,1.11153,1.11178,1.11126,1.11146,1.1135230111999999,1.111992222222222,1.1122766666666593,1.1124526666666597,1.112386000000003,1.1131196000000014,1.1133128000000008,1.116952600000005,1.1120221961453047,1.1123613235166272,-4274,-116119,-112079.6,-0.01053505313085565,-169.7524195229407,-0.06653479590003461
2023-07-21T10:45:00-04:00,1.11146,1.11151,1.1107799999999999,1.11135,1.113417690752,1.1118068888888888,1.112155555555548,1.1123537777777708,1.1123140000000031,1.1130718000000015,1.113243100000001,1.116900800000005,1.1118877569162438,1.1121914588133013,-5058,-121177,-115065.6,-0.013724861477492625,-170.2530043393076,-0.09798281255618597
2023-07-21T11:00:00-04:00,1.11135,1.1124,1.1112,1.11237,1.1132594293068798,1.1118497777777778,1.1121055555555481,1.1122717777777709,1.112309000000003,1.1130384000000015,1.1132006000000008,1.116853050000005,1.111984205532995,1.1120755670506406,3874,-117303,-116322.4,-0.01255637633139905,-166.69743678633142,-0.04043780665335269
2023-07-21T11:15:00-04:00,1.11237,1.1126,1.11197,1.11207,1.113110663548467,1.1118426666666665,1.1119822222222149,1.1121757777777708,1.1122950000000031,1.1130010000000015,1.1131727000000007,1.116806500000005,1.112001364426396,1.112011653640512,-2649,-119952,-117279.2,-0.017586933952398166,-167.41185734783568,-0.09971433191399112
2023-07-21T11:30:00-04:00,1.11207,1.11218,1.1115,1.11166,1.1129708237355591,1.1117782222222223,1.1118088888888815,1.1120657777777707,1.1122465000000032,1.1129584000000015,1.1131461000000007,1.1167550000000048,1.1119330915411167,1.1119657229124091,-2413,-122365,-119383.2,-0.02829918878482763,-168.30148659779252,-0.14013402561937494
2023-07-21T11:45:00-04:00,1.11166,1.11237,1.1116,1.11195,1.1128393743114255,1.1118064444444447,1.111734444444437,1.1119573333333261,1.1122170000000033,1.1129200000000015,1.1131188000000007,1.116708000000005,1.1119364732328934,1.111948578329927,2501,-119864,-120132.2,-0.03680714204950606,-167.64904790250822,-0.06021822365227557
2023-07-21T12:00:00-04:00,1.11195,1.11216,1.11154,1.11162,1.11271581185274,1.1117835555555555,1.1117066666666593,1.1118675555555484,1.1121795000000032,1.1128804000000014,1.1130866000000008,1.116669600000005,1.1118731785863147,1.1119456626639412,-2228,-122092,-120315.2,-0.04186083552089949,-168.3102646838382,-0.022484642988826162
2023-07-21T12:15:00-04:00,1.11162,1.11211,1.11155,1.11198,1.1125996631415755,1.111838222222222,1.1117766666666595,1.1118017777777707,1.1121530000000033,1.1128478000000015,1.1130643000000007,1.116635000000005,1.1118945428690519,1.1119277301311525,1603,-120489,-120952.4,-0.039202639883880126,-167.79113044731864,0.05668781212038587
2023-07-21T12:30:00-04:00,1.11198,1.112,1.11178,1.11186,1.112490483353081,1.1118548888888888,1.111813333333326,1.111767999999993,1.1120920000000032,1.1128108000000017,1.1130469000000007,1.116600500000005,1.1118876342952415,1.1119049841049216,-1539,-122028,-121367.6,-0.031834833944748224,-167.9572125710977,0.029688807319655206
2023-07-21T12:45:00-04:00,1.11186,1.11254,1.11179,1.1123399999999999,1.1107799999999999,1.1119602222222225,1.1119111111111037,1.1117884444444373,1.1121175000000032,1.1127816000000015,1.1130356000000008,1.116566900000005,1.1119781074361932,1.111913987283937,1574,-120454,-120985.4,-0.021383752287324947,-167.2777025608449,0.07917513900635129
2023-07-21T13:00:00-04:00,1.1123399999999999,1.11263,1.11227,1.11258,1.1108151999999998,1.112094,1.1120477777777706,1.111851111111104,1.1121235000000032,1.1127562000000015,1.1130280000000008,1.116531550000005,1.1120984859489544,1.111946389827149,1484,-118970,-120806.6,-0.014523700134983143,-166.9575126908411,0.11067620461599337
2023-07-21T13:15:00-04:00,1.11258,1.11267,1.11231,1.11255,1.1108877919999998,1.1121944444444445,1.1120677777777703,1.1119233333333263,1.1121410000000032,1.1127282000000016,1.1130248000000007,1.116495350000005,1.1121887887591635,1.1120095118617186,-1506,-120476,-120483.4,-0.004119028799532704,-166.99812100664758,0.016181666172213106
2023-07-21T13:30:00-04:00,1.11255,1.11289,1.11241,1.11288,1.1109947244799998,1.1123568888888888,1.1121577777777705,1.1119995555555486,1.1121630000000031,1.1127080000000016,1.113033500000001,1.116462550000005,1.1123270310073308,1.1120960094893746,1203,-119273,-120240.2,-0.0024447993420561006,-166.64129210008142,0.07283714154686302
2023-07-21T13:45:00-04:00,1.11288,1.11289,1.11247,1.11259,1.1111463465215998,1.1124433333333335,1.1122611111111036,1.112089111111104,1.1121515000000033,1.1126850000000015,1.1130353000000008,1.116428500000005,1.1123796248058646,1.1121944075914991,-1008,-120281,-119890.8,0.0015884671294822618,-166.90396192971275,0.0836586726157166
2023-07-21T14:00:00-04:00,1.11259,1.11302,1.11255,1.11283,1.1112858387998719,1.112557111111111,1.1123588888888816,1.1121786666666595,1.1121340000000033,1.1126662000000014,1.1130395000000006,1.116399600000005,1.1124696998446917,1.1122927260731987,1514,-118767,-119553.4,0.01206549448431708,-166.57737262008385,0.07914024911191977
2023-07-21T14:15:00-04:00,1.11283,1.11291,1.11242,1.11245,1.1114592549198847,1.1125753333333332,1.1124511111111037,1.1122593333333264,1.1120955000000035,1.1126292000000015,1.1130374000000007,1.116370700000005,1.1124657598757532,1.1123661808585585,-1406,-120173,-119794,0.019687323513357252,-167.05748189104173,0.07466580306218729
2023-07-21T14:30:00-04:00,1.11245,1.11279,1.1124,1.11269,1.1116153294278963,1.112623111111111,1.1125299999999927,1.1123517777777707,1.1120990000000035,1.1125998000000015,1.1130310000000008,1.1163379500000048,1.1125106079006026,1.1124305446868465,1588,-118585,-119415.8,0.031578361436580465,-166.71488671822496,0.06385006924584871
2023-07-21T14:45:00-04:00,1.11269,1.11274,1.1124,1.11247,1.1117557964851066,1.1126111111111112,1.1125977777777705,1.1124397777777708,1.1121290000000035,1.1125606000000017,1.1130255000000007,1.1163042500000049,1.1125024863204822,1.1124656357494769,-1344,-119929,-119547,0.03662685269859584,-166.9806211096546,0.05486302232295427
2023-07-21T15:00:00-04:00,1.11247,1.11247,1.1118999999999999,1.11193,1.1118822168365958,1.1124775555555555,1.1125522222222148,1.112497999999993,1.1121580000000033,1.1125118000000014,1.1130167000000006,1.116266650000005,1.1123879890563857,1.1124673085995809,-1665,-121594,-119809.6,0.03699927765589052,-167.7888226791351,-0.03685923368752355
2023-07-21T15:15:00-04:00,1.11193,1.11231,1.11193,1.11227,1.11302,1.112421111111111,1.1125177777777704,1.112529777777771,1.1121950000000036,1.1124714000000016,1.1130152000000004,1.1162319500000049,1.1123643912451087,1.1124462468796645,1103,-120491,-120154.4,0.032429289463178905,-167.4515532467068,-0.02786316489599044
2023-07-21T15:30:00-04:00,1.11227,1.11247,1.11215,1.11237,1.1129981999999998,1.1123915555555555,1.1124977777777705,1.112539111111104,1.1122405000000035,1.1124430000000016,1.1130119000000007,1.116195000000005,1.112365512996087,1.1124261975037313,735,-119756,-120071,0.026943514525533938,-167.38547216927057,-0.016179048132654437
2023-07-21T15:45:00-04:00,1.11237,1.11253,1.11233,1.11253,1.1129768359999999,1.1123980000000002,1.1124588888888818,1.112524888888882,1.1122995000000033,1.1124206000000014,1.1130109000000006,1.1161581000000047,1.1123984103968696,1.1124037580029846,1095,-118661,-120086.2,0.02218146415675203,-167.22797061852762,-0.03144993170872623
2023-07-21T16:00:00-04:00,1.11253,1.11266,1.11249,1.11261,1.11295589928,1.1124282222222222,1.1124611111111038,1.1124975555555487,1.1123115000000035,1.1124148000000016,1.1130072000000006,1.1161226000000048,1.1124407283174957,1.1123914064023874,798,-117863,-119673,0.014358737253396156,-167.1705878962639,0.0017976073845829123
2023-07-21T16:15:00-04:00,1.11261,1.11294,1.11259,1.11291,1.11193,1.1125180000000001,1.1124699999999927,1.1124811111111041,1.1123535000000033,1.1124174000000016,1.1130073000000005,1.1160877500000046,1.1125345826539965,1.1124207251219096,494,-117369,-118828,0.014923494615285164,-167.03738758348584,0.007188878804496645
2023-07-21T16:30:00-04:00,1.11291,1.11292,1.11268,1.11273,1.1119502,1.11257,1.1125011111111038,1.1124777777777708,1.1124070000000035,1.1124194000000016,1.1130017000000005,1.1160514500000047,1.1125736661231973,1.1124625800975274,-289,-117658,-118261.4,0.011198726016803323,-167.08412990766303,0.02516967054699609
2023-07-21T16:45:00-04:00,1.11273,1.11273,1.11242,1.11245,1.111969996,1.1125597777777778,1.112474444444437,1.1124731111111044,1.1124320000000036,1.1124024000000015,1.1129942000000006,1.1160128500000048,1.1125489328985578,1.1124992640780214,-1248,-118906,-118091.4,0.007816583399965684,-167.3981683536473,-0.021569349953717388
2023-07-23T17:00:00-04:00,1.1133,1.1133,1.11211,1.1124,1.11198939608,1.112544888888889,1.1124666666666594,1.1124746666666596,1.1124710000000035,1.1123804000000015,1.1129894000000007,1.1159739500000045,1.1125191463188462,1.112523411262417,-68,-118974,-118154,0.003283244239454093,-167.40122467078513,-0.006292304511583638
2023-07-23T17:15:00-04:00,1.1124,1.11275,1.11239,1.11275,1.1120418202368,1.1126015555555557,1.1125577777777704,1.112493999999993,1.1125095000000036,1.1123792000000015,1.1129874000000006,1.1159362500000047,1.1125653170550769,1.112548329009933,41,-118933,-118368,0.0009630954662063198,-167.38832463482683,0.07374564945633455
2023-07-23T17:30:00-04:00,1.11275,1.11298,1.11245,1.11294,1.112092147427328,1.112678,1.112632222222215,1.1125264444444376,1.1125635000000036,1.1123824000000015,1.1129875000000005,1.1159015000000048,1.1126402536440616,1.1125694632079461,74,-118859,-118666,0.005932424294506589,-167.375689271987,0.06023717262894336
2023-07-23T17:45:00-04:00,1.11294,1.113,1.11249,1.1129499999999999,1.1121404615302348,1.1127415555555555,1.1126966666666593,1.1125655555555487,1.1125940000000036,1.1123838000000013,1.1129879000000005,1.1158644000000046,1.1127022029152493,1.1125951705663564,101,-118758,-118886,0.007378804000611947,-167.37478176574228,0.05214092433271329
2023-07-23T18:00:00-04:00,1.1129499999999999,1.11302,1.11254,1.11255,1.1121868430690254,1.112712222222222,1.1126988888888816,1.1126104444444374,1.1125925000000039,1.1123870000000013,1.1129811000000005,1.1158264000000047,1.1126717623321996,1.112619736453085,-814,-119572,-119019.2,0.008097779402607329,-167.66733758585997,0.0017977043315604054
2023-07-23T18:15:00-04:00,1.11255,1.1129499999999999,1.11245,1.11293,1.1122313693462644,1.1127584444444445,1.1127344444444371,1.112663999999993,1.1126115000000039,1.1123898000000014,1.1129794000000006,1.1157902500000048,1.1127234098657597,1.1126605891624677,1141,-118431,-118910.6,0.010194831708559438,-167.27762026978425,0.028761201139651443
2023-07-23T18:30:00-04:00,1.11293,1.1129499999999999,1.11284,1.1129,1.1122741145724138,1.1127915555555556,1.112733333333326,1.1126991111111042,1.1126125000000038,1.1123984000000013,1.1129773000000005,1.1157539000000047,1.1127587278926077,1.112699271329974,-876,-119307,-118985.4,0.011303168439802029,-167.30123361473855,-0.0008985452552376662
2023-07-23T18:45:00-04:00,1.1129,1.11291,1.1127,1.11285,1.1123151499895172,1.112814888888889,1.1127466666666592,1.112721999999993,1.1126255000000038,1.1124084000000014,1.1129709000000005,1.1157195500000046,1.112776982314086,1.1127266170639787,-569,-119876,-119188.8,0.010892313750328283,-167.32679745695265,0.010784287293404327
2023-07-23T19:00:00-04:00,1.11285,1.113,1.11282,1.11296,1.1123545439899365,1.1128575555555553,1.1128033333333258,1.1127433333333265,1.1126320000000038,1.1124150000000013,1.1129640000000005,1.1156846500000046,1.1128135858512689,1.1127488936511827,519,-119357,-119308.6,0.011375760898792506,-167.27549674257062,0.045844757067734325
2023-07-23T19:15:00-04:00,1.11296,1.11306,1.1128,1.1129499999999999,1.112392362230339,1.1128868888888888,1.1128644444444369,1.1127764444444375,1.1126570000000038,1.1124232000000014,1.1129585000000006,1.1156497500000047,1.1128408686810152,1.1127827149209457,-639,-119996,-119393.4,0.015355914402671578,-167.28123818880414,0.049442646530009744
2023-07-23T19:30:00-04:00,1.1129499999999999,1.11301,1.11237,1.11255,1.1133,1.1128239999999998,1.112842222222215,1.112797999999993,1.112650000000004,1.1124268000000013,1.1129510000000007,1.1156121500000047,1.112782694944812,1.1127945719367562,-1143,-121139,-119935,0.016276001265436348,-167.69203831459592,-0.017973489103570252
2023-07-23T19:45:00-04:00,1.11255,1.11273,1.11243,1.11244,1.1132814,1.1127435555555556,1.1127866666666593,1.1128086666666597,1.1126485000000037,1.1124254000000011,1.1129403000000004,1.1155741000000046,1.1127141559558498,1.1127856575494046,-886,-122025,-120478.6,0.014559965487828052,-167.7796388718741,-0.04492605171886579
2023-07-23T20:00:00-04:00,1.11244,1.1129,1.11228,1.11283,1.113263172,1.1127522222222221,1.1127733333333258,1.112813999999993,1.1126935000000038,1.1124204000000013,1.1129326000000006,1.1155386500000046,1.11273732476468,1.1127777260395235,2009,-120016,-120506.6,0.012030403410465271,-167.07532223457252,-0.010782155532584391
2023-07-23T20:15:00-04:00,1.11283,1.11306,1.11276,1.113,1.1132238451199998,1.1127975555555556,1.112823333333326,1.112817999999993,1.1127300000000038,1.1124438000000012,1.1129280000000006,1.1155032000000047,1.1127898598117438,1.1127729808316185,1717,-118299,-120295,0.007900073908410363,-166.8130270052922,0.04044762033167602
2023-07-23T20:30:00-04:00,1.113,1.11328,1.11298,1.11308,1.11228,1.1128488888888888,1.1128399999999927,1.112813111111104,1.1127655000000038,1.1124562000000011,1.1129221000000005,1.1154679500000046,1.112847887849395,1.1127743846652944,1729,-116570,-119609.8,0.009196462807076094,-166.68875027573233,0.013477936617765224
2023-07-23T20:45:00-04:00,1.11308,1.11309,1.11269,1.11297,1.1122999999999998,1.112874888888889,1.1128477777777706,1.1128142222222153,1.1127875000000038,1.1124716000000012,1.1129173000000006,1.1154310500000046,1.112872310279516,1.1127923077322355,-1793,-118363,-119054.6,0.006988105243850677,-166.86594328971165,0.006289873303981894
2023-07-23T21:00:00-04:00,1.11297,1.11307,1.1128,1.11304,1.1123195999999997,1.1129133333333334,1.1128688888888818,1.1128306666666596,1.1128090000000037,1.1124836000000011,1.1129137000000007,1.1153949000000047,1.1129058482236127,1.1128306461857878,2075,-116288,-117907.2,0.006063643004535073,-166.73543662735776,0.01707328031631707
2023-07-23T21:15:00-04:00,1.11304,1.11308,1.112,1.1121699999999999,1.11328,1.1127735555555556,1.112781111111104,1.1128322222222153,1.1127720000000036,1.1124706000000013,1.1129019000000004,1.1153539500000047,1.11275867857889,1.1128349169486298,-2507,-118795,-117663,0.001835816392995743,-168.695015797918,-0.07098188614146676
2023-07-23T21:30:00-04:00,1.1121699999999999,1.11242,1.11195,1.1124,1.1132544,1.1126973333333334,1.1127199999999928,1.1128115555555487,1.1127555000000038,1.1124550000000013,1.1128918000000005,1.1153136500000047,1.112686942863112,1.1128143335589036,3546,-115249,-117053,-0.0010142144071790362,-167.96169265487276,-0.04941821285770506
2023-07-23T21:45:00-04:00,1.1124,1.11263,1.11205,1.11222,1.113202224,1.1125973333333332,1.1126833333333261,1.1127802222222154,1.1127440000000037,1.1124350000000012,1.1128766000000005,1.1152723000000047,1.1125935542904897,1.1127634668471225,-2547,-117796,-117298.2,-0.005392143646382877,-168.37382857720303,-0.029661588243219763
2023-07-23T22:00:00-04:00,1.11222,1.11248,1.11209,1.11243,1.11315213504,1.1125466666666666,1.112682222222215,1.1127471111111042,1.1127455000000037,1.1124312000000012,1.1128670000000005,1.1152308000000049,1.1125608434323917,1.1127011734776977,2016,-115780,-116781.6,-0.006384988258931405,-167.9931844600319,-0.0008989248858424284
2023-07-23T22:15:00-04:00,1.11243,1.11313,1.11237,1.11302,1.11195,1.1126142222222222,1.1127033333333263,1.112713999999993,1.1127590000000036,1.1124542000000013,1.1128615000000004,1.1151914500000049,1.1126526747459133,1.112650538782158,1966,-113814,-116286.8,-0.0038257560679548813,-166.95047615479046,0.017073587160654588
2023-07-23T22:30:00-04:00,1.11302,1.11304,1.1128,1.11298,1.1119736,1.1126695555555555,1.112701111111104,1.1126979999999933,1.1127610000000037,1.1124868000000012,1.1128526000000005,1.1151497500000047,1.1127181397967307,1.112642431025726,-2041,-115855,-115698.8,-0.0034619756109533664,-167.02382613951636,-0.0017969451931634304
2023-07-23T22:45:00-04:00,1.11298,1.11299,1.11252,1.11264,1.111996728,1.1126573333333334,1.1126522222222153,1.1126844444444377,1.1127455000000037,1.1125090000000013,1.1128398000000006,1.1151039500000048,1.1127025118373846,1.1126455448205805,-1557,-117412,-116131.4,-0.005413418258800822,-167.49946810972247,-0.039529952923419334
2023-07-23T23:00:00-04:00,1.11264,1.11292,1.11257,1.11269,1.11201939344,1.1126648888888888,1.1126211111111042,1.1126719999999932,1.1127525000000036,1.1125336000000015,1.1128266000000004,1.1150591000000047,1.1127000094699075,1.112666835856464,1590,-115822,-115736.6,-0.007805679658717819,-167.42801642723774,-0.02515791081521137
2023-07-23T23:15:00-04:00,1.11269,1.11282,1.11252,1.11274,1.1120416055712,1.1126886666666667,1.1125877777777708,1.1126531111111044,1.1127430000000036,1.1125614000000015,1.1128166000000004,1.115011650000005,1.1127080075759261,1.112696268685171,2032,-113790,-115338.6,-0.010685648920718178,-167.33670617910013,-0.026953209228775872
2023-07-23T23:30:00-04:00,1.11274,1.11274,1.11253,1.11259,1.112063373459776,1.1126891111111112,1.1126344444444376,1.1126393333333267,1.1127275000000034,1.1125658000000014,1.1128021000000006,1.1149612000000049,1.1126844060607408,1.1127026149481363,-1400,-115190,-115613.8,-0.01327487594897453,-167.52542951069614,0.0377640108976224
2023-07-23T23:45:00-04:00,1.11259,1.11262,1.11247,1.11254,1.1120847059905805,1.1126702222222222,1.1126499999999933,1.1126291111111046,1.1127120000000035,1.1125752000000013,1.1127881000000004,1.1149110000000049,1.1126555248485928,1.1126900919585085,-1299,-116489,-115740.6,-0.008409262770550104,-167.58380681050994,0.012585400934918103
2023-07-24T00:00:00-04:00,1.11254,1.11255,1.11218,1.1123399999999999,1.1121056118707688,1.1126082222222222,1.1126633333333267,1.1126313333333269,1.1126810000000034,1.1125888000000013,1.1127736000000006,1.1148600000000048,1.1125924198788741,1.1126680735668066,-1293,-117782,-115814.6,-0.006766073597131247,-167.8162478912803,0.010789232346109399
2023-07-24T00:15:00-04:00,1.1123399999999999,1.1123399999999999,1.11203,1.11204,1.11313,1.1124835555555557,1.1126199999999933,1.1126311111111047,1.1126355000000037,1.1125906000000014,1.1127553000000006,1.1148072500000048,1.1124819359030993,1.1126244588534449,-1213,-118995,-116449.2,-0.004446696562126043,-168.1433960653997,-0.03505838569618874
2023-07-24T00:30:00-04:00,1.11204,1.11204,1.11176,1.11178,1.113108,1.1123155555555555,1.1124822222222155,1.1126099999999937,1.1125970000000034,1.1125938000000013,1.1127371000000006,1.1147546500000047,1.1123415487224795,1.1125511670827557,-1100,-120095,-117710.2,-0.005281519091293419,-168.40058105874522,-0.1114086000251485
2023-07-24T00:45:00-04:00,1.11178,1.11204,1.11168,1.112,1.11305408,1.1122191111111113,1.1123733333333266,1.1125577777777713,1.1125750000000034,1.1125942000000013,1.1127210000000005,1.1147021000000048,1.1122732389779837,1.1124689336662041,1054,-119041,-118480.4,-0.012095562648828533,-168.1920146157438,-0.0880518967097325
2023-07-24T01:00:00-04:00,1.112,1.11262,1.11198,1.11258,1.1129716351999999,1.1122604444444444,1.11236666666666,1.1125011111111047,1.1125625000000035,1.1126086000000013,1.1127097000000006,1.1146535500000048,1.112334591182387,1.1124047469329632,1427,-117614,-118705.4,-0.016289963054126097,-167.44771605459297,-0.0053925798101965615
2023-07-24T01:15:00-04:00,1.11258,1.11259,1.11208,1.1121,1.112894137088,1.112207111111111,1.1123011111111045,1.1124286666666603,1.1125175000000034,1.1126038000000014,1.1126927000000004,1.1146013000000048,1.1122876729459097,1.1123437975463704,-1420,-119034,-118955.8,-0.018019676116368795,-168.06034615759657,-0.05302465196953944
2023-07-24T01:30:00-04:00,1.1121,1.11226,1.11187,1.11224,1.1128212888627198,1.1121948888888888,1.1122455555555488,1.1123537777777712,1.1124755000000035,1.1125970000000014,1.1126766000000006,1.1145497500000048,1.1122781383567277,1.1123030380370962,1616,-117418,-118640.4,-0.018812126566164943,-167.85691121469603,-0.04493412657046273
2023-07-24T01:45:00-04:00,1.11224,1.11322,1.1121699999999999,1.11318,1.11168,1.1123817777777778,1.1123111111111046,1.1123195555555492,1.1124860000000036,1.1126096000000012,1.1126689000000005,1.1145027500000049,1.1124585106853822,1.1123264304296765,1795,-115623,-117746,-0.015285054931321094,-166.3398825158538,0.05302941784485664
2023-07-24T02:00:00-04:00,1.11318,1.11318,1.1125,1.11263,1.1117108,1.1124455555555555,1.1123211111111044,1.1123091111111048,1.1124655000000034,1.1126046000000012,1.1126563000000005,1.1144536000000047,1.1124928085483057,1.112370344343741,-2599,-118222,-117582.2,-0.013470391462883452,-167.62399649562357,0.008089596778535916
2023-07-24T02:15:00-04:00,1.11263,1.11315,1.11243,1.1129499999999999,1.111740984,1.1125713333333331,1.1123888888888822,1.112313555555549,1.1125045000000033,1.1126118000000014,1.1126484000000005,1.1144066500000047,1.1125842468386444,1.1124202754749926,2301,-115921,-117243.6,-0.009399775535117678,-166.96221315345258,0.05483934768146426
2023-07-24T02:30:00-04:00,1.1129499999999999,1.11304,1.11268,1.11299,1.11177056432,1.1126915555555554,1.1124944444444378,1.1123522222222157,1.1125340000000035,1.1126150000000015,1.1126406000000004,1.114360100000005,1.1126653974709155,1.1124958203799937,1805,-114116,-116260,-0.007066705245788105,-166.89734051766473,0.08542858170569462
2023-07-24T02:45:00-04:00,1.11299,1.11412,1.11299,1.11358,1.1117995530336,1.1129086666666665,1.112694444444438,1.1124419999999935,1.1126020000000034,1.1126376000000013,1.1126334000000007,1.114317400000005,1.1128483179767323,1.1126098563039946,2454,-111662,-115108.8,0.0017248566831033988,-165.5964662959734,0.16190253467412832
2023-07-24T03:00:00-04:00,1.11358,1.11469,1.11341,1.11449,1.111892370912256,1.1132677777777777,1.1129711111111047,1.1125739999999935,1.1127050000000034,1.1126736000000015,1.1126367000000006,1.1142796500000047,1.113176654381386,1.1127534850431953,4962,-106700,-113324.2,0.0163652882993847,-161.54159821285427,0.22392086330934183
2023-07-24T03:15:00-04:00,1.11449,1.11449,1.112,1.11244,1.11469,1.1131615555555556,1.1129555555555493,1.1127008888888823,1.1126760000000036,1.1126730000000016,1.1126168000000005,1.1142320500000047,1.1130293235051087,1.1128607880345558,-6879,-113579,-112395.6,0.020276857421173217,-174.19487459936218,-0.012583364791727962
2023-07-24T03:30:00-04:00,1.11244,1.11244,1.10744,1.10787,1.11469,1.1121444444444444,1.1124855555555493,1.1127202222222157,1.1124205000000034,1.1125918000000015,1.1125518000000005,1.1141642000000047,1.111997458804087,1.1127434304276442,-11600,-125179,-114247.2,-0.00001284170136195984,-221.84868064733075,-0.3803614782843429
2023-07-24T03:45:00-04:00,1.10787,1.10872,1.10753,1.10812,1.11449,1.1112713333333333,1.1120277777777714,1.1126268888888826,1.1121945000000033,1.1125088000000014,1.1124901000000005,1.1140963500000047,1.1112219670432697,1.112454744342115,5269,-119910,-115406,-0.014989384124861288,-220.6596873538934,-0.370423649572026
2023-07-24T04:00:00-04:00,1.10812,1.10877,1.10749,1.10784,1.114208,1.1104337777777777,1.1114344444444382,1.1123748888888827,1.1119520000000034,1.1124182000000014,1.1124306000000006,1.1140310000000047,1.1105455736346157,1.111994195473692,-5830,-125740,-118221.6,-0.034006045804456056,-222.13281300815495,-0.479706785964545
2023-07-24T04:15:00-04:00,1.10784,1.10839,1.10759,1.10802,1.11393728,1.1097508888888887,1.110922222222216,1.111965111111105,1.1117160000000033,1.1123280000000015,1.1123743000000006,1.1139651500000047,1.1100404589076927,1.1113669563789532,3959,-121781,-121237.8,-0.06042302542561157,-221.48956127505247,-0.41433360596065205
2023-07-24T04:30:00-04:00,1.10802,1.10833,1.10656,1.1072899999999999,1.1136773888,1.1090244444444444,1.110293333333327,1.1114326666666605,1.111451000000003,1.1122216000000014,1.1123182000000007,1.1138966500000047,1.109490367126154,1.1106591651031623,-7274,-129055,-124333,-0.08513123130724246,-226.28191159363956,-0.508558335953996
2023-07-24T04:45:00-04:00,1.1072899999999999,1.10783,1.10692,1.10709,1.113250345472,1.1083837777777776,1.1096377777777713,1.110863111111105,1.1111785000000032,1.1121052000000013,1.1122613000000008,1.1138268000000047,1.1090102937009232,1.1100617320825295,-4049,-133104,-125918,-0.11431639634856812,-227.0132466549152,-0.5301035948211589
2023-07-24T05:00:00-04:00,1.10709,1.10833,1.10692,1.10823,1.11284892474368,1.108102222222222,1.109043333333327,1.1102662222222162,1.110973000000003,1.1120152000000014,1.1122173000000006,1.1137594000000046,1.1088542349607386,1.1095881856660232,4570,-128534,-127642.8,-0.13870768650481002,-222.30739618205334,-0.48043247903158876
2023-07-24T05:15:00-04:00,1.10823,1.10909,1.10817,1.10871,1.112471589259059,1.1080355555555554,1.1084011111111047,1.1096595555555495,1.1108065000000031,1.1119404000000015,1.1121714000000007,1.1136957500000049,1.108825387968591,1.1092441485328184,4003,-124531,-127401,-0.16700838514092947,-220.57360446011822,-0.5186228678588319
2023-07-24T05:30:00-04:00,1.10871,1.10919,1.10853,1.1088,1.1121168939035155,1.1081153333333333,1.1079966666666603,1.1090744444444385,1.1106575000000032,1.1118684000000014,1.1121244000000008,1.1136389000000049,1.1088203103748728,1.1090001188262544,2448,-122083,-127461.4,-0.20436931643496914,-220.3748870317557,-0.32720865844450825
2023-07-24T05:45:00-04:00,1.1088,1.1088,1.10799,1.10819,1.1117834802693045,1.1081539999999999,1.1080322222222159,1.1086222222222162,1.110467000000003,1.1117772000000015,1.1120782000000007,1.113577150000005,1.1086942482998983,1.1088408950610031,-2778,-124861,-126622.6,-0.22727682028534385,-221.90318789755656,0.028884255372931662
2023-07-24T06:00:00-04:00,1.10819,1.10853,1.108,1.10825,1.1114700714531462,1.1081975555555554,1.1080466666666602,1.108303999999994,1.1102505000000031,1.1116834000000013,1.1120329000000007,1.1135127500000048,1.1086053986399187,1.1087599160488022,2681,-122180,-124437.8,-0.20780878298287173,-221.7580322834472,0.01173158141717174
2023-07-24T06:15:00-04:00,1.10825,1.10879,1.10806,1.10817,1.1111754671659575,1.108222222222222,1.1080833333333269,1.108111999999994,1.110054000000003,1.1115878000000015,1.1119858000000007,1.1134504000000047,1.108518318911935,1.1086927328390415,-2680,-124860,-123703,-0.18848136547624225,-221.95149043819532,0.029787694974018227
2023-07-24T06:30:00-04:00,1.10817,1.10899,1.10806,1.10898,1.110898539136,1.1084015555555555,1.1081899999999936,1.108069777777772,1.1098910000000033,1.1115164000000015,1.1119517000000005,1.1133937500000048,1.108610655129548,1.1086497862712328,2297,-122563,-123309.4,-0.16485157052335428,-220.27253323848774,0.08664103536037905
2023-07-24T06:45:00-04:00,1.10898,1.10933,1.10885,1.10915,1.11063822678784,1.1085935555555557,1.1083966666666603,1.1081497777777718,1.109689500000003,1.1114408000000013,1.1119153000000006,1.1133352500000049,1.1087185241036384,1.108629429016986,2612,-119951,-122883,-0.141434086026326,-219.87212926366402,0.16797767522511672
2023-07-24T07:00:00-04:00,1.10915,1.10982,1.10876,1.10972,1.1103935331805697,1.1088582222222223,1.1086888888888824,1.1082811111111053,1.1095440000000032,1.1113772000000015,1.1118878000000008,1.113279700000005,1.1089188192829107,1.1086743432135884,2592,-117359,-121382.6,-0.10470954804631634,-218.5400822005978,0.23755972865802533
2023-07-24T07:15:00-04:00,1.10972,1.11022,1.1092899999999999,1.11008,1.10656,1.1091364444444445,1.108894444444438,1.1084506666666607,1.1094005000000033,1.1113218000000016,1.1118651000000006,1.1132249500000049,1.1091510554263286,1.1087834745708705,2876,-114483,-119843.2,-0.06682986452030758,-217.60709009448115,0.16693285689792797
2023-07-24T07:30:00-04:00,1.11008,1.11091,1.10991,1.11073,1.1066332,1.1095035555555555,1.1091188888888823,1.1086577777777717,1.1092875000000033,1.1112772000000013,1.1118461000000006,1.1131731500000048,1.109466844341063,1.1089731796566962,3169,-111314,-117134,-0.03477441269327051,-215.75150310975923,0.18219372063027398
2023-07-24T07:45:00-04:00,1.11073,1.11075,1.10967,1.10974,1.1068042720000002,1.1096277777777779,1.1092233333333268,1.1088644444444387,1.1090955000000033,1.1112130000000016,1.1118181000000005,1.113115850000005,1.1095214754728504,1.1091553437253565,-3044,-114358,-115493,-0.011543006822039589,-218.46463771492893,0.08477633477632944
2023-07-24T08:00:00-04:00,1.10974,1.10998,1.10926,1.10937,1.1069685011200001,1.1096571111111109,1.1093544444444379,1.109055999999994,1.1088395000000033,1.1111494000000015,1.1117881000000005,1.1130585000000048,1.1094911803782803,1.1093098749802852,-2916,-117274,-114957.6,0.011669603388353177,-219.4368654439465,0.1064799357510859
2023-07-24T08:15:00-04:00,1.10937,1.10939,1.10869,1.10884,1.1071261610752001,1.1095542222222223,1.1094199999999934,1.1092022222222162,1.1086595000000035,1.1110774000000014,1.1117514000000006,1.112997250000005,1.1093609443026242,1.1093982999842278,-2840,-120114,-115508.6,0.04179831080400862,-220.79367155912877,0.053237085495158175
2023-07-24T08:30:00-04:00,1.10884,1.10937,1.1083399999999999,1.10849,1.107277514632192,1.1093682222222223,1.1094555555555488,1.1093144444444385,1.1086905000000034,1.1109906000000014,1.1117055000000007,1.1129334500000048,1.1091867554420993,1.109405439987382,-3171,-123285,-117269,0.060936324183102485,-221.7945824209305,0.02887643592588465
2023-07-24T08:45:00-04:00,1.10849,1.10883,1.10823,1.10877,1.1074228140469045,1.109231111111111,1.1094322222222153,1.109377111111105,1.1087230000000035,1.1109060000000013,1.1116749000000006,1.1128752500000048,1.1091034043536794,1.1093327519899054,3342,-119943,-118994.8,0.062480189051512175,-220.95040701113862,-0.018936319861498265
2023-07-24T09:00:00-04:00,1.10877,1.10896,1.10819,1.1082,1.1075623014850282,1.1089846666666665,1.10932666666666,1.109397777777772,1.1087410000000035,1.1108084000000014,1.1116323000000008,1.1128163000000049,1.1089227234829435,1.1092130015919242,-3731,-123674,-120858,0.05510109240125156,-222.86845133051943,-0.0856511743226801
2023-07-24T09:15:00-04:00,1.1082,1.10824,1.10744,1.10801,1.11091,1.1087213333333332,1.10913666666666,1.1093542222222161,1.1087405000000037,1.1107092000000014,1.1115904000000005,1.1127543500000048,1.108740178786355,1.109062801273539,-3646,-127320,-122867.2,0.044088283082731904,-223.4935551024022,-0.1540929243412843
2023-07-24T09:30:00-04:00,1.10801,1.10969,1.10792,1.10943,1.1108406,1.1087799999999999,1.1090644444444377,1.109283111111105,1.1088475000000035,1.1106370000000014,1.1115603000000005,1.112697250000005,1.108878143029084,1.108966241018831,5411,-121909,-123226.2,0.03541451213383299,-216.55894259890508,-0.05855433842606294
2023-07-24T09:45:00-04:00,1.10943,1.11044,1.10794,1.1085,1.110772588,1.108667111111111,1.10881666666666,1.109155333333327,1.1089180000000036,1.1105636000000014,1.1115171000000006,1.1126363000000048,1.1088025144232672,1.1088893928150645,-11306,-133215,-125212.2,0.01596705238707741,-226.03640399800065,-0.20076886372025193
2023-07-24T10:00:00-04:00,1.1085,1.10907,1.10816,1.10848,1.1107059362399998,1.1085997777777779,1.1086766666666599,1.109004222222216,1.1089305000000036,1.1104852000000014,1.1114701000000005,1.1125804000000048,1.1087380115386136,1.1088163142520515,-6124,-139339,-129091.4,-0.010293367412355519,-226.14689565339154,-0.11354010849388496
2023-07-24T10:15:00-04:00,1.10848,1.10849,1.1069,1.10702,1.1106406175151997,1.1082684444444444,1.1084155555555488,1.108821999999994,1.1088460000000036,1.1103812000000013,1.1114081000000005,1.1125181500000048,1.1083944092308908,1.1087106514016407,-5875,-145214,-133399.4,-0.029627714603088443,-233.88496941205213,-0.21183194065100683
2023-07-24T10:30:00-04:00,1.10702,1.10876,1.1069,1.1085099999999999,1.1104909928145916,1.1082873333333332,1.108378888888882,1.1086704444444382,1.1088315000000035,1.1103028000000015,1.1113670000000004,1.1124710000000047,1.1084175273847126,1.1086461211213123,5157,-140057,-135946.8,-0.036524985795517384,-226.94387530354464,-0.029760831138862548
2023-07-24T10:45:00-04:00,1.1085099999999999,1.10861,1.10761,1.10792,1.110347353102008,1.1081955555555554,1.1083155555555486,1.1085206666666605,1.1088180000000034,1.1102008000000014,1.1113275000000002,1.1124193500000048,1.10831802190777,1.1085340968970496,-5293,-145350,-140635,-0.041044383507222455,-229.76105331727416,-0.05142130285342759
2023-07-24T11:00:00-04:00,1.10792,1.10806,1.1073,1.10755,1.1102094589779277,1.1080424444444446,1.108179999999993,1.1083933333333271,1.1087830000000034,1.1100922000000013,1.1112895000000005,1.1123691500000048,1.108164417526216,1.1084064775176394,-3522,-148872,-143766.4,-0.046774789972701784,-230.93725737532884,-0.11003183708072899
2023-07-24T11:15:00-04:00,1.10755,1.1078999999999999,1.10709,1.10741,1.1100770806188105,1.1078884444444443,1.1080922222222154,1.1082764444444382,1.1087450000000036,1.1099876000000015,1.1112483000000004,1.1123131000000048,1.1080135340209727,1.108261582014111,-2858,-151730,-146244.6,-0.05543512947360575,-231.29852323240084,-0.07128677134091936
2023-07-24T11:30:00-04:00,1.10741,1.10799,1.1073,1.10734,1.109949997394058,1.107738,1.1080177777777707,1.1081968888888827,1.1086630000000035,1.1098806000000014,1.1112071000000003,1.1122599500000048,1.107878827216778,1.1081584656112884,-2387,-154117,-148025.2,-0.05962914221283741,-231.44940682565,-0.06046876833241112
2023-07-24T11:45:00-04:00,1.10734,1.10842,1.10722,1.1082,1.1098279974982959,1.1077744444444446,1.1078811111111042,1.1080973333333273,1.1086155000000035,1.1097898000000015,1.1111756000000004,1.1122093500000048,1.1079430617734225,1.1080635724890304,2462,-151655,-150344.8,-0.05456702457633611,-229.53732923430476,-0.11086774289498594
2023-07-24T12:00:00-04:00,1.1082,1.10832,1.10717,1.10784,1.109710877598364,1.1077662222222224,1.1078077777777708,1.1079957777777718,1.1085215000000033,1.1096948000000015,1.1111303000000003,1.1121654500000049,1.107922449418738,1.1079844579912241,-3871,-155526,-152380,-0.06328567470540222,-230.79482788075896,-0.05953991880921109
2023-07-24T12:15:00-04:00,1.10784,1.10801,1.10765,1.10788,1.1095984424944294,1.1077806666666667,1.1077411111111042,1.1079079999999941,1.1084115000000034,1.1096016000000015,1.1110884000000003,1.1121305500000047,1.1079139595349905,1.107934366392979,2388,-153138,-153233.2,-0.06097951268770412,-230.70860604367047,-0.05412817551962453
2023-07-24T12:30:00-04:00,1.10788,1.10828,1.10767,1.1078999999999999,1.1094905047946522,1.1078124444444444,1.107838888888882,1.1078573333333275,1.1082700000000032,1.1095128000000016,1.1110508000000003,1.1120984500000046,1.1079111676279925,1.1079138931143828,2186,-150952,-153077.6,-0.05685223445618551,-230.66914328597127,0.07949269209228306
2023-07-24T12:45:00-04:00,1.1078999999999999,1.10825,1.1077299999999999,1.10814,1.109386884602866,1.1078726666666667,1.1077977777777708,1.1078133333333275,1.1081900000000033,1.1094348000000016,1.1110127000000003,1.1120657500000046,1.107956934102394,1.1079295144915062,2418,-148534,-151961,-0.03562414656270827,-230.14534149880632,-0.033378138221575045
2023-07-24T13:00:00-04:00,1.10814,1.10839,1.10784,1.10821,1.1092874092187515,1.107955111111111,1.1078299999999932,1.1078031111111053,1.1081320000000034,1.1093634000000017,1.1109786000000001,1.1120326000000047,1.1080075472819153,1.1079424115932046,2625,-145909,-150811.8,-0.03175918195262592,-229.97952310040895,0.02617517510288662
2023-07-24T13:15:00-04:00,1.10821,1.10845,1.10761,1.10774,1.1091919128500014,1.107937111111111,1.1078511111111042,1.1078117777777718,1.1080770000000033,1.1092782000000014,1.1109362000000003,1.1120002500000048,1.1079540378255321,1.1079487292745636,-2052,-147961,-149298.8,-0.02638117641364473,-230.84979137086304,0.01715498171639316
2023-07-24T13:30:00-04:00,1.10774,1.10774,1.10685,1.10739,1.1091002363360014,1.1078448888888888,1.107848888888882,1.1078333333333275,1.1080220000000032,1.1091744000000014,1.1108915000000004,1.111969200000005,1.1078412302604257,1.1079341834196506,-1925,-149886,-148648.4,-0.02159532045491131,-231.4580117113759,-0.0018060158387506868
2023-07-24T13:45:00-04:00,1.10739,1.10751,1.10728,1.10748,1.1089652221558413,1.107771111111111,1.1078644444444374,1.1078384444444387,1.1079575000000035,1.1090820000000015,1.1108429000000004,1.111939250000005,1.1077689842083405,1.1079057467357203,1778,-148108,-148079.6,-0.016623746342310824,-231.31350977438905,0.012642910036667057
2023-07-24T14:00:00-04:00,1.10748,1.1075,1.10708,1.10719,1.1088383088264908,1.1076362222222222,1.1077522222222154,1.1078293333333276,1.1079070000000033,1.1089810000000015,1.1107890000000002,1.1119085000000049,1.1076531873666724,1.1078449973885758,-1637,-149745,-148321.8,-0.011187836161299333,-231.74216762825566,-0.09113878361308224
2023-07-24T14:15:00-04:00,1.10719,1.10749,1.10719,1.10731,1.1087190102969013,1.1075477777777776,1.1076933333333265,1.1078019999999944,1.1078720000000035,1.1088636000000016,1.1107366,1.1118807000000048,1.1075845498933379,1.1077603979108606,1282,-148463,-148832.6,-0.015396220575696881,-231.60322128661588,-0.047840843443089205
2023-07-24T14:30:00-04:00,1.10731,1.10747,1.10686,1.10697,1.1086068696790872,1.1074031111111111,1.1075922222222152,1.1077502222222164,1.1077490000000034,1.1087504000000015,1.1106775000000002,1.111855500000005,1.1074616399146704,1.1076619183286882,-1404,-149867,-149213.8,-0.018779758437604436,-232.0343200755729,-0.0821388598043079
2023-07-24T14:45:00-04:00,1.10697,1.10711,1.1067,1.10706,1.1085014574983418,1.1072966666666666,1.1074988888888821,1.1076802222222166,1.1076770000000034,1.1086326000000015,1.1106222000000001,1.111828750000005,1.1073813119317364,1.1075699346629504,1490,-148377,-148912,-0.015996017545901287,-231.91317858122358,-0.07581911724884484
2023-07-24T15:00:00-04:00,1.10706,1.10723,1.10652,1.10655,1.1083573408984746,1.107106888888889,1.1073222222222154,1.1075717777777723,1.1075805000000034,1.1085038000000014,1.1105594000000003,1.1117994500000048,1.1072150495453892,1.1074591477303601,-1672,-150049,-149300.2,-0.019802158976729583,-232.6834349358927,-0.14348367534787848
2023-07-24T15:15:00-04:00,1.10655,1.10675,1.10625,1.10625,1.1081736068086272,1.1068924444444443,1.1071044444444376,1.1074422222222167,1.1075420000000036,1.1083572000000015,1.1104974,1.1117674000000048,1.1070220396363113,1.1073329181842877,-1065,-151114,-149574,-0.02728109980855351,-232.97217019412773,-0.1768617861235652
2023-07-24T15:30:00-04:00,1.10625,1.10641,1.10609,1.10619,1.107942773991592,1.1067095555555555,1.1069322222222153,1.1072899999999943,1.1074260000000034,1.1081912000000016,1.1104324000000003,1.1117317000000049,1.106855631709049,1.10718713454743,-1349,-152463,-150374,-0.04195290628224215,-233.04533629582258,-0.13992453102713096
2023-07-24T15:45:00-04:00,1.10619,1.10622,1.10602,1.10602,1.107683385632769,1.106527111111111,1.1067799999999932,1.10712755555555,1.1073310000000034,1.1080628000000017,1.1103679000000002,1.1116967000000049,1.1066885053672393,1.107032507637944,-1207,-153670,-151134.6,-0.04678226273207106,-233.23082884231098,-0.12371431925519404
2023-07-24T16:00:00-04:00,1.10602,1.10633,1.10601,1.1063,1.107417243931526,1.1064311111111111,1.1066488888888821,1.1069575555555502,1.1072685000000033,1.1080314000000013,1.1103116000000002,1.1116641500000048,1.1066108042937914,1.1068784061103547,1007,-152663,-151991.8,-0.049662580011164824,-232.97589674343388,-0.10654819951601463
2023-07-24T16:15:00-04:00,1.1063,1.10642,1.10627,1.10632,1.1071639400238513,1.1063653333333332,1.1065522222222155,1.1068035555555502,1.1072140000000033,1.1079954000000014,1.1102521000000003,1.1116336500000048,1.1065526434350332,1.1067459248882836,568,-152095,-152401,-0.054851926891921324,-232.96562828099155,-0.07857729928918492
2023-07-24T16:30:00-04:00,1.10632,1.10645,1.10625,1.10628,1.106956230819558,1.1063108888888888,1.106437777777771,1.106670222222217,1.1071610000000034,1.1079642000000016,1.1101912000000003,1.111601550000005,1.1064981147480266,1.1066411399106266,-628,-152723,-152722.8,-0.05821365162789813,-232.98833418886633,-0.09301821531459901
2023-07-24T16:45:00-04:00,1.10628,1.1065099999999999,1.10623,1.10638,1.1067859092720376,1.1062993333333333,1.1063722222222152,1.1065582222222168,1.1070700000000033,1.1079314000000016,1.1101297000000003,1.1115703000000048,1.1064744917984213,1.106564911928501,1365,-151358,-152501.8,-0.06248709655193926,-232.864947704432,-0.053298644046368956
2023-07-24T17:00:00-04:00,1.10638,1.10638,1.10603,1.10637,1.1066462456030708,1.1062988888888887,1.1062955555555487,1.106461333333328,1.1069965000000033,1.1079130000000015,1.1100673000000003,1.111537250000005,1.106453593438737,1.1065179295428007,-74,-151432,-152054.2,-0.060040167293192434,-232.8656165523866,-0.06232724513575212
2023-07-24T17:15:00-04:00,1.10637,1.10649,1.10632,1.10642,1.106531721394518,1.106323777777778,1.1062811111111044,1.1063877777777726,1.1069235000000033,1.1078996000000014,1.1100024000000004,1.1115048500000049,1.1064468747509895,1.1064851436342402,69,-151363,-151794.2,-0.05971690179292364,-232.8624982465757,-0.011748226469654646
2023-07-24T17:30:00-04:00,1.10642,1.1066,1.10641,1.10658,1.10601,1.1063835555555557,1.1063177777777708,1.1063408888888837,1.1068575000000034,1.1078666000000015,1.1099409000000002,1.111471300000005,1.1064734998007915,1.1064693149073919,500,-150863,-151547.8,-0.05385662753977287,-232.79019297371372,0.02983050847457098
2023-07-24T17:45:00-04:00,1.10658,1.10673,1.10625,1.10632,1.1060218,1.1063839999999998,1.1063322222222152,1.1063197777777725,1.1067665000000033,1.1078188000000013,1.1098796000000002,1.1114369000000048,1.1064427998406332,1.1064582519259132,-970,-151833,-151369.8,-0.04643024470930426,-233.01810238830637,0.011752049828687971
2023-07-24T18:00:00-04:00,1.10632,1.10662,1.10627,1.10653,1.106050128,1.1064235555555555,1.106388888888882,1.106323111111106,1.1066825000000033,1.1077734000000015,1.1098209000000003,1.1114051500000048,1.1064602398725065,1.1064554015407304,572,-151261,-151350.4,-0.03643426128519813,-232.90952620781607,0.046111281893637585
2023-07-24T18:15:00-04:00,1.10653,1.10659,1.10644,1.10647,1.1060773228799998,1.106439777777778,1.1064077777777708,1.1063455555555504,1.1066190000000033,1.1077390000000014,1.1097581000000003,1.1113727500000048,1.1064621918980053,1.1064571212325838,-460,-151721,-151408.2,-0.024883692510797497,-232.93446904714258,0.015366537105667854
2023-07-24T18:30:00-04:00,1.10647,1.10647,1.10626,1.1064,1.1061034299647998,1.1064382222222222,1.1064166666666597,1.1063726666666613,1.1065695000000033,1.1077020000000013,1.1096927000000003,1.1113401000000047,1.1064497535184044,1.1064576969860669,-377,-152098,-151555.2,-0.018215241935831097,-232.95831967119926,0.007231180851840336
2023-07-24T18:45:00-04:00,1.1064,1.10644,1.10623,1.10626,1.1061284927662078,1.1064068888888887,1.1064144444444373,1.1063919999999947,1.1065085000000034,1.1076638000000012,1.1096258000000006,1.1113068500000047,1.1064118028147234,1.106445357588853,-318,-152416,-151865.8,-0.013895553121474929,-232.99855828291294,-0.0018078605777840132
2023-07-24T19:00:00-04:00,1.10626,1.10627,1.10608,1.10609,1.10673,1.1063420000000002,1.106382222222215,1.1064019999999948,1.1064535000000033,1.1076060000000012,1.1095612000000004,1.1112711500000048,1.1063474422517787,1.1064262860710823,-714,-153130,-152125.2,-0.009631498356154521,-233.10827932498262,-0.02621160903124618
2023-07-24T19:15:00-04:00,1.10609,1.10647,1.10598,1.10636,1.106717,1.1063375555555555,1.1063811111111042,1.106400444444439,1.1064060000000033,1.1075502000000013,1.1094955000000004,1.1112374500000046,1.106349953801423,1.1064042288568658,1021,-152109,-152294.8,-0.006240469833899764,-232.8590500579248,-0.0009038567567871066
2023-07-24T19:30:00-04:00,1.10636,1.10637,1.10615,1.1062,1.10668752,1.1063013333333331,1.1063566666666598,1.1063902222222168,1.1063675000000033,1.107479800000001,1.1094285000000004,1.1112029000000048,1.1063199630411384,1.1063757830854923,-511,-152620,-152474.6,-0.002999872601979397,-232.93295005430932,-0.019883950037046235
2023-07-24T19:45:00-04:00,1.1062,1.1063399999999999,1.10615,1.10629,1.1066592192,1.106288,1.1063244444444376,1.1063717777777726,1.1063290000000032,1.1074040000000012,1.1093629000000005,1.1111669000000048,1.1063139704329108,1.1063486264683937,1116,-151504,-152355.8,-0.0012481901240239976,-232.84215273013655,-0.026206871622467556
2023-07-24T20:00:00-04:00,1.10629,1.10657,1.10625,1.1065099999999999,1.106632050432,1.1063251111111112,1.1063455555555486,1.1063579999999948,1.1063270000000034,1.1073196000000012,1.1092984000000004,1.1111312000000046,1.1063531763463286,1.1063369011747146,1618,-149886,-151849.8,0.0004863752521557994,-232.52039261298842,0.01717405452309571
2023-07-24T20:15:00-04:00,1.1065099999999999,1.10671,1.10631,1.10666,1.10598,1.106388,1.106359999999993,1.1063535555555504,1.1063475000000031,1.1072580000000012,1.1092355000000003,1.1110970000000047,1.106414541077063,1.1063503209397716,1659,-148227,-150869.2,0.003086100924821292,-232.29549631742836,0.011748438813223634
2023-07-24T20:30:00-04:00,1.10666,1.1069499999999999,1.10661,1.10691,1.1059946,1.106498,1.106408888888882,1.106359111111106,1.1063835000000033,1.1072088000000013,1.1091791000000004,1.1110650500000048,1.1065136328616503,1.1063830567518171,1504,-146723,-149792,0.0036799739692969097,-231.95573523453015,0.039766103012281936
2023-07-24T20:45:00-04:00,1.10691,1.10701,1.10665,1.10673,1.1060328160000001,1.1065622222222222,1.1064455555555486,1.1063768888888839,1.1064190000000031,1.107166600000001,1.1091220000000002,1.1110311500000047,1.1065569062893201,1.1064304454014535,-2098,-148821,-149032.2,0.003705712220089143,-232.29690118298137,0.029826464208237657
2023-07-24T21:00:00-04:00,1.10673,1.10756,1.10669,1.10753,1.10609144704,1.1067791111111112,1.1065866666666595,1.1064293333333282,1.106480500000003,1.107147400000001,1.1090690000000003,1.1110008000000047,1.1067515250314561,1.1065179563211625,2442,-146379,-148007.2,0.00741955017067311,-230.53170099865477,0.11480122213583446
2023-07-24T21:15:00-04:00,1.10753,1.10769,1.10714,1.1074599999999999,1.1062089312768,1.1069537777777778,1.1067388888888818,1.106507999999995,1.106537500000003,1.107121200000001,1.1090136000000004,1.1109708000000047,1.1068932200251649,1.1066259650569297,-3059,-149438,-147917.6,0.013271897016534494,-230.72504113391074,0.12385972208408641
2023-07-24T21:30:00-04:00,1.1074599999999999,1.10761,1.10701,1.10703,1.10635703814912,1.1070119999999999,1.1068133333333263,1.1065986666666616,1.1065750000000032,1.1070978000000011,1.1089531000000004,1.1109376000000046,1.106920576020132,1.1067271720455434,-2586,-152024,-148677,0.018710909562213687,-231.72912254542882,0.0605589500704968
2023-07-24T21:45:00-04:00,1.10703,1.1075,1.10692,1.10735,1.1064903343342078,1.1071193333333333,1.106941111111104,1.106705111111106,1.106623500000003,1.1070846000000012,1.1088969000000004,1.1109071000000048,1.1070064608161057,1.1068257376364343,2247,-149777,-149287.8,0.023051915219823683,-231.07960085224957,0.10395950099439381
2023-07-24T22:00:00-04:00,1.10735,1.10742,1.10703,1.10717,1.106610300900787,1.1071651111111112,1.1070388888888818,1.1068237777777725,1.1066635000000031,1.107039400000001,1.1088382000000003,1.1108759500000047,1.1070391686528844,1.1069221901091473,-2175,-151952,-149914,0.0284169634300177,-231.43314760801798,0.07954514639018628
2023-07-24T22:15:00-04:00,1.10717,1.10741,1.10709,1.10737,1.1067182708107084,1.1072313333333332,1.1071344444444375,1.1069333333333282,1.106711000000003,1.1070168000000011,1.1087902000000005,1.1108460500000048,1.1071053349223074,1.1069929520873176,1832,-150120,-150662.2,0.033871700607501096,-231.10221378575042,0.07772184616497664
2023-07-24T22:30:00-04:00,1.10737,1.10768,1.10737,1.10763,1.1068154437296376,1.1073304444444445,1.1072422222222151,1.1070339999999947,1.1067635000000031,1.1069998000000012,1.1087425000000004,1.1108171500000048,1.107210267937846,1.1070563616698537,2006,-148114,-150397.4,0.038783487545407204,-230.63122396301742,0.08765113042848892
2023-07-24T22:45:00-04:00,1.10763,1.10817,1.10756,1.1080699999999999,1.1069028993566739,1.1074959999999998,1.107371111111104,1.10714555555555,1.1068510000000031,1.107020800000001,1.1087010000000006,1.1107888000000048,1.1073822143502767,1.1071486893358826,1852,-146262,-149245,0.0451096959389973,-229.89552702450908,0.1047962345628667
2023-07-24T23:00:00-04:00,1.1080699999999999,1.10808,1.10779,1.10794,1.107054951433873,1.1076097777777778,1.1075055555555484,1.1072584444444389,1.1069215000000032,1.107009400000001,1.1086561000000004,1.1107615500000048,1.1074937714802213,1.1072461514687058,-1457,-147719,-148833.4,0.04744254238368501,-230.0664638786789,0.10933109249771249
2023-07-24T23:15:00-04:00,1.10794,1.1080699999999999,1.10765,1.10767,1.1071887572618082,1.1076426666666666,1.107521111111104,1.1073548888888833,1.1069815000000032,1.107004400000001,1.1086026000000004,1.1107320500000046,1.107529017184177,1.1073441211749644,-1442,-149161,-148275.2,0.051027914360149126,-230.4178727997396,0.012640741108595614
2023-07-24T23:30:00-04:00,1.10767,1.10784,1.10758,1.10778,1.1073065063903913,1.1076944444444443,1.1075566666666596,1.1074393333333277,1.1070505000000033,1.107009000000001,1.1085506000000003,1.110701600000005,1.1075792137473415,1.1074388969399713,1247,-147914,-147834,0.04764831867323205,-230.2940362780318,0.02889494880177144
2023-07-24T23:45:00-04:00,1.10778,1.10797,1.1077299999999999,1.10784,1.1074101256235445,1.1077511111111111,1.1076466666666596,1.1075202222222167,1.1071295000000032,1.1070176000000012,1.1085026000000004,1.1106712000000047,1.1076313709978731,1.1075231175519769,942,-146972,-147605.6,0.04488394049630414,-230.24301531719124,0.07316874881439324
2023-07-25T00:00:00-04:00,1.10784,1.10789,1.10768,1.10784,1.107501310548719,1.1077897777777779,1.107701111111104,1.1075862222222166,1.107217000000003,1.107027600000001,1.1084541000000003,1.1106403500000048,1.1076730967982984,1.107581294041581,0,-146972,-147747.6,0.045401310857786,-230.24301531719124,0.044249785523987846
2023-07-25T00:15:00-04:00,1.10784,1.10786,1.10763,1.10768,1.1075815532828728,1.1077855555555554,1.1077577777777707,1.107636666666661,1.1072830000000031,1.107017200000001,1.1084035000000005,1.1106100500000047,1.1076744774386387,1.1076174352332646,-1010,-147982,-147800.2,0.041540476913718115,-230.38888475682145,0.046063386833097936
2023-07-25T00:30:00-04:00,1.10768,1.10769,1.10705,1.1071199999999999,1.10817,1.107658,1.107729999999993,1.1076784444444387,1.1073290000000031,1.107002800000001,1.1083488000000006,1.1105754500000047,1.1075635819509109,1.1076243481866113,-1180,-149162,-147800.4,0.037819133884493754,-230.98544694084583,-0.022576013437250738
2023-07-25T00:45:00-04:00,1.1071199999999999,1.10713,1.10687,1.10703,1.1081476000000001,1.107518,1.1076633333333266,1.107699777777772,1.1073660000000032,1.106985800000001,1.1082937000000006,1.1105409000000046,1.1074568655607286,1.1075998785492889,-1189,-150351,-148287.8,0.031177954735083266,-231.08210312987674,-0.054169713713057066
2023-07-25T01:00:00-04:00,1.10703,1.10732,1.10694,1.10728,1.1080964960000002,1.107441333333333,1.1075755555555487,1.1076855555555496,1.107404500000003,1.106973400000001,1.1082431000000006,1.1105083500000048,1.107421492448583,1.1075579028394307,1437,-148914,-148676.2,0.02375874020654619,-230.7575861791165,-0.07129513478388969
2023-07-25T01:15:00-04:00,1.10728,1.1075,1.1072,1.10743,1.1080474361600001,1.107412222222222,1.107518888888882,1.1076491111111053,1.107443000000003,1.1069592000000013,1.1081970000000008,1.1104761500000047,1.1074231939588663,1.1075079222715443,1424,-147490,-148779.8,0.014022477244431068,-230.56468104220457,-0.046031373540084346
2023-07-25T01:30:00-04:00,1.10743,1.10776,1.10734,1.10764,1.1080003387136002,1.1074364444444442,1.1075155555555487,1.1076006666666607,1.107479500000003,1.106947800000001,1.1081556000000006,1.1104463500000046,1.107466555167093,1.1074663378172351,1713,-145777,-148338.8,0.007099090577141431,-230.23984786990468,-0.0027083878772535585
2023-07-25T01:45:00-04:00,1.10764,1.10783,1.10706,1.10762,1.1079551251650561,1.107457333333333,1.1074977777777708,1.1075542222222166,1.107524000000003,1.106945400000001,1.1081118000000005,1.1104164000000047,1.1074972441336743,1.1074530702537877,-2985,-148762,-148258.8,0.0035945842174027968,-230.29374624843896,-0.01444330101644171
2023-07-25T02:00:00-04:00,1.10762,1.10799,1.10716,1.10778,1.10687,1.1075137777777777,1.1074911111111043,1.1075197777777719,1.1075365000000033,1.106953200000001,1.1080638000000007,1.1103867500000046,1.1075537953069394,1.10747245620303,3284,-145478,-147284.2,-0.0009201032232390811,-229.8193597259856,-0.005415944540723298
2023-07-25T02:15:00-04:00,1.10778,1.10842,1.10774,1.10835,1.1068924,1.1076855555555556,1.107547777777771,1.1075142222222163,1.107581000000003,1.106970600000001,1.1080263000000008,1.1103595000000046,1.1077130362455516,1.1075307649624238,2151,-143327,-146166.8,0.00015907765943072797,-228.71257859615847,0.04603552859618812
2023-07-25T02:30:00-04:00,1.10835,1.1086799999999999,1.10808,1.1081,1.106953504,1.107796,1.1075944444444377,1.1075293333333274,1.107634500000003,1.106988800000001,1.1079849000000008,1.1103307500000046,1.1077904289964413,1.1076042119699387,-2288,-145615,-145791.8,-0.00024505883960783355,-229.22866106108353,0.03791708796765194
2023-07-25T02:45:00-04:00,1.1081,1.10853,1.10788,1.10797,1.10705709376,1.107871111111111,1.107688888888882,1.1075639999999942,1.107665500000003,1.107002000000001,1.1079328000000006,1.1103008500000044,1.1078263431971531,1.1076761695759507,-2580,-148195,-146275.4,-0.0016680524109218544,-229.5313413245981,0.076775778596721
2023-07-25T03:00:00-04:00,1.10797,1.1083,1.10715,1.10824,1.1086799999999999,1.1079813333333335,1.1078233333333263,1.107629111111105,1.1077190000000032,1.107027400000001,1.1078889000000007,1.1102726000000045,1.1079090745577225,1.1077585356607604,4792,-143403,-145203.6,0.004617061202150549,-228.3635840748531,0.10930146427828816
2023-07-25T03:15:00-04:00,1.10824,1.1084,1.10792,1.10804,1.1086493999999998,1.1080246666666667,1.107907777777771,1.1077124444444384,1.1077525000000032,1.107047000000001,1.1078398000000005,1.1102441000000045,1.107935259646178,1.1078348285286082,-3114,-146517,-145411.4,0.00999466091693175,-228.92555621085245,0.06863665920091322
2023-07-25T03:30:00-04:00,1.10804,1.10846,1.10754,1.10787,1.1086194119999997,1.108017111111111,1.1079566666666598,1.1077942222222164,1.1077645000000031,1.107073400000001,1.1077886000000006,1.1102146000000046,1.1079222077169424,1.1078766628228862,-3256,-149773,-146700.6,0.013171175415923267,-229.42510496360507,0.03973163089314864
2023-07-25T03:45:00-04:00,1.10787,1.10821,1.10696,1.10707,1.1085900237599997,1.1078397777777778,1.1078933333333265,1.107853999999994,1.107714500000003,1.107089800000001,1.1077235000000005,1.1101784500000047,1.1077517661735539,1.1078689302583087,-2814,-152587,-148095,0.01232892965318713,-231.45711232908997,-0.05146076342493585
2023-07-25T04:00:00-04:00,1.10707,1.1071,1.10535,1.10597,1.1085248228095996,1.107455111111111,1.1077099999999933,1.1078582222222164,1.1076160000000033,1.1070854000000008,1.1076383000000007,1.1101375000000047,1.107395412938843,1.1077827442066466,-7531,-160118,-150479.6,0.0062810991797611895,-238.94001765576377,-0.1489680576371094
2023-07-25T04:15:00-04:00,1.10597,1.10645,1.10528,1.10635,1.1083343334410236,1.107183111111111,1.1075511111111043,1.107803777777772,1.1075500000000031,1.1070920000000009,1.1075774000000005,1.1100971000000046,1.1071863303510745,1.107638195365317,3542,-156576,-153114.2,0.0016509972413426563,-237.7230226197319,-0.12908700283450164
2023-07-25T04:30:00-04:00,1.10635,1.10678,1.10601,1.10648,1.1080899867657417,1.1069688888888887,1.1073433333333265,1.107690888888883,1.1074850000000032,1.107095600000001,1.1075635000000006,1.1100576500000046,1.1070450642808596,1.1074601562922533,3125,-153451,-154501,-0.004970443917087183,-237.35582417439372,-0.16871926737944137
2023-07-25T04:45:00-04:00,1.10648,1.10701,1.10632,1.10647,1.1078651878244823,1.1067942222222222,1.1071622222222155,1.1075319999999942,1.1074165000000031,1.107098600000001,1.1075470000000005,1.1100185500000046,1.1069300514246876,1.1072617250338024,-2954,-156405,-155827.4,-0.01631395023311574,-237.38252144863233,-0.14709863730710407
2023-07-25T05:00:00-04:00,1.10647,1.10675,1.10606,1.10606,1.1076583727985236,1.1065737777777778,1.1069499999999932,1.1073433333333278,1.1073275000000031,1.107094200000001,1.1075292000000005,1.1099799000000046,1.1067560411397501,1.1070625800270417,-2236,-158641,-157038.2,-0.02708305829538021,-238.21106628039465,-0.1723873390073609
2023-07-25T05:15:00-04:00,1.10606,1.10609,1.10541,1.10551,1.1074681029746418,1.1062857777777777,1.1066466666666601,1.107130666666661,1.107219000000003,1.1070768000000009,1.1075041000000005,1.1099392000000043,1.1065068329118002,1.106884864021633,-2184,-160825,-157179.6,-0.039282540987444256,-239.29708331382875,-0.24633653360282065
2023-07-25T05:30:00-04:00,1.10551,1.10554,1.10432,1.10447,1.1072930547366704,1.1058504444444444,1.1062499999999933,1.1068704444444388,1.1070865000000032,1.1070388000000009,1.1074759000000005,1.1098970500000045,1.1060994663294401,1.1066674912173062,-2587,-163412,-158546.8,-0.05953412749414955,-241.73078359695583,-0.3221905346377253
2023-07-25T05:45:00-04:00,1.10447,1.10472,1.10418,1.10423,1.1069957492630034,1.1054464444444443,1.1058455555555489,1.1065708888888834,1.1069465000000032,1.1069950000000008,1.1074473000000007,1.1098543000000045,1.105725573063552,1.1064035929738445,-2418,-165830,-161022.6,-0.08152814510531674,-242.25621208301706,-0.3285584048669849
2023-07-25T06:00:00-04:00,1.10423,1.10464,1.10409,1.1046,1.106657859351443,1.1051973333333334,1.1055711111111046,1.1062526666666612,1.106812500000003,1.1069554000000008,1.1074110000000006,1.1098141500000045,1.1055004584508417,1.1061176743790753,2161,-163669,-162475.4,-0.10062585158073911,-241.5321147482227,-0.22311145636680357
2023-07-25T06:15:00-04:00,1.1046,1.1047,1.10436,1.10457,1.1062983590422408,1.1049971111111114,1.105415555555549,1.1059457777777721,1.1066695000000029,1.1069204000000008,1.1073696000000006,1.1097705000000047,1.1053143667606733,1.1058293395032601,-1554,-165223,-163791.8,-0.11156663146967508,-241.5743200714166,-0.12658571208982575
2023-07-25T06:30:00-04:00,1.10457,1.10461,1.10447,1.1045,1.1059891887763271,1.104814,1.1052099999999934,1.1056584444444388,1.106512500000003,1.1068798000000009,1.1073266000000006,1.1097255000000046,1.1051514934085387,1.1055582716026078,-878,-166101,-164847,-0.11225631931267072,-241.62996163329137,-0.16721652280019048
2023-07-25T06:45:00-04:00,1.1045,1.1047,1.10446,1.10449,1.1057233023476414,1.10467,1.1049888888888821,1.1054062222222165,1.106356000000003,1.1068402000000008,1.1072896000000008,1.1096839000000045,1.1050191947268309,1.105342217282086,-1439,-167540,-165672.6,-0.11552528670398547,-241.64299015298363,-0.17984961318776085
2023-07-25T07:00:00-04:00,1.10449,1.10465,1.10391,1.10425,1.1054946400189716,1.1045222222222224,1.1047422222222154,1.1051855555555499,1.1061795000000028,1.1067972000000008,1.1072496000000007,1.1096412500000046,1.1048653557814647,1.1051701738256683,-1862,-169402,-166387,-0.12119388568097621,-242.04759318243617,-0.20063806519834343
2023-07-25T07:15:00-04:00,1.10425,1.10467,1.10393,1.10437,1.1052410976159361,1.1044477777777777,1.104554444444438,1.1049822222222165,1.105980500000003,1.106759400000001,1.1072116000000007,1.1095987000000045,1.1047662846251718,1.1050233390605344,3164,-166238,-166900.8,-0.1255168340221432,-241.70375800018545,-0.15279460427101327
2023-07-25T07:30:00-04:00,1.10437,1.10477,1.1043,1.10474,1.1050281219973863,1.1044848888888887,1.1044688888888823,1.104792888888883,1.105812500000003,1.1067324000000012,1.1071692000000006,1.1095604500000045,1.1047610277001374,1.1049126712484274,1589,-164649,-166786,-0.1219280625719669,-241.1713911303864,-0.06965111125181477
2023-07-25T07:45:00-04:00,1.10474,1.105,1.10461,1.10495,1.10391,1.1045811111111112,1.1045222222222157,1.1046553333333275,1.1056615000000027,1.1067042000000011,1.1071272000000008,1.1095212500000045,1.10479882216011,1.1048421369987416,3644,-161005,-165766.8,-0.11344374967674559,-240.47870325812673,0.043459758979423245
2023-07-25T08:00:00-04:00,1.10495,1.10522,1.10482,1.10517,1.1039318,1.1047106666666666,1.1046266666666602,1.1045828888888833,1.1055080000000026,1.106683600000001,1.1070817000000008,1.1094847500000045,1.1048730577280879,1.104812909598993,2741,-158264,-163911.6,-0.09506684353761008,-239.93295910680794,0.0851271927044131
2023-07-25T08:15:00-04:00,1.10517,1.10532,1.10484,1.1051,1.103983328,1.1048053333333334,1.1046822222222157,1.1045708888888834,1.1053610000000027,1.1066598000000012,1.1070319000000008,1.1094485000000045,1.1049184461824704,1.1048235276791942,-2312,-160576,-162146.4,-0.0736842921420636,-240.07939811619116,0.04526525439072469
2023-07-25T08:30:00-04:00,1.1051,1.1051199999999999,1.10422,1.10479,1.10406352832,1.104826888888889,1.1047066666666605,1.104601333333328,1.1052070000000027,1.106625400000001,1.1069725000000008,1.1094093000000043,1.1048927569459763,1.104848822143355,-2712,-163288,-161556.4,-0.05797429864944563,-240.84016184798023,0.019917252867621513
2023-07-25T08:45:00-04:00,1.10479,1.10503,1.10446,1.10486,1.1041389166208,1.1048575555555555,1.1047466666666603,1.1046568888888835,1.1050965000000026,1.106589400000001,1.1069237000000007,1.1093709000000045,1.104886205556781,1.1048738577146837,2223,-161065,-160839.6,-0.04238872851021988,-240.6993115506386,0.032593933906737524
2023-07-25T09:00:00-04:00,1.10486,1.10499,1.10286,1.10288,1.10532,1.1044842222222222,1.1045677777777714,1.1046659999999948,1.1049420000000025,1.106508800000001,1.1068588000000008,1.1093234500000044,1.1044849644454249,1.1048110861717466,-5025,-166090,-161856.6,-0.03900053480266102,-249.7045248808337,-0.1457686352977292
2023-07-25T09:15:00-04:00,1.10288,1.10347,1.10255,1.1027,1.1052708,1.1041106666666667,1.1043955555555491,1.1046197777777726,1.1047595000000026,1.106428200000001,1.1067974000000007,1.1092744000000045,1.10412797155634,1.104662068937397,-4343,-170433,-164290.4,-0.0411136502143411,-250.41334179654555,-0.1403667647724646
2023-07-25T09:30:00-04:00,1.1027,1.10408,1.10259,1.10399,1.105161968,1.1040295555555555,1.1043533333333266,1.1045539999999947,1.1046350000000025,1.106357400000001,1.1067524000000009,1.1092289500000043,1.104100377245072,1.1044984551499173,4098,-166335,-165442.2,-0.03329859072576998,-245.61927269343497,-0.03440875793439218
2023-07-25T09:45:00-04:00,1.10399,1.10415,1.10342,1.10385,1.10505748928,1.1039288888888887,1.1042544444444378,1.1044635555555502,1.1045040000000026,1.1062852000000012,1.106703200000001,1.1091890500000043,1.1040503017960575,1.1043299641199336,-2226,-168561,-166496.8,-0.026672069768746635,-245.9015578590615,-0.0805619421764449
2023-07-25T10:00:00-04:00,1.10385,1.10385,1.1026799999999999,1.10361,1.1049571897088,1.1038000000000001,1.104105555555549,1.104335333333328,1.1043815000000026,1.1062168000000012,1.1066573000000008,1.1091448000000041,1.103962241436846,1.1041451712959465,-4132,-172693,-168822.4,-0.02457564966998383,-246.79994079152522,-0.12127245576724004
2023-07-25T10:15:00-04:00,1.10361,1.10395,1.1028,1.10295,1.104860902120448,1.103568888888889,1.1038588888888823,1.10419355555555,1.1042535000000027,1.1061288000000011,1.1066067000000008,1.1090985500000043,1.1037597931494767,1.1040001370367567,-2124,-174817,-170567.8,-0.02927912971532934,-248.07017212324544,-0.2008740736719137
2023-07-25T10:30:00-04:00,1.10295,1.10322,1.10204,1.10298,1.10476846603563,1.103393111111111,1.1036233333333267,1.1040391111111056,1.1041790000000025,1.106045000000001,1.1065422000000007,1.1090512500000045,1.1036038345195813,1.103895309629405,2806,-172011,-170883.4,-0.03820502370809092,-247.99384953382622,-0.19183784272915572
2023-07-25T10:45:00-04:00,1.10298,1.1045,1.10272,1.10444,1.1046047580734923,1.1035564444444443,1.1035844444444376,1.1038853333333278,1.1041895000000026,1.105986400000001,1.1065016000000008,1.1090093500000042,1.1037710676156651,1.1038294477035238,3023,-168988,-171414,-0.04405292043022071,-243.992344520136,-0.031680228821753496
2023-07-25T11:00:00-04:00,1.10444,1.10491,1.10436,1.10459,1.10204,1.1037575555555557,1.1035544444444376,1.1037453333333276,1.1041890000000023,1.105925600000001,1.106462700000001,1.1089664000000043,1.103934854092532,1.1038063581628186,2927,-166061,-170914,-0.04741599025002515,-243.59481273932434,-0.024437485292253543
2023-07-25T11:15:00-04:00,1.10459,1.10501,1.10421,1.10488,1.1020974,1.1040226666666666,1.10377666666666,1.1036795555555499,1.1042045000000025,1.105861800000001,1.1064413000000008,1.1089247000000042,1.1041238832740257,1.1038386865302545,1836,-164225,-169220.4,-0.048441781456709486,-243.11278773457124,0.18134339184680126
2023-07-25T11:30:00-04:00,1.10488,1.10534,1.10456,1.10526,1.1022139039999999,1.1043193333333332,1.1040611111111043,1.1037199999999943,1.1042425000000025,1.1058082000000011,1.1064088000000007,1.1088879000000043,1.1043511066192204,1.1039569492242034,2005,-162220,-166701,-0.02986284652194265,-242.42321058592194,0.2321574317584017
2023-07-25T11:45:00-04:00,1.10526,1.1053,1.10478,1.10492,1.1024014697599998,1.104491111111111,1.1041644444444376,1.1038282222222164,1.1042640000000026,1.105753200000001,1.1063788000000008,1.1088531500000043,1.1044648852953762,1.104129159379362,-2003,-164223,-165143.4,-0.011569756836464402,-243.0393732987678,0.0842398934772847
2023-07-25T12:00:00-04:00,1.10492,1.10547,1.10481,1.10522,1.1025777815743998,1.1047022222222223,1.1043166666666597,1.103974666666661,1.1043125000000025,1.105702000000001,1.1063555000000007,1.1088225000000043,1.104615908236301,1.1042981275034893,2084,-162139,-163773.6,-0.003579051766632117,-242.47354047829174,0.12411106581511015
2023-07-25T12:15:00-04:00,1.10522,1.1054599999999999,1.10486,1.10492,1.102809159048448,1.104822888888889,1.1044622222222154,1.1041562222222165,1.1043400000000025,1.1056436000000012,1.1063306000000008,1.1087894500000042,1.1046767265890407,1.1044465020027912,-1451,-163590,-163279.4,0.003221053530522404,-242.86739871466122,0.11870135283296838
2023-07-25T12:30:00-04:00,1.10492,1.10513,1.1048,1.10507,1.103022026324572,1.1049444444444445,1.104697777777771,1.1043404444444387,1.1043565000000024,1.105588200000001,1.106307900000001,1.1087575000000043,1.1047553812712325,1.1045728016022325,1482,-162108,-162856,0.013422807216747755,-242.66620767820598,0.19221179563895913
2023-07-25T12:45:00-04:00,1.10507,1.10507,1.10409,1.10422,1.1032178642186063,1.1048488888888888,1.1048355555555487,1.1044953333333276,1.1043200000000026,1.1055190000000013,1.106268100000001,1.1087218500000042,1.104648305016986,1.1046322412817855,-2820,-164928,-163397.6,0.02716530085594521,-244.83530103880761,0.11242270938728788
2023-07-25T13:00:00-04:00,1.10422,1.10422,1.10384,1.10386,1.103398035081118,1.1046537777777776,1.1047711111111043,1.1046166666666608,1.1042545000000026,1.1054538000000012,1.106228300000001,1.1086793000000044,1.1044906440135889,1.104637393025428,-2440,-167368,-164026.6,0.03983568963891265,-245.6307946904348,-0.052515301872444395
2023-07-25T13:15:00-04:00,1.10386,1.10394,1.10353,1.10392,1.10547,1.1044835555555557,1.1046966666666598,1.1046926666666608,1.1041955000000025,1.1053916000000013,1.106188700000001,1.1086385500000042,1.104376515210871,1.1045895144203421,1631,-165737,-164746.2,0.04051919422199427,-245.5421421439163,-0.06065599000533668
2023-07-25T13:30:00-04:00,1.10392,1.1040699999999999,1.10374,1.10405,1.1054312,1.1043542222222222,1.1046044444444376,1.1047211111111053,1.1041585000000027,1.1053270000000013,1.106150200000001,1.1086005000000043,1.1043112121686969,1.1045164115362733,1110,-164627,-164953.6,0.0401587720526109,-245.41142615000373,-0.07512128013902943
2023-07-25T13:45:00-04:00,1.10405,1.10419,1.10388,1.10393,1.105393176,1.1042193333333332,1.1044566666666598,1.1046728888888828,1.1041120000000026,1.1052570000000013,1.106108100000001,1.1085604000000044,1.1042349697349576,1.1044123292290184,-980,-165607,-165653.4,0.035265298377335476,-245.51794306499843,-0.1203336771438242
2023-07-25T14:00:00-04:00,1.10393,1.10409,1.1037,1.10398,1.1053559124799999,1.1041239999999999,1.1043522222222153,1.1045762222222162,1.1041670000000026,1.1051838000000012,1.106065800000001,1.1085222000000043,1.1041839757879661,1.1043194633832143,1081,-164526,-165573,0.027468901787557034,-245.4689816272262,-0.08507403250913559
2023-07-25T14:15:00-04:00,1.10398,1.10402,1.10355,1.10391,1.1053193942303998,1.1040355555555557,1.10420666666666,1.1044633333333276,1.1042275000000028,1.1051096000000014,1.106027500000001,1.1084818500000042,1.1041291806303728,1.104247170706571,-1023,-165549,-165209.2,0.013878316747586631,-245.53384693275711,-0.11852843777710721
2023-07-25T14:30:00-04:00,1.10391,1.10408,1.10378,1.10403,1.1052836063457918,1.1040002222222223,1.104107777777771,1.1043455555555497,1.1042295000000029,1.1050346000000013,1.105993900000001,1.108442700000004,1.1041093445042982,1.1041937365652568,1735,-163814,-164824.6,-0.002634917704960138,-245.3452446010451,-0.08054881801395897
2023-07-25T14:45:00-04:00,1.10403,1.10457,1.10402,1.10452,1.105248534218876,1.1040826666666668,1.1040466666666597,1.104233999999994,1.1042630000000027,1.1049580000000012,1.105964300000001,1.1084036000000044,1.1041914756034386,1.1041697892522049,2136,-161678,-164234.8,-0.008542803065515785,-244.39722688413545,-0.04977060276725008
2023-07-25T15:00:00-04:00,1.10452,1.10482,1.10434,1.1048,1.1052141635344985,1.1042333333333334,1.1041111111111044,1.1041648888888829,1.1043225000000028,1.1048920000000013,1.1059404000000008,1.1083647000000043,1.1043131804827508,1.1041854314017636,2067,-159611,-163035.6,-0.015084048941400077,-243.87323456167852,0.05252576479324998
2023-07-25T15:15:00-04:00,1.1048,1.10506,1.10467,1.10493,1.1051804802638086,1.104397111111111,1.1042299999999932,1.1041404444444385,1.1044215000000026,1.1048312000000011,1.105916600000001,1.1083266000000043,1.1044365443862008,1.1042359451214103,1522,-158089,-161748.2,-0.014345847465507081,-243.6941433234454,0.09693258203032126
2023-07-25T15:30:00-04:00,1.10493,1.10507,1.10479,1.10496,1.1051474706585325,1.104543111111111,1.1043455555555488,1.1041682222222164,1.1045205000000027,1.1047656000000012,1.105896500000001,1.1082870000000042,1.1045412355089606,1.104318356097128,1451,-156638,-159966,-0.013051132240459387,-243.65474716260266,0.09420972534240976
2023-07-25T15:45:00-04:00,1.10496,1.10531,1.10494,1.10521,1.10353,1.104716,1.1044744444444377,1.1042415555555496,1.1045590000000027,1.104709000000001,1.105878000000001,1.1082501000000042,1.1046749884071685,1.104431484877702,1719,-154919,-158187,-0.01098483248107104,-243.26581905660774,0.10506770526697612
2023-07-25T16:00:00-04:00,1.10521,1.10549,1.10521,1.10524,1.1035655999999998,1.104869111111111,1.1046199999999933,1.1043562222222163,1.1045915000000028,1.104656400000001,1.105864900000001,1.1082121500000044,1.1047879907257347,1.1045507879021614,1797,-153122,-156475.8,-0.003660047541581023,-243.21704099632964,0.11866694446205124
2023-07-25T16:15:00-04:00,1.10524,1.10535,1.10514,1.10534,1.103642576,1.105013111111111,1.1047711111111045,1.1044882222222163,1.1046145000000025,1.104621800000001,1.105855800000001,1.1081766000000044,1.1048983925805878,1.1046678303217288,734,-152388,-155031.2,0.0058714058656831195,-243.15063008105332,0.12319063751155165
2023-07-25T16:30:00-04:00,1.10534,1.10541,1.10525,1.10532,1.10371647296,1.1051228888888889,1.104927777777771,1.104627777777772,1.1046175000000027,1.104608800000001,1.105847100000001,1.1081397500000045,1.1049827140644701,1.1047770642573826,-564,-152952,-154003.8,0.016105107379823083,-243.1608350858482,0.12772780389706892
2023-07-25T16:45:00-04:00,1.10532,1.10554,1.10482,1.10482,1.1037874140416,1.1051013333333333,1.105015555555549,1.1047617777777718,1.1046125000000027,1.104578200000001,1.105835100000001,1.1081015000000045,1.1049501712515761,1.104858851405906,-1128,-154080,-153492.2,0.026240269826216408,-243.67109455821836,0.07155602655723543
2023-07-25T17:00:00-04:00,1.10482,1.10545,1.10474,1.1052899999999999,1.103892569199104,1.1051562222222222,1.1051011111111047,1.1048871111111052,1.1046160000000027,1.1045544000000012,1.105825000000001,1.1080683000000044,1.1050181370012608,1.1049274811247245,93,-153987,-153305.8,0.036051236467535656,-243.63153155247986,0.06971354072356657
2023-07-25T17:15:00-04:00,1.1052899999999999,1.10559,1.10526,1.10558,1.1039914150471577,1.105252,1.105187777777771,1.1050006666666607,1.1046490000000027,1.104536600000001,1.105817600000001,1.1080348500000046,1.1051305096010087,1.104995984899779,88,-153899,-153461.2,0.044094508554881555,-243.60844258940227,0.07060101375814654
2023-07-25T17:30:00-04:00,1.10558,1.10561,1.10542,1.10561,1.104119301843385,1.1053364444444445,1.1052633333333268,1.105099111111105,1.1046760000000027,1.104527600000001,1.105810900000001,1.1080010500000046,1.105226407680807,1.105061587919823,249,-153650,-153713.6,0.04845122052694999,-243.6016859548756,0.061542360149513
2023-07-25T17:45:00-04:00,1.10561,1.10575,1.10554,1.1057,1.1042683716590465,1.105423777777778,1.105345555555549,1.1051826666666607,1.1047500000000026,1.1045314000000008,1.105804100000001,1.1079669000000045,1.1053211261446456,1.105129270335858,1062,-152588,-153640.8,0.05270435816396284,-243.51523594085626,0.06697075007239746
2023-07-25T18:00:00-04:00,1.1057,1.1057,1.10508,1.1051,1.1044461670599608,1.1053746666666666,1.1053333333333266,1.1052462222222164,1.1048120000000026,1.1045440000000009,1.1057914000000009,1.1079293500000045,1.1052769009157164,1.105194616268686,-877,-153465,-153517.8,0.050176507860079884,-243.9911335622725,-0.009952859637539878
2023-07-25T18:15:00-04:00,1.1051,1.10523,1.1049,1.1052,1.1046026270127656,1.1053479999999998,1.1053288888888821,1.1052917777777718,1.1048760000000026,1.1045634000000009,1.1057792000000009,1.1078908000000045,1.105261520732573,1.1052432930149485,777,-152688,-153258,0.04430759470123121,-243.92082318312129,-0.003619123448304441
2023-07-25T18:30:00-04:00,1.1052,1.10531,1.10515,1.10524,1.1047403117712338,1.105330222222222,1.105317777777771,1.1053177777777718,1.1049355000000027,1.104576200000001,1.105765800000001,1.1078533500000045,1.1052572165860586,1.1052686344119584,348,-152340,-152946.2,0.03861609567158973,-243.9082281776924,-0.009046990066403911
2023-07-25T18:45:00-04:00,1.10524,1.10536,1.10511,1.10513,1.1048614743586858,1.1052926666666667,1.1052966666666597,1.1053244444444381,1.1049955000000027,1.104587400000001,1.105753900000001,1.1078167500000045,1.1052317732688468,1.1052697075295665,-331,-152671,-152750.4,0.03205934879762684,-243.94117124888058,-0.01718959215432042
2023-07-25T19:00:00-04:00,1.10513,1.10526,1.10509,1.10521,1.1049680974356435,1.1052753333333332,1.1053399999999933,1.105323333333327,1.1050570000000026,1.104601600000001,1.105740700000001,1.1077808000000045,1.1052274186150775,1.1052509660236527,672,-151999,-152632.6,0.025546086381154447,-243.89252538821256,0.035299867851786945
2023-07-25T19:15:00-04:00,1.10521,1.10522,1.10506,1.10513,1.10575,1.1052333333333333,1.1053222222222157,1.105321111111105,1.1051180000000025,1.104614400000001,1.105727300000001,1.1077427000000044,1.105207934892062,1.1052371728189219,-481,-152480,-152435.6,0.023394539493214878,-243.92734230083553,-0.014475838920096806
2023-07-25T19:30:00-04:00,1.10513,1.10516,1.10489,1.10495,1.1057362,1.1051588888888888,1.1052522222222154,1.1053057777777715,1.1051640000000025,1.104628400000001,1.105712800000001,1.1077027500000045,1.1051563479136497,1.105216138255137,-635,-153115,-152521,0.015835527685231002,-244.0307690470101,-0.056983664682782646
2023-07-25T19:45:00-04:00,1.10495,1.10511,1.1048499999999999,1.10499,1.105702352,1.1051064444444445,1.1051833333333265,1.1052788888888827,1.1051875000000027,1.1046408000000012,1.1057001000000009,1.1076629500000046,1.1051230783309198,1.1051893106041093,773,-152342,-152521.4,0.0063598019156466,-244.0027858803511,-0.05607764039761443
2023-07-25T20:00:00-04:00,1.10499,1.10531,1.1047,1.1047,1.10565121088,1.1050097777777779,1.1050722222222154,1.1052339999999938,1.1051825000000026,1.104640000000001,1.105686200000001,1.1076237000000044,1.1050384626647358,1.1051506484832871,-1962,-154304,-152848,-0.002649896912337546,-244.51770456739786,-0.09044044496697928
2023-07-25T20:15:00-04:00,1.1047,1.10483,1.10443,1.10466,1.1055751140096,1.1049273333333332,1.1050233333333266,1.1051706666666603,1.1051690000000025,1.104634200000001,1.105669200000001,1.1075823500000046,1.1049627701317886,1.1050977187866295,-1758,-156062,-153660.6,-0.011457103080566092,-244.58135985842716,-0.03981540132114704
2023-07-25T20:30:00-04:00,1.10466,1.1048,1.10441,1.10469,1.10546060260864,1.1048606666666665,1.1049666666666598,1.1050995555555494,1.1051555000000026,1.1046246000000008,1.1056541000000009,1.1075413000000045,1.1049082161054309,1.105037775029303,1663,-154399,-154044.4,-0.014133014938132309,-244.53619664078556,-0.04614549402823113
2023-07-25T20:45:00-04:00,1.10469,1.10471,1.10447,1.10457,1.1053345302956032,1.1047813333333334,1.1048922222222153,1.1050275555555493,1.1051235000000026,1.1046140000000009,1.105636900000001,1.1074999000000043,1.1048405728843447,1.1049746200234423,-1975,-156374,-154696.2,-0.018153473332753294,-244.75073646643781,-0.06062031775903409
2023-07-25T21:00:00-04:00,1.10457,1.10464,1.10421,1.10446,1.1052235866601308,1.1046948888888888,1.1048177777777708,1.1049544444444381,1.1050845000000025,1.104607400000001,1.105616400000001,1.1074574000000046,1.1047644583074758,1.1049028960187532,-1633,-158007,-155829.2,-0.021980503237413435,-244.9133608361021,-0.06062635165093233
2023-07-25T21:15:00-04:00,1.10446,1.10466,1.10411,1.10425,1.1050816845277125,1.1045813333333332,1.1047111111111043,1.104882222222216,1.1050300000000026,1.104595200000001,1.1055923000000007,1.1074139000000045,1.1046615666459807,1.1048275168150021,-2222,-160229,-157014.2,-0.0256787701767118,-245.33584784332743,-0.08686132047303878
2023-07-25T21:30:00-04:00,1.10425,1.10461,1.10399,1.10405,1.1049262150032786,1.1044491111111112,1.1045911111111044,1.1047957777777715,1.1049665000000028,1.1046186000000011,1.105563700000001,1.1073714000000043,1.1045392533167846,1.1047428134520014,-4336,-164565,-158714.8,-0.03061886302940692,-246.12117725242854,-0.09772605937762706
2023-07-25T21:45:00-04:00,1.10405,1.10435,1.10378,1.10384,1.1047576963026884,1.104298888888889,1.104467777777771,1.1046959999999937,1.1049175000000027,1.104641400000001,1.105534800000001,1.1073284000000043,1.1043994026534276,1.1046410507616007,-2654,-167219,-161278.8,-0.03591750609918613,-246.62599134599324,-0.10045703425495871
2023-07-25T22:00:00-04:00,1.10384,1.10412,1.10379,1.1038999999999999,1.10461,1.1041853333333331,1.10434666666666,1.1045868888888826,1.1048480000000027,1.104639600000001,1.1054985000000008,1.1072837500000046,1.104299522122742,1.1045328406092803,1975,-165244,-163052.8,-0.041457186264066116,-246.51863883113612,-0.09864342663734835
2023-07-25T22:15:00-04:00,1.1038999999999999,1.10428,1.10381,1.10425,1.104444,1.1041659999999998,1.10429666666666,1.1044826666666605,1.1047815000000027,1.104647600000001,1.105466400000001,1.1072400000000044,1.1042896176981936,1.104437872487424,1213,-164031,-164257.6,-0.04367444628947734,-246.13404783557485,-0.04073504118765832
2023-07-25T22:30:00-04:00,1.10425,1.10456,1.10421,1.1045099999999999,1.10378,1.1042086666666668,1.1042799999999933,1.1043964444444385,1.1047265000000026,1.1046656000000008,1.105441200000001,1.1071971500000044,1.1043336941585549,1.1043722979899386,1500,-162531,-164718,-0.04078423664664518,-245.7808669435668,-0.013578838737719706
2023-07-25T22:45:00-04:00,1.1045099999999999,1.10463,1.10437,1.10457,1.1037956,1.1042666666666665,1.1042666666666598,1.1043315555555495,1.1046700000000027,1.1046980000000008,1.1054134000000009,1.1071551500000043,1.104380955326844,1.1043406383919503,1584,-160947,-163994.4,-0.03711781922554442,-245.694819737113,-0.010862775982393068
2023-07-25T23:00:00-04:00,1.10457,1.10477,1.10449,1.10467,1.103828976,1.1043473333333333,1.104277777777771,1.1042935555555495,1.1046485000000026,1.104731800000001,1.105388400000001,1.1071133000000044,1.1044387642614752,1.10434851071356,1470,-159477,-162446,-0.032860492273539973,-245.5617362747702,0.009053296758013434
2023-07-25T23:15:00-04:00,1.10467,1.1046799999999999,1.10448,1.10458,1.10388543744,1.1044077777777779,1.1042911111111045,1.1042824444444386,1.1046175000000027,1.104734600000001,1.1053605000000009,1.1070753500000043,1.1044670114091801,1.1043820085708476,-1295,-160772,-161551.6,-0.030529086045535204,-245.66724289665746,0.01086503811816616
2023-07-25T23:30:00-04:00,1.10458,1.10505,1.10458,1.10488,1.1039385111936,1.1045255555555553,1.1043611111111042,1.1042953333333272,1.1045995000000026,1.104740400000001,1.105333000000001,1.1070377500000044,1.1045496091273441,1.1044340068566778,1267,-159505,-160646.4,-0.025347854032396273,-245.32313020223944,0.05705229793978995
2023-07-25T23:45:00-04:00,1.10488,1.10501,1.10478,1.10493,1.104027430298112,1.1046393333333333,1.1044588888888822,1.104331111111105,1.1045895000000026,1.1047414000000009,1.1053016000000009,1.1070013000000045,1.1046256873018754,1.1044924054853418,1097,-158408,-159821.8,-0.01785581878954383,-245.2734868020513,0.07970653503011565
2023-07-26T00:00:00-04:00,1.10493,1.1051,1.10488,1.10503,1.104109235874263,1.1047535555555557,1.1045911111111044,1.1043959999999937,1.1045805000000026,1.104736800000001,1.105272500000001,1.1069643000000045,1.1047065498415003,1.104557524388273,965,-157443,-159121,-0.008552896474443048,-245.1861509527215,0.10780547905493772
2023-07-26T00:15:00-04:00,1.10503,1.1053,1.10503,1.1052899999999999,1.1042083122868367,1.1048933333333333,1.1047455555555485,1.1044895555555496,1.1045885000000024,1.104744200000001,1.1052487000000009,1.1069256500000044,1.1048232398732003,1.1046344195106181,1002,-156441,-158513.8,0.004229013359709841,-244.9503926475172,0.12591720264516737
2023-07-26T00:30:00-04:00,1.1052899999999999,1.1053,1.10507,1.10507,1.1043393148124163,1.1049582222222223,1.1048366666666598,1.1045986666666605,1.1045945000000026,1.104741200000001,1.105221600000001,1.1068861000000043,1.1048725918985602,1.1047155356084941,-883,-157324,-157824.2,0.01507964015806733,-245.1261474268058,0.07425854652479447
2023-07-26T00:45:00-04:00,1.10507,1.10508,1.10462,1.10481,1.1044545970349264,1.1049528888888889,1.1048699999999931,1.1047004444444384,1.1045855000000027,1.104739000000001,1.105191300000001,1.1068469500000044,1.1048600735188483,1.104777628486795,-1177,-158501,-157623.4,0.020752951928679743,-245.40307106060268,0.027161365673483175
2023-07-26T01:00:00-04:00,1.10481,1.10506,1.10474,1.10502,1.1045560453907353,1.1049828888888888,1.104919999999993,1.1047926666666605,1.1046015000000027,1.1047380000000009,1.105163100000001,1.1068086000000046,1.1048920588150786,1.1048309027894354,1280,-157221,-157386,0.025240626588478973,-245.1597713077042,0.0407398354110504
2023-07-26T01:15:00-04:00,1.10502,1.10517,1.10494,1.1051,1.10462,1.105018888888889,1.1049677777777707,1.1048679999999937,1.1046235000000029,1.104755600000001,1.105137300000001,1.1067704000000045,1.1049336470520628,1.104876322231548,1210,-156011,-157099.6,0.028313847445955952,-245.0721710832738,0.03892565200466478
2023-07-26T01:30:00-04:00,1.1051,1.1058999999999999,1.10502,1.10575,1.1047015999999998,1.1051753333333332,1.1050977777777709,1.104938444444438,1.1046765000000027,1.1047934000000008,1.105123600000001,1.1067362000000045,1.1050969176416503,1.104931057785238,1859,-154152,-156641.8,0.03339049289143824,-243.9787406244917,0.10592261311992934
2023-07-26T01:45:00-04:00,1.10575,1.10629,1.10572,1.1062,1.104869376,1.1053957777777776,1.1052444444444374,1.1050199999999937,1.1047580000000028,1.104839000000001,1.1051153000000011,1.1067045000000046,1.1053175341133203,1.10502004622819,2172,-151980,-155573,0.04154358692983729,-243.09481568666658,0.11946998769096985
2023-07-26T02:00:00-04:00,1.1062,1.10638,1.10566,1.10636,1.10502,1.1056188888888887,1.1054033333333264,1.1051266666666604,1.1048530000000027,1.104885200000001,1.105106100000001,1.1066746000000045,1.1055260272906562,1.1051532369825516,2897,-149083,-153689.4,0.04722104413865375,-242.67579561796308,0.12941996325559468
2023-07-26T02:15:00-04:00,1.10636,1.10706,1.10636,1.10698,1.1052647999999998,1.1059342222222222,1.105619999999993,1.1052666666666604,1.1049895000000027,1.1049462000000008,1.1051016000000011,1.1066493000000046,1.105816821832525,1.1053381895860408,3186,-145897,-151424.6,0.05490854178856905,-240.89037315149628,0.17646579730868106
2023-07-26T02:30:00-04:00,1.10698,1.10711,1.10623,1.1063399999999999,1.1056238399999998,1.106078222222222,1.1057366666666597,1.105420444444438,1.1051040000000028,1.1049934000000008,1.1050886000000013,1.1066221000000045,1.10592145746602,1.1055357516688322,-2620,-148517,-149925.8,0.05775198191183999,-242.40512499886526,0.0949976929131717
2023-07-26T02:45:00-04:00,1.1063399999999999,1.10667,1.10613,1.1063399999999999,1.105921072,1.1061988888888887,1.1058777777777709,1.105576444444438,1.1052290000000027,1.1050420000000007,1.1050758000000012,1.1065938000000046,1.106005165972816,1.1057174013350655,0,-148517,-148798.8,0.057380037072907966,-242.40512499886526,0.1149248463898108
2023-07-26T03:00:00-04:00,1.1063399999999999,1.1069499999999999,1.10601,1.10631,1.10711,1.1062853333333331,1.1060444444444375,1.105736444444438,1.1053495000000029,1.1050876000000007,1.1050611000000012,1.1065624500000044,1.1060661327782528,1.105867121068052,-4390,-152907,-148984.2,0.05795124616089947,-242.524166161618,0.13576995139434245
2023-07-26T03:15:00-04:00,1.10631,1.10641,1.10571,1.10615,1.107088,1.1063064444444444,1.106169999999993,1.1058897777777712,1.1054445000000028,1.1051202000000009,1.1050391000000013,1.1065327000000045,1.1060829062226023,1.105978496854441,-3592,-156499,-150467.4,0.060375287445135935,-243.04365888969585,0.10226059256846713
2023-07-26T03:30:00-04:00,1.10615,1.10671,1.10608,1.1065099999999999,1.10703288,1.1063744444444445,1.1063266666666598,1.1060311111111045,1.1055445000000028,1.1051544000000009,1.105023200000001,1.1065040500000045,1.1061683249780818,1.1060487974835524,2963,-153536,-151995.2,0.0641126149023352,-242.07934121126186,0.12759026332457798
2023-07-26T03:45:00-04:00,1.1065099999999999,1.10748,1.1065,1.10693,1.10571,1.106495111111111,1.1064577777777707,1.1061753333333268,1.1056625000000027,1.105194400000001,1.1050128000000012,1.1064728000000046,1.1063206599824655,1.1061286379868416,3332,-150204,-152332.6,0.0702348454765942,-240.81460795083015,0.10671489938955088
2023-07-26T04:00:00-04:00,1.10693,1.10715,1.10671,1.10699,1.1057454,1.1066015555555555,1.1065455555555486,1.1063088888888823,1.1057785000000027,1.1052350000000009,1.1050003000000013,1.1064446000000046,1.1064545279859723,1.1062185103894728,3448,-146756,-151980.4,0.071019937778571,-240.62771266386545,0.07141565720483152
2023-07-26T04:15:00-04:00,1.10699,1.1072,1.10676,1.10693,1.105780092,1.1066784444444444,1.1066088888888819,1.1064217777777712,1.1058960000000027,1.1052694000000007,1.1049892000000012,1.1064145000000045,1.1065496223887779,1.106315208311578,-2920,-149676,-151334.2,0.06788244159771986,-240.7859796762141,0.05152030080624385
2023-07-26T04:30:00-04:00,1.10693,1.10775,1.10664,1.10736,1.10581409016,1.1068286666666667,1.1066511111111041,1.1065179999999935,1.1060200000000027,1.1053118000000008,1.1049841000000014,1.1063863500000044,1.1067116979110223,1.1064409666492618,2640,-147036,-149441.6,0.06494647212018127,-239.76044057256726,0.03432763012880313
2023-07-26T04:45:00-04:00,1.10736,1.10774,1.10711,1.10756,1.1058915265536,1.1070104444444446,1.1067866666666597,1.1066099999999932,1.1061515000000028,1.1053562000000006,1.1049890000000013,1.1063562500000044,1.106881358328818,1.106583573319409,2689,-144347,-147603.8,0.05864484009802922,-239.27478098580187,0.11027351447115905
2023-07-26T05:00:00-04:00,1.10756,1.10774,1.10721,1.10722,1.105965865491456,1.1070971111111112,1.1068844444444375,1.1066953333333267,1.1062610000000028,1.1053942000000008,1.1050015000000013,1.1063199000000046,1.1069490866630545,1.106709258655527,-2070,-146417,-146846.4,0.05673636745206657,-239.91023188688175,0.07954155142182458
2023-07-26T05:15:00-04:00,1.10722,1.10777,1.10713,1.10764,1.1060372308717976,1.1072482222222224,1.1070322222222153,1.10679266666666,1.1063785000000026,1.1054506000000008,1.1050144000000013,1.1062959000000046,1.1070872693304437,1.1068358069244213,1788,-144629,-146421,0.05724650344396319,-239.23199269322578,0.12021946832262688
2023-07-26T05:30:00-04:00,1.10764,1.10766,1.10685,1.10694,1.1061411970194897,1.107229777777778,1.107119999999993,1.1068948888888823,1.1064720000000026,1.1054836000000006,1.1050190000000013,1.1062912500000046,1.1070578154643549,1.1069374455395367,-2378,-147007,-145887.2,0.055835048813278484,-240.73482754931604,0.07141888532297323
2023-07-26T05:45:00-04:00,1.10694,1.10771,1.10693,1.10747,1.1062389251983202,1.1072997777777778,1.1072266666666597,1.1070099999999934,1.1066050000000025,1.1055214000000007,1.1050290000000011,1.1062880000000046,1.107140252371484,1.107023156431629,1935,-145072,-145494.4,0.057430183273209624,-239.8083545697509,0.08675927013764648
2023-07-26T06:00:00-04:00,1.10747,1.10775,1.10738,1.10747,1.106330789686421,1.1073484444444444,1.1072866666666596,1.1071099999999934,1.1067275000000025,1.1055586000000006,1.1050431000000012,1.1062861500000047,1.107206201897187,1.1070881251453029,0,-145072,-145639.4,0.05465247420687509,-239.8083545697509,0.04878357258363085
2023-07-26T06:15:00-04:00,1.10747,1.10795,1.10731,1.10789,1.1064171423052358,1.107469111111111,1.1073866666666596,1.1072104444444377,1.1068670000000025,1.1056024000000007,1.105066900000001,1.1062855000000047,1.1073429615177497,1.1071669001162419,2009,-143063,-144968.6,0.050971412640155464,-239.0464558275726,0.08130154743946404
2023-07-26T06:30:00-04:00,1.10789,1.10849,1.10783,1.10806,1.106539770920817,1.1076037777777779,1.1075122222222151,1.1073064444444376,1.1069825000000026,1.1056616000000006,1.1051028000000012,1.1062893500000046,1.1074863692141999,1.1072467200929932,2574,-140489,-144140.6,0.047897648567172345,-238.65148881821247,0.10208414262871865
2023-07-26T06:45:00-04:00,1.10806,1.10862,1.10794,1.10821,1.1067347938287353,1.1077433333333333,1.1076066666666595,1.107403777777771,1.1070830000000025,1.1057218000000006,1.1051426000000013,1.1062949500000048,1.10763109537136,1.107361376074394,2409,-138080,-142355.2,0.0488733156515684,-238.3253783187813,0.07675913885276853
2023-07-26T07:00:00-04:00,1.10821,1.10836,1.10779,1.1083399999999999,1.106961018569287,1.10789,1.1076933333333263,1.1074971111111043,1.1071820000000026,1.1057838000000006,1.1051800000000012,1.1062955000000045,1.107772876297088,1.1074879008595149,2009,-136071,-140555,0.04851612903243255,-238.08970998877172,0.07042507855102936
2023-07-26T07:15:00-04:00,1.1083399999999999,1.10837,1.10713,1.1072,1.10862,1.1077913333333334,1.107691111111104,1.107577999999993,1.1071930000000028,1.1058252000000008,1.1052063000000012,1.1062879500000047,1.1076583010376704,1.1075783206876113,-1865,-137936,-139127.8,0.0416501081252834,-240.007984164566,-0.001806325752798091
2023-07-26T07:30:00-04:00,1.1072,1.10753,1.1067,1.10689,1.1085901999999999,1.107631111111111,1.1076077777777709,1.1076222222222154,1.1072205000000026,1.1058588000000007,1.105230200000001,1.1062784000000045,1.1075046408301363,1.1076106565500887,-2278,-140214,-138558,0.03905680461934473,-240.64579124549093,-0.0677115308222914
2023-07-26T07:45:00-04:00,1.10689,1.1069,1.10597,1.10626,1.108514592,1.1073615555555556,1.1075322222222153,1.1076262222222153,1.1072165000000027,1.1058814000000006,1.105247900000001,1.1062687500000046,1.1072557126641092,1.1075645252400705,-2847,-143061,-139072.4,0.02693685816381816,-242.26619616377525,-0.061430610511862785
2023-07-26T08:00:00-04:00,1.10626,1.10627,1.10581,1.10596,1.1083619164799998,1.107047111111111,1.1073644444444377,1.107577777777771,1.1071990000000027,1.1059016000000006,1.105265000000001,1.1062573000000047,1.1069965701312874,1.1074376201920562,-2993,-146054,-140667.2,0.01972018413548687,-243.0778498437419,-0.13634680849141742
2023-07-26T08:15:00-04:00,1.10596,1.10642,1.1057299999999999,1.10633,1.1081577631615998,1.1068402222222222,1.1072377777777709,1.1074866666666598,1.1072080000000029,1.1059284000000007,1.1052846000000012,1.1062481000000046,1.10686325610503,1.1072556961536446,2978,-143076,-142068.2,0.009337509908629174,-242.08155703025864,-0.10293732561603645
2023-07-26T08:30:00-04:00,1.10633,1.1067,1.10618,1.1065099999999999,1.1079149868454397,1.1066946666666666,1.1070844444444374,1.1073653333333267,1.1072080000000026,1.1059646000000007,1.105302300000001,1.1062357500000046,1.106792604884024,1.1070825569229155,3338,-139738,-142428.6,-0.0008816950219586819,-241.53846410138615,-0.12456110263655767
2023-07-26T08:45:00-04:00,1.1065099999999999,1.10707,1.10647,1.10682,1.1076964881608957,1.106641777777778,1.1069466666666596,1.1072331111111045,1.1072025000000028,1.1060078000000007,1.105321000000001,1.1062241000000046,1.1067980839072191,1.1069412455383318,3194,-136544,-141694.6,-0.011879069183184515,-240.64363260415604,-0.11190729743877857
2023-07-26T09:00:00-04:00,1.10682,1.1069,1.10631,1.1064,1.1074998393448061,1.1065324444444444,1.1067455555555485,1.107075777777771,1.1071730000000026,1.1060420000000006,1.1053333000000012,1.1062075000000045,1.1067184671257753,1.106833796430665,-3707,-140251,-141132.6,-0.02459307239199774,-242.0503111968807,-0.16332644534879376
2023-07-26T09:15:00-04:00,1.1064,1.107,1.10639,1.10681,1.1073228554103256,1.1065453333333333,1.1065755555555485,1.1069179999999934,1.1071670000000027,1.1060868000000006,1.1053504000000012,1.1061911500000046,1.1067367737006202,1.1067818371445315,3175,-137076,-139337,-0.03646409267489222,-240.87374756709033,-0.1380442824403892
2023-07-26T09:30:00-04:00,1.10681,1.10733,1.10638,1.10654,1.1057299999999999,1.1065382222222222,1.1065022222222152,1.106770888888882,1.1071260000000025,1.1061284000000007,1.1053679000000012,1.1061702000000047,1.1066974189604961,1.1067486697156248,-5840,-142916,-139305,-0.0510454247504455,-242.29838232825074,-0.0596098265895848
2023-07-26T09:45:00-04:00,1.10654,1.10656,1.10576,1.10652,1.10733,1.106541777777778,1.106461111111104,1.1066462222222155,1.1070740000000026,1.1061738000000008,1.105384500000001,1.1061541000000046,1.1066619351683968,1.1067225357724992,-5120,-148036,-140964.6,-0.053576405735301195,-242.39092304074254,-0.033426989131709696
2023-07-26T10:00:00-04:00,1.10652,1.10696,1.10599,1.1064,1.10733,1.1065295555555557,1.1064766666666597,1.1065522222222155,1.1070330000000026,1.1062208000000007,1.105419700000001,1.1061392500000047,1.1066095481347176,1.106684828617999,-6921,-154957,-144647.2,-0.05301558679746628,-243.1414923933067,0.012655252833875308
2023-07-26T10:15:00-04:00,1.1064,1.10657,1.10576,1.1065,1.1072986,1.1065342222222223,1.1065366666666596,1.1065104444444376,1.1069760000000026,1.1062740000000006,1.105457700000001,1.1061275500000047,1.106587638507774,1.1066586628943988,3730,-151227,-146842.4,-0.04775206949996008,-242.8043629645287,0.04882635900032414
2023-07-26T10:30:00-04:00,1.1065,1.10714,1.10616,1.10697,1.1072678280000001,1.1066208888888889,1.1066077777777705,1.106516888888882,1.1069775000000024,1.1063354000000007,1.105487500000001,1.1061199500000047,1.1066641108062192,1.1066441303155188,4048,-147179,-148863,-0.03574733217774881,-241.08492328987901,0.05784892391962379
2023-07-26T10:45:00-04:00,1.10697,1.10715,1.10621,1.10635,1.10723767144,1.1065693333333333,1.1065899999999929,1.1065344444444376,1.1069215000000026,1.1063774000000006,1.1055125000000012,1.1061078500000048,1.1066012886449754,1.1066249042524146,-4323,-151502,-150580.2,-0.033029480467408924,-243.50618131855214,-0.014459878356267723
2023-07-26T11:00:00-04:00,1.10635,1.10691,1.10616,1.1069,1.1072081180112001,1.1066313333333333,1.1065988888888816,1.1065619999999932,1.1068930000000026,1.1064252000000006,1.1055454000000013,1.1061013500000048,1.1066610309159803,1.106624723401931,4550,-146952,-150363.4,-0.02705489661780572,-241.24423889526815,0.00722791420466562
2023-07-26T11:15:00-04:00,1.1069,1.10766,1.1069,1.10722,1.10576,1.1067555555555555,1.1066899999999928,1.1066046666666598,1.1068595000000025,1.1064782000000006,1.1055881000000014,1.1060974000000048,1.1067728247327844,1.1066573787215446,3537,-143415,-148055,-0.02236602326155887,-240.22170750128464,0.07411424439624394
2023-07-26T11:30:00-04:00,1.10722,1.10782,1.10704,1.10757,1.105798,1.1069315555555557,1.1067744444444374,1.1066522222222153,1.1068350000000025,1.1065362000000007,1.1056340000000013,1.106088100000005,1.1069322597862274,1.106726302977235,2431,-140984,-146006.4,-0.01041955262160376,-239.45325136790586,0.0686658053324303
2023-07-26T11:45:00-04:00,1.10757,1.10797,1.10747,1.10766,1.1058788800000001,1.1071086666666667,1.1068988888888818,1.1067104444444376,1.1068075000000026,1.1065978000000007,1.1056662000000013,1.106083900000005,1.107077807828982,1.1068090423817876,2212,-138772,-144325,-0.0010196021743275009,-239.27350652107873,0.10121640428723858
2023-07-26T12:00:00-04:00,1.10766,1.10797,1.1075,1.10788,1.1060043472,1.1073048888888888,1.107049999999993,1.1068024444444375,1.1067845000000027,1.106657800000001,1.1056991000000014,1.1060809000000047,1.1072382462631856,1.1069364339054295,2006,-136766,-141377.8,0.012506437136919133,-238.875081011446,0.12290785525792827
2023-07-26T12:15:00-04:00,1.10788,1.10822,1.10749,1.10752,1.106122286368,1.107398888888889,1.1071744444444371,1.1069175555555488,1.1068005000000025,1.1067096000000007,1.1057255000000012,1.1060834000000048,1.1072945970105486,1.1070631471243433,-1594,-138360,-139659.4,0.025069687018418562,-239.3930432456229,0.10122921185827999
2023-07-26T12:30:00-04:00,1.10752,1.10756,1.10707,1.10725,1.10629010345856,1.107414,1.1072577777777706,1.1070311111111042,1.1068185000000026,1.106754000000001,1.1057454000000013,1.1060771000000047,1.1072856776084388,1.107165717699474,-1718,-140078,-138992,0.03253416259179853,-239.81187089659082,0.06778129236331029
2023-07-26T12:45:00-04:00,1.10725,1.10726,1.10681,1.10717,1.106444495181875,1.1073964444444442,1.107279999999993,1.1071322222222153,1.1068640000000027,1.1067916000000009,1.1057679000000014,1.1060733500000048,1.107262542086751,1.1072317741595787,-1616,-141694,-139134,0.03738242969889034,-239.92862862971353,0.018067336964866072
2023-07-26T13:00:00-04:00,1.10717,1.10717,1.10633,1.10636,1.10822,1.1072124444444447,1.1072811111111038,1.1072086666666596,1.1068840000000024,1.1068174000000008,1.1057793000000014,1.1060674000000048,1.1070820336694007,1.1072326193276625,-1898,-143592,-140098,0.03144085866083341,-241.31719587774225,0.0009038730962232126
2023-07-26T13:15:00-04:00,1.10636,1.10657,1.10631,1.10635,1.1081822,1.1070262222222222,1.1072199999999928,1.1072426666666597,1.1068850000000026,1.1068482000000008,1.1057936000000015,1.1060621000000048,1.1069356269355206,1.1071720954621296,-1689,-145281,-141801,0.029762480946862704,-241.33246215634966,-0.0496883187279836
2023-07-26T13:30:00-04:00,1.10635,1.10657,1.10625,1.10656,1.1081073119999998,1.1068942222222222,1.1071466666666594,1.1072371111111043,1.1068875000000025,1.1068790000000008,1.1058085000000013,1.1060582000000048,1.1068605015484165,1.1070852763697032,1760,-143521,-142833.2,0.02570096875543036,-240.99839065998768,-0.05960874984195597
2023-07-26T13:45:00-04:00,1.10656,1.10665,1.10567,1.10572,1.1079958732799997,1.1066088888888888,1.1069411111111038,1.107173777777771,1.1068325000000026,1.1068914000000007,1.1058235000000014,1.1060458000000049,1.1066324012387332,1.106954621095762,-2310,-145831,-143983.8,0.01554845296346973,-242.75193317010903,-0.16703233204221019
2023-07-26T14:00:00-04:00,1.10572,1.10783,1.10565,1.10705,1.10565,1.1066306666666668,1.106873333333326,1.1070924444444377,1.1068650000000024,1.106917400000001,1.1058554000000014,1.1060418500000049,1.1067159209909865,1.1068452968766092,12008,-133823,-142409.6,0.009860736457766743,-228.30827654817884,-0.055071050683422655
2023-07-26T14:15:00-04:00,1.10705,1.10718,1.10595,1.10619,1.10565,1.106494,1.1066855555555484,1.1069733333333265,1.1068340000000023,1.106917200000001,1.1058781000000015,1.106033400000005,1.106610736792789,1.1067510375012868,-6697,-140520,-141795.2,-0.0025168337455857824,-233.51076966050488,-0.15254359677943183
2023-07-26T14:30:00-04:00,1.10619,1.11029,1.1056,1.10969,1.11029,1.107094888888889,1.1069266666666595,1.1069146666666598,1.1069915000000026,1.106983800000001,1.1059345000000014,1.106042350000005,1.1072265894342312,1.1068092300010288,20222,-120298,-136798.6,0.0014453869573312988,-169.52809037394363,0.19593325628431135
2023-07-26T14:45:00-04:00,1.10969,1.11048,1.10828,1.11038,1.1056,1.1077855555555556,1.1072744444444373,1.1069402222222153,1.1071845000000025,1.1070518000000011,1.1059990000000013,1.1060535500000048,1.107857271547385,1.1070085840008226,13416,-106882,-129470.8,0.010761193124839046,-161.18608494900684,0.2826823210656902
2023-07-26T15:00:00-04:00,1.11038,1.11067,1.10819,1.10881,1.1056,1.1080926666666666,1.1074566666666597,1.1070433333333267,1.1073050000000024,1.1071012000000011,1.1060473000000013,1.1060565500000048,1.108047817237908,1.1072916672006574,-11343,-118225,-123949.6,0.015000537576710351,-177.22429709259578,0.1481254007966334
2023-07-26T15:15:00-04:00,1.10881,1.10899,1.10783,1.10877,1.1058028,1.1083553333333331,1.1077244444444372,1.1072135555555487,1.1074185000000025,1.107149800000001,1.1060959000000012,1.1060617000000048,1.1081922537903264,1.1075869337605253,-7107,-125332,-122251.4,0.019256181608542176,-177.4806800617251,0.2178314472685223
2023-07-26T15:30:00-04:00,1.10877,1.1095599999999999,1.10855,1.10951,1.105997488,1.1087124444444445,1.1080755555555486,1.107491555555549,1.1075455000000025,1.107213800000001,1.1061507000000013,1.1060723000000048,1.108455803032261,1.1079559470084197,4390,-120942,-118335.8,0.03475381247141193,-174.55076673434448,0.2856238984046687
2023-07-26T15:45:00-04:00,1.10951,1.10974,1.10936,1.10963,1.10618438848,1.1090233333333332,1.1084166666666595,1.1077895555555488,1.1077095000000023,1.107283400000001,1.1062018000000011,1.106083050000005,1.108690642425809,1.1082487576067352,2834,-118108,-117897.8,0.05292654426780059,-174.24425304812289,0.27743637941005517
2023-07-26T16:00:00-04:00,1.10963,1.10964,1.10893,1.10903,1.1063638129408,1.1091460000000002,1.1087844444444375,1.1080915555555488,1.1078160000000026,1.107333800000001,1.1062441000000012,1.106092250000005,1.108758513940647,1.1084290060853879,-1748,-119856,-120492.6,0.06369711501685851,-175.1894329729626,0.29935245812682454
2023-07-26T16:15:00-04:00,1.10903,1.10904,1.10849,1.10854,1.106536060423168,1.109097111111111,1.108949999999993,1.1083902222222153,1.1078820000000023,1.1073660000000012,1.1062802000000012,1.106098400000005,1.1087148111525176,1.1085624048683096,-984,-120840,-121015.6,0.08209806549462363,-175.62419127526272,0.13459193351700385
2023-07-26T16:30:00-04:00,1.10854,1.10867,1.1085099999999999,1.10852,1.1067014180062413,1.1090111111111112,1.109208888888882,1.1086871111111045,1.1079295000000022,1.107396600000001,1.106315800000001,1.106106150000005,1.108675848922014,1.1086591238946473,-584,-121424,-120234,0.08977416127125895,-175.63472765644886,0.21063289308346153
2023-07-26T16:45:00-04:00,1.10852,1.10872,1.1085099999999999,1.10857,1.1068601612859916,1.1088833333333332,1.1090844444444374,1.1088888888888822,1.1079750000000024,1.1074294000000011,1.1063494000000011,1.106113700000005,1.1086546791376113,1.108698899115717,665,-120759,-120197.4,0.10695331961454577,-175.60473270822956,-0.10092908830394162
2023-07-26T17:00:00-04:00,1.10857,1.10857,1.10787,1.10837,1.107012554834552,1.1087404444444444,1.1088611111111042,1.108977777777771,1.1079995000000022,1.1074496000000011,1.1063807000000012,1.106122800000005,1.108597743310089,1.1086803192925732,-39,-120798,-120735.4,0.09198521394535893,-175.6117687997709,-0.18101911057474426
2023-07-26T17:15:00-04:00,1.10837,1.10884,1.10817,1.10867,1.10715885264117,1.1087022222222223,1.1088455555555485,1.1089899999999933,1.1080570000000025,1.107471800000001,1.1064140000000011,1.106134900000005,1.1086121946480714,1.108651055434058,206,-120592,-120882.6,0.07315419108803776,-175.5560112458855,-0.012626148754072293
2023-07-26T17:30:00-04:00,1.10867,1.10869,1.10837,1.1086,1.1072992985355232,1.1086531111111113,1.1088266666666597,1.1089653333333265,1.1081245000000024,1.107499400000001,1.1064468000000012,1.106146950000005,1.108609755718457,1.108630044347246,-652,-121244,-120963.4,0.06661440995913309,-175.59717768856004,-0.015332305166987154
2023-07-26T17:45:00-04:00,1.1086,1.10869,1.10857,1.10866,1.1074341265941023,1.1086197777777778,1.1087322222222153,1.1088699999999931,1.1081990000000024,1.107519800000001,1.106485200000001,1.1061601500000051,1.1086198045747657,1.1086188354777964,147,-121097,-120898,0.05955872399958812,-175.58922170804408,-0.0766103955800324
2023-07-26T18:00:00-04:00,1.10866,1.1089499999999999,1.10861,1.10862,1.1075635615303383,1.1085973333333334,1.1086199999999933,1.1087771111111042,1.1083120000000024,1.1075534000000011,1.106518500000001,1.106171750000005,1.1086198436598125,1.1086118683822366,-645,-121742,-121094.6,0.045293607074536286,-175.61249304461256,-0.09102133143479858
2023-07-26T18:15:00-04:00,1.10862,1.1088,1.1086,1.10879,1.1076878190691248,1.108631333333333,1.1085933333333264,1.1087235555555488,1.1084340000000026,1.107579800000001,1.1065506000000012,1.106184100000005,1.10865387492785,1.108623094705789,527,-121215,-121178,0.027269567429260063,-175.53168086370297,-0.021640532717782025
2023-07-26T18:30:00-04:00,1.10879,1.10889,1.10872,1.10882,1.10780710630636,1.1086766666666665,1.1086244444444375,1.1086793333333265,1.1085470000000026,1.107606800000001,1.1065827000000013,1.106196800000005,1.10868709994228,1.1086380757646306,570,-120645,-121188.6,0.014761035334653498,-175.51625864669165,0.025258448048770088
2023-07-26T18:45:00-04:00,1.10882,1.1089,1.10842,1.10847,1.1079216220541055,1.1086457777777778,1.108618888888882,1.108637777777771,1.1086845000000027,1.1076184000000011,1.1066104000000012,1.106207250000005,1.108643679953824,1.1086448606117039,-411,-121056,-121151,0.005923689646880591,-175.645991155124,-0.004510518529199606
2023-07-26T19:00:00-04:00,1.10847,1.10848,1.10831,1.10843,1.1080315571719412,1.108608,1.1086033333333265,1.1086119999999933,1.1087535000000026,1.107625800000001,1.1066437000000011,1.106217550000005,1.108600943963059,1.1086410884893625,-793,-121849,-121301.4,-0.006528615091661094,-175.67460717540422,-0.01262888225371686
2023-07-26T19:15:00-04:00,1.10843,1.10848,1.10829,1.1083,1.1081370948850635,1.1085473333333333,1.1085955555555487,1.1086071111111042,1.1088590000000027,1.107627600000001,1.106674700000001,1.1062269500000048,1.1085407551704474,1.1086252707914894,-488,-122337,-121420.4,-0.014332117730286273,-175.73184128130174,-0.006315580537186543
2023-07-26T19:30:00-04:00,1.1083,1.1083,1.10779,1.10785,1.11067,1.1083982222222222,1.1085044444444376,1.1085893333333265,1.1087670000000025,1.107617800000001,1.1067008000000012,1.1062333000000049,1.108402604136358,1.1085750166331911,-834,-123171,-121811.6,-0.02614984820710899,-176.0704680069176,-0.0739624956028433
2023-07-26T19:45:00-04:00,1.10785,1.10793,1.10778,1.10779,1.1106124,1.1082553333333331,1.1084144444444375,1.1085473333333264,1.1086375000000026,1.107629600000001,1.1067274000000011,1.106240650000005,1.1082800833090865,1.1084936133065526,-720,-123891,-122460.8,-0.025928644473418503,-176.1094624556245,-0.07306512718744158
2023-07-26T20:00:00-04:00,1.10779,1.10852,1.10774,1.1082,1.1104991039999998,1.1082124444444443,1.1083633333333263,1.1084962222222154,1.1086070000000026,1.1076558000000012,1.106757300000001,1.1062490000000051,1.1082640666472692,1.1084176906452416,1901,-121990,-122647.6,-0.020175293533899605,-175.4058904789863,-0.04149153031586825
2023-07-26T20:15:00-04:00,1.1082,1.10847,1.10817,1.10842,1.1103335577599998,1.108223777777778,1.1083411111111041,1.108443777777771,1.1085895000000026,1.107699000000001,1.1067902000000012,1.106258750000005,1.1082952533178154,1.108356552516193,1379,-120611,-122400,-0.020665310456387972,-175.13213122975344,-0.018040446681457847
2023-07-26T20:30:00-04:00,1.10842,1.10852,1.10808,1.10836,1.1101779442943998,1.1082275555555556,1.1082933333333262,1.1083833333333264,1.1085320000000025,1.1077470000000011,1.1068243000000013,1.106268550000005,1.1083082026542523,1.108310042012954,-1627,-122238,-122380.2,-0.021249863080690514,-175.22020253846307,-0.038781013537273104
2023-07-26T20:45:00-04:00,1.10836,1.10873,1.10825,1.10864,1.1100316676367357,1.108296888888889,1.1082733333333263,1.108337111111104,1.1084825000000027,1.107793200000001,1.1068608000000013,1.106280450000005,1.1083745621234018,1.1083044336103627,2054,-120184,-121782.8,-0.018866562883312538,-174.70130975994334,-0.016233473422182766
2023-07-26T21:00:00-04:00,1.10864,1.10907,1.10864,1.10897,1.1098941675785314,1.1084362222222224,1.1083288888888818,1.108319999999993,1.1084795000000027,1.1078424000000011,1.1069035000000012,1.106294850000005,1.1084936496987214,1.1083471468882897,2139,-118045,-120613.6,-0.0146787051809028,-174.06461074132605,0.04510721986160608
2023-07-26T21:15:00-04:00,1.10897,1.1095,1.10884,1.1095,1.1097649175238196,1.1086704444444446,1.1084477777777708,1.1083368888888816,1.1085275000000028,1.107896000000001,1.1069519000000012,1.1063105500000048,1.108694919758977,1.1084333175106313,2255,-115790,-119373.6,-0.007405787769123188,-172.98689899078292,0.09653293396966019
2023-07-26T21:30:00-04:00,1.1095,1.10995,1.1093,1.10985,1.10774,1.108950888888889,1.108619999999993,1.1083926666666595,1.1085940000000027,1.107965000000001,1.1070035000000014,1.1063288000000049,1.1089259358071817,1.1085594540085046,2954,-112836,-117818.6,-0.00022336385967001502,-172.05503779204454,0.13985383019037628
2023-07-26T21:45:00-04:00,1.10985,1.11002,1.10957,1.1098999999999999,1.1077842,1.1092068888888889,1.1088477777777708,1.1085035555555485,1.1086605000000027,1.108026800000001,1.1070568000000014,1.1063468500000049,1.1091207486457453,1.108721963206803,2280,-110556,-115482.2,0.008281153760627526,-171.9523212087227,0.18504310150290068
2023-07-26T22:00:00-04:00,1.1098999999999999,1.11179,1.1098999999999999,1.11136,1.107873632,1.1097093333333334,1.1092444444444376,1.108697777777771,1.108810000000003,1.1081232000000012,1.1071258000000013,1.106371100000005,1.1095685989165962,1.1089607705654418,3833,-106723,-112790,0.02795413443329716,-166.91026336567373,0.3222632448388098
2023-07-26T22:15:00-04:00,1.11136,1.11151,1.11031,1.11032,1.10810861408,1.1099244444444445,1.1094799999999931,1.108927999999993,1.108892500000003,1.1081992000000012,1.1071865000000014,1.106389400000005,1.109718879133277,1.109205816452353,-2530,-109253,-111031.6,0.04239362515316567,-169.27781303454773,0.19130120916801116
2023-07-26T22:30:00-04:00,1.11032,1.11082,1.11029,1.11076,1.1083294972352,1.1101804444444443,1.109739999999993,1.1091864444444375,1.109000500000003,1.108286400000001,1.1072536000000013,1.106408650000005,1.1099271033066216,1.109452253161882,2044,-107209,-109315.4,0.05649972239655906,-168.46781231403475,0.21111131159668797
2023-07-26T22:45:00-04:00,1.11076,1.11088,1.10991,1.10992,1.108537127401088,1.1102164444444445,1.1099133333333262,1.109445111111104,1.1090635000000029,1.108354800000001,1.1073144000000013,1.1064246000000049,1.1099256826452972,1.1096522025295052,-1933,-109142,-108576.6,0.06435399333537979,-169.92962224597315,0.1407484932693354
2023-07-26T23:00:00-04:00,1.10992,1.11041,1.10985,1.11038,1.1087322997570228,1.1103097777777777,1.1101066666666597,1.109696888888882,1.109151500000003,1.108423000000001,1.1073792000000013,1.1064388500000049,1.1100165461162377,1.1098313620236036,1701,-107441,-107953.6,0.07517715576189786,-169.22465251842536,0.1569490546976343
2023-07-26T23:15:00-04:00,1.11038,1.11063,1.11021,1.11057,1.1089157617716014,1.1104024444444442,1.1102844444444375,1.109904888888882,1.1092405000000027,1.108507400000001,1.1074424000000014,1.1064544000000047,1.1101272368929902,1.1099430896188824,1343,-106098,-107828.6,0.08419909331324599,-168.99484830725424,0.1442780237517738
2023-07-26T23:30:00-04:00,1.11057,1.11058,1.11024,1.11027,1.1090882160653053,1.1103995555555555,1.110369999999993,1.110082888888882,1.1093130000000029,1.108574800000001,1.1075000000000015,1.1064706000000049,1.110155789514392,1.1100304716951053,-1410,-107508,-107479.6,0.0895596838474639,-169.37573379848843,0.06940063091484087
2023-07-26T23:45:00-04:00,1.11027,1.11036,1.10988,1.11002,1.109250323101387,1.1103295555555555,1.110388888888882,1.1102126666666596,1.109390500000003,1.1086308000000011,1.1075545000000013,1.1064839500000048,1.1101286316115138,1.1100707773560836,-1317,-108825,-107802.8,0.08909147726594126,-169.67228328645092,0.015317385232238905
2023-07-27T00:00:00-04:00,1.11002,1.1103,1.10995,1.11028,1.1094027037153038,1.1103077777777777,1.110431111111104,1.1103162222222154,1.109483000000003,1.108685000000001,1.1076106000000012,1.1064995000000046,1.110158905289211,1.1101174218848664,1427,-107398,-107454,0.08519153286819567,-169.33803705665335,0.03423731867736256
2023-07-27T00:15:00-04:00,1.11028,1.1105099999999999,1.11015,1.11036,1.1095459414923856,1.1102935555555555,1.1103199999999929,1.110358888888882,1.109586000000003,1.108739000000001,1.1076684000000012,1.1065144500000048,1.1101991242313687,1.1101539375078926,1423,-105975,-107160.8,0.08104714073213508,-169.2355043621978,-0.08997984451481877
2023-07-27T00:30:00-04:00,1.11036,1.11056,1.11022,1.11037,1.1096805850028424,1.1103035555555556,1.1103255555555487,1.1103671111111042,1.109712000000003,1.108788800000001,1.1077233000000013,1.1065281500000048,1.110233299385095,1.1101751500063135,1385,-104590,-106859.2,0.0632346712248439,-169.22303093015765,0.004503206282882909
2023-07-27T00:45:00-04:00,1.11037,1.1107799999999999,1.1096,1.1096,1.11179,1.1101584444444446,1.1101966666666596,1.1103324444444376,1.109802500000003,1.108830400000001,1.1077700000000013,1.106535800000005,1.1101066395080759,1.1101653200050505,-1891,-106481,-106653.8,0.04923222953821451,-170.53436859237863,-0.10443300082826622
2023-07-27T01:00:00-04:00,1.1096,1.10977,1.1094,1.10977,1.1117462,1.110073111111111,1.110179999999993,1.1102906666666599,1.1098810000000028,1.1088808000000012,1.1078174000000014,1.1065449500000049,1.1100393116064606,1.1101474560040399,2089,-104392,-105767.2,0.03181179636684645,-170.21431632128994,-0.013514487530641352
2023-07-27T01:15:00-04:00,1.10977,1.10983,1.1092,1.10924,1.1116523520000001,1.109885111111111,1.1100533333333265,1.1102151111111045,1.109922000000003,1.1089222000000012,1.1078569000000014,1.1065528000000049,1.1098794492851685,1.1100915648032312,-1992,-106384,-105564.4,0.02122121984693435,-171.16564857932525,-0.10266755525134809
2023-07-27T01:30:00-04:00,1.10924,1.10972,1.10906,1.10967,1.11150521088,1.1098084444444443,1.1099533333333265,1.1101417777777711,1.109987500000003,1.108988400000001,1.1079029000000014,1.106562250000005,1.1098375594281347,1.1100192518425844,2098,-104286,-105226.6,0.009460226504933705,-170.3523529895522,-0.08103946622006022
2023-07-27T01:45:00-04:00,1.10967,1.10995,1.10878,1.10888,1.1113095940096,1.1095937777777776,1.109798888888882,1.1100364444444377,1.109999500000003,1.109039000000001,1.1079436000000014,1.106567450000005,1.1096460475425078,1.109901801474067,-2429,-106715,-105651.6,-0.007997038006884557,-172.08161484217473,-0.12519477244273935
2023-07-27T02:00:00-04:00,1.10888,1.10953,1.10888,1.10941,1.1110566346086401,1.1095160000000002,1.1097311111111041,1.1099433333333268,1.1100215000000029,1.109096000000001,1.1079875000000015,1.106575300000005,1.1095988380340063,1.1098002411792531,3436,-103279,-105011.2,-0.019048109346380054,-170.43934516466254,-0.054953964793427096
2023-07-27T02:15:00-04:00,1.10941,1.10984,1.10917,1.1094,1.1108289711477761,1.1094497777777779,1.1096333333333266,1.1098339999999935,1.1100165000000028,1.109169600000001,1.1080305000000015,1.1065839000000048,1.109559070427205,1.109704192943402,-2438,-105717,-105276.2,-0.026478099582825765,-170.46132080937474,-0.0792592859458868
2023-07-27T02:30:00-04:00,1.1094,1.10966,1.10896,1.10935,1.1106240740329985,1.109393111111111,1.1095211111111043,1.109727555555549,1.109991500000003,1.109215600000001,1.1080665000000014,1.106595050000005,1.109517256341764,1.109631754354721,-3369,-109086,-105816.6,-0.034213253892758755,-170.61315964117537,-0.09096148996721382
2023-07-27T02:45:00-04:00,1.10935,1.11003,1.10923,1.10999,1.1104396666296985,1.109486888888889,1.109478888888882,1.1096326666666603,1.1099960000000029,1.109291600000001,1.1081044000000013,1.106609850000005,1.1096118050734112,1.1095866034837765,3453,-105633,-106086,-0.03814701271817011,-168.62107418572856,-0.03422282662536334
2023-07-27T03:00:00-04:00,1.10999,1.11086,1.10982,1.1107799999999999,1.10878,1.109747111111111,1.109609999999993,1.1095948888888825,1.1099670000000028,1.109313400000001,1.1081486000000014,1.106627350000005,1.1098454440587289,1.1096264827870206,5356,-100277,-104798.4,-0.038227080267822115,-164.80911191579895,0.10634462869502154
2023-07-27T03:15:00-04:00,1.1107799999999999,1.1118,1.11058,1.11168,1.1088216000000002,1.1101611111111112,1.1098222222222152,1.1096131111111045,1.1100350000000028,1.109339400000001,1.1081956000000013,1.1066486000000049,1.1102123552469831,1.109749186229616,4784,-95493,-103241.2,-0.020861378009160242,-160.9329168096568,0.17210773403498728
2023-07-27T03:30:00-04:00,1.11168,1.11297,1.11167,1.11291,1.108940736,1.1107786666666668,1.110229999999993,1.1097324444444379,1.1101425000000027,1.109421400000001,1.1082613000000014,1.1066749500000048,1.1107518841975865,1.1099877489836922,4722,-90771,-100252,-0.00368454306300413,-155.70833779411248,0.33085716346327776
2023-07-27T03:45:00-04:00,1.11291,1.11341,1.11266,1.11284,1.1091824918400002,1.1113006666666667,1.1105822222222153,1.10994466666666,1.110288500000003,1.109502800000001,1.1083263000000014,1.106701050000005,1.1111695073580692,1.1103181991869533,-3778,-94549,-97344.6,0.019819271915205654,-155.94596707231113,0.28567051465752136
2023-07-27T04:00:00-04:00,1.11284,1.11316,1.11243,1.11281,1.1095206924928,1.111746222222222,1.1110188888888817,1.11025266666666,1.110410000000003,1.109568800000001,1.1083913000000016,1.1067262000000049,1.1114976058864554,1.110695359349562,-3327,-97876,-95793.2,0.03570114475242726,-156.0356565155374,0.35441165861048884
2023-07-27T04:15:00-04:00,1.11281,1.11335,1.11266,1.11328,1.109831837093376,1.1121984444444444,1.1114488888888816,1.1106204444444376,1.1105455000000028,1.1096418000000008,1.1084626000000015,1.106750850000005,1.1118540847091642,1.1110970874796493,3225,-94651,-94668,0.0628819440276179,-154.67356415475712,0.3488340649534473
2023-07-27T04:30:00-04:00,1.11328,1.11376,1.11286,1.11376,1.1101180901259058,1.1126606666666667,1.1119333333333261,1.1110426666666597,1.110720000000003,1.109736400000001,1.1085351000000014,1.106779150000005,1.1122352677673315,1.111501669983719,2937,-91714,-93912.2,0.08836137874622478,-153.40725199609074,0.39300522805121163
2023-07-27T04:45:00-04:00,1.11376,1.11392,1.11346,1.1139,1.1104822811133153,1.113054,1.1124388888888816,1.1114844444444376,1.110914000000003,1.1098436000000007,1.1086048000000013,1.106808800000005,1.112568214213865,1.1118649359869746,3053,-88661,-93490.2,0.11329586810872294,-153.02348888734252,0.41015008788928936
2023-07-27T05:00:00-04:00,1.1139,1.1144,1.11381,1.11391,1.1108948073797174,1.1133482222222222,1.1128744444444374,1.111942888888882,1.111095500000003,1.1099514000000008,1.1086740000000015,1.106837150000005,1.1128365713710922,1.1121983487895792,2765,-85896,-91759.6,0.13764674469052388,-152.9986661923069,0.3531563347417475
2023-07-27T05:15:00-04:00,1.11391,1.11411,1.11305,1.11316,1.1113855343465568,1.1134053333333334,1.1131388888888818,1.112366888888882,1.111235500000003,1.1100432000000007,1.1087363000000015,1.1068627500000048,1.1129012570968737,1.112479079031663,-2930,-88826,-89949.6,0.15381569457475935,-154.97144675806183,0.2142638506274914
2023-07-27T05:30:00-04:00,1.11316,1.11321,1.11276,1.11281,1.111807559538039,1.1133395555555554,1.1132644444444373,1.1127299999999933,1.1113575000000029,1.1101320000000008,1.1087908000000015,1.1068874500000048,1.112883005677499,1.11268486322533,-2181,-91007,-89220.8,0.161568152914311,-155.65719723418357,0.10164795624640863
2023-07-27T05:45:00-04:00,1.11281,1.11403,1.11267,1.11396,1.1121705012027137,1.1134786666666667,1.1133811111111038,1.1130195555555487,1.111575500000003,1.1102378000000008,1.1088548000000016,1.1069219000000048,1.1130984045419992,1.1128574905802633,3262,-87745,-88427,0.16667587788244362,-152.28618151721486,0.09434725179933645
2023-07-27T06:00:00-04:00,1.11396,1.1147799999999999,1.11392,1.11465,1.1124826310343336,1.1137324444444445,1.113582222222215,1.1132482222222155,1.111819500000003,1.1103588000000009,1.1089291000000017,1.1069653000000048,1.1134087236335992,1.11302559246421,3323,-84422,-87579.2,0.16066025419171667,-150.2278760125293,0.16264692139030473
2023-07-27T06:15:00-04:00,1.11465,1.11497,1.11448,1.1146,1.11267,1.113936,1.1137811111111038,1.1134295555555487,1.112087500000003,1.1104776000000007,1.1089987000000014,1.1070065500000046,1.1136469789068795,1.1131876739713675,-1888,-86310,-87662,0.1557706975164861,-150.31256627404616,0.16085405415119905
2023-07-27T06:30:00-04:00,1.1146,1.1149,1.11421,1.1143,1.113084,1.1140397777777777,1.1138944444444372,1.11358066666666,1.112319000000003,1.1105912000000009,1.1090723000000016,1.1070456500000048,1.1137775831255037,1.1133629391770936,-2113,-88423,-87581.4,0.14746928526017652,-150.88129048003927,0.09162115550445718
2023-07-27T06:45:00-04:00,1.1143,1.11432,1.11361,1.11372,1.11342348,1.114004888888889,1.1138899999999927,1.1137057777777708,1.112561000000003,1.1106898000000007,1.1091348000000014,1.107081900000005,1.113766066500403,1.1135395513416744,-2438,-90861,-87552.2,0.1340619261048262,-152.1502844672959,-0.0035914380117835084
2023-07-27T07:00:00-04:00,1.11372,1.11377,1.1131,1.11353,1.11497,1.1139328888888889,1.1138488888888816,1.1137993333333263,1.112767000000003,1.1107840000000009,1.1091954000000015,1.1071192500000047,1.1137188532003224,1.113663641073339,-2501,-93362,-88675.6,0.11206625365135997,-152.57695364805977,-0.03321662626806549
2023-07-27T07:15:00-04:00,1.11353,1.1137,1.11333,1.1137,1.1149326,1.113903111111111,1.1138255555555483,1.113847999999993,1.1129820000000028,1.110888600000001,1.1092535000000014,1.107160200000005,1.113715082560258,1.1137249128586708,2023,-91339,-90059,0.09189080937860203,-152.26810700719693,-0.01885251052598895
2023-07-27T07:30:00-04:00,1.1137,1.11411,1.11334,1.11393,1.114895948,1.1139240000000001,1.1139111111111037,1.113873999999993,1.1132110000000028,1.110998600000001,1.1093122000000013,1.107207500000005,1.1137580660482065,1.1137471302869362,2448,-88891,-90575.2,0.07267182548497063,-151.76254895745245,0.0691724460095727
2023-07-27T07:45:00-04:00,1.11393,1.11405,1.1133899999999999,1.11385,1.11486002904,1.1139117777777778,1.1140266666666594,1.1139004444444374,1.113404000000003,1.111109600000001,1.1093686000000016,1.107255600000005,1.1137764528385652,1.1137469042295485,-2652,-91543,-91199.2,0.05960714464457211,-151.95300975840064,0.09345710408784337
2023-07-27T08:00:00-04:00,1.11385,1.11392,1.11233,1.11287,1.1148248284592,1.1136804444444446,1.1139055555555482,1.1139035555555483,1.113508500000003,1.111210000000001,1.1094139000000014,1.107296950000005,1.1135951622708522,1.1137127233836384,-4234,-95777,-92182.4,0.047820982466532526,-155.67821512716657,-0.09784911486947784
2023-07-27T08:15:00-04:00,1.11287,1.1129499999999999,1.10931,1.10932,1.114725035320832,1.1127633333333333,1.113313333333326,1.1137964444444373,1.1133905000000026,1.1112406000000008,1.1094351000000016,1.107320700000005,1.1127401298166817,1.1135169787069101,-11650,-107427,-94995.4,0.012391202716628585,-192.84113622307115,-0.4781770062351263
2023-07-27T08:30:00-04:00,1.10932,1.10941,1.10701,1.10808,1.114400133201582,1.1117166666666665,1.1125888888888817,1.1135491111111038,1.1131490000000028,1.111238200000001,1.1094470000000014,1.107338600000005,1.1118081038533454,1.1131355829655276,-16786,-124213,-101570.2,-0.03122875749325701,-211.60455886036442,-0.5849632155033269
2023-07-27T08:45:00-04:00,1.10808,1.10831,1.10472,1.1058999999999999,1.1138089225454555,1.1103788888888888,1.1116555555555483,1.113097999999993,1.1128020000000027,1.1111878000000008,1.1094434000000013,1.107345650000005,1.1106264830826762,1.1125092663724214,-13972,-138185,-111429,-0.07942186360658127,-239.09261026459606,-0.753836489275795
2023-07-27T09:00:00-04:00,1.1058999999999999,1.10652,1.10334,1.10368,1.11290003029091,1.1087837777777778,1.1105399999999928,1.1124006666666595,1.1123455000000027,1.111094200000001,1.1094206000000013,1.107342800000005,1.109237186466141,1.1116014130979366,-15137,-153322,-123784.8,-0.13571224312615068,-269.4788477182522,-0.9014833171712862
2023-07-27T09:15:00-04:00,1.10368,1.1037,1.10199,1.10246,1.1117528266560008,1.1071677777777778,1.1093099999999927,1.1114815555555484,1.1118045000000027,1.110970600000001,1.1093819000000014,1.1073332500000048,1.1078817491729127,1.1104587304783489,-10174,-163496,-137328.6,-0.1927161203920448,-280.7251147521751,-0.9941357664364601
2023-07-27T09:30:00-04:00,1.10246,1.1025,1.0993,1.09951,1.1103860309241607,1.1052077777777778,1.107733333333326,1.1103655555555485,1.1110920000000024,1.110781400000001,1.1093119000000013,1.107307100000005,1.1062073993383301,1.1091521843826784,-15105,-178601,-151563.4,-0.2599890296370309,-321.14358798476417,-1.2741312741312676
2023-07-27T09:45:00-04:00,1.09951,1.10157,1.09913,1.1008,1.108612265976295,1.103821111111111,1.1062744444444372,1.1091026666666597,1.1104370000000026,1.110607400000001,1.1092517000000015,1.1072863500000047,1.1051259194706642,1.1078157475061423,10788,-167813,-160283.4,-0.32071840923663975,-308.4865680395157,-1.1787096137100253
2023-07-27T10:00:00-04:00,1.1008,1.10106,1.09918,1.10057,1.1069054581005617,1.1026802222222223,1.1047988888888818,1.1077313333333263,1.1097700000000026,1.110421800000001,1.1091934000000014,1.1072633500000049,1.1042147355765313,1.1065333980049132,-10537,-178350,-168316.4,-0.38407829317977343,-310.6881577924222,-1.1922610764465555
2023-07-27T10:15:00-04:00,1.10057,1.10086,1.09919,1.09933,1.1055058756424607,1.1015864444444443,1.1032944444444373,1.106282222222215,1.1090785000000025,1.110210400000001,1.1091186000000015,1.1072345000000048,1.103237788461225,1.10533351840393,-7666,-186016,-174855.2,-0.4526259802109152,-319.32535488120436,-1.2166740050500156
2023-07-27T10:30:00-04:00,1.09933,1.09943,1.09869,1.09881,1.1043582180268179,1.1006895555555556,1.1021266666666594,1.1048455555555485,1.1083785000000026,1.1099594000000008,1.1090413000000015,1.107204600000005,1.10235223076898,1.1042276147231436,-7987,-194003,-180956.6,-0.5180929177272066,-323.103328738007,-0.9474272527314047
2023-07-27T10:45:00-04:00,1.09881,1.09932,1.09838,1.09918,1.1032245744214544,1.1001002222222223,1.1011377777777704,1.1035264444444375,1.1076395000000026,1.1097366000000009,1.1089679000000014,1.107176200000005,1.101717784615184,1.1033296917785143,8677,-185326,-182301.6,-0.5513361341828368,-320.18154062177234,-0.8031911053353465
2023-07-27T11:00:00-04:00,1.09918,1.10032,1.09875,1.09925,1.1022556595371635,1.0997226666666666,1.1003988888888816,1.1023513333333264,1.1068695000000024,1.109506400000001,1.1088964000000014,1.1071580500000051,1.1012242276921471,1.1025493534228108,6023,-179303,-184599.6,-0.5681695025467959,-319.79797287126735,-0.6013201916990527
2023-07-27T11:15:00-04:00,1.09925,1.09945,1.09875,1.09914,1.1014805276297308,1.0994708888888889,1.0998944444444372,1.1013704444444372,1.1060965000000025,1.1092908000000008,1.1088228000000013,1.107140250000005,1.1008073821537177,1.101867882738248,-4465,-183768,-185683.2,-0.5628938572152705,-320.2447775107945,-0.4113511162655832
2023-07-27T11:30:00-04:00,1.09914,1.10016,1.09909,1.09969,1.1008604221037845,1.0994300000000001,1.0995866666666592,1.1006288888888816,1.1053660000000023,1.109077000000001,1.1087500000000015,1.107118750000005,1.100583905722974,1.101337106190598,3855,-179913,-184462.6,-0.5351306239615894,-318.31576937716255,-0.25125628140702966
2023-07-27T11:45:00-04:00,1.09969,1.10023,1.09968,1.0997,1.1003643376830277,1.0994526666666669,1.0996077777777704,1.100125111111104,1.1046650000000025,1.108859600000001,1.1086835000000015,1.107098000000005,1.1004071245783793,1.100948084952478,3247,-176666,-180995.2,-0.4975304886193216,-318.28624287423946,0.017280424916545776
2023-07-27T12:00:00-04:00,1.0997,1.10011,1.09917,1.09936,1.09838,1.099403111111111,1.0994477777777705,1.099787111111104,1.1039565000000024,1.108641400000001,1.1086081000000014,1.1070767500000052,1.1001976996627034,1.100644067961982,-3754,-180420,-180014,-0.43728058791007857,-319.4468866861882,-0.1308139534883819
2023-07-27T12:15:00-04:00,1.09936,1.10004,1.09898,1.09979,1.0984146,1.0994715555555556,1.099361111111104,1.0995795555555483,1.1032610000000027,1.108436800000001,1.1085338000000013,1.1070609500000053,1.1001161597301627,1.100422454369585,2859,-177561,-179665.6,-0.3874123557093613,-318.32862697144463,-0.07087236613754717
2023-07-27T12:30:00-04:00,1.09979,1.09982,1.09937,1.09948,1.098448508,1.0994953333333333,1.0993777777777707,1.099476222222215,1.1025385000000028,1.108220800000001,1.1084529000000014,1.1070434500000053,1.0999889277841302,1.1002587634956675,-2622,-180183,-178948.6,-0.33614508281990546,-319.0676953390422,0.013644674483557669
2023-07-27T12:45:00-04:00,1.09948,1.09959,1.0986,1.099,1.09848173784,1.0994197777777777,1.0993988888888817,1.0994386666666596,1.1017960000000024,1.107993600000001,1.1083663000000015,1.1070162500000051,1.0997911422273041,1.1001002107965336,-2294,-182477,-179461.4,-0.2748623420448139,-320.0691869532599,0.017291433459825853
2023-07-27T13:00:00-04:00,1.099,1.10106,1.0986799999999999,1.10031,1.0985143030832,1.099602,1.099524444444437,1.099421999999993,1.1011680000000026,1.107792400000001,1.1082906000000015,1.106994850000005,1.0998949137818432,1.0999977686372264,12473,-170004,-178129,-0.2028852583155639,-305.2014617485292,0.10280390836804285
2023-07-27T13:15:00-04:00,1.10031,1.10035,1.09943,1.09949,1.0986,1.099595111111111,1.0995511111111036,1.0994426666666595,1.1006765000000027,1.107590200000001,1.1082103000000016,1.106967900000005,1.0998139310254746,1.0999210149097807,-6734,-176738,-177392.6,-0.14232242132776407,-310.219938359665,0.021833068000911345
2023-07-27T13:30:00-04:00,1.09949,1.09971,1.09915,1.09927,1.0986799999999999,1.0995388888888888,1.0995655555555481,1.0994835555555482,1.1002360000000027,1.1073802000000008,1.1081305000000017,1.1069379500000052,1.0997051448203796,1.0998388119278242,-5220,-181958,-178272,-0.09872018967839385,-311.2644226205501,0.011827428716993603
2023-07-27T13:45:00-04:00,1.09927,1.09999,1.099,1.09987,1.0987752,1.0995997777777777,1.0995855555555485,1.099525111111104,1.0999345000000027,1.1071928000000009,1.1080575000000017,1.106912700000005,1.0997381158563038,1.0997886495422589,3682,-178276,-177890.6,-0.05658615885409305,-309.2547252759489,0.01636824923386108
2023-07-27T14:00:00-04:00,1.09987,1.09988,1.09883,1.09884,1.10106,1.0994506666666666,1.099489999999993,1.0995433333333262,1.0996925000000026,1.106976200000001,1.1079823000000015,1.106880800000005,1.099558492685043,1.0997421196338064,-2888,-181164,-177628,-0.033765515187074074,-311.95926308496234,-0.07820314631261807
2023-07-27T14:15:00-04:00,1.09884,1.09895,1.09809,1.09809,1.1010153999999999,1.0991706666666667,1.0993488888888818,1.0995082222222152,1.0994740000000027,1.106760400000001,1.1078997000000017,1.106846650000005,1.0992647941480345,1.0996160957070447,-3494,-184658,-180558.8,-0.024207580653621916,-314.34405067915264,-0.11552175811380098
2023-07-27T14:30:00-04:00,1.09809,1.09821,1.09741,1.098,1.100898384,1.098900888888889,1.0991499999999927,1.099427999999993,1.0993985000000026,1.1065322000000009,1.1078141000000017,1.1068113000000048,1.0990118353184275,1.0994556765656351,-4221,-188879,-182987,-0.017264768610460165,-314.69000592872203,-0.16275834477490778
2023-07-27T14:45:00-04:00,1.098,1.09831,1.09716,1.09733,1.10068908096,1.0985368888888891,1.0989111111111038,1.099297111111104,1.0992250000000028,1.106290800000001,1.1077302000000016,1.106776850000005,1.098675468254742,1.0992497412525077,-3752,-192631,-185121.6,-0.03020103702349969,-316.9794776955714,-0.1955469858478641
2023-07-27T15:00:00-04:00,1.09733,1.09741,1.09683,1.09708,1.1004067544832001,1.0981706666666666,1.0986977777777704,1.0991195555555486,1.0990505000000028,1.106045400000001,1.1076305000000017,1.106742950000005,1.0983563746037937,1.0989733930020056,-2539,-195170,-188500.4,-0.03592475038535179,-317.55792720483447,-0.17470427661509752
2023-07-27T15:15:00-04:00,1.09708,1.09721,1.09672,1.09674,1.10004907903488,1.097779111111111,1.0983011111111038,1.0988817777777704,1.0989210000000027,1.105780400000001,1.1075360000000016,1.106707050000005,1.098033099683035,1.098668314401604,-2283,-197453,-191758.2,-0.03989990358675963,-318.2654599280634,-0.32445401750414443
2023-07-27T15:30:00-04:00,1.09674,1.0969,1.0966,1.09665,1.0996495895506944,1.097448888888889,1.0979855555555484,1.098609111111104,1.0988130000000027,1.105497800000001,1.1074056000000017,1.106670050000005,1.0977564797464279,1.0983666515212827,-2219,-199672,-194761,-0.06159894639534513,-318.44755413453015,-0.2583015761853382
2023-07-27T15:45:00-04:00,1.09665,1.09691,1.09657,1.0967,1.099222647013597,1.0971917777777778,1.0976999999999928,1.098319111111104,1.0986890000000025,1.105198200000001,1.1072688000000017,1.106633900000005,1.0975451837971424,1.0980733212170257,2341,-197331,-196451.4,-0.07785303662812285,-318.3408199896341,-0.23379151618801217
2023-07-27T16:00:00-04:00,1.0967,1.09692,1.09662,1.09684,1.0987982234914215,1.0970197777777777,1.0973633333333261,1.0980095555555482,1.0985685000000025,1.1048768000000009,1.1071491000000016,1.106598200000005,1.0974041470377138,1.09781905697362,1432,-195899,-197105,-0.08983720420167574,-318.15801703531656,-0.275487103021254
2023-07-27T16:15:00-04:00,1.09684,1.09752,1.09684,1.0975,1.0984417077327941,1.097047111111111,1.0972144444444372,1.0977128888888816,1.0984865000000026,1.104570000000001,1.1070364000000017,1.106566150000005,1.097423317630171,1.0976324455788955,1040,-194859,-197042.8,-0.10383256743826662,-317.5322192890638,-0.12194678024099222
2023-07-27T16:30:00-04:00,1.0975,1.09764,1.09743,1.09762,1.0981422344955472,1.0971282222222223,1.097162222222215,1.097485111111104,1.0983830000000026,1.1042662000000008,1.1069175000000016,1.106534100000005,1.0974626541041368,1.097518356463116,664,-194195,-196391.2,-0.10835661660307098,-317.4596179223211,-0.04280159185494545
2023-07-27T16:45:00-04:00,1.09762,1.0977,1.09749,1.09752,1.0978906769762595,1.0971997777777776,1.0971088888888818,1.0973097777777707,1.0982740000000026,1.103951000000001,1.1067964000000017,1.106499100000005,1.0974741232833094,1.0974618851704923,-1061,-195256,-195508,-0.10414833094732857,-317.55628161285154,-0.04371584699453879
2023-07-27T17:00:00-04:00,1.09752,1.09778,1.09739,1.09778,1.09657,1.097334,1.0971588888888817,1.0972015555555485,1.0981950000000027,1.103631400000001,1.1066839000000015,1.106464000000005,1.0975352986266476,1.0974599081363934,74,-195182,-195078.2,-0.09783525832855271,-317.53875118060427,0.041008630038371456
2023-07-27T17:15:00-04:00,1.09778,1.09778,1.09764,1.0977,1.0965942,1.0974422222222222,1.0972277777777704,1.0971744444444373,1.0980905000000027,1.1033074000000012,1.1065755000000015,1.106427850000005,1.097568238901318,1.0974927265091141,-53,-195235,-194945.4,-0.08727495056713694,-317.5426135209639,0.05651365442810395
2023-07-27T17:30:00-04:00,1.0977,1.09787,1.09765,1.09768,1.096617916,1.0975326666666665,1.0973322222222148,1.097197999999993,1.0980005000000026,1.102982800000001,1.1064671000000015,1.1063914500000052,1.0975905911210544,1.0975261812072907,-98,-195333,-195040.2,-0.07266856292135153,-317.5443990725718,0.08570855444316254
2023-07-27T17:45:00-04:00,1.09768,1.0977999999999999,1.09762,1.0976299999999999,1.09666799936,1.097592222222222,1.0974411111111038,1.0972537777777709,1.0979320000000026,1.102672200000001,1.1063577000000016,1.106353550000005,1.0975984728968435,1.0975533449658321,-326,-195659,-195333,-0.05654524921020476,-317.55924857333713,0.08936306022887712
2023-07-27T18:00:00-04:00,1.0976299999999999,1.09827,1.09762,1.09819,1.0967160793856,1.097742,1.0976066666666593,1.097353333333326,1.0978260000000026,1.1023798000000011,1.1062559000000016,1.106318300000005,1.0977167783174748,1.0976018759726653,837,-194822,-195246.2,-0.03900796423441336,-317.1322194287255,0.13586213185009496
2023-07-27T18:15:00-04:00,1.09819,1.09837,1.09817,1.09819,1.096809314622464,1.0978586666666665,1.0977566666666592,1.0974728888888816,1.0977610000000027,1.102064400000001,1.1061511000000015,1.106282550000005,1.09781142265398,1.0976571007781317,0,-194822,-195174.2,-0.016243969236619697,-317.1322194287255,0.12308085044308763
2023-07-27T18:30:00-04:00,1.09819,1.09833,1.09813,1.09823,1.0969341694526669,1.0979533333333333,1.0978377777777704,1.0975948888888818,1.0977090000000027,1.1017360000000012,1.1060474000000016,1.1062471000000051,1.0978951381231838,1.097722480622505,454,-194368,-195000.8,0.001882581565903183,-317.1156831280853,0.06651480637814301
2023-07-27T18:45:00-04:00,1.09823,1.09834,1.09819,1.0983,1.0970490358964535,1.098045777777778,1.097913333333326,1.097711111111104,1.0976305000000026,1.101410000000001,1.1059438000000015,1.1062145000000052,1.097976110498547,1.0977995844980033,399,-193969,-194728,0.013378170157848856,-317.090251296866,0.061952223902626946
2023-07-27T19:00:00-04:00,1.0983,1.09832,1.09762,1.09778,1.0971547130247372,1.098019111111111,1.0979422222222148,1.0978113333333261,1.0975775000000028,1.1010796000000012,1.1058354000000017,1.1061769500000052,1.0979368883988376,1.0978672675984023,-677,-194646,-194525.4,0.023904150862544084,-317.4107830277228,0.023689773307085698
2023-07-27T19:15:00-04:00,1.09778,1.09815,1.09768,1.09811,1.0972519359827582,1.0980526666666666,1.0979788888888815,1.0978857777777706,1.0975785000000027,1.1007674000000012,1.1057286000000017,1.1061396000000052,1.0979715107190702,1.0979182140787214,503,-194143,-194389.6,0.03244733327955184,-317.2595778682191,0.030060667893379498
2023-07-27T19:30:00-04:00,1.09811,1.09829,1.098,1.0980699999999999,1.0973413811041375,1.0980708888888888,1.0980199999999927,1.0979384444444373,1.0975820000000027,1.1004582000000012,1.1056211000000018,1.1061019000000052,1.0979912085752561,1.0979541712629766,-1000,-195143,-194453.8,0.03517625437971352,-317.29600409145723,0.0337068415778429
2023-07-27T19:45:00-04:00,1.0980699999999999,1.0983,1.09775,1.0977999999999999,1.0974236706158065,1.0980268888888889,1.0980333333333259,1.0979775555555487,1.0976055000000027,1.1001402000000011,1.105514400000002,1.1060624000000052,1.0979529668602048,1.0979657370103808,-1264,-196407,-194861.6,0.036955344685193604,-317.60680394938976,0.010932147802628996
2023-07-27T20:00:00-04:00,1.0977999999999999,1.09816,1.09775,1.0981,1.097499376966542,1.098040222222222,1.098085555555548,1.098011999999993,1.0976565000000027,1.0998236000000012,1.1054111000000018,1.1060274000000052,1.097982373488164,1.0979669896083044,2174,-194233,-194914.4,0.037440005969613964,-317.01270666390934,0.04281952934961622
2023-07-27T20:15:00-04:00,1.0981,1.09825,1.09783,1.09805,1.0975690268092186,1.098033111111111,1.0980699999999926,1.0980375555555484,1.0977220000000028,1.0995076000000013,1.1053086000000016,1.105991650000005,1.0979958987905312,1.097978791686643,-1392,-195625,-195110.2,0.03705667128539008,-317.0760888695374,-0.012748249392184321
2023-07-27T20:30:00-04:00,1.09805,1.09825,1.09784,1.09786,1.0976331046644812,1.0979911111111111,1.0980333333333259,1.0980484444444374,1.0977825000000025,1.0992074000000012,1.105208700000002,1.105954750000005,1.097968719032425,1.097978233349314,-1640,-197265,-195734.6,0.029190145885668536,-317.35986465388225,-0.030049444995851486
2023-07-27T20:45:00-04:00,1.09786,1.09823,1.09776,1.098,1.0976920562913226,1.0979844444444444,1.0980077777777704,1.0980459999999928,1.0978475000000028,1.098981000000001,1.1051108000000018,1.105919100000005,1.09797497522594,1.0979749866794506,1971,-195294,-195764.8,0.0216017854005937,-317.1085211310286,-0.020942789761703145
2023-07-27T21:00:00-04:00,1.098,1.09826,1.09748,1.09753,1.09837,1.097888888888889,1.0979222222222147,1.0980237777777706,1.0978820000000027,1.0987700000000011,1.105004100000002,1.105880700000005,1.097885980180752,1.09796158934356,-2019,-197313,-195946,0.011624638681949144,-317.97275610370656,-0.0701083492670636
2023-07-27T21:15:00-04:00,1.09753,1.0980699999999999,1.09735,1.09795,1.0983522000000001,1.0978944444444447,1.0979411111111037,1.0979948888888815,1.0979045000000025,1.0986110000000011,1.1048994000000019,1.1058448000000052,1.0978987841446015,1.0979448714748477,2157,-195156,-196130.6,0.0036216813362983545,-317.14732080808807,0.015485798611744019
2023-07-27T21:30:00-04:00,1.09795,1.09843,1.09773,1.0984099999999999,1.09735,1.0979882222222221,1.0979744444444368,1.0979757777777703,1.0979440000000025,1.098505600000001,1.104799900000002,1.1058121000000052,1.0980010273156813,1.0979458971798777,3768,-191388,-195283.2,0.0054127903194756575,-315.5686696855418,0.027319667428578828
2023-07-27T21:45:00-04:00,1.0984099999999999,1.0986,1.09816,1.09822,1.09735,1.0980373333333335,1.0979911111111038,1.097967333333326,1.0979790000000027,1.098420800000001,1.1046957000000017,1.105778250000005,1.098044821852545,1.0979611177439017,-2506,-193894,-194609,0.0038122747440005973,-316.00215080825535,0.013660331308577278
2023-07-27T22:00:00-04:00,1.09822,1.09827,1.09777,1.09781,1.0974000000000002,1.098001111111111,1.0979922222222147,1.0979642222222148,1.0979805000000025,1.098386800000001,1.1045841000000018,1.105743800000005,1.097997857482036,1.0979656941951208,-2461,-196355,-194821.2,0.00018649118569222828,-316.9209193610044,0.0009109127345659968
2023-07-27T22:15:00-04:00,1.09781,1.09851,1.09775,1.0985,1.0974480000000002,1.0981026666666667,1.0980366666666592,1.0979871111111037,1.0980205000000027,1.098340800000001,1.1044741000000018,1.1057130000000048,1.0980982859856288,1.098008155356096,1919,-194436,-194245.8,0.0034391370324899227,-315.71478168690766,0.03642655495856078
2023-07-27T22:30:00-04:00,1.0985,1.0986,1.09806,1.09814,1.0974940800000001,1.0981233333333333,1.098046666666659,1.0980082222222147,1.0980435000000026,1.0982922000000008,1.1043570000000016,1.105680250000005,1.098106628788503,1.0980497242848766,-2258,-196694,-194553.4,0.0018951755422946857,-316.4547725835852,0.008196348071574471
2023-07-27T22:45:00-04:00,1.09814,1.09834,1.09794,1.09827,1.0975383168000001,1.098168,1.0980922222222145,1.0980317777777702,1.0980755000000026,1.098271000000001,1.1042407000000016,1.105648750000005,1.0981393030308024,1.0980773794279008,1986,-194708,-195217.4,0.0013400326291666603,-316.2196659487296,0.03734538101397459
2023-07-27T23:00:00-04:00,1.09827,1.09855,1.09826,1.09844,1.097580784128,1.0982375555555555,1.0981411111111035,1.0980617777777701,1.0980880000000028,1.098263600000001,1.1041115000000017,1.105618650000005,1.098199442424642,1.0981083035423203,2077,-192631,-194964.8,0.003109286880542347,-315.8981694132693,0.04007285974499052
2023-07-27T23:15:00-04:00,1.09844,1.0987,1.09717,1.09817,1.0987,1.0982433333333332,1.0982122222222146,1.09810577777777,1.0980870000000027,1.098243400000001,1.1039900000000018,1.105588250000005,1.0981935539397136,1.0981474428338558,-5534,-198165,-195326.8,0.004744160108062042,-317.2584439844793,0.05831275682671053
2023-07-27T23:30:00-04:00,1.09817,1.09887,1.0976,1.09815,1.09717,1.098230888888889,1.0982344444444367,1.0981453333333255,1.0980830000000028,1.0982214000000008,1.1038639000000017,1.105558750000005,1.098184843151771,1.0981647542670843,-14607,-212772,-198994,0.010563797138688701,-317.5244683705051,0.01821576574525051
2023-07-27T23:45:00-04:00,1.09815,1.09816,1.09714,1.09765,1.09887,1.098114,1.0981499999999924,1.0981659999999922,1.0980505000000025,1.0981916000000007,1.1037412000000018,1.105527800000005,1.0980778745214168,1.098159003413667,-6846,-219618,-203578.8,0.01034723068473326,-320.6415288813639,-0.06919092142277218
2023-07-28T00:00:00-04:00,1.09765,1.09787,1.09662,1.0967,1.09887,1.0978240000000001,1.0979811111111035,1.09814377777777,1.0979965000000027,1.0981318000000009,1.1036044000000016,1.105491800000005,1.0978022996171335,1.098091602730933,-7558,-227176,-210072.4,0.0017130929307460306,-327.1828671950341,-0.13840578390486113
2023-07-28T00:15:00-04:00,1.0967,1.09674,1.09595,1.09605,1.09878,1.0974377777777777,1.097785555555548,1.0980726666666587,1.0978935000000027,1.098058800000001,1.1034592000000016,1.105450800000005,1.0974518396937067,1.0979420821847459,-5374,-232550,-218056.2,-0.010548239545631454,-330.3679679518502,-0.16031918091472877
2023-07-28T00:30:00-04:00,1.09605,1.09683,1.09596,1.09669,1.0986102,1.0972186666666668,1.097584444444437,1.0979471111111032,1.0978245000000029,1.0980054000000008,1.1033234000000016,1.105411700000005,1.0972994717549653,1.0977632657477963,3366,-229184,-224260,-0.014591473443830293,-328.4025101716395,-0.16477014110151017
2023-07-28T00:45:00-04:00,1.09669,1.0973,1.09663,1.09726,1.098450588,1.0971537777777778,1.097486666666659,1.0977975555555477,1.0977975000000029,1.0979548000000008,1.1031958000000017,1.1053751500000049,1.0972915774039722,1.0975846125982367,3173,-226011,-226907.8,-0.022373800357814014,-326.753356810161,-0.0801355018485796
2023-07-28T01:00:00-04:00,1.09726,1.0975,1.09689,1.0971,1.09830055272,1.0970764444444445,1.097356666666659,1.097638888888881,1.0977475000000028,1.0979072000000007,1.1030640000000016,1.105337300000005,1.0972532619231778,1.0974196900785889,-2817,-228828,-228749.8,-0.028811805813098345,-327.16412545205065,-0.10653118085717676
2023-07-28T01:15:00-04:00,1.0971,1.09721,1.09675,1.09693,1.0981595195568001,1.096991111111111,1.0971888888888812,1.0974804444444366,1.097691500000003,1.0978658000000008,1.1029297000000016,1.105299050000005,1.0971886095385424,1.0972969520628706,-3050,-231878,-229690.2,-0.03594500752211584,-327.6367350591968,-0.13746768143914298
2023-07-28T01:30:00-04:00,1.09693,1.09704,1.0948499999999999,1.0965799999999999,1.0980269483833922,1.0968693333333333,1.0970122222222145,1.0973257777777699,1.0976275000000029,1.0977912000000005,1.1027918000000017,1.105257550000005,1.0970668876308338,1.097219961650296,-7564,-239442,-231068.6,-0.046515441590817164,-330.05019808783175,-0.14478632634293437
2023-07-28T01:45:00-04:00,1.0965799999999999,1.09866,1.09651,1.0986,1.0948499999999999,1.0971868888888887,1.0970622222222144,1.0972213333333254,1.0976575000000028,1.0977734000000006,1.1026818000000016,1.105225900000005,1.097373510104667,1.0972347693202364,4796,-234646,-232161,-0.04580682525598828,-321.21553030253506,0.040978008468794014
2023-07-28T02:00:00-04:00,1.0986,1.0986,1.09767,1.09811,1.0948499999999999,1.0973964444444444,1.0971133333333256,1.0971466666666587,1.097686500000003,1.0977502000000008,1.1025652000000017,1.105191300000005,1.0975208080837338,1.0972806154561885,-4630,-239276,-234814,-0.04664820925188564,-323.28061313523165,0.04190771193002368
2023-07-28T02:15:00-04:00,1.09811,1.09865,1.09781,1.09817,1.0949262,1.0976077777777777,1.0972766666666591,1.0971306666666587,1.0976975000000029,1.0977162000000007,1.1024545000000017,1.1051557000000052,1.097650646466987,1.0973600923649505,4122,-235154,-236079.2,-0.04468612131753269,-323.0553897969498,0.1340384790735919
2023-07-28T02:30:00-04:00,1.09817,1.09862,1.09769,1.09776,1.095000876,1.0977044444444444,1.097466666666659,1.0971862222222142,1.0976650000000028,1.0976946000000007,1.1023354000000016,1.105119150000005,1.0976725171735897,1.09745687389196,-5579,-240733,-237850.2,-0.034205705346783466,-325.1383004574123,0.15601478034762103
2023-07-28T02:45:00-04:00,1.09776,1.0991,1.09683,1.09709,1.09507405848,1.0976291111111112,1.0975111111111033,1.097285999999992,1.0976085000000029,1.0976746000000006,1.1022175000000016,1.1050805500000052,1.0975560137388718,1.0975546991135676,-6470,-247203,-239402.4,-0.019006186012439936,-329.08715995311366,0.036473388104200456
2023-07-28T03:00:00-04:00,1.09709,1.09877,1.09607,1.09731,1.0952350961408,1.097588888888889,1.097516666666659,1.0973768888888809,1.097583500000003,1.0976608000000008,1.1020965000000016,1.1050420000000052,1.0975068109910975,1.0975813592908537,8945,-238258,-240124.8,-0.009410190598642945,-327.2934146815307,0.004556805132794918
2023-07-28T03:15:00-04:00,1.09731,1.09769,1.09554,1.09575,1.095389692295168,1.0972355555555555,1.0973666666666588,1.0974275555555475,1.0974460000000028,1.0976292000000007,1.1019600000000016,1.104995250000005,1.097155448792878,1.0975082874326827,-5493,-243751,-241019.8,-0.01423152786732238,-335.1025843783347,-0.12305168170631323
2023-07-28T03:30:00-04:00,1.09575,1.09629,1.09531,1.09599,1.0991,1.0969602222222221,1.0972622222222144,1.0974246666666585,1.0973385000000029,1.0976074000000007,1.1018264000000015,1.1049464500000052,1.0969223590343025,1.0973626299461456,5198,-238553,-241699.6,-0.013456333741356023,-333.9640765070136,-0.08569370880547901
2023-07-28T03:45:00-04:00,1.09599,1.09605,1.09434,1.09516,1.0990242,1.096539777777778,1.0971044444444367,1.097352222222214,1.097183000000003,1.0975758000000007,1.1016781000000015,1.1048912500000052,1.0965698872274419,1.0971421039569162,-5340,-243893,-242331.6,-0.01665659083242691,-338.008091507151,-0.12949351620492594
2023-07-28T04:00:00-04:00,1.09516,1.09574,1.09474,1.0951,1.098836832,1.0961388888888888,1.0967155555555477,1.0971931111111028,1.097016000000003,1.0975448000000008,1.1015213000000015,1.1048349500000052,1.0962759097819534,1.0968860831655323,-5081,-248974,-242685.8,-0.016389770977232373,-338.2864617909449,-0.31858729291826493
2023-07-28T04:15:00-04:00,1.0951,1.09589,1.09494,1.09544,1.09865695872,1.0958837777777777,1.0964188888888813,1.096973555555547,1.096879500000003,1.0975196000000007,1.1013589000000017,1.1047772500000053,1.0961087278255628,1.0966064665324253,4436,-244538,-243941.8,-0.032176060177707126,-336.9091994404746,-0.24314504011437382
2023-07-28T04:30:00-04:00,1.09544,1.09688,1.09537,1.09642,1.0984842803711998,1.095884,1.096224444444437,1.0967451111111026,1.096793000000003,1.0975112000000007,1.1011940000000018,1.1047276500000052,1.0961709822604502,1.0964095732259398,5175,-239363,-243064.2,-0.03998869497754194,-332.2795529057489,-0.1593560195598259
2023-07-28T04:45:00-04:00,1.09642,1.09653,1.09577,1.09596,1.0983185091563519,1.095831111111111,1.0960244444444367,1.0964975555555472,1.096708500000003,1.0974804000000007,1.1010252000000016,1.1046757500000053,1.0961287858083602,1.0962508585807513,-3346,-242709,-243895.4,-0.05063429637778533,-333.68335801692865,-0.16397026672496937
2023-07-28T05:00:00-04:00,1.09596,1.09643,1.09564,1.09642,1.098159368790098,1.0959102222222223,1.0959499999999922,1.0962666666666583,1.096694500000003,1.0974564000000007,1.1008613000000016,1.1046263000000054,1.0961870286466882,1.0961742868646005,3348,-239361,-242989,-0.05751480965096548,-332.27812424927316,-0.06107065053914888
2023-07-28T05:15:00-04:00,1.09642,1.0967,1.09609,1.09621,1.098006594038494,1.0959622222222223,1.09582777777777,1.0960891111111029,1.096702500000003,1.0974302000000007,1.1006906000000016,1.1045766000000052,1.0961916229173505,1.09615742949168,-3192,-242553,-241704.8,-0.06341266429584581,-332.8894958039695,-0.10024514494537559
2023-07-28T05:30:00-04:00,1.09621,1.09738,1.0961,1.09711,1.0978599302769543,1.0962186666666667,1.095978888888881,1.0960011111111028,1.0967235000000028,1.0974168000000006,1.1005241000000017,1.1045296000000053,1.0963752983338804,1.0962107435933437,2949,-239604,-240718,-0.06983582242491167,-330.4683356248064,0.12411590234999113
2023-07-28T05:45:00-04:00,1.09711,1.09771,1.09695,1.09734,1.0977191330658762,1.096490888888889,1.0961288888888812,1.0959819999999916,1.096727500000003,1.0974096000000007,1.1003585000000016,1.1044816500000052,1.0965682386671043,1.0962901948746746,3048,-236556,-240156.6,-0.058158694431703246,-329.82934773845056,0.12317630635315671
2023-07-28T06:00:00-04:00,1.09734,1.09756,1.09703,1.09751,1.09771,1.096767111111111,1.0963899999999922,1.0960551111111028,1.096748000000003,1.0974062000000007,1.1001945000000015,1.104434250000005,1.0967565909336834,1.0964157558997392,2896,-233660,-238346.8,-0.045384563951252815,-329.38069918832025,0.21458051791519728
2023-07-28T06:15:00-04:00,1.09751,1.0988499999999999,1.09747,1.09862,1.09434,1.097213111111111,1.0967811111111034,1.0962213333333248,1.096832500000003,1.0974260000000005,1.1000491000000017,1.1043927000000051,1.0971292727469466,1.0966042047197908,2628,-231032,-236681,-0.020435381733925544,-326.7227917432857,0.32143183270933867
2023-07-28T06:30:00-04:00,1.09862,1.0994599999999999,1.09818,1.09942,1.0944302000000001,1.0977408888888887,1.0972233333333254,1.0965004444444362,1.096974500000003,1.0974506000000006,1.0999152000000016,1.1043530000000052,1.0975874181975573,1.0968833637758322,3050,-227982,-233766.8,0.008139409196127136,-324.5018236196393,0.3633243262981172
2023-07-28T06:45:00-04:00,1.09942,1.09965,1.09921,1.09935,1.0946313920000001,1.0981662222222222,1.0975488888888811,1.096814444444436,1.0970120000000032,1.0974738000000004,1.0997691000000016,1.1043119500000054,1.0979399345580458,1.0971962910206652,-2234,-230216,-231889.2,0.03175507100188237,-324.64406225455593,0.2672333594790408
2023-07-28T07:00:00-04:00,1.09935,1.10105,1.09919,1.10081,1.0949325084800001,1.0988184444444442,1.09808777777777,1.0972062222222139,1.0971470000000032,1.0975254000000005,1.0996307000000016,1.1042799000000052,1.0985139476464367,1.0975854328165318,3573,-226643,-229906.6,0.06217164582345228,-319.8989128480884,0.4425343990656612
2023-07-28T07:15:00-04:00,1.10081,1.10176,1.10066,1.10176,1.0954219078016,1.099552888888889,1.0986811111111034,1.0976644444444363,1.0973265000000034,1.0975946000000005,1.0995023000000015,1.1042505000000054,1.0991631581171495,1.098066746253225,3440,-223203,-227815.2,0.09917681722914652,-316.9301898168659,0.4870396380949018
2023-07-28T07:30:00-04:00,1.10176,1.10181,1.1009,1.10097,1.09605571702144,1.1000106666666667,1.0992099999999922,1.098150222222214,1.0974870000000032,1.0976584000000005,1.0993690000000016,1.1042206500000051,1.0995245264937197,1.0985457970025796,-3252,-226455,-226899.8,0.1284738041002599,-319.26198621535576,0.4342233696098465
2023-07-28T07:45:00-04:00,1.10097,1.10138,1.10076,1.1009,1.0967462309788671,1.1003486666666666,1.0996311111111035,1.0986317777777697,1.0976775000000032,1.0977142000000004,1.0992408000000016,1.1041878000000052,1.0997996211949757,1.0989882376020632,-2949,-229404,-227184.2,0.15756178570317603,-319.4494845123121,0.3454530539326011
2023-07-28T08:00:00-04:00,1.1009,1.10182,1.10081,1.10109,1.0973538832614032,1.1006404444444444,1.1000477777777702,1.0991315555555474,1.0978665000000032,1.0977746000000004,1.0991164000000015,1.1041559000000052,1.1000576969559805,1.09941179008165,3844,-225560,-226253,0.17643736792249284,-318.7860636748158,0.3417354694078335
2023-07-28T08:15:00-04:00,1.10109,1.10185,1.10069,1.1014,1.0979791396048066,1.100910888888889,1.1004799999999924,1.0996099999999918,1.0981490000000032,1.0978466000000004,1.0989934000000017,1.1041234500000052,1.1003261575647845,1.0997742320653194,4157,-221403,-225205,0.1956439058005482,-317.6157052118381,0.35443868392998235
2023-07-28T08:30:00-04:00,1.1014,1.10334,1.10039,1.1006,1.0985984772680375,1.1009348888888888,1.1006999999999922,1.1000137777777694,1.0983795000000032,1.0978966000000003,1.0988601000000018,1.1040861500000052,1.1003809260518276,1.1000177856522553,-12787,-234190,-227402.4,0.20270920646322912,-326.9035207193729,0.18022610183685833
2023-07-28T08:45:00-04:00,1.1006,1.10155,1.10032,1.10092,1.0994519513597907,1.100978888888889,1.1008666666666589,1.100345111111103,1.098667500000003,1.0979540000000005,1.0987308000000018,1.1040497000000051,1.100488740841462,1.1002106285218036,7641,-226549,-227421.2,0.20223239385642458,-324.68189615095656,0.13643557512141263
2023-07-28T09:00:00-04:00,1.10092,1.10093,1.09932,1.09987,1.10334,1.1007795555555555,1.1009244444444368,1.1006037777777695,1.098906000000003,1.0979942000000005,1.0986008000000018,1.1040073500000052,1.1003649926731696,1.1003237028174424,-7490,-234039,-228348.2,0.18587349316655422,-331.82546698262456,0.04730067767315722
2023-07-28T09:15:00-04:00,1.09987,1.10023,1.0992899999999999,1.09997,1.1032596,1.1005886666666667,1.1008311111111035,1.1007604444444365,1.099132500000003,1.0980336000000006,1.0985073000000016,1.103971200000005,1.1002859941385357,1.1003693622539534,4880,-229159,-229068,0.17037371810235408,-331.3817781830392,-0.07630744633498732
2023-07-28T09:30:00-04:00,1.09997,1.10022,1.0993,1.09977,1.103100816,1.1003764444444442,1.1006099999999923,1.1007864444444362,1.0993000000000028,1.0980784000000003,1.0984242000000017,1.1039356000000051,1.1001827953108285,1.1003406898031622,-7115,-236274,-232042.2,0.14212114674288487,-332.6754498286294,-0.18062009875110352
2023-07-28T09:45:00-04:00,1.09977,1.10175,1.0996,1.1017,1.10294838336,1.1005944444444442,1.1006911111111033,1.1007846666666583,1.099587000000003,1.0981534000000004,1.0983822000000019,1.1039128000000051,1.1004862362486627,1.1003617518425295,6789,-229485,-231101.2,0.11867357943842584,-320.76134960767416,0.06630516726158728
2023-07-28T10:00:00-04:00,1.1017,1.10386,1.1017,1.10351,1.0992899999999999,1.101158222222222,1.1009811111111034,1.1008075555555474,1.099941500000003,1.0982554000000007,1.0983805000000018,1.103900550000005,1.1010909889989302,1.100482201474023,10658,-218827,-229556.8,0.10903973760840917,-303.2511562701041,0.23707875374693443
2023-07-28T10:15:00-04:00,1.10351,1.10475,1.10345,1.10376,1.0993814,1.1017139999999999,1.10127777777777,1.1008782222222142,1.100319000000003,1.0983662000000005,1.0983935000000018,1.1038877000000051,1.1016247911991441,1.1007341611792179,6672,-212155,-225180,0.1032308498744463,-301.7396158218974,0.24248699016430741
2023-07-28T10:30:00-04:00,1.10376,1.10437,1.10367,1.10381,1.099596144,1.1022204444444443,1.1015455555555478,1.101021111111103,1.100654000000003,1.0984862000000006,1.0984365000000018,1.103874200000005,1.1020618329593153,1.1010893289433739,5514,-206641,-220676.4,0.0950273450802643,-301.4898332604716,0.21881242055565855
2023-07-28T10:45:00-04:00,1.10381,1.10381,1.10307,1.10357,1.09980229824,1.1026253333333333,1.1018755555555477,1.1012742222222143,1.1009655000000031,1.0985876000000006,1.0984642000000018,1.103857950000005,1.1023634663674522,1.1015254631546987,-4605,-211246,-215670.8,0.08676862780726673,-302.49109253516565,0.26985280755950547
2023-07-28T11:00:00-04:00,1.10357,1.1036,1.10245,1.10305,1.1000002063104,1.1028602222222221,1.1021122222222146,1.1015584444444364,1.101242500000003,1.0986858000000004,1.0984890000000016,1.1038412000000049,1.1025007730939618,1.1019283705237584,-4200,-215446,-212863,0.08430367834428444,-304.470124223232,0.19347454855940371
2023-07-28T11:15:00-04:00,1.10305,1.1032899999999999,1.10221,1.10305,1.100190198057984,1.1030477777777778,1.1024655555555478,1.1018553333333254,1.101464000000003,1.0987814000000002,1.0985262000000018,1.103822400000005,1.1026106184751694,1.102232296419006,0,-215446,-212186.8,0.07967000895027028,-304.470124223232,0.28912507841837515
2023-07-28T11:30:00-04:00,1.10305,1.10331,1.10263,1.103,1.1003725901356647,1.1031546666666667,1.1028022222222145,1.1021602222222142,1.101643000000003,1.0988726000000004,1.0985681000000018,1.103804700000005,1.1026884947801354,1.1024450371352044,-4032,-219478,-213651.4,0.08913518252421147,-304.65289019032366,0.2754620580561368
2023-07-28T11:45:00-04:00,1.103,1.104,1.103,1.10382,1.1005476865302382,1.1033582222222225,1.1032522222222145,1.1025015555555477,1.101866500000003,1.0989856000000002,1.0986145000000018,1.103791200000005,1.1029147958241083,1.102615629708163,3873,-215605,-215444.2,0.10504532197364454,-301.7735973526082,0.36825881775281283
2023-07-28T12:00:00-04:00,1.10382,1.10429,1.10355,1.10356,1.1007157790690287,1.1034197777777779,1.1034588888888814,1.1028182222222145,1.102004000000003,1.0990938000000003,1.098657600000002,1.1037770000000051,1.1030438366592867,1.1027517037665298,-3245,-218850,-216965,0.1212269709592454,-302.53794298867183,0.1688299900154484
2023-07-28T12:15:00-04:00,1.10356,1.10378,1.10316,1.10327,1.1008771479062676,1.103382,1.1034322222222146,1.1030822222222143,1.102079500000003,1.0992062000000002,1.0986989000000018,1.103760850000005,1.1030890693274293,1.1028693630132234,-2695,-221545,-218184.8,0.12483067490235138,-303.246150970114,-0.02174878342742866
2023-07-28T12:30:00-04:00,1.10327,1.1035,1.10284,1.10291,1.101032061990017,1.1032775555555554,1.10333777777777,1.1032566666666588,1.1021765000000028,1.0993304000000004,1.0987311000000017,1.103740550000005,1.1030532554619434,1.1029578904105781,-2213,-223758,-219847.2,0.114411631273127,-303.96825888567395,-0.07700949481771557
2023-07-28T12:45:00-04:00,1.10291,1.10307,1.10249,1.10254,1.1011807795104163,1.103118,1.103196666666659,1.1033355555555475,1.1022585000000027,1.0994602000000002,1.0987595000000017,1.103721500000005,1.1029506043695547,1.103010312328462,-2434,-226192,-221190,0.0965520280549176,-304.7848078334575,-0.1150560331941079
2023-07-28T13:00:00-04:00,1.10254,1.10292,1.10244,1.10282,1.1013235483299997,1.1030426666666668,1.1031133333333256,1.1033077777777698,1.1023450000000028,1.0995828000000005,1.0987941000000019,1.103701100000005,1.1029244834956438,1.103012249862769,2095,-224097,-222888.4,0.0792682215605248,-304.25276364458483,-0.06796125302427834
2023-07-28T13:15:00-04:00,1.10282,1.1028499999999999,1.10179,1.10191,1.1014606063967998,1.102802,1.102986666666659,1.1032133333333252,1.102370500000003,1.0996758000000002,1.0988153000000018,1.103674550000005,1.102721586796515,1.1029477998902144,-2013,-226110,-224340.4,0.06066402549419935,-305.91380533769876,-0.10334980281946791
2023-07-28T13:30:00-04:00,1.10191,1.10217,1.10161,1.10167,1.1015921821409278,1.1025386666666668,1.1028333333333256,1.1030935555555474,1.102424000000003,1.0997672000000003,1.0988372000000017,1.103645050000005,1.102511269437212,1.102832239912171,-2109,-228219,-225675.2,0.04697810884925854,-306.37315319732437,-0.125107656044618
2023-07-28T13:45:00-04:00,1.10167,1.10244,1.1015,1.10211,1.10475,1.1023939999999999,1.1027344444444367,1.1029728888888808,1.1024835000000028,1.0998708000000001,1.0988683000000017,1.103617300000005,1.1024310155497694,1.1027077919297361,2596,-225623,-226048.2,0.0319257522162642,-305.3363272875692,-0.08068902991840955
2023-07-28T14:00:00-04:00,1.10211,1.10229,1.10157,1.10178,1.104685,1.102203111111111,1.1025077777777699,1.1028351111111028,1.1025790000000029,1.0999748000000003,1.0988830000000016,1.1035868000000049,1.1023008124398155,1.1025778335437884,-2419,-228042,-226418.2,0.017143634631995863,-306.06063792806776,-0.1848127412078094
2023-07-28T14:15:00-04:00,1.10178,1.1022399999999999,1.10177,1.10218,1.1046212999999998,1.1021375555555555,1.1023544444444366,1.102683333333325,1.102689500000003,1.1000464000000003,1.0989099000000018,1.103560100000005,1.1022766499518524,1.10244826683503,2155,-225887,-226776.2,-0.007709331011434161,-305.27826758190076,-0.12504983870384562
2023-07-28T14:30:00-04:00,1.10218,1.10227,1.10206,1.1022,1.1045588739999999,1.1021066666666666,1.1022355555555476,1.102533111111103,1.1028110000000029,1.1001282000000001,1.0989392000000016,1.1035348500000048,1.102261319961482,1.1023562134680236,1439,-224448,-226443.8,-0.029672667849625547,-305.2521556945501,-0.09698441904519332
2023-07-28T14:45:00-04:00,1.1022,1.10298,1.1022,1.10234,1.10449769652,1.1021275555555554,1.1021722222222143,1.1024008888888805,1.102843000000003,1.1002116000000002,1.0989639000000018,1.1035107000000048,1.1022770559691855,1.1023093707744183,2202,-222246,-225249.2,-0.04919995025595093,-304.97246053940574,-0.05168146086262337
2023-07-28T15:00:00-04:00,1.10234,1.10267,1.10212,1.10254,1.1044377425896,1.102201111111111,1.1021722222222143,1.102288444444436,1.102794500000003,1.1003072,1.0990009000000018,1.103491600000005,1.1023296447753483,1.102289096619534,2142,-220104,-224145.4,-0.056180211922574615,-304.58383271133096,0
2023-07-28T15:15:00-04:00,1.10254,1.10257,1.10195,1.10214,1.1043789877378078,1.1021946666666669,1.102096666666659,1.102206222222214,1.102713500000003,1.1004082,1.0990414000000017,1.103470550000005,1.1022917158202787,1.1022872772956265,-1697,-221801,-222897.2,-0.05389491247742549,-305.1995019841014,-0.061660107723836524
2023-07-28T15:30:00-04:00,1.10214,1.10226,1.10195,1.10199,1.1043214079830517,1.1021733333333332,1.102105555555548,1.102156444444436,1.102622500000003,1.1005018,1.0990813000000017,1.1034477000000047,1.102231372656223,1.1022782218365008,-1142,-222943,-222308.4,-0.05378243291445234,-305.3549268847491,0.007260121062525979
2023-07-28T15:45:00-04:00,1.10199,1.10247,1.10189,1.10229,1.1042649798233906,1.102210222222222,1.1021744444444368,1.102144222222214,1.1025585000000029,1.1006326,1.0991309000000016,1.103430550000005,1.1022430981249784,1.1022745774692,1443,-221500,-221718.8,-0.04377505426534366,-304.96209210403424,0.05627819582997313
2023-07-28T16:00:00-04:00,1.10229,1.10234,1.10199,1.10202,1.1042096802269228,1.1021793333333334,1.102164444444437,1.1021426666666585,1.1025070000000028,1.1007532,1.0991803000000016,1.1034054000000049,1.1021984784999828,1.1022588619753595,-1120,-222620,-221793.6,-0.03390893436281966,-305.2364300731712,-0.008166154013657756
2023-07-28T16:15:00-04:00,1.10202,1.10221,1.10201,1.10205,1.1041554866223844,1.1021564444444445,1.102194444444437,1.102147111111103,1.102457000000003,1.100891,1.0992334000000017,1.1033847000000048,1.1021687827999862,1.102226689580287,676,-221944,-222161.6,-0.030135378121885364,-305.2180275033449,0.02450579970592972
2023-07-28T16:30:00-04:00,1.10205,1.10208,1.10157,1.10157,1.1041023768899367,1.1020315555555555,1.1021266666666591,1.102153111111103,1.102385500000003,1.1010204000000001,1.0992826000000016,1.1033441000000048,1.102049026239989,1.1021781516642288,-561,-222505,-222302.4,-0.025649321338282894,-305.46237213380635,-0.05534486200076208
2023-07-28T16:45:00-04:00,1.10157,1.10177,1.10105,1.1013,1.104050329352138,1.1018662222222222,1.1020266666666592,1.1021373333333253,1.1022595000000028,1.1011376,1.0993286000000015,1.103298700000005,1.1018992209919911,1.1021117213313825,-1397,-223902,-222494.2,-0.026290541150551835,-305.80478341951675,-0.0816548720740449
2023-07-30T17:00:00-04:00,1.10193,1.10198,1.10142,1.10197,1.1039303161780525,1.1018548888888886,1.101985555555548,1.1020995555555475,1.1021800000000028,1.1012486,1.0993799000000015,1.103264500000005,1.101913376793593,1.1020457770651055,137,-223765,-222947.2,-0.020386950278099496,-305.72143646591644,-0.03356496180853489
2023-07-30T17:15:00-04:00,1.10197,1.10199,1.10154,1.10175,1.1038151035309305,1.1018077777777777,1.10189777777777,1.102046222222214,1.1021040000000029,1.1013644,1.0994224000000015,1.103229400000005,1.1018807014348744,1.1019822216520838,-107,-223872,-223197.6,-0.017921526354101023,-305.7427982089766,-0.07165272915269
2023-07-30T17:30:00-04:00,1.10175,1.10193,1.10153,1.10177,1.1037044993896932,1.1017822222222224,1.101856666666659,1.1019786666666582,1.1020470000000027,1.1014714,1.0994639000000015,1.103190700000005,1.1018585611478995,1.1019201773216665,59,-223813,-223571.4,-0.018428221752165824,-305.7417271856047,-0.033571052679331255
2023-07-30T17:45:00-04:00,1.10177,1.10192,1.10156,1.10188,1.1035983194141055,1.1017868888888886,1.1018444444444369,1.101922222222214,1.1020140000000027,1.1015848000000001,1.0995075000000016,1.1031519500000049,1.1018628489183195,1.1018829418573326,492,-223321,-223734.6,-0.016337680541920082,-305.6926062256947,-0.009981941759912022
2023-07-30T18:00:00-04:00,1.10188,1.10248,1.10124,1.10247,1.1034963866375413,1.101912,1.1018644444444368,1.1018897777777696,1.1019965000000027,1.1016920000000001,1.0995544000000015,1.1031191500000048,1.1019842791346557,1.1018999534858653,718,-222603,-223474.8,-0.011679683702196691,-305.30815419825063,0.0163296410200645
2023-07-30T18:15:00-04:00,1.10247,1.10271,1.10226,1.10247,1.1033985311720398,1.102033111111111,1.1019144444444366,1.1018755555555473,1.1020245000000028,1.1017946000000003,1.0996021000000016,1.1030888000000048,1.1020814233077245,1.1019335627886917,0,-222603,-223242.4,-0.008534119192418633,-305.30815419825063,0.040834104644204415
2023-07-30T18:30:00-04:00,1.10247,1.10271,1.10229,1.10259,1.1033045899251581,1.1021682222222222,1.1019744444444366,1.1018908888888803,1.1020705000000026,1.1018962,1.0996512000000016,1.1030591500000049,1.1021831386461796,1.1019940502309529,1006,-221597,-222787.4,-0.006299939333865528,-305.19865462003094,0.04899959167006805
2023-07-30T18:45:00-04:00,1.10259,1.10279,1.1024,1.1027,1.1032144063281517,1.1023133333333335,1.102099999999992,1.1019395555555471,1.1021000000000025,1.1019778000000002,1.0997019000000017,1.1030298000000047,1.1022865109169437,1.1020796401847617,785,-220812,-222187.2,-0.004852206457656417,-305.12033901767643,0.10258086186080553
2023-07-30T19:00:00-04:00,1.1027,1.10284,1.10245,1.1026799999999999,1.1031278300750256,1.1024293333333333,1.1022533333333255,1.1020213333333246,1.1021450000000026,1.102043,1.0997468000000017,1.1030013500000049,1.102365208733555,1.1021801121478088,-917,-221729,-221868.8,0.0027565730008533456,-305.1369709211861,0.125306456006532
2023-07-30T19:15:00-04:00,1.1026799999999999,1.10269,1.10247,1.10253,1.1030447168720245,1.1024846666666668,1.1023155555555477,1.1021115555555467,1.1021625000000026,1.1021066000000002,1.0997902000000017,1.102970650000005,1.102398166986844,1.1022628897182465,-728,-222457,-221839.6,0.010675973615567543,-305.23600237183354,0.05081808034702542
2023-07-30T19:30:00-04:00,1.10253,1.1026799999999999,1.10242,1.10265,1.1029649281971436,1.1025515555555556,1.1024155555555477,1.1022117777777691,1.1021850000000026,1.1021434,1.0998344000000015,1.102940900000005,1.1024485335894751,1.1023363117745968,875,-221582,-221635.4,0.014814718805529278,-305.1407668680378,0.08168822328113463
2023-07-30T19:45:00-04:00,1.10265,1.10269,1.10237,1.10238,1.1028883310692579,1.1025444444444443,1.1024833333333255,1.1023135555555468,1.1021870000000027,1.1021558000000002,1.0998752000000016,1.1029095000000049,1.10243482687158,1.1023866494196768,-941,-222523,-221820.6,0.019752804794629993,-305.3711844982922,0.05536545740036482
2023-07-30T20:00:00-04:00,1.10238,1.10279,1.1022,1.10262,1.1028147978264875,1.102571777777778,1.1025655555555476,1.1024066666666579,1.1021910000000026,1.1021888000000002,1.0999236000000017,1.102879500000005,1.102471861497264,1.1024237195357407,1796,-220727,-221803.6,0.02625466812064369,-304.9801759531444,0.06715794823392411
2023-07-30T20:15:00-04:00,1.10262,1.10271,1.10221,1.10223,1.10279,1.1025046666666667,1.1025388888888807,1.102463777777769,1.1021955000000028,1.1022154000000002,1.0999648000000015,1.1028467000000048,1.102423489197811,1.102435375628592,-1593,-222320,-221921.8,0.030769828977360157,-305.54362482945703,-0.021769299844895368
2023-07-30T20:30:00-04:00,1.10223,1.10245,1.10214,1.10223,1.10279,1.1024428888888889,1.1025122222222141,1.1025031111111023,1.1022075000000027,1.1022382000000002,1.1000064000000016,1.1028137500000048,1.102384791358249,1.1024327005028733,0,-222320,-221894.4,0.028203406701960598,-305.54362482945703,-0.021769299844895368
2023-07-30T20:45:00-04:00,1.10223,1.10236,1.10193,1.1022,1.1027204,1.1023804444444445,1.102468888888881,1.102513777777769,1.102203000000003,1.1022542000000002,1.1000504000000015,1.1027824000000048,1.1023478330865992,1.102412560402298,-2180,-224500,-222478,0.024846250056761224,-305.602959088187,-0.03537126220987769
2023-07-30T21:00:00-04:00,1.1022,1.10241,1.10183,1.10209,1.102653584,1.1023046666666667,1.1024011111111032,1.1024973333333246,1.1022065000000028,1.1022840000000003,1.1000903000000015,1.1027507000000047,1.1022962664692795,1.102384848321838,-2378,-226878,-223349,0.021174147752469636,-305.8402844374885,-0.05531876303618386
2023-07-30T21:15:00-04:00,1.10209,1.1022399999999999,1.10186,1.10186,1.10258944064,1.1021964444444448,1.1023099999999921,1.1024462222222133,1.1021970000000028,1.1023028000000001,1.1001284000000016,1.1027185000000048,1.1022090131754236,1.1023322786574696,-1860,-228738,-224951.2,0.014244368030977289,-306.22845600242414,-0.07436427612723737
2023-07-30T21:30:00-04:00,1.10186,1.10265,1.1018,1.10208,1.10105,1.1021504444444445,1.102259999999992,1.1023904444444355,1.1022225000000028,1.1023470000000002,1.1001706000000016,1.102689650000005,1.1021832105403389,1.102284222925975,3956,-224782,-225443.6,0.00867103718052353,-305.43859159133785,-0.04081521591249775
2023-07-30T21:45:00-04:00,1.10208,1.10222,1.1014,1.10143,1.1010820000000001,1.1019844444444442,1.1021244444444365,1.10231288888888,1.1022290000000026,1.1023762000000001,1.1002049000000016,1.1026578500000048,1.1020325684322712,1.1022137783407797,-2603,-227385,-226456.6,-0.0007042290031263045,-306.9738249682253,-0.11064254296467592
2023-07-30T22:00:00-04:00,1.10143,1.1016,1.10092,1.10159,1.10265,1.1018775555555556,1.1020366666666588,1.1022264444444356,1.1022100000000028,1.1024126,1.1002455000000015,1.1026248000000047,1.101944054745817,1.1021330226726234,3177,-224208,-226398.2,-0.011574269090690894,-306.5123158391835,-0.07166312886662007
2023-07-30T22:15:00-04:00,1.10159,1.10161,1.10099,1.10115,1.1026154,1.1017002222222223,1.1018733333333255,1.1021208888888803,1.1021800000000028,1.1024016,1.1002775000000016,1.102588450000005,1.1017852437966535,1.102030818138098,-2742,-226950,-226412.6,-0.019191759899887986,-307.6075327529173,-0.13331882244108217
2023-07-30T22:30:00-04:00,1.10115,1.10144,1.1009,1.10133,1.1025814919999999,1.1015915555555555,1.1017733333333253,1.102013555555547,1.1021580000000029,1.1023580000000002,1.1003067000000015,1.102553300000005,1.101694195037323,1.1019278545104778,2208,-224742,-225613.4,-0.02908196309078027,-307.24660099975046,-0.0816526496284916
2023-07-30T22:45:00-04:00,1.10133,1.10155,1.1012,1.10154,1.10251423232,1.1015448888888888,1.1016966666666588,1.1019008888888804,1.1021410000000027,1.1023136,1.1003399000000016,1.1025178000000049,1.1016633560298583,1.1018238836083818,2065,-222677,-225192.4,-0.03434911664436689,-306.85284980800947,-0.06260036471517555
2023-07-30T23:00:00-04:00,1.10154,1.1017,1.10139,1.10155,1.1024496630271998,1.1015155555555556,1.1016244444444365,1.1018008888888804,1.102095000000003,1.1022684,1.1003773000000014,1.1024807000000048,1.1016406848238867,1.101745506886705,1739,-220938,-223903,-0.03909374072393869,-306.83706281888504,-0.0589729631645835
2023-07-30T23:15:00-04:00,1.10155,1.1018,1.10151,1.10164,1.1023876765061118,1.1015186666666668,1.1015744444444366,1.101708444444436,1.102053500000003,1.1022298000000001,1.1004087000000016,1.102441400000005,1.1016405478591094,1.1016848055093633,1441,-219497,-222960.8,-0.04059016036433545,-306.71932871693787,-0.04083151103812406
2023-07-30T23:30:00-04:00,1.10164,1.10172,1.1013,1.10135,1.1023281694458673,1.1014737777777779,1.1015177777777698,1.101637333333325,1.101991500000003,1.1021958,1.1004408000000014,1.102398900000005,1.1015824382872874,1.10164424440749,-1821,-221318,-221834.4,-0.04246746882989836,-307.1986958423144,-0.046285372007334
2023-07-30T23:45:00-04:00,1.10135,1.10148,1.10118,1.10123,1.1022710426680327,1.1014162222222221,1.1014233333333254,1.1015673333333251,1.1019180000000028,1.1021594000000001,1.1004704000000014,1.1023555500000048,1.1015119506298299,1.1016077955259915,-1566,-222884,-221462.8,-0.04231007568361022,-307.36932280013906,-0.07712688734030355
2023-07-31T00:00:00-04:00,1.10123,1.10125,1.101,1.10112,1.1022162009613115,1.1013555555555556,1.101388888888881,1.1015057777777693,1.101840000000003,1.1021218000000002,1.1004972000000013,1.102304350000005,1.1014335605038639,1.1015618364207924,-1549,-224433,-221814,-0.04419719025656289,-307.52404978723507,-0.02814522938360227
2023-07-31T00:15:00-04:00,1.10112,1.10121,1.10092,1.10097,1.102163552922859,1.1012717777777776,1.101319999999992,1.1014448888888806,1.101762000000003,1.1020648000000002,1.1005252000000014,1.1022576000000048,1.101340848403091,1.1015018691366332,-1597,-226030,-222832.4,-0.04098493502175839,-307.74160100781063,-0.05628228288202189
2023-07-31T00:30:00-04:00,1.10097,1.10116,1.10088,1.1010199999999999,1.1021130108059447,1.1012117777777777,1.1013055555555475,1.1013911111111028,1.101680500000003,1.102014,1.1005539000000015,1.1022089000000048,1.1012766787224728,1.1014290953093062,1182,-224848,-223902.6,-0.03963475514186585,-307.68792107102774,-0.011805839349787541
2023-07-31T00:45:00-04:00,1.1010199999999999,1.10108,1.10055,1.10058,1.102039030157588,1.1010666666666666,1.1012222222222143,1.1013319999999918,1.1015905000000028,1.1019602000000002,1.1005832000000015,1.1021622000000049,1.1011373429779783,1.1013400762474443,-1723,-226571,-224953.2,-0.03586466610667299,-308.37648258671317,-0.06809947971997753
2023-07-31T01:00:00-04:00,1.10058,1.10104,1.10052,1.1010199999999999,1.1019199077449808,1.1010262222222222,1.1011644444444366,1.101280222222214,1.101510500000003,1.1019224000000003,1.1006264000000014,1.102115400000005,1.1011138743823825,1.1012604609979548,1933,-224638,-225304,-0.03280186643825311,-307.6036900591368,-0.047206637979562795
2023-07-31T01:15:00-04:00,1.1010199999999999,1.10108,1.1007,1.10072,1.1017799169704827,1.1009373333333334,1.1010722222222145,1.1012168888888807,1.1014350000000028,1.1018860000000001,1.1006731000000014,1.102066150000005,1.101035099505906,1.1011807687983632,-1326,-225964,-225610.2,-0.03203502842291217,-307.96499139789535,-0.07534837274750202
2023-07-31T01:30:00-04:00,1.10072,1.10098,1.1006,1.1006,1.1016539252734345,1.100842888888889,1.1009566666666588,1.101144222222214,1.101353500000003,1.1018416000000004,1.1007122000000016,1.102017800000005,1.1009480796047248,1.10110221503869,-1956,-227920,-225988.2,-0.0336153709796332,-308.1782336393371,-0.09440470571147834
2023-07-31T01:45:00-04:00,1.1006,1.10145,1.10058,1.10143,1.101540532746091,1.1009375555555554,1.1009655555555478,1.1010762222222141,1.101315000000003,1.1018320000000004,1.1007539000000015,1.101974850000005,1.10104446368378,1.1010557720309513,1919,-226001,-226218.8,-0.032064336208510805,-306.7310502848034,0.0072638125936221876
2023-07-31T02:00:00-04:00,1.10143,1.10144,1.10086,1.10133,1.10052,1.1010104444444444,1.1009766666666587,1.101027111111103,1.1012770000000027,1.1018252000000004,1.1007962000000016,1.101930100000005,1.101101570947024,1.1010486176247605,-3330,-229331,-226770.8,-0.028485409010726964,-307.03338452302097,0.00908075515559774
2023-07-31T02:15:00-04:00,1.10133,1.10176,1.10095,1.10104,1.1005384,1.101023111111111,1.10096777777777,1.1009877777777697,1.101236000000003,1.1018038000000003,1.1008373000000014,1.101883500000005,1.1010892567576192,1.101043694099808,-2853,-232184,-228280,-0.0256717595078269,-307.7846307434996,-0.007265329845982273
2023-07-31T02:30:00-04:00,1.10104,1.10149,1.10093,1.10103,1.100587264,1.1010355555555555,1.1009744444444367,1.1009682222222141,1.1011835000000028,1.1017888000000005,1.1008818000000016,1.101836800000005,1.1010774054060952,1.1010521552798458,-2523,-234707,-230028.6,-0.022900878890357534,-307.8075454423299,0.005449739774921114
2023-07-31T02:45:00-04:00,1.10103,1.10147,1.10065,1.10109,1.10063417344,1.1010586666666666,1.1009822222222145,1.1009733333333251,1.1011665000000028,1.1017670000000004,1.1009067000000015,1.101794250000005,1.1010799243248761,1.1010785242238759,3252,-231455,-230735.6,-0.017530992754013965,-307.63032956265374,0.006357741003797796
2023-07-31T03:00:00-04:00,1.10109,1.10189,1.10108,1.10131,1.10065,1.1011242222222222,1.1010633333333255,1.100992888888881,1.1011525000000029,1.1017492000000004,1.1009387000000015,1.101751950000005,1.101125939459901,1.1010948193791001,4603,-226852,-230905.8,-0.014378602218152636,-306.7106408905193,0.06632866306857471
2023-07-31T03:15:00-04:00,1.10131,1.10264,1.10127,1.10254,1.10065,1.1014195555555557,1.1012322222222144,1.101043999999992,1.101222000000003,1.1017532000000005,1.1009824000000017,1.101718450000005,1.1014087515679207,1.1011562555032794,4187,-222665,-229572.6,-0.0006875500256912503,-302.034382616282,0.1380538046538835
2023-07-31T03:30:00-04:00,1.10254,1.10288,1.10192,1.10193,1.1008091999999998,1.1015591111111112,1.1013666666666586,1.1011237777777698,1.1012520000000028,1.1017410000000005,1.1010241000000016,1.101679750000005,1.1015130012543366,1.1012410044026228,-4156,-226821,-228500,0.004202994244319171,-304.33376404462024,0.10992804709646009
2023-07-31T03:45:00-04:00,1.10193,1.10214,1.10173,1.10198,1.1010162799999998,1.1016817777777776,1.101519999999992,1.1012328888888807,1.1012740000000028,1.1017378000000007,1.1010730000000017,1.1016452500000051,1.1016064010034692,1.1013468035220977,3409,-223412,-226241,0.012833473573415455,-304.17908089777825,0.12538615300744474
2023-07-31T04:00:00-04:00,1.10198,1.10225,1.10157,1.10217,1.1012026519999998,1.1018117777777778,1.1016022222222142,1.1013568888888807,1.1013050000000029,1.1017414000000005,1.1011216000000017,1.101609050000005,1.1017191208027755,1.1014746428176778,4510,-218902,-223730.4,0.02436477549605599,-303.4014805783527,0.06718538627059233
2023-07-31T04:15:00-04:00,1.10217,1.10238,1.10158,1.10189,1.1013703867999998,1.1018693333333334,1.1016644444444363,1.101477111111103,1.1013175000000028,1.1017334000000005,1.1011830000000016,1.101571500000005,1.1017532966422203,1.1016001142541416,-3290,-222192,-222798.4,0.027071094375342716,-304.2372863070517,0.050847611524258485
2023-07-31T04:30:00-04:00,1.10189,1.10196,1.10115,1.10147,1.10288,1.1018304444444444,1.101712222222214,1.1015731111111031,1.1013235000000028,1.1017224000000005,1.1012378000000016,1.101532100000005,1.1016966373137762,1.1016576914033125,-3368,-225560,-223377.4,0.029077535193624254,-305.5210442139211,0.03905398532296106
2023-07-31T04:45:00-04:00,1.10147,1.10357,1.10147,1.10338,1.10115,1.102164,1.1019733333333253,1.1016944444444363,1.101431000000003,1.1017490000000008,1.1013200000000016,1.101499050000005,1.1020333098510209,1.1017617531226496,4108,-221452,-222303.6,0.04154371947946126,-298.3975819316979,0.2134365094502488
2023-07-31T05:00:00-04:00,1.10338,1.1036,1.10256,1.10315,1.10115,1.1023993333333333,1.102202222222214,1.1018308888888808,1.101532500000003,1.1017806000000006,1.1014005000000016,1.101460900000005,1.1022566478808167,1.101891802498119,-3419,-224871,-222595.4,0.05248625591563624,-299.1102738420097,0.18708734072602357
2023-07-31T05:15:00-04:00,1.10315,1.10315,1.10264,1.10281,1.101248,1.102520888888889,1.1023688888888807,1.101984222222214,1.101624500000003,1.1018108000000006,1.1014742000000015,1.101416550000005,1.1023673183046534,1.1020214419984946,-2329,-227200,-224255,0.06079073342256874,-299.82809100196073,0.13620143283907862
2023-07-31T05:30:00-04:00,1.10281,1.10375,1.1027,1.10355,1.10134208,1.1027571111111112,1.102481111111103,1.1021475555555473,1.1017510000000028,1.1018424000000007,1.1015455000000016,1.101369750000005,1.1026038546437227,1.1021915535987952,2240,-224960,-224808.6,0.06996443643775266,-298.3250215702364,0.09160665372684486
2023-07-31T05:45:00-04:00,1.10355,1.10356,1.10291,1.10325,1.1014865552,1.1029108888888888,1.1026277777777698,1.1023306666666586,1.1018845000000028,1.1018724000000006,1.1016184000000013,1.1013218000000051,1.1027330837149782,1.1023988428790354,-2556,-227516,-225199.8,0.06676385053858816,-299.0198700138954,0.11978982331000951
2023-07-31T06:00:00-04:00,1.10325,1.10367,1.10291,1.10365,1.101622361888,1.1031153333333334,1.1028133333333252,1.1024986666666585,1.1020160000000028,1.1019100000000006,1.1016907000000016,1.101276000000005,1.1029164669719826,1.1025754743032277,2495,-225021,-225913.6,0.06909712229289286,-298.11526996857486,0.1515454000980109
2023-07-31T06:15:00-04:00,1.10365,1.10395,1.1033,1.10375,1.10175002017472,1.1033026666666668,1.1029888888888808,1.1026559999999919,1.1021675000000029,1.1019474000000007,1.1017661000000016,1.1012283500000053,1.1030831735775861,1.1027407794425816,2426,-222595,-225458.4,0.07335356313739202,-297.89545390369926,0.1433535661467754
2023-07-31T06:30:00-04:00,1.10375,1.10384,1.1034,1.10377,1.1019260185607422,1.1034588888888888,1.1031977777777697,1.1028217777777698,1.1023260000000028,1.1019734000000008,1.1018327000000014,1.101178400000005,1.1032205388620688,1.1029114235540647,2105,-220490,-224116.4,0.07468315712717997,-297.8573112083427,0.17061594170015898
2023-07-31T06:45:00-04:00,1.10377,1.10402,1.10347,1.10365,1.102087937075883,1.1035493333333335,1.103439999999992,1.1030135555555476,1.102437000000003,1.1019970000000006,1.1018958000000014,1.1011271500000053,1.103306431089655,1.103051938843251,-2241,-222731,-223670.6,0.07746379400245125,-298.1009489227214,0.19791732866079612
2023-07-31T07:00:00-04:00,1.10365,1.10366,1.1031199999999999,1.10336,1.1022811433682946,1.1035333333333333,1.1034377777777697,1.1031755555555478,1.1025385000000028,1.1020124000000004,1.1019543000000016,1.1010744000000052,1.103317144871724,1.1031687510746002,-2292,-225023,-223172,0.08626431295656335,-298.7032050727692,-0.0018126121553889887
2023-07-31T07:15:00-04:00,1.10336,1.10336,1.10286,1.1031199999999999,1.1024550290314652,1.1034697777777778,1.1034344444444364,1.10329977777777,1.1026425000000029,1.1020208000000007,1.1019993000000015,1.1010242000000052,1.1032777158973792,1.1032410008596796,-1884,-226907,-223549.2,0.07616862652461302,-299.113007856992,-0.002719485110836834
2023-07-31T07:30:00-04:00,1.1031199999999999,1.1032,1.10239,1.10245,1.10402,1.1032728888888887,1.1033944444444364,1.103380888888881,1.1027135000000028,1.1020162000000007,1.1020296000000014,1.1009724000000052,1.1031121727179034,1.103246800687743,-2127,-229034,-224837,0.0637262311436727,-300.4048800014549,-0.03264388244576472
2023-07-31T07:45:00-04:00,1.10245,1.10295,1.1023,1.1026799999999999,1.1039874,1.10313,1.1032977777777697,1.1034008888888809,1.1027930000000028,1.1020192000000006,1.1020629000000015,1.1009160000000053,1.1030257381743227,1.1032078405501937,2512,-226522,-226043.4,0.05541748805441063,-299.8808108826741,-0.07883648226180494
2023-07-31T08:00:00-04:00,1.1026799999999999,1.1032899999999999,1.102,1.10208,1.103919904,1.1028864444444444,1.1031677777777698,1.1033464444444365,1.1028315000000029,1.1020078000000006,1.1020756000000016,1.1008531500000052,1.1028365905394582,1.1031138724401544,-3696,-230218,-227540.8,0.037809926098853565,-301.891911111208,-0.10605030591435444
2023-07-31T08:15:00-04:00,1.10208,1.10267,1.10187,1.10262,1.1038047097600001,1.102776888888889,1.1030533333333254,1.1032695555555478,1.1028355000000027,1.1020126000000006,1.1020842000000015,1.1007932500000053,1.1027932724315666,1.103009097952123,2723,-227495,-228035.2,0.026438680009124617,-300.55768855023246,-0.09332668871472717
2023-07-31T08:30:00-04:00,1.10262,1.10328,1.10262,1.10306,1.1036499329792,1.1027782222222222,1.1029766666666587,1.1031779999999922,1.1028920000000029,1.1020214000000006,1.1021051000000015,1.100737050000005,1.1028466179452532,1.1029228783616978,3568,-223927,-227439.2,0.01884301959827664,-299.1338798037922,-0.06251415628539791
2023-07-31T08:45:00-04:00,1.10306,1.10385,1.10281,1.10282,1.10187,1.1027468888888887,1.1028711111111031,1.1030733333333256,1.1029340000000027,1.1020332000000006,1.1021243000000016,1.1006825500000053,1.1028412943562025,1.1028687026893575,-3044,-226971,-227026.6,0.006567170365677941,-299.7961828516772,-0.08606865560759999
2023-07-31T09:00:00-04:00,1.10282,1.10286,1.1022,1.10229,1.1019096,1.1026306666666663,1.102719999999992,1.10295777777777,1.102940000000003,1.1020344000000006,1.1021363000000015,1.1006263500000053,1.102731035484962,1.1028097621514854,-3933,-230904,-227903,-0.008190503247426078,-301.68632811563657,-0.1232274724776902
2023-07-31T09:15:00-04:00,1.10229,1.10229,1.10145,1.10225,1.10385,1.1025366666666665,1.1025966666666587,1.1028435555555476,1.102958000000003,1.1020354000000006,1.1021448000000016,1.100569100000005,1.1026348283879697,1.1027694097211878,-4594,-235498,-228959,-0.0212296074659015,-301.85303560640597,-0.10060179814384647
2023-07-31T09:30:00-04:00,1.10225,1.1037,1.10221,1.10366,1.103802,1.1027493333333334,1.1026566666666586,1.102764222222214,1.103067500000003,1.1020668000000007,1.1021754000000015,1.1005177500000052,1.1028398627103757,1.1027787277769494,5365,-230133,-229486.6,-0.026149665714223544,-294.990118845235,0.04895206323883232
2023-07-31T09:45:00-04:00,1.10366,1.10455,1.10348,1.10375,1.10145,1.1029680000000002,1.1028011111111031,1.102729111111103,1.103086000000003,1.1021046000000005,1.1022037000000013,1.1004672500000052,1.1030218901683007,1.1028137822215591,6200,-223933,-229487.8,-0.030278306590442193,-294.48452835541065,0.1179191800081708
2023-07-31T10:00:00-04:00,1.10375,1.10458,1.10369,1.1042399999999999,1.101512,1.1032557777777776,1.1029744444444365,1.1027497777777695,1.1031405000000027,1.1021478000000007,1.1022474000000015,1.1004241000000052,1.1032655121346404,1.1028986257772466,6179,-217754,-227644.4,-0.01776313176740206,-291.74141623763103,0.1414735009250196
2023-07-31T10:15:00-04:00,1.1042399999999999,1.10453,1.10372,1.10385,1.10163472,1.1034308888888889,1.103171111111103,1.1028399999999918,1.1031925000000027,1.1021962000000005,1.1022862000000015,1.1003967500000054,1.1033824097077123,1.1030289006217968,-4430,-222184,-225900.4,-0.01017842019514483,-293.3060217581696,0.1606054006968686
2023-07-31T10:30:00-04:00,1.10385,1.10448,1.10301,1.10319,1.1017525312,1.1034346666666668,1.1032344444444364,1.1029675555555474,1.1031745000000028,1.1022282000000005,1.1023204000000015,1.1003723000000054,1.1033439277661699,1.1031707204974368,-5199,-227383,-224277.4,-0.0017568062211729073,-296.4145419375423,0.05169505359960453
2023-07-31T10:45:00-04:00,1.10319,1.10325,1.10222,1.1025,1.101865629952,1.1032877777777779,1.103172222222214,1.1030706666666585,1.103137000000003,1.1022552000000005,1.1023284000000015,1.1003553000000053,1.1031751422129359,1.1032377763979488,-8474,-235857,-225422.2,0.0016878190831186247,-301.714680626253,-0.05076786394211502
2023-07-31T11:00:00-04:00,1.1025,1.10266,1.10187,1.10198,1.10458,1.1030493333333333,1.1030788888888807,1.103126222222214,1.1030535000000028,1.1022682000000004,1.1023131000000015,1.1003468000000054,1.1029361137703486,1.1032206211183584,-5854,-241711,-228977.8,-0.002620364070809369,-304.475750921038,-0.07616836836473331
2023-07-31T11:15:00-04:00,1.10198,1.10263,1.10122,1.1026,1.1045258,1.1029535555555556,1.1031133333333252,1.1031539999999915,1.1029960000000032,1.1022894000000005,1.1023015000000016,1.1003475000000054,1.102868891016279,1.103141296894686,3830,-237881,-233003.2,-0.00008202499856601426,-302.3209023756921,0.028123270645658806
2023-07-31T11:30:00-04:00,1.1026,1.10296,1.10204,1.10225,1.104393568,1.102780888888889,1.1031133333333252,1.1031424444444362,1.102920000000003,1.1023034000000005,1.1022859000000016,1.1003612000000054,1.1027451128130232,1.1030138375157486,-3077,-240958,-236758,0.006031386523868065,-303.2976391796103,0
2023-07-31T11:45:00-04:00,1.10225,1.10242,1.1018,1.10183,1.1042666252800002,1.1025242222222222,1.1029099999999918,1.103077555555547,1.102829000000003,1.1023072000000005,1.1022685000000014,1.1003663500000054,1.1025620902504185,1.1028574700125984,-2636,-243594,-240000.2,0.010600067443256889,-304.30205741503755,-0.16581193483500337
2023-07-31T12:00:00-04:00,1.10183,1.10203,1.10109,1.10139,1.1041447602688002,1.1022202222222222,1.1026477777777697,1.1029726666666582,1.102730500000003,1.1023080000000005,1.1022519000000015,1.1003704500000053,1.1023276722003348,1.102687976010078,-2260,-245854,-241999.6,-0.0002245447247173143,-305.20455598559744,-0.2138165345413289
2023-07-31T12:15:00-04:00,1.10139,1.10154,1.10109,1.10118,1.1039614746526722,1.1019266666666667,1.10230777777777,1.102818444444436,1.1026335000000027,1.1023070000000006,1.1022332000000015,1.1003797000000055,1.1020981377602679,1.102520380808062,-1978,-247832,-243223.8,-0.01411741944449303,-305.5816975975606,-0.27711367094108535
2023-07-31T12:30:00-04:00,1.10118,1.10132,1.10044,1.10058,1.1037891861735118,1.1015811111111111,1.1019444444444364,1.1025846666666583,1.1025400000000027,1.1022962000000005,1.1022090000000013,1.1003885500000055,1.1017945102082143,1.102305504646449,-2050,-249882,-245624,-0.03634478960831202,-306.6986811969724,-0.29623590161707714
2023-07-31T12:45:00-04:00,1.10058,1.1008499999999999,1.10037,1.10069,1.1035212512796309,1.1013302222222223,1.1016666666666586,1.1022953333333247,1.1024405000000028,1.1022906000000006,1.1021777000000015,1.1003961000000053,1.1015736081665715,1.1020712037171585,1684,-248198,-247072,-0.057408832001675056,-306.5303699429063,-0.22661554220034147
2023-07-31T13:00:00-04:00,1.10069,1.10074,1.10045,1.1005,1.1032061261516677,1.1010968888888888,1.1014444444444365,1.102002222222214,1.1023615000000029,1.1022802000000005,1.1021471000000014,1.1004023500000053,1.101358886533257,1.1018305629737262,-1507,-249705,-248294.2,-0.07239956612089897,-306.7905067661716,-0.18140589569161014
2023-07-31T13:15:00-04:00,1.1005,1.10113,1.10047,1.10088,1.1029225135365008,1.100984,1.1013222222222143,1.101737111111103,1.102274500000003,1.1022862000000004,1.1021232000000014,1.1004110500000055,1.1012631092266056,1.1016176503789805,1672,-248033,-248730,-0.08191597499745727,-306.2131691923414,-0.09982032341783688
2023-07-31T13:30:00-04:00,1.10088,1.10107,1.10072,1.10086,1.1026672621828508,1.1008915555555556,1.1011288888888808,1.101501333333325,1.1021645000000029,1.1022830000000006,1.1021027000000014,1.1004169000000055,1.1011824873812845,1.1014345203031837,-1418,-249451,-249053.8,-0.08447984239407103,-306.23893040155605,-0.15780881552694312
2023-07-31T13:45:00-04:00,1.10086,1.10096,1.1004,1.10048,1.1024375359645657,1.1007617777777776,1.1009322222222144,1.1012988888888806,1.102047500000003,1.1022782000000004,1.1020821000000014,1.1004208000000053,1.1010419899050277,1.1012840162425463,-1425,-250876,-249252.6,-0.09257782980032467,-306.7308185617218,-0.160580630528469
2023-07-31T14:00:00-04:00,1.10048,1.10065,1.1000699999999999,1.10017,1.1022307823681092,1.1006093333333333,1.1007477777777699,1.101115111111103,1.101941500000003,1.1022696000000005,1.1020556000000015,1.1004248500000053,1.100867591924022,1.1011428129940366,-1690,-252566,-250126.2,-0.10001244537852501,-307.2068835515441,-0.15065845003312622
2023-07-31T14:15:00-04:00,1.10017,1.10079,1.10017,1.10039,1.101971488483936,1.1005377777777776,1.1006366666666587,1.1009535555555474,1.1018485000000031,1.1022488000000006,1.1020404000000015,1.1004278500000053,1.1007720735392177,1.1010254503952288,1856,-250710,-250327.2,-0.10487821110642231,-306.8357409099525,-0.090794359854376
2023-07-31T14:30:00-04:00,1.10039,1.10044,1.1001,1.10025,1.1017433098658638,1.1004604444444444,1.1005333333333254,1.1007957777777695,1.101678000000003,1.1022272000000006,1.1020262000000016,1.1004317000000055,1.1006676588313742,1.1009063603161824,-1296,-252006,-251121.8,-0.10659016078844942,-307.00062790456354,-0.08445485751649116
2023-07-31T14:45:00-04:00,1.10025,1.10035,1.09972,1.09986,1.10154251268196,1.100325777777778,1.1004533333333255,1.1006606666666585,1.101483500000003,1.1022036000000006,1.1020037000000016,1.1004360000000053,1.1005061270650993,1.1007710882529456,-1868,-253874,-252006.4,-0.10216388238305218,-307.66276832719456,-0.06542005124569154
2023-07-31T15:00:00-04:00,1.09986,1.1000699999999999,1.09975,1.09989,1.1012873609064857,1.100213111111111,1.1003644444444367,1.100547111111103,1.101266000000003,1.1021808000000006,1.1019848000000017,1.1004339000000054,1.1003829016520794,1.1006392706023558,2024,-251850,-252201.2,-0.09175704163839779,-307.6075613008458,-0.07268168149069329
2023-07-31T15:15:00-04:00,1.09989,1.09997,1.09952,1.09974,1.1010679303795776,1.1000882222222224,1.1002799999999922,1.1004535555555475,1.101060500000003,1.1021538000000006,1.1019604000000016,1.1004351500000054,1.1002543213216636,1.1005166164818843,-1780,-253630,-252414,-0.08094249268964973,-307.85031284872804,-0.06905951840073547
2023-07-31T15:30:00-04:00,1.09974,1.09977,1.09945,1.09951,1.1008202615188452,1.0999342222222221,1.10012777777777,1.1003517777777696,1.1008765000000031,1.1021178000000005,1.1019335000000015,1.1004363500000054,1.1001054570573308,1.1003832931855069,-1814,-255444,-253360.8,-0.07117857921370165,-308.22969342959254,-0.12444589782720127
2023-07-31T15:45:00-04:00,1.09951,1.09964,1.09936,1.09954,1.100573614445453,1.0998166666666667,1.0999811111111033,1.1002413333333254,1.100728500000003,1.1020578000000005,1.1019055000000015,1.1004347000000054,1.0999923656458646,1.1002482345484048,2168,-253276,-253614.8,-0.06757344248202682,-308.17053980661507,-0.11990625510964045
2023-07-31T16:00:00-04:00,1.09954,1.09955,1.09935,1.09941,1.1003308915563623,1.0997024444444443,1.0998622222222145,1.100123111111103,1.1006000000000031,1.1020074000000006,1.1018742000000015,1.1004375500000054,1.0998758925166916,1.1001221876387235,-1222,-254498,-253739.6,-0.0673877886888177,-308.3150184067569,-0.09723029950566157
2023-07-31T16:15:00-04:00,1.09941,1.09947,1.09934,1.0994599999999999,1.1001347132450898,1.0996219999999999,1.0997833333333253,1.1000068888888808,1.1004430000000032,1.1019570000000005,1.1018474000000014,1.1004444000000053,1.0997927140133532,1.1000041501109783,658,-253840,-254137.6,-0.06575958420618475,-308.2850932650901,-0.06453548088024673
2023-07-31T16:30:00-04:00,1.0994599999999999,1.09949,1.0994,1.09947,1.0999757705960718,1.099559333333333,1.0996811111111033,1.099887111111103,1.100304000000003,1.1019030000000005,1.1018222000000015,1.1004517500000055,1.0997281712106826,1.099898920088782,385,-253455,-254102.6,-0.05858493452350658,-308.28159154606436,-0.0836067212533767
2023-07-31T16:45:00-04:00,1.09947,1.09978,1.09943,1.09967,1.0998486164768575,1.099557111111111,1.0996166666666587,1.0997848888888808,1.100196000000003,1.1018586000000006,1.1017960000000016,1.1004634500000052,1.099716536968546,1.099821136071025,828,-252627,-253539.2,-0.0539692500783503,-308.13097352101596,-0.05271529197909793
2023-07-31T17:00:00-04:00,1.09967,1.09967,1.09931,1.09949,1.09978,1.0995317777777778,1.0995755555555478,1.0997037777777696,1.100101000000003,1.1018190000000005,1.1017707000000017,1.1004755000000055,1.0996712295748368,1.0997569088568195,-107,-252734,-253430.8,-0.050754412443763434,-308.1484878662286,-0.03364064517302033
2023-07-31T17:15:00-04:00,1.09949,1.09962,1.09941,1.09961,1.09978,1.0995386666666667,1.0995444444444367,1.0996402222222141,1.100022500000003,1.1017436000000005,1.1017463000000014,1.1004898500000053,1.0996589836598694,1.099713527085455,106,-252628,-253056.8,-0.045325806014453476,-308.1369188660558,-0.02545709116366709
2023-07-31T17:30:00-04:00,1.09961,1.09976,1.09954,1.09965,1.09931,1.0995597777777777,1.0995344444444366,1.0995904444444364,1.099976000000003,1.1016736000000005,1.1017271000000013,1.1005048500000054,1.0996571869278955,1.0996864216683633,196,-252432,-252775.2,-0.04088726888621804,-308.1297890654901,-0.008183752523316736
2023-07-31T17:45:00-04:00,1.09965,1.09976,1.09954,1.0996299999999999,1.099319,1.0995788888888889,1.09954777777777,1.0995637777777696,1.099923000000003,1.1016100000000004,1.1017104000000013,1.1005195000000052,1.0996517495423164,1.0996711373346901,-636,-253068,-252697.8,-0.03777628181113453,-308.14135638236377,0.010913952578866765
2023-07-31T18:00:00-04:00,1.0996299999999999,1.1000699999999999,1.09958,1.1000699999999999,1.0993278199999998,1.0996833333333333,1.0996066666666588,1.0995617777777693,1.099901500000003,1.1015404000000004,1.1016914000000013,1.1005356500000054,1.099735399633853,1.0996749098677516,480,-252588,-252690,-0.030001909212318306,-307.9492917788153,0.04820197537151167
2023-07-31T18:15:00-04:00,1.1000699999999999,1.1003,1.10002,1.10016,1.0993575072,1.099794,1.0996899999999923,1.0995846666666584,1.099865500000003,1.1014786000000003,1.1016755000000014,1.1005489500000052,1.0998203197070824,1.0997047278942005,764,-251824,-252508,-0.02289356871677713,-307.8867866655042,0.0682184080552322
2023-07-31T18:30:00-04:00,1.10016,1.10016,1.10005,1.1001,1.099414056768,1.0998759999999999,1.0997611111111034,1.0996279999999916,1.099827500000003,1.1014076000000004,1.1016588000000014,1.1005613500000053,1.0998762557656658,1.0997481823153599,-573,-252397,-252461.8,-0.01324390916550642,-307.9180366655042,0.05821039419353101
2023-07-31T18:45:00-04:00,1.1001,1.10014,1.10004,1.10012,1.0994672133619199,1.0999477777777777,1.0998333333333257,1.0996877777777696,1.0998095000000032,1.1013350000000006,1.1016412000000013,1.1005743500000051,1.0999250046125326,1.0998017458522873,315,-252082,-252391.8,-0.004039543362677512,-307.91230991339074,0.05911939388978685
2023-07-31T19:00:00-04:00,1.10012,1.10015,1.09992,1.09995,1.0995171805602046,1.099971111111111,1.0998644444444368,1.099751111111103,1.0997985000000032,1.1012586000000004,1.1016160000000013,1.1005852000000054,1.0999300036900261,1.0998573966818292,-528,-252610,-252300.2,0.0026194853339474005,-307.9939010125436,0.025462184109783664
2023-07-31T19:15:00-04:00,1.09995,1.10005,1.09984,1.09984,1.0995641497265924,1.0999662222222222,1.0999033333333257,1.099810444444436,1.0997710000000032,1.1011824000000003,1.1015897000000012,1.1005959000000052,1.0999120029520209,1.099892717345463,-450,-253060,-252394.6,0.005594088278393615,-308.03890305809114,0.031832940727050764
2023-07-31T19:30:00-04:00,1.09984,1.09987,1.09967,1.09967,1.0996083007429969,1.0999195555555557,1.0999099999999922,1.0998544444444363,1.099742000000003,1.1011086000000005,1.1015605000000013,1.1006058500000053,1.0998636023616166,1.0999013738763697,-562,-253622,-252754.2,0.010348519966863031,-308.12577023877196,0.005456480024731403
2023-07-31T19:45:00-04:00,1.09967,1.09987,1.09964,1.09965,1.1003,1.0998675555555555,1.0999099999999922,1.0998842222222138,1.099731500000003,1.1010392000000004,1.1015300000000012,1.1006159500000054,1.0998208818892934,1.099890299101095,-662,-254284,-253131.6,0.013310534244355868,-308.137810214401,0
2023-07-31T20:00:00-04:00,1.09965,1.10017,1.09956,1.09973,1.1002868000000001,1.0998315555555556,1.0999211111111036,1.0999017777777695,1.0997235000000032,1.1009848000000004,1.101500500000001,1.1006236500000055,1.0998027055114348,1.0998658392808756,1758,-252526,-253220.4,0.014600967508997982,-308.0099149750065,0.009093967971063998
2023-07-31T20:15:00-04:00,1.09973,1.09991,1.09914,1.09927,1.100257728,1.0997013333333334,1.0998322222222146,1.099895333333325,1.0997000000000032,1.1009166000000006,1.1014679000000012,1.1006290500000053,1.0996961644091479,1.0998190714246998,-1370,-253896,-253477.6,0.01401245532344552,-308.5829647235813,-0.07272264492258783
2023-07-31T20:30:00-04:00,1.09927,1.09945,1.09917,1.09917,1.1001906643200001,1.0995688888888888,1.0997222222222145,1.099859111111103,1.0996830000000033,1.1008584000000006,1.101433100000001,1.1006337500000054,1.0995909315273182,1.0997548571397595,-1178,-255074,-253880.4,0.00829682542506153,-308.6901267492893,-0.08998691099476862
2023-07-31T20:45:00-04:00,1.09917,1.09935,1.09883,1.09889,1.1001276244608,1.0994024444444446,1.09958777777777,1.0997946666666585,1.0996505000000032,1.1007838000000003,1.101398200000001,1.1006367000000055,1.0994507452218545,1.0996722857118069,-2044,-257118,-254579.6,-0.0005672825217960008,-309.21081053796627,-0.10999000090902239
2023-07-31T21:00:00-04:00,1.09889,1.09908,1.09876,1.09892,1.100023814503936,1.0992688888888889,1.0994544444444367,1.0997035555555474,1.0996260000000033,1.1007010000000004,1.101361200000001,1.1006424000000055,1.0993445961774835,1.0995770285694448,1551,-255567,-254836.2,-0.008613398706749865,-309.1684678103048,-0.10907900956260135
2023-07-31T21:15:00-04:00,1.09892,1.09906,1.09875,1.09879,1.0998974330535425,1.099136,1.0993255555555477,1.0995844444444363,1.099592500000003,1.1006204000000004,1.1013268000000012,1.1006458000000052,1.0992336769419868,1.0994632228555552,-1507,-257074,-255745.8,-0.018024096510708534,-309.34674284397414,-0.10545933906087093
2023-07-31T21:30:00-04:00,1.09879,1.09894,1.09858,1.09867,1.0997597410871174,1.0990048888888888,1.099195555555548,1.099457111111103,1.099552500000003,1.1005480000000005,1.1012912000000012,1.1006488000000052,1.0991209415535894,1.0993481782844436,-2096,-259170,-256800.6,-0.026244536718923586,-309.57564918640514,-0.1063791096886723
2023-07-31T21:45:00-04:00,1.09867,1.09875,1.09839,1.09859,1.099594577334921,1.0988837777777778,1.0990755555555478,1.0993277777777695,1.099498500000003,1.1004748000000004,1.1012551000000013,1.1006527500000054,1.0990147532428716,1.0992329426275542,-1748,-260918,-257969.4,-0.03380303893861419,-309.7029303536347,-0.09821128156628534
2023-07-31T22:00:00-04:00,1.09859,1.0987,1.09839,1.0985,1.0994018449613336,1.0987686666666667,1.0989477777777699,1.0991997777777693,1.099449000000003,1.1003716000000003,1.1012192000000012,1.1006547500000052,1.0989118025942972,1.0991251541020426,-1913,-262831,-259112,-0.039378962746293725,-309.8596494208025,-0.10457872959577905
2023-07-31T22:15:00-04:00,1.0985,1.09871,1.09803,1.09827,1.0992399497675203,1.0986331111111112,1.0987855555555477,1.0990659999999917,1.0993820000000032,1.1002620000000005,1.101183300000001,1.1006558500000052,1.0987834420754379,1.0990129232816337,-1608,-264439,-260886.4,-0.046649124516743794,-310.19632670801224,-0.13275985923817815
2023-07-31T22:30:00-04:00,1.09827,1.0984099999999999,1.09815,1.09827,1.0990221588093667,1.0985300000000002,1.0986744444444367,1.0989357777777695,1.099313000000003,1.1001426000000005,1.101145200000001,1.1006579000000054,1.0986807536603502,1.0989023386253063,0,-264439,-262359.4,-0.0541282539869241,-310.19632670801224,-0.09096946155174705
2023-07-31T22:45:00-04:00,1.09827,1.09856,1.09816,1.09851,1.0988435702236807,1.0984971111111113,1.0986011111111034,1.0988168888888805,1.099257000000003,1.1000358000000003,1.1011160000000013,1.1006604500000052,1.0986466029282802,1.0988074709002444,1457,-262982,-263121.8,-0.05610625533626933,-309.8779350556863,-0.060045306913387636
2023-07-31T23:00:00-04:00,1.09851,1.0988,1.09839,1.09865,1.09803,1.098506888888889,1.0985744444444367,1.0987166666666583,1.099186000000003,1.0999450000000004,1.1010866000000012,1.1006660500000054,1.098647282342624,1.0987339767201951,1661,-261321,-263202.4,-0.05659382623042763,-309.6662483163761,-0.02184022058622956
2023-07-31T23:15:00-04:00,1.09865,1.0989,1.09865,1.09874,1.0980454000000002,1.09854,1.0985544444444366,1.0986379999999918,1.0991150000000032,1.0998698000000005,1.1010625000000012,1.1006700000000054,1.0986658258740993,1.0986847813761556,1206,-260115,-262659.2,-0.052199808859151854,-309.5674543419528,-0.01637971826883185
2023-07-31T23:30:00-04:00,1.09874,1.09877,1.09847,1.0985,1.0980795840000002,1.098529111111111,1.0985222222222144,1.098585333333325,1.099035000000003,1.0998002000000004,1.101034200000001,1.1006704500000053,1.0986326606992796,1.098654625100924,-1321,-261436,-262058.6,-0.0488327960902309,-309.8560030431924,-0.02639266829875604
2023-07-31T23:45:00-04:00,1.0985,1.09862,1.0984099999999999,1.09855,1.0981124006400003,1.0985346666666667,1.0985088888888812,1.0985522222222142,1.098956500000003,1.0997192000000005,1.1010043000000012,1.1006721000000053,1.0986161285594236,1.0986417000807385,1344,-260092,-261189.2,-0.04430386602679764,-309.7948287145626,-0.010922296959061412
2023-08-01T00:00:00-04:00,1.09855,1.09856,1.09829,1.09837,1.0981439046144001,1.0985068888888887,1.0984844444444368,1.0985288888888807,1.098877500000003,1.0996416000000004,1.1009725000000012,1.1006749000000053,1.0985669028475389,1.0986257600645903,-1192,-261284,-260849.6,-0.03945401364964293,-309.99014071674713,-0.02002566926695919
2023-08-01T00:15:00-04:00,1.09837,1.0986799999999999,1.09819,1.09851,1.0981741484298242,1.0985120000000002,1.0984855555555477,1.0985111111111028,1.098811000000003,1.0995752000000003,1.1009412000000014,1.1006749500000053,1.0985555222780312,1.0986074080516717,1286,-259998,-260585,-0.03394426951565568,-309.82622509632773,0.0009103322712849806
2023-08-01T00:30:00-04:00,1.09851,1.09879,1.0982399999999999,1.09869,1.09819,1.0985528888888891,1.0985322222222145,1.0985066666666585,1.0987620000000031,1.0995212000000003,1.1009146000000012,1.1006777000000054,1.098582417822425,1.0985907264413368,3495,-256503,-259862.6,-0.02723304229567554,-309.2535402778013,0.03824196235897046
2023-08-01T00:45:00-04:00,1.09869,1.0991,1.09867,1.09901,1.09819,1.0986484444444444,1.0986144444444368,1.098525111111103,1.098730000000003,1.0994778000000003,1.100892400000001,1.1006814000000054,1.09866793425794,1.098597781153069,1719,-254784,-258532.2,-0.017638709817191667,-308.75287129929035,0.06737869558487102
2023-08-01T01:00:00-04:00,1.09901,1.09924,1.09869,1.09871,1.0982399999999999,1.0986675555555554,1.098636666666659,1.0985506666666585,1.098679000000003,1.0994404000000004,1.1008683000000012,1.1006827500000054,1.098676347406352,1.0986098249224547,-2080,-256864,-257886.6,-0.009560830240634147,-309.3206550319224,0.018206479686118285
2023-08-01T01:15:00-04:00,1.09871,1.09939,1.09867,1.09931,1.09832,1.0988022222222222,1.0987099999999923,1.0985957777777695,1.0986810000000031,1.0994128000000003,1.100851700000001,1.1006884500000054,1.0988030779250815,1.0986570599379633,1744,-255120,-256653.8,-0.00045941362350142685,-308.3682654113675,0.060073726846594004
2023-08-01T01:30:00-04:00,1.09931,1.09948,1.09905,1.09913,1.098427,1.0988862222222222,1.0987533333333255,1.098649333333325,1.0986790000000028,1.0993854000000005,1.1008328000000012,1.1006933500000053,1.098868462340065,1.09871964795037,-1848,-256968,-256047.8,0.004516150003799987,-308.67085521770065,0.035495203596837326
2023-08-01T01:45:00-04:00,1.09913,1.09991,1.09894,1.09987,1.0985533600000001,1.0991095555555555,1.0989055555555476,1.0987239999999918,1.098728000000003,1.0993652000000005,1.1008257000000012,1.1007044500000054,1.099068769872052,1.0988169183602952,2308,-254660,-255679.2,0.011766770899030964,-307.1169716916392,0.12471552116521359
2023-08-01T02:00:00-04:00,1.09987,1.09991,1.09916,1.09922,1.0987432896000002,1.0991724444444446,1.0989799999999923,1.098797111111103,1.098743000000003,1.0993324000000004,1.1008077000000012,1.1007170500000054,1.0990990158976417,1.0989031346882356,-3053,-257713,-256265,0.01688930032272622,-308.92123037675606,0.06098948614083751
2023-08-01T02:15:00-04:00,1.09922,1.09942,1.09882,1.09941,1.09991,1.0992584444444444,1.0990955555555477,1.0988888888888808,1.0987740000000028,1.0993110000000004,1.100794600000001,1.1007338500000055,1.0991612127181134,1.099000107750588,2013,-255700,-256032.2,0.022592264023965074,-308.5732836508961,0.09468576162858872
2023-08-01T02:30:00-04:00,1.09941,1.10003,1.09938,1.09966,1.09882,1.0993713333333335,1.0992233333333254,1.0989915555555474,1.098823500000003,1.0993008000000004,1.1007852000000011,1.1007487000000054,1.0992609701744906,1.0990916862004698,2427,-253273,-255662.8,0.030561028015450756,-308.0213967297291,0.10468725819519023
2023-08-01T02:45:00-04:00,1.09966,1.09971,1.09921,1.09945,1.09882,1.0994166666666665,1.0993077777777698,1.099102444444436,1.0988665000000029,1.0992820000000005,1.1007654000000011,1.1007596500000054,1.0992987761395925,1.0991777489603751,-2015,-255288,-255326.8,0.035734219914136355,-308.4061974863267,0.0691732881886696
2023-08-01T03:00:00-04:00,1.09945,1.09947,1.097,1.09727,1.10003,1.099009111111111,1.0991144444444367,1.0991442222222139,1.098805000000003,1.0992224000000004,1.100724800000001,1.1007605000000054,1.098893020911674,1.0991425991682997,-4711,-259999,-256394.6,0.028533539042966502,-317.7472134488537,-0.15832431006087977
2023-08-01T03:15:00-04:00,1.09727,1.09822,1.09721,1.09761,1.0999694,1.0987082222222222,1.0989922222222144,1.0991466666666583,1.098772000000003,1.0991774000000005,1.1006905000000011,1.1007639000000053,1.0986364167293392,1.0990500793346392,4169,-255830,-256018,0.019650069278023527,-316.4554074211668,-0.10011741041768081
2023-08-01T03:30:00-04:00,1.09761,1.09823,1.09761,1.09801,1.099910012,1.0985117777777778,1.0988477777777699,1.0990971111111028,1.0987590000000031,1.0991398000000003,1.100660300000001,1.1007710500000052,1.0985111333834714,1.098920063467711,3630,-252200,-255318,0.01440616812833934,-315.13253317621655,-0.11825599694354448
2023-08-01T03:45:00-04:00,1.09801,1.09853,1.09733,1.09794,1.09985181176,1.0983302222222222,1.0987155555555477,1.0989955555555473,1.0987305000000032,1.0991038000000004,1.1006288000000009,1.1007677500000055,1.0983969067067771,1.0987472507741682,-3420,-255620,-255787.4,0.0033675549731058668,-315.3505639773933,-0.1082674478906066
2023-08-01T04:00:00-04:00,1.09794,1.09867,1.0974,1.09851,1.0997947755248,1.0982891111111108,1.0985644444444367,1.0988468888888807,1.098723500000003,1.0990838000000003,1.100600800000001,1.1007697500000053,1.0984195253654216,1.0985714006193341,3455,-252165,-255162.8,-0.002275374981751274,-313.5568867272697,-0.12365097693361997
2023-08-01T04:15:00-04:00,1.09851,1.0986,1.0976299999999999,1.0979,1.0997388800143042,1.098156222222222,1.0984177777777697,1.0987075555555474,1.098681500000003,1.0990510000000004,1.100554400000001,1.1007684000000053,1.0983156202923374,1.0984559204954667,-3022,-255187,-254200.4,-0.016955345289573275,-315.23499616641914,-0.12008515128909479
2023-08-01T04:30:00-04:00,1.0979,1.09791,1.09708,1.09716,1.099684102414018,1.0979046666666668,1.0981677777777699,1.0985426666666585,1.0986145000000032,1.0990060000000004,1.100506700000001,1.1007654000000053,1.0980844962338698,1.0983455363963728,-3230,-258417,-254717.8,-0.02885900309433725,-317.4120614729139,-0.20465522416569662
2023-08-01T04:45:00-04:00,1.09716,1.09791,1.0971,1.09747,1.0996304203657377,1.097765111111111,1.0979244444444365,1.0983579999999917,1.0985605000000032,1.0989662000000004,1.100461600000001,1.1007673000000053,1.097961596987096,1.0982356291170976,2525,-255892,-255456.2,-0.04205505388868313,-316.69862860988565,-0.19915246530747105
2023-08-01T05:00:00-04:00,1.09747,1.09758,1.09666,1.09671,1.099577811958423,1.0975222222222223,1.097619999999992,1.0981388888888808,1.098477500000003,1.0989110000000004,1.1004070000000008,1.1007643000000054,1.0977112775896767,1.0980985032936776,-2688,-258580,-256048.2,-0.06093744039333593,-318.5600735696564,-0.24921551684933055
2023-08-01T05:15:00-04:00,1.09671,1.09737,1.09657,1.09717,1.099461099480086,1.0974322222222221,1.0976088888888809,1.0979477777777695,1.098410500000003,1.0988610000000005,1.1003598000000008,1.1007714000000053,1.0976030220717414,1.0979352026349418,2363,-256217,-256858.6,-0.07649548787166818,-317.5689455595172,-0.009113527208434478
2023-08-01T05:30:00-04:00,1.09717,1.09749,1.097,1.09721,1.099287633511281,1.0973524444444445,1.0975644444444363,1.0977771111111028,1.0983365000000032,1.0988154000000003,1.100317200000001,1.1007775000000053,1.097524417657393,1.0977769621079527,2257,-253960,-256613.2,-0.07140992880248481,-317.48666113686613,-0.03644281666529605
2023-08-01T05:45:00-04:00,1.09721,1.09766,1.09707,1.09753,1.099124575500604,1.0973455555555556,1.0975111111111029,1.0976457777777695,1.0982625000000033,1.0987738000000005,1.100258700000001,1.1007893500000052,1.0975255341259145,1.0976651696863615,2366,-251594,-255248.6,-0.06711249352892307,-316.7966200326111,-0.043715448857481805
2023-08-01T06:00:00-04:00,1.09753,1.09784,1.09744,1.09751,1.0989713009705677,1.0973453333333332,1.0974633333333252,1.0975535555555471,1.0982025000000033,1.0987310000000006,1.100202300000001,1.100801400000005,1.0975224273007316,1.0975773357490888,-2219,-253813,-254832.8,-0.06516566100498399,-316.83705628492294,-0.039164253055716206
2023-08-01T06:15:00-04:00,1.09751,1.09757,1.09692,1.09737,1.0988272229123337,1.0973266666666666,1.0973366666666586,1.0974968888888808,1.098105500000003,1.0986858000000006,1.100147900000001,1.1008110500000052,1.0974919418405853,1.0975334685992704,-2190,-256003,-254317.4,-0.06454936426288453,-317.11641592629303,-0.10377693421089847
2023-08-01T06:30:00-04:00,1.09737,1.0977,1.09722,1.09754,1.0986917895375936,1.0973673333333334,1.0972966666666588,1.0974344444444362,1.098026000000003,1.0986352000000006,1.100087800000001,1.1008166500000052,1.0975015534724681,1.0975131748794156,2100,-253903,-253854.6,-0.06571218557088992,-316.7910926533769,-0.03278987157301557
2023-08-01T06:45:00-04:00,1.09754,1.09846,1.09731,1.09821,1.098564482165338,1.09755,1.0974133333333251,1.0974042222222138,1.097943000000003,1.0985962000000005,1.100037400000001,1.1008279000000052,1.0976432427779745,1.0975369399035322,3021,-250882,-253239,-0.05890176952499103,-314.9469047422303,0.09570162966203612
2023-08-01T07:00:00-04:00,1.09821,1.09823,1.09778,1.09783,1.09846,1.0976333333333335,1.0974533333333254,1.0973926666666585,1.0978735000000033,1.0985508000000004,1.099979200000001,1.1008349500000052,1.0976805942223797,1.0975679519228252,-2155,-253037,-253527.6,-0.04395687325455258,-315.69257269280405,0.03280271898094144
2023-08-01T07:15:00-04:00,1.09783,1.09802,1.09747,1.09797,1.09846,1.0977366666666666,1.0975933333333252,1.0974186666666585,1.0978015000000032,1.0985078000000004,1.099921400000001,1.1008437500000052,1.0977384753779038,1.0976111615382595,2302,-250735,-252912,-0.03398330285604334,-315.3990117589622,0.11488907733127415
2023-08-01T07:30:00-04:00,1.09797,1.09797,1.09747,1.09769,1.0983466,1.097756,1.097651111111103,1.0974815555555473,1.0977030000000032,1.0984626000000004,1.099860600000001,1.1008466500000051,1.097728780302323,1.0976585292306071,-2520,-253255,-252362.4,-0.017598027563448287,-316.04165226826535,0.04739466080917961
2023-08-01T07:45:00-04:00,1.09769,1.09796,1.09737,1.09755,1.098240004,1.0977357777777776,1.0976888888888807,1.0975599999999917,1.0976080000000032,1.0984168000000005,1.099799600000001,1.1008477000000052,1.0976930242418583,1.097696823384485,-2735,-255990,-252779.8,-0.004984467462365519,-316.3904757065768,0.03098768695145022
2023-08-01T08:00:00-04:00,1.09755,1.09771,1.09604,1.09614,1.09813980376,1.097426,1.0975344444444364,1.0975842222222139,1.0975515000000033,1.0983462000000004,1.099727400000001,1.100840850000005,1.0973824193934867,1.0976446587075877,-3909,-259899,-254583.2,-0.00037312947157360686,-321.41228792469946,-0.12664801873297335
2023-08-01T08:15:00-04:00,1.09614,1.09642,1.09559,1.09574,1.0979718194592,1.0970671111111112,1.0973377777777698,1.0975611111111028,1.0974580000000034,1.0982680000000005,1.099653600000001,1.1008264500000053,1.0970539355147892,1.0975193269660697,-4215,-264114,-256798.6,-0.010044791526094578,-322.95041261680063,-0.1612741569552942
2023-08-01T08:30:00-04:00,1.09574,1.09636,1.09565,1.09602,1.09773363751328,1.0968035555555555,1.0971877777777697,1.0974799999999916,1.0973585000000032,1.0981938000000004,1.099589300000001,1.1008094500000052,1.0968471484118314,1.097341061572855,3986,-260128,-258677.2,-0.01672367063309749,-321.9318498190564,-0.12302140572459265
2023-08-01T08:45:00-04:00,1.09602,1.09615,1.09523,1.09564,1.097519273761952,1.0964939999999999,1.0969766666666585,1.0973451111111028,1.0972435000000034,1.0981212000000005,1.099518900000001,1.1007909000000051,1.096605718729465,1.0971164492582832,-3951,-264079,-260842,-0.022206493044889666,-323.30169708461744,-0.17311441952001866
2023-08-01T09:00:00-04:00,1.09564,1.09714,1.0956,1.09713,1.0972445609105177,1.0965246666666666,1.0968566666666584,1.0971786666666585,1.0971745000000033,1.0980804000000004,1.099469400000001,1.1007725000000053,1.0967105749835722,1.0969199594066261,3746,-260333,-261710.6,-0.022428608627736032,-318.207377782657,-0.0983418471876936
2023-08-01T09:15:00-04:00,1.09713,1.09767,1.09693,1.0976,1.09523,1.0966733333333332,1.0968311111111029,1.0970379999999917,1.0971595000000032,1.0980546000000004,1.099419200000001,1.1007517000000053,1.0968884599868578,1.0968211675253003,3581,-256752,-261081.2,-0.024039661318121235,-316.673311628236,-0.02095042037475515
2023-08-01T09:30:00-04:00,1.0976,1.09778,1.097,1.09705,1.0952788,1.0967171111111111,1.0967288888888806,1.0969162222222137,1.0971540000000033,1.0980172000000004,1.099359100000001,1.1007321000000052,1.0969207679894863,1.0967945340202399,-4465,-261217,-260501.8,-0.02746065145156357,-318.910693188002,-0.08379099611098755
2023-08-01T09:45:00-04:00,1.09705,1.09782,1.0970199999999999,1.09728,1.095378848,1.0968273333333334,1.096683333333325,1.096815333333325,1.097144500000003,1.0979870000000005,1.099303700000001,1.1007140000000053,1.0969926143915891,1.0968236272161913,4396,-256821,-259840.4,-0.03427029785994322,-317.9890578933484,-0.03735116471863836
2023-08-01T10:00:00-04:00,1.09728,1.0989,1.09665,1.09672,1.09552531712,1.0968346666666666,1.0965911111111029,1.0967382222222137,1.0971450000000031,1.0979480000000004,1.0992480000000011,1.1006921500000053,1.0969380915132714,1.0968901017729527,-12619,-269440,-260912.6,-0.03985744550366339,-324.42920079215406,-0.07562297845201663
2023-08-01T10:15:00-04:00,1.09672,1.09686,1.09617,1.09678,1.0957952917504,1.0968724444444446,1.096662222222214,1.096699333333325,1.097125500000003,1.0979118000000005,1.099193300000001,1.1006690500000051,1.096906473210617,1.0969292814183615,6391,-263049,-261455.8,-0.047179474714946434,-324.07955822157896,0.058386702428539786
2023-08-01T10:30:00-04:00,1.09678,1.09765,1.09662,1.09709,1.0960436684103678,1.0969579999999999,1.0968122222222139,1.0966955555555473,1.097119500000003,1.0978836000000003,1.099127600000001,1.1006515000000052,1.0969431785684935,1.096940225134689,5456,-257593,-261624,-0.03817340578829916,-322.53744403277267,0.12320440980524235
2023-08-01T10:45:00-04:00,1.09709,1.09812,1.09608,1.09783,1.0989,1.0971615555555556,1.097013333333325,1.096752444444436,1.097134500000003,1.0978748000000005,1.099068400000001,1.1006360500000052,1.0971205428547948,1.0969801801077506,7446,-250147,-259410,-0.021814027817456044,-317.5150301925213,0.16514297184358764
2023-08-01T11:00:00-04:00,1.09783,1.09849,1.09688,1.09695,1.0988436,1.097148888888889,1.0971588888888806,1.0968475555555472,1.0971065000000029,1.0978484000000004,1.0989955000000011,1.1006214500000053,1.0970864342838358,1.0969989440862,-5615,-255762,-259198.2,-0.010820481570036409,-322.0159091992891,0.11956482056151149
2023-08-01T11:15:00-04:00,1.09695,1.0970199999999999,1.09619,1.0962399999999999,1.098788328,1.0969651111111112,1.0970599999999917,1.096941333333325,1.097050000000003,1.0978030000000003,1.098919400000001,1.1006028000000052,1.0969171474270687,1.0969947552689594,-3494,-259256,-257161.4,0.00016060163976233367,-324.27739787242893,-0.08112074230037074
2023-08-01T11:30:00-04:00,1.0962399999999999,1.09681,1.0961,1.09621,1.09873416144,1.0967951111111112,1.0969055555555471,1.0969899999999915,1.096983500000003,1.0977542000000005,1.098849600000001,1.1005850000000053,1.0967757179416548,1.096968604215167,-2977,-262233,-256998.2,-0.0031904905151483765,-324.35886725869466,-0.12663994169096232
2023-08-01T11:45:00-04:00,1.09621,1.09714,1.09605,1.09704,1.0986810782112,1.096822,1.0969044444444362,1.0970084444444361,1.096925000000003,1.0977202000000004,1.098795000000001,1.1005617000000052,1.096828574353324,1.0969456833721332,2270,-259963,-257472.2,-0.00612500656562234,-322.6401272362535,-0.0009115354815245897
2023-08-01T12:00:00-04:00,1.09704,1.09739,1.09689,1.0971899999999999,1.098575835082752,1.096879111111111,1.0968944444444364,1.0969846666666583,1.096893000000003,1.0976940000000004,1.098747100000001,1.1005301000000052,1.096900859482659,1.096901746697706,1746,-258217,-259086.2,-0.0004210857152946641,-322.40139391750506,-0.00820209973754607
2023-08-01T12:15:00-04:00,1.0971899999999999,1.09782,1.09717,1.09731,1.098474801679442,1.0969622222222222,1.096959999999992,1.0969448888888806,1.096860000000003,1.0976692000000003,1.098694200000001,1.1004978500000053,1.0969826875861273,1.0968809973581641,1821,-256396,-259213,0.0021098172924097734,-322.20223060030366,0.05379677584069685
2023-08-01T12:30:00-04:00,1.09731,1.09743,1.097,1.09715,1.0983778096122643,1.0970002222222222,1.0970011111111029,1.096933111111103,1.096833000000003,1.0976448000000003,1.0986432000000013,1.1004645500000052,1.0970161500689017,1.0969007978865308,-1766,-258162,-258994.2,0.009590025331705401,-322.45973303808324,0.03373511551997496
2023-08-01T12:45:00-04:00,1.09715,1.09725,1.09681,1.0972,1.0982846972277738,1.09704,1.0970133333333252,1.0969546666666585,1.096815500000003,1.0976186000000003,1.098596900000001,1.1004327000000051,1.0970529200551213,1.0969562383092242,2088,-256074,-257762.4,0.015546677803889304,-322.3645774075863,0.010026524715388391
2023-08-01T13:00:00-04:00,1.0972,1.09764,1.0971899999999999,1.09738,1.0981953093386627,1.0971133333333332,1.096963333333325,1.0969664444444363,1.096877500000003,1.0975924000000004,1.0985568000000012,1.1004043500000054,1.097118336044097,1.0970141906473787,1980,-254094,-256588.6,0.018928795169139548,-322.0397505756503,-0.040989952907104145
2023-08-01T13:15:00-04:00,1.09738,1.09739,1.09651,1.09671,1.0981094969651162,1.0970626666666667,1.0969366666666585,1.0969748888888806,1.0969260000000032,1.0975464000000004,1.0985121000000013,1.1003726500000053,1.0970366688352777,1.0970413525179026,-1650,-255744,-256094,0.006242874743961788,-323.0471500179583,-0.021878845890880894
2023-08-01T13:30:00-04:00,1.09671,1.09671,1.09635,1.09639,1.0980271170865115,1.0969533333333332,1.0969533333333252,1.096973555555547,1.0969445000000033,1.0975000000000004,1.0984702000000013,1.1003396000000054,1.0969073350682221,1.0970262820143215,-1168,-256912,-256197.2,-0.0016843998956407563,-323.3879511413183,0.01368313507991813
2023-08-01T13:45:00-04:00,1.09639,1.09653,1.09626,1.09635,1.097948032403051,1.0968326666666666,1.0969688888888807,1.0969671111111026,1.0969800000000032,1.0974408000000002,1.0984268000000013,1.1003022500000053,1.0967958680545777,1.0969822256114568,-1319,-258231,-256211,-0.0021141520557203877,-323.436072703901,0.012771275576762574
2023-08-01T14:00:00-04:00,1.09635,1.09725,1.09633,1.0971899999999999,1.097872111106929,1.096876888888889,1.0969855555555474,1.0969615555555472,1.0969830000000032,1.0974020000000002,1.0983937000000012,1.1002704000000052,1.0968746944436623,1.096946580489165,1584,-256647,-256325.6,0.00009115853379864272,-322.22244566873894,0.013673156858443855
2023-08-01T14:15:00-04:00,1.0971899999999999,1.09735,1.09693,1.0970199999999999,1.0977992266626517,1.0968837777777778,1.0969666666666584,1.096962222222214,1.0969540000000033,1.0973450000000002,1.0983551000000011,1.1002391500000053,1.0969037555549297,1.0969036643913315,-1544,-258191,-257145,0.0003863403928189584,-322.4616749726881,-0.015494125903444572
2023-08-01T14:30:00-04:00,1.0970199999999999,1.09704,1.09677,1.0969,1.0977292575961457,1.0968704444444444,1.096921111111103,1.0969591111111026,1.0969465000000032,1.0972986000000002,1.098315500000001,1.1002091000000052,1.0969030044439438,1.0968769315130646,-1122,-259313,-257858.8,0.0007813863356302366,-322.5844074661704,-0.03736409947963852
2023-08-01T14:45:00-04:00,1.0969,1.09744,1.0968499999999999,1.09735,1.0976620872923,1.0969562222222222,1.0969433333333252,1.0969571111111027,1.0969500000000032,1.0972574000000004,1.0982842000000013,1.1001831500000054,1.096992403555155,1.0968939452104514,1768,-257545,-257985.4,-0.00015627523195744182,-321.85909066427405,0.01822904798796682
2023-08-01T15:00:00-04:00,1.09735,1.09771,1.09734,1.09771,1.09605,1.0971095555555554,1.0969999999999918,1.0969633333333249,1.096999500000003,1.0972184000000005,1.0982596000000013,1.1001576000000055,1.097135922844124,1.0969619561683608,1544,-256001,-257539.4,0.0030820373221667526,-321.3525612980738,0.04648195406489341
2023-08-01T15:15:00-04:00,1.09771,1.09802,1.09756,1.0979,1.0960832,1.0972895555555555,1.0970577777777697,1.0969777777777694,1.097055500000003,1.0971874000000004,1.0982347000000012,1.1001375500000055,1.0972887382752992,1.0970447649346882,1241,-254760,-257162,0.0043406752962006955,-321.1377595744855,0.04738559113525633
2023-08-01T15:30:00-04:00,1.0979,1.09852,1.0979,1.09845,1.0961606720000001,1.0975679999999999,1.097251111111103,1.0970346666666582,1.0971235000000032,1.0972110000000006,1.0982167000000012,1.1001214500000054,1.0975209906202392,1.0971682119477504,1543,-253217,-256167.2,0.006844748771223376,-320.36478389364044,0.1586563448860549
2023-08-01T15:45:00-04:00,1.09845,1.09848,1.09813,1.09826,1.0963022316800002,1.097769777777778,1.0974588888888805,1.0971422222222138,1.0971450000000034,1.0972240000000004,1.0982007000000011,1.1001022000000054,1.0976687924961914,1.0973213695581996,-1255,-254472,-255199,0.015893593649152035,-320.5818625044101,0.17055974607576121
2023-08-01T16:00:00-04:00,1.09826,1.09826,1.09804,1.09818,1.0964352977792002,1.0979139999999998,1.0976622222222139,1.0972859999999915,1.0972065000000033,1.0972274000000004,1.0981836000000014,1.1000842000000055,1.097771033996953,1.0974770956465594,-806,-255278,-254745.6,0.030688665635400562,-320.6405735564379,0.16691749897386768
2023-08-01T16:15:00-04:00,1.09818,1.09844,1.09804,1.09838,1.0965603799124481,1.0980575555555558,1.0977944444444363,1.0974448888888806,1.0973135000000032,1.0972362000000004,1.0981700000000012,1.1000652000000055,1.0978928271975625,1.097628476517247,526,-254752,-254495.8,0.042981428672444026,-320.5447786958504,0.10845888132411201
2023-08-01T16:30:00-04:00,1.09838,1.0984099999999999,1.09823,1.0983,1.0966779571177012,1.0981586666666667,1.0979366666666586,1.0976206666666584,1.0974180000000033,1.0972320000000004,1.0981579000000012,1.1000457000000055,1.0979742617580501,1.0977655812137972,-414,-255166,-254577,0.044153568497883405,-320.5749321946395,0.11667973236587939
2023-08-01T16:45:00-04:00,1.0983,1.09853,1.09826,1.09843,1.096788479690639,1.0982573333333332,1.0981066666666586,1.0977917777777693,1.0974875000000033,1.0972426000000006,1.0981468000000012,1.1000261500000057,1.0980654094064402,1.0978744649710375,747,-254419,-254817.4,0.04736451366977504,-320.4865137297392,0.1394840003646669
2023-08-01T17:00:00-04:00,1.09843,1.09843,1.09798,1.09823,1.096927801315388,1.098282,1.0982044444444363,1.0979408888888804,1.0975395000000032,1.0972640000000005,1.0981350000000012,1.1000046000000057,1.0980983275251521,1.0979603719768296,-57,-254476,-254818.2,0.05431712453755132,-320.49689217898043,0.08019319269148328
2023-08-01T17:15:00-04:00,1.09823,1.0992,1.09812,1.09883,1.097055977210157,1.0984071111111111,1.0983288888888807,1.098074222222214,1.0976155000000032,1.0972912000000006,1.098128700000001,1.0999880500000054,1.0982446620201216,1.0980550975814634,583,-253893,-254541.2,0.06068212838210179,-320.1783796633872,0.10203059095753977
2023-08-01T17:30:00-04:00,1.09883,1.09965,1.09881,1.09964,1.0972703794891412,1.0986693333333333,1.098522222222214,1.0982197777777694,1.097740000000003,1.0973498000000006,1.0981304000000012,1.0999763000000053,1.0985237296160972,1.0981812780651703,2200,-251693,-253929.4,0.06815041677597326,-318.5566547377846,0.1584843792695011
2023-08-01T17:45:00-04:00,1.09964,1.10199,1.09961,1.10189,1.0975559339504442,1.099342888888889,1.0989044444444362,1.098413333333325,1.0979745000000034,1.0974442000000004,1.0981526000000013,1.0999743000000055,1.0991969836928779,1.098425822452136,3535,-248158,-252527.8,0.08391924426266456,-311.3236057399305,0.3131685556921216
2023-08-01T18:00:00-04:00,1.10189,1.10189,1.10052,1.10054,1.098176703197382,1.0996700000000001,1.0991577777777697,1.0986235555555472,1.0981325000000033,1.0975108000000007,1.0981631000000012,1.0999669000000054,1.0994655869543024,1.0987058579617084,-2638,-250796,-251803.2,0.08845608613684991,-314.5555980440624,0.20760111449019902
2023-08-01T18:15:00-04:00,1.10054,1.10097,1.10015,1.10027,1.0987105647497484,1.0998924444444445,1.0993899999999919,1.0988606666666585,1.098310500000003,1.0975656000000005,1.0981697000000012,1.0999580000000053,1.099626469563442,1.0990114863693663,-1877,-252673,-251442.6,0.09421617037214547,-315.01609016611155,0.19031488462730586
2023-08-01T18:30:00-04:00,1.10027,1.10036,1.09984,1.10029,1.0991696856847837,1.1000724444444443,1.099602222222214,1.0991153333333252,1.0985055000000032,1.0976212000000005,1.0981761000000012,1.0999516000000054,1.0997591756507534,1.0993143890954928,1147,-251526,-250969.2,0.09789088071439819,-314.9952407382439,0.1738924598044464
2023-08-01T18:45:00-04:00,1.10029,1.10095,1.10019,1.10091,1.099564529688914,1.1003340000000001,1.0998922222222138,1.0993893333333251,1.0987335000000034,1.0976920000000006,1.0981889000000011,1.0999496500000054,1.0999893405206027,1.099607511276394,1038,-250488,-250728.2,0.10130891482038326,-314.4103403937892,0.2376399890740236
2023-08-01T19:00:00-04:00,1.10091,1.1010199999999999,1.10045,1.101,1.09984,1.1005555555555555,1.1001777777777695,1.0996439999999919,1.0989240000000033,1.0977612000000005,1.0981982000000012,1.0999448000000054,1.100191472416482,1.0998064090211146,1876,-248612,-250819,0.10570873998453036,-314.2569763585821,0.2339703030689221
2023-08-01T19:15:00-04:00,1.101,1.1014,1.10083,1.1013,1.100141,1.10078,1.1005188888888808,1.0999162222222139,1.0991380000000033,1.0978230000000004,1.0982096000000012,1.0999425500000053,1.1004131779331856,1.0999959272168913,1421,-247191,-250098,0.11399588730909237,-313.86978289809167,0.2795407155149564
2023-08-01T19:30:00-04:00,1.1013,1.10167,1.10119,1.10132,1.10039986,1.1009402222222222,1.1007955555555473,1.100197333333325,1.0993590000000033,1.0978928000000006,1.0982218000000012,1.0999403000000054,1.1005945423465484,1.1001895417735128,1044,-246147,-248792.8,0.12345737841833267,-313.85082348648706,0.2266046613215969
2023-08-01T19:45:00-04:00,1.10132,1.10138,1.10073,1.10077,1.1006224796,1.1009351111111112,1.100921111111103,1.100461111111103,1.0995300000000034,1.0979488000000006,1.098228300000001,1.0999347500000054,1.1006296338772388,1.1003636334188096,-1259,-247406,-247968.8,0.12432026230128929,-314.4795689918806,0.10276090356844744
2023-08-01T20:00:00-04:00,1.10077,1.10079,1.09951,1.0997999999999999,1.10199,1.1007108888888888,1.1006888888888806,1.1006204444444363,1.0996345000000034,1.0979910000000006,1.0982268000000013,1.0999214000000053,1.100463707101791,1.1004585067350474,-2801,-250207,-247912.6,0.11515175137716742,-316.94781394768466,-0.18967410540073393
2023-08-01T20:15:00-04:00,1.0997999999999999,1.09992,1.09934,1.09954,1.1019404,1.1004811111111112,1.1005777777777697,1.1007004444444362,1.0997165000000033,1.0980308000000008,1.0982238000000013,1.0999067500000053,1.100278965681433,1.1004760053880376,-1801,-252008,-248591.8,0.08584705764662744,-317.3735822691975,-0.09086448470751739
2023-08-01T20:30:00-04:00,1.09954,1.09961,1.09926,1.0994,1.1018363839999998,1.1002455555555555,1.100481111111103,1.1006928888888807,1.0997640000000035,1.0980960000000006,1.0982211000000013,1.0998908000000054,1.1001031725451462,1.1004140043104296,-1632,-253640,-249881.6,0.06897976203926234,-317.5813782566105,-0.07907150063167662
2023-08-01T20:45:00-04:00,1.0994,1.09982,1.09935,1.09962,1.1016818009599998,1.1000733333333332,1.1004066666666585,1.100615111111103,1.0998320000000033,1.0981736000000006,1.0982208000000013,1.0998754000000053,1.100006538036117,1.1002964034483431,2187,-251453,-250942.8,0.05799981814162633,-317.1437395445855,-0.060893037290164265
2023-08-01T21:00:00-04:00,1.09962,1.09988,1.09948,1.09969,1.1015364929023999,1.0999299999999999,1.100271111111103,1.100485111111103,1.0999075000000036,1.0982470000000006,1.0982204000000013,1.0998604500000053,1.0999432304288936,1.1001591227586742,1896,-249557,-251373,0.04634935507064903,-317.02304330406605,-0.11081741468421567
2023-08-01T21:15:00-04:00,1.09969,1.09986,1.09943,1.09972,1.1013999033282558,1.0998197777777778,1.100128888888881,1.100373111111103,1.0999745000000036,1.0983286000000005,1.0982249000000013,1.0998464000000052,1.0998985843431148,1.100046098206939,2086,-247471,-250825.8,0.028859803955919566,-316.966136357563,-0.11625794732061288
2023-08-01T21:30:00-04:00,1.09972,1.10073,1.09962,1.10043,1.1012715091285603,1.09988,1.100032222222214,1.1002639999999917,1.1000810000000034,1.0983946000000007,1.0982375000000013,1.0998353000000052,1.1000048674744918,1.0999912785655508,3146,-244325,-249289.2,0.014800917059413832,-314.9350193459601,-0.07899754835194102
2023-08-01T21:45:00-04:00,1.10043,1.10057,1.09912,1.09914,1.1011508185808467,1.0997015555555556,1.0997899999999918,1.1001257777777695,1.1001165000000035,1.0984254000000007,1.0982400000000014,1.0998191000000053,1.0998318939795935,1.0999370228524403,-2151,-246476,-247856.4,-0.008471582753163754,-317.4565700125177,-0.19794428503977687
2023-08-01T22:00:00-04:00,1.09914,1.0992,1.09874,1.09894,1.100988353094379,1.0995315555555556,1.0995866666666585,1.0999617777777693,1.1001520000000036,1.0984632000000005,1.0982402000000016,1.0998007000000054,1.0996535151836748,1.099866418281952,-2273,-248749,-247315.6,-0.03231424073228691,-317.87016609672895,-0.16624726327934067
2023-08-01T22:15:00-04:00,1.09894,1.09895,1.09864,1.09882,1.100763517784941,1.0993782222222221,1.0994777777777693,1.0998031111111026,1.1001515000000037,1.0984940000000005,1.0982405000000015,1.0997836500000053,1.0994868121469399,1.099775134625561,-1769,-250518,-247507.8,-0.05259316782288073,-318.0633340585833,-0.0891071103837044
2023-08-01T22:30:00-04:00,1.09882,1.09891,1.09849,1.09854,1.1005086956507482,1.0991906666666666,1.0993666666666584,1.0996506666666581,1.1000965000000036,1.0985304000000005,1.0982392000000014,1.0997652000000055,1.0992974497175518,1.0996549077004485,-1991,-252509,-248515.4,-0.06279226909691359,-318.57067830058804,-0.09094712334247866
2023-08-01T22:45:00-04:00,1.09854,1.09866,1.09803,1.09842,1.1002260782596434,1.0990013333333335,1.0992577777777697,1.0994957777777692,1.0999230000000038,1.0985632000000005,1.0982375000000015,1.0997463000000054,1.0991219597740414,1.0994783261603585,-2590,-255099,-250670.2,-0.06769594400088404,-318.85359926841835,-0.08913953065308176
2023-08-01T23:00:00-04:00,1.09842,1.09851,1.0981,1.09814,1.0998747057381004,1.0987777777777779,1.099093333333325,1.099356444444436,1.0998030000000036,1.0985842000000006,1.0982339000000012,1.0997265500000055,1.0989255678192331,1.0992970609282864,-2268,-257367,-252848.4,-0.06292701090206546,-319.4317387778957,-0.13459194994635854
2023-08-01T23:15:00-04:00,1.09814,1.09864,1.09802,1.0986,1.0995795528200043,1.098679111111111,1.098972222222214,1.0992335555555468,1.0997195000000037,1.0985996000000007,1.0982372000000014,1.0997102500000053,1.0988604542553866,1.0991384487426288,2135,-255232,-254145,-0.06380695797215474,-318.53740836465124,-0.09911884258291294
2023-08-01T23:30:00-04:00,1.0986,1.09887,1.09852,1.09865,1.0992988333124036,1.0986146666666667,1.0988533333333248,1.099108666666658,1.0996375000000036,1.0986336000000005,1.0982410000000014,1.0996931000000054,1.0988183634043092,1.0990047589941028,1641,-253591,-254759.6,-0.06625372839612685,-318.4627224006973,-0.09729749390755159
2023-08-01T23:45:00-04:00,1.09865,1.09877,1.0982399999999999,1.0987,1.099068643316171,1.098584,1.0986611111111029,1.098967555555547,1.0995270000000037,1.0986828000000006,1.0982429000000014,1.0996794500000053,1.0987946907234474,1.098904207195282,1718,-251873,-254632.4,-0.06864878558950384,-318.38453553499835,-0.15721127195732662
2023-08-02T00:00:00-04:00,1.0987,1.09882,1.0983,1.0984,1.0988798875192602,1.0985317777777774,1.0985788888888806,1.0988317777777692,1.0993970000000037,1.0987266000000007,1.0982404000000012,1.0996635000000055,1.0987157525787579,1.098822965756225,-1650,-253523,-254317.2,-0.07624862813105919,-318.83506798243616,-0.06732536346597912
2023-08-02T00:15:00-04:00,1.0984,1.0985,1.09814,1.09836,1.09882,1.0984880000000001,1.0985144444444361,1.0987159999999914,1.0992500000000036,1.0987530000000008,1.0982366000000012,1.0996495500000054,1.0986446020630063,1.0987667726049797,-1442,-254965,-253836.8,-0.07191711101390814,-318.8875807282483,-0.05277813165414171
2023-08-02T00:30:00-04:00,1.09836,1.0986799999999999,1.09821,1.09858,1.09802,1.098501111111111,1.0984877777777693,1.0986191111111023,1.0991130000000036,1.0987808000000008,1.0982374000000013,1.0996358000000053,1.098631681650405,1.0987210180839833,1154,-253811,-253552.6,-0.06341737286855764,-318.65643611263965,-0.021841611910960665
2023-08-02T00:45:00-04:00,1.09858,1.09892,1.09818,1.0989,1.0980332,1.0985835555555556,1.0985277777777693,1.0985539999999916,1.0990195000000038,1.0988126000000007,1.0982409000000013,1.0996226000000053,1.098685345320324,1.0986944144671864,2174,-251637,-253161.8,-0.05221141398442614,-318.02318227586835,0.03277076847451307
2023-08-02T01:00:00-04:00,1.0989,1.09974,1.09886,1.09973,1.098068672,1.098824,1.098673333333325,1.0985564444444358,1.0990160000000038,1.0988642000000006,1.0982545000000015,1.0996135000000054,1.0988942762562592,1.0987143315737486,3037,-248600,-252507.2,-0.03688022419298532,-315.72933388201966,0.11926221299686317
2023-08-02T01:15:00-04:00,1.09973,1.10006,1.09965,1.09973,1.09816895168,1.0990353333333334,1.0988499999999917,1.0986106666666582,1.0990255000000038,1.0989148000000006,1.0982667000000015,1.0996039500000052,1.0990614210050074,1.0987834652589987,0,-248600,-251522.6,-0.02465765888725295,-315.72933388201966,0.1447902817491579
2023-08-02T01:30:00-04:00,1.09973,1.09973,1.09925,1.09937,1.0983202355455999,1.0991393333333332,1.0989355555555471,1.0986948888888803,1.0990240000000038,1.0989546000000008,1.0982735000000015,1.0995940500000052,1.099123136804006,1.0988791722071987,-2451,-251051,-250739.8,-0.0127297022341811,-316.53167627515285,0.07008920444201142
2023-08-02T01:45:00-04:00,1.09937,1.09954,1.09903,1.09942,1.098459416701952,1.099236222222222,1.0990211111111026,1.0988015555555468,1.0990140000000037,1.0990088000000007,1.0982776000000016,1.0995850000000054,1.0991825094432048,1.0989893377657587,2735,-248316,-249640.8,-0.005355309165147574,-316.4072868521194,0.07008601465436304
2023-08-02T02:00:00-04:00,1.09942,1.09956,1.0983,1.0983,1.10006,1.099092,1.0989766666666583,1.0988913333333246,1.0989445000000038,1.0990470000000006,1.0982735000000015,1.0995709000000053,1.0990060075545638,1.0990534702126067,-3376,-251692,-249651.8,-0.0028207974667522786,-319.84648206414033,-0.03640666241921871
2023-08-02T02:15:00-04:00,1.0983,1.09863,1.09814,1.09815,1.1000248000000001,1.0989266666666666,1.0989488888888803,1.0989464444444357,1.098866000000004,1.0990830000000007,1.0982619000000016,1.0995568000000053,1.098834806043651,1.0990415761700851,-2759,-254451,-250822,-0.0011526608265381509,-320.2232916789999,-0.022760378732709714
2023-08-02T02:30:00-04:00,1.09815,1.09936,1.09812,1.09935,1.099949408,1.0990068888888889,1.0990588888888804,1.0989882222222134,1.0988120000000037,1.0991262000000008,1.0982641000000015,1.0995484500000052,1.0989378448349207,1.0990168609360678,3026,-251425,-251387,0.009095766416886088,-316.9166395822915,0.09013438216978463
2023-08-02T02:45:00-04:00,1.09935,1.09962,1.09889,1.09897,1.09983964352,1.0989891111111112,1.0991022222222135,1.0990215555555465,1.0988035000000038,1.0991652000000007,1.0982551000000014,1.0995404000000053,1.0989442758679366,1.098981088748854,-2788,-254213,-252019.4,0.020974890369314353,-317.88033631217746,0.03550037320906193
2023-08-02T03:00:00-04:00,1.09897,1.09899,1.09833,1.09876,1.0997364649088,1.0989206666666667,1.099086666666658,1.099034666666658,1.0987945000000037,1.0992024000000007,1.0982505000000016,1.0995291000000054,1.0989074206943492,1.098926070999083,-5331,-259544,-254265,0.02426020040017813,-318.8990265403004,-0.012740012740015379
2023-08-02T03:15:00-04:00,1.09876,1.09891,1.09814,1.09858,1.099639477014272,1.0988193333333334,1.0989588888888802,1.0990311111111022,1.0987825000000038,1.0992270000000006,1.0982422000000014,1.0995184000000053,1.0988419365554793,1.098893256799266,-3963,-263507,-256628,0.022908435166644262,-319.548249300503,-0.10457112200269214
2023-08-02T03:30:00-04:00,1.09858,1.09972,1.09858,1.09928,1.09812,1.0988835555555556,1.0989088888888803,1.0990231111111022,1.0988195000000036,1.0992584000000007,1.0982384000000014,1.0995118000000053,1.0989295492443836,1.0989122054394127,4531,-258976,-257533,0.016819119277912898,-316.66115869262677,-0.040919134696703864
2023-08-02T03:45:00-04:00,1.09928,1.09952,1.09864,1.099,1.09814,1.0989017777777776,1.0988677777777691,1.09898488888888,1.098848500000004,1.0992804000000007,1.0982339000000014,1.0994996500000054,1.0989436393955068,1.0989133643515299,-4465,-263441,-259936.2,0.008181876882664944,-317.7984485550824,-0.033655639138777796
2023-08-02T04:00:00-04:00,1.099,1.0992899999999999,1.0976,1.09835,1.09972,1.0987982222222223,1.0987488888888803,1.0989142222222132,1.0988590000000038,1.0992784000000007,1.0982447000000015,1.0994847500000053,1.0988249115164055,1.0988894914812235,-5674,-269115,-262916.6,-0.0007973887252747601,-321.15431752687516,-0.0973240435866299
2023-08-02T04:15:00-04:00,1.09835,1.09906,1.09821,1.09886,1.0996776,1.0988204444444443,1.0988111111111025,1.0988591111111021,1.0988720000000038,1.0992904000000008,1.0982572000000015,1.0994738500000054,1.0988319292131243,1.0988743931849787,4094,-265021,-264012,-0.009013678256779014,-319.2533387860366,0.05098789037602603
2023-08-02T04:30:00-04:00,1.09886,1.09887,1.09809,1.09833,1.0996360479999998,1.0987242222222222,1.0988311111111024,1.0988335555555468,1.0988560000000036,1.0992934000000005,1.0982604000000016,1.0994603500000053,1.0987315433704994,1.0988523145479827,-4446,-269467,-265204,-0.0075707116165732,-321.3977247860727,0.01639120338752165
2023-08-02T04:45:00-04:00,1.09833,1.09869,1.0980699999999999,1.09842,1.0995953270399998,1.0986420000000001,1.098727777777769,1.0987973333333245,1.0988420000000036,1.0992942000000006,1.0982652000000015,1.0994470000000054,1.0986692346963995,1.098800251638386,3364,-266103,-266629.4,-0.0041169134070256075,-321.1220699282433,-0.08459544276164073
2023-08-02T05:00:00-04:00,1.09842,1.0985,1.09796,1.09815,1.0995554204991997,1.0985264444444445,1.098636666666658,1.0987511111111024,1.0988295000000037,1.0992912000000006,1.0982616000000014,1.0994312000000055,1.0985653877571195,1.0987246013107081,-3156,-269259,-267793,-0.012654393349690738,-321.8978387598378,-0.07461532161933837
2023-08-02T05:15:00-04:00,1.09815,1.09845,1.09777,1.09802,1.0995163120892157,1.098403111111111,1.098554444444436,1.0987122222222137,1.0988125000000035,1.0992830000000007,1.0982628000000014,1.0994086000000054,1.0984563102056957,1.0986508810485662,-2812,-272071,-268384.2,-0.019653636616178513,-322.2307258881899,-0.06734864756634415
2023-08-02T05:30:00-04:00,1.09802,1.09815,1.09773,1.09781,1.0994779858474315,1.098254222222222,1.0984688888888803,1.0986437777777691,1.0987740000000037,1.0992746000000007,1.0982693000000014,1.0993880000000054,1.0983270481645566,1.0985499048388525,-2558,-274629,-270305.8,-0.025916548713163283,-322.7199519496461,-0.0700904804383784
2023-08-02T05:45:00-04:00,1.09781,1.09826,1.09761,1.09805,1.0994404261304829,1.0981704444444442,1.0983322222222138,1.0985439999999915,1.0987315000000037,1.0992590000000007,1.0982751000000015,1.0993683500000053,1.0982716385316453,1.0984579238710819,2534,-272095,-270831.4,-0.028443848860600914,-322.16597630723066,-0.11189141983844555
2023-08-02T06:00:00-04:00,1.09805,1.09805,1.09717,1.09729,1.0994036176078732,1.097962,1.098142222222214,1.0984268888888802,1.0986095000000038,1.0992120000000007,1.0982809000000016,1.0993439500000053,1.0980753108253163,1.0983391390968653,-2734,-274829,-272576.6,-0.03958058106997937,-324.05827629356975,-0.15559599636031649
2023-08-02T06:15:00-04:00,1.09729,1.09742,1.09681,1.09723,1.0993142729035583,1.0977795555555558,1.0980177777777693,1.0983031111111026,1.0984845000000039,1.0991188000000007,1.0982815000000015,1.0993206500000055,1.097906248660253,1.0982073112774917,-2597,-277426,-274210,-0.04486025223002439,-324.2002806862102,-0.10197113852597169
2023-08-02T06:30:00-04:00,1.09723,1.09793,1.09709,1.09778,1.0991640165293448,1.097732,1.0978977777777692,1.0981717777777693,1.0984050000000039,1.0990636000000007,1.0982872000000015,1.0993022000000052,1.0978809989282026,1.098092249021993,2797,-274629,-274721.6,-0.04159970729342676,-322.7982501183255,-0.09828367580947253
2023-08-02T06:45:00-04:00,1.09778,1.09802,1.0976,1.09788,1.099022775537584,1.0977284444444444,1.0978477777777693,1.098047555555547,1.0983280000000037,1.0990158000000008,1.0982907000000015,1.0992747000000052,1.097880799142562,1.0980029992175944,2459,-272170,-274229.8,-0.04406489557347438,-322.57425259605327,-0.040971292780863804
2023-08-02T07:00:00-04:00,1.09788,1.098,1.09749,1.09753,1.098890009005329,1.097664888888889,1.0977488888888804,1.0979308888888801,1.098289500000004,1.0989606000000007,1.0982909000000014,1.0992466000000052,1.0978106393140497,1.097910799374075,-3216,-275386,-274888,-0.043158000163898834,-323.59950125710935,-0.08102547295206364
2023-08-02T07:15:00-04:00,1.09753,1.09783,1.09739,1.09761,1.0987652084650092,1.0976371111111112,1.0976888888888805,1.0978402222222137,1.0982625000000037,1.0988946000000006,1.0982933000000015,1.0992206000000053,1.0977705114512397,1.0978498394992597,2464,-272922,-274506.6,-0.04754286011601299,-323.41989796608294,-0.04917361016254473
2023-08-02T07:30:00-04:00,1.09761,1.09778,1.09733,1.09744,1.0986478959571087,1.0975873333333332,1.0976244444444359,1.097761555555547,1.098167000000004,1.0988234000000003,1.0982923000000016,1.0991900500000051,1.0977044091609918,1.0978094715994076,-2345,-275267,-274074.8,-0.05093074571962384,-323.7830961876735,-0.05282235296260769
2023-08-02T07:45:00-04:00,1.09744,1.09785,1.09726,1.09782,1.098537622199682,1.0976264444444443,1.097625555555547,1.0977071111111028,1.0981095000000038,1.0987538000000006,1.0982884000000015,1.0991629000000054,1.0977275273287934,1.0977787772795256,2653,-272614,-273671.8,-0.04612083693971382,-322.86446737880914,0.0009109044370214802
2023-08-02T08:00:00-04:00,1.09782,1.09871,1.09779,1.09836,1.09681,1.0977733333333333,1.0976599999999914,1.0976695555555471,1.098089500000004,1.0986946000000004,1.0982937000000015,1.0991364500000054,1.0978540218630348,1.0977734218236201,3253,-269361,-273110,-0.03846829325407651,-321.2643690020261,0.028231865579894586
2023-08-02T08:15:00-04:00,1.09836,1.09839,1.0965799999999999,1.09699,1.09871,1.0976393333333332,1.097626666666658,1.0976451111111025,1.098010000000004,1.0986190000000005,1.0982839000000015,1.0991026500000054,1.0976812174904278,1.0977475374588959,-10243,-279604,-273953.6,-0.040448800847249486,-334.0406081221697,-0.027340083296137664
2023-08-02T08:30:00-04:00,1.09699,1.0974,1.09573,1.0963,1.09871,1.097374,1.0975233333333247,1.0976119999999914,1.097861000000004,1.0985490000000007,1.0982700000000016,1.0990653000000055,1.0974049739923422,1.0976744299671164,-7939,-287543,-276877.8,-0.03958102921086872,-339.03419056138875,-0.08475889284834313
2023-08-02T08:45:00-04:00,1.0963,1.09684,1.09593,1.0959699999999999,1.0985908,1.0970633333333333,1.0973222222222137,1.097551555555547,1.0977095000000041,1.0984776000000005,1.0982542000000015,1.0990269000000052,1.0971179791938737,1.0975571439736929,-5039,-292582,-280340.8,-0.03670641676923552,-340.5509925316531,-0.16487820874857342
2023-08-02T09:00:00-04:00,1.0959699999999999,1.09621,1.09537,1.09614,1.098476368,1.096826888888889,1.0971288888888804,1.0974522222222136,1.097599000000004,1.0984124000000006,1.0982542000000015,1.0989908000000055,1.096922383355099,1.0973961151789537,5101,-287481,-283314.2,-0.039244557453208206,-339.7597573701067,-0.15848726636791588
2023-08-02T09:15:00-04:00,1.09614,1.09679,1.09612,1.09651,1.09828998592,1.0967031111111112,1.0970155555555472,1.0973233333333248,1.097481500000004,1.0983502000000005,1.0982619000000013,1.0989577500000054,1.0968399066840793,1.0971932921431626,4338,-283143,-286070.6,-0.0437469005561716,-338.2954736107321,-0.09293595619252311
2023-08-02T09:30:00-04:00,1.09651,1.09654,1.09521,1.09562,1.0981147867648,1.0964239999999998,1.096794444444436,1.0971568888888803,1.097346000000004,1.0982688000000005,1.0982579000000015,1.0989236000000053,1.0965959253472635,1.0969762337145297,-5527,-288670,-287883.8,-0.04709864288735861,-342.7815521690674,-0.181303012909862
2023-08-02T09:45:00-04:00,1.09562,1.09605,1.09499,1.09501,1.097882403823616,1.096067111111111,1.096524444444436,1.0969571111111025,1.0971755000000039,1.0981746000000006,1.0982516000000013,1.0988852500000055,1.0962787402778107,1.0967509869716237,-5370,-294040,-289183.2,-0.056392845564590434,-345.7713661556686,-0.22142440589006526
2023-08-02T10:00:00-04:00,1.09501,1.09506,1.09349,1.09356,1.0975931634412543,1.0954742222222222,1.0960511111111026,1.0967028888888803,1.096946000000004,1.0980372000000005,1.0982159000000014,1.0988426500000055,1.0957349922222486,1.0964743895772986,-6109,-300149,-290696.6,-0.07067739083136727,-353.86083565823,-0.38804175547903397
2023-08-02T10:15:00-04:00,1.09356,1.09373,1.09183,1.09199,1.0971007838283038,1.0946619999999998,1.0953433333333247,1.0963457777777692,1.096644500000004,1.0978942000000007,1.0981598000000015,1.0987895000000052,1.0949859937777988,1.0960871116618387,-6375,-306524,-294505.2,-0.09710862488715062,-363.01328271189,-0.5799555701227272
2023-08-02T10:30:00-04:00,1.09199,1.09314,1.09178,1.09203,1.0963628740923412,1.0939993333333335,1.0947922222222135,1.0959011111111026,1.0963555000000038,1.0977560000000006,1.0981096000000015,1.0987343500000053,1.094394795022239,1.0955980893294706,6791,-299733,-297823.2,-0.12885169633593027,-362.764525855142,-0.4521463276784523
2023-08-02T10:45:00-04:00,1.09203,1.09325,1.09193,1.09272,1.0956296142375666,1.0935848888888888,1.0943944444444358,1.0954211111111025,1.096089000000004,1.0976340000000007,1.0980640000000015,1.0986838500000053,1.094059836017791,1.0950908714635763,6713,-293020,-298693.2,-0.14572218821771143,-358.5229116137759,-0.3265529508346382
2023-08-02T11:00:00-04:00,1.09272,1.09342,1.09229,1.09288,1.095013675959556,1.093282,1.0940511111111024,1.0949264444444358,1.095868500000004,1.0975208000000005,1.0980256000000015,1.0986368000000053,1.093823868814233,1.0945998971708608,5828,-287192,-297323.6,-0.15449717701670154,-357.66955485266516,-0.281942023960493
2023-08-02T11:15:00-04:00,1.09288,1.09376,1.09253,1.09368,1.094496287806027,1.0932077777777778,1.093777777777769,1.094471777777769,1.095691000000004,1.0974260000000005,1.0979946000000014,1.0985939500000053,1.0937950950513864,1.0942119177366882,3553,-283639,-294021.6,-0.15973195486512087,-355.06872036031496,-0.22442388745962258
2023-08-02T11:30:00-04:00,1.09368,1.0944099999999999,1.09364,1.09393,1.09178,1.0932382222222223,1.0934911111111023,1.0941013333333245,1.095498500000004,1.0973418000000006,1.0979630000000014,1.0985453000000052,1.093822076041109,1.0939791341893503,3202,-280437,-288804.2,-0.16558333604978023,-354.33678780234527,-0.23529197180144518
2023-08-02T11:45:00-04:00,1.09393,1.09398,1.09337,1.09382,1.0918326,1.093304,1.0932911111111023,1.0938011111111023,1.095295500000004,1.0972462000000005,1.0979229000000013,1.0984956500000052,1.0938216608328872,1.09386450735148,-3240,-283677,-285593,-0.17295410886636614,-354.6625856139056,-0.16429053869042404
2023-08-02T12:00:00-04:00,1.09382,1.0945,1.09371,1.09376,1.091884148,1.0933977777777777,1.0931522222222136,1.093552666666658,1.095107000000004,1.0971484000000005,1.0978910000000013,1.0984432500000052,1.0938093286663098,1.0938144058811836,-2823,-286500,-284289,-0.17205464252313316,-354.81743741767576,-0.1141542086373616
2023-08-02T12:15:00-04:00,1.09376,1.09463,1.09369,1.09456,1.09198878208,1.0936793333333332,1.0932633333333248,1.0933951111111022,1.094954500000004,1.0970656000000005,1.0978742000000015,1.0983968000000053,1.0939594629330478,1.0938415247049467,2956,-283544,-283559.4,-0.16327125196223094,-352.65535432814994,0.09144445663702859
2023-08-02T12:30:00-04:00,1.09456,1.0949,1.09423,1.09442,1.0921472551552,1.0939106666666665,1.0935333333333248,1.0933462222222134,1.094803500000004,1.0969860000000005,1.0978563000000015,1.0983529500000053,1.0940515703464382,1.093892819763957,-2732,-286276,-284086.8,-0.14156603319805525,-353.0047915449312,0.2225295103434951
2023-08-02T12:45:00-04:00,1.09442,1.09527,1.0943,1.09505,1.092367474742784,1.094214,1.0938688888888803,1.093421777777769,1.094665000000004,1.0969198000000007,1.0978364000000014,1.0983157000000052,1.0942512562771505,1.0939786558111653,2880,-283396,-284678.6,-0.10323551005779147,-351.346927105319,0.2765491790518596
2023-08-02T13:00:00-04:00,1.09505,1.09577,1.09501,1.09543,1.0926577272685056,1.0945262222222223,1.0941699999999916,1.0935975555555468,1.0945185000000044,1.0968568000000005,1.0978188000000013,1.0982829500000053,1.0944870050217204,1.094111724648932,2375,-281021,-284147.4,-0.061791147227328834,-350.5227638251039,0.24800497840251762
2023-08-02T13:15:00-04:00,1.09543,1.09553,1.09509,1.09534,1.093031199996285,1.0947602222222221,1.0944433333333248,1.0938557777777693,1.0944360000000042,1.0967856000000007,1.0977991000000014,1.0982466500000052,1.0946576040173763,1.0942813797191453,-2080,-283101,-283467.6,-0.024724056816139192,-350.6936556210195,0.2250933313812959
2023-08-02T13:30:00-04:00,1.09534,1.09536,1.09492,1.09521,1.0933598559967308,1.0949135555555556,1.0946133333333248,1.094125777777769,1.0943815000000043,1.0966952000000005,1.0977797000000014,1.0982114500000053,1.094768083213901,1.094443103775316,-1910,-285011,-283761,0.004307357357950335,-350.9203432248685,0.13989466754444
2023-08-02T13:45:00-04:00,1.09521,1.09534,1.09459,1.0946,1.0936490732771231,1.0949108888888888,1.0946877777777693,1.094356666666658,1.0943130000000045,1.0965926000000006,1.0977537000000013,1.0981753000000052,1.094734466571121,1.0945796830202525,-1854,-286865,-283878.8,0.020111190254388837,-351.9529671052202,0.0612470633404284
2023-08-02T14:00:00-04:00,1.0946,1.09495,1.09451,1.09476,1.0939035844838683,1.0949253333333335,1.094792222222214,1.0945413333333247,1.0942440000000044,1.0965004000000007,1.0977275000000015,1.0981421500000053,1.0947395732568967,1.0946773464162018,1916,-284949,-284189.4,0.03296198341067679,-351.67290132776736,0.085937357151994
2023-08-02T14:15:00-04:00,1.09476,1.09481,1.0944,1.0944,1.094127554345804,1.094846888888889,1.0948633333333249,1.0946799999999914,1.0941385000000043,1.0964000000000005,1.0977044000000016,1.0981082500000054,1.0946716586055174,1.094714277132961,-1590,-286539,-285293,0.04583694528288139,-352.1957556520027,0.0585137507314195
2023-08-02T14:30:00-04:00,1.0944,1.0944,1.09407,1.09416,1.09577,1.0947062222222224,1.0948188888888803,1.0947551111111025,1.0940655000000044,1.0963172000000005,1.0976821000000014,1.0980761500000051,1.0945693268844139,1.0946966217063685,-1510,-288049,-286282.6,0.05972512428774867,-352.5268960028799,-0.036544364858934725
2023-08-02T14:45:00-04:00,1.09416,1.09437,1.0941,1.09429,1.0957359999999998,1.0946004444444446,1.094804444444436,1.0947933333333248,1.0940295000000044,1.0962400000000005,1.0976615000000012,1.0980441500000053,1.0945134615075311,1.0946456973650946,1936,-286113,-286503,0.06304949598708373,-352.29687479939963,-0.011878437894040998
2023-08-02T15:00:00-04:00,1.09429,1.0945799999999999,1.09426,1.09429,1.0957026799999998,1.0944975555555556,1.0947199999999917,1.0947997777777694,1.0940660000000042,1.0961388000000007,1.0976325000000013,1.0980131000000055,1.0944687692060249,1.0945925578920754,0,-286113,-286352.6,0.06499707506634034,-352.29687479939963,-0.0694032235971046
2023-08-02T15:15:00-04:00,1.09429,1.0943,1.09373,1.09378,1.0956700263999999,1.0943095555555555,1.0945366666666583,1.0947486666666582,1.0941555000000043,1.0960350000000005,1.0976001000000013,1.0979776000000054,1.0943310153648198,1.09451084631366,-1597,-287710,-286904.8,0.052430674948141326,-353.041165618104,-0.150625781656512
2023-08-02T15:30:00-04:00,1.09378,1.09398,1.09347,1.09398,1.095592425344,1.094198222222222,1.094385555555547,1.0946531111111024,1.0942530000000044,1.0959394000000007,1.0975709000000013,1.0979432000000053,1.0942608122918558,1.0944286770509275,1572,-286138,-286824.6,0.030513002299279047,-352.7537220736984,-0.12416236054558656
2023-08-02T15:45:00-04:00,1.09398,1.09429,1.09396,1.0939699999999999,1.0954650798233598,1.0941151111111111,1.0942477777777693,1.0945388888888803,1.0943155000000044,1.0958472000000006,1.0975371000000012,1.0979106500000053,1.0942026498334847,1.0943553416407419,-1702,-287840,-286782.8,0.009547835570130269,-352.76927994495753,-0.11322029565107421
2023-08-02T16:00:00-04:00,1.0939699999999999,1.0939699999999999,1.09359,1.09369,1.0953453750339583,1.0940035555555556,1.0941466666666582,1.0944073333333248,1.0943560000000043,1.0957354000000006,1.0974969000000014,1.0978782500000053,1.0941001198667877,1.094272673312593,-1021,-288861,-287332.4,-0.008563968668363682,-353.0306033816147,-0.08313539192398743
2023-08-02T16:15:00-04:00,1.09369,1.09376,1.09364,1.09375,1.0952328525319208,1.0939242222222223,1.094034444444436,1.0942702222222138,1.0943595000000044,1.0956304000000006,1.0974554000000014,1.0978450500000054,1.0940300958934301,1.094184938650074,439,-288422,-287794.2,-0.02011673187305806,-353.00651977474257,-0.0922576637801852
2023-08-02T16:30:00-04:00,1.09375,1.09377,1.09352,1.09364,1.0951270813800056,1.0938453333333333,1.0939499999999915,1.0941528888888805,1.0943450000000046,1.0955362000000006,1.0974073000000013,1.0978120000000053,1.0939520767147441,1.094109150920059,-480,-288902,-288032.6,-0.030177326058287653,-353.05479406045686,-0.06944444444445302
2023-08-02T16:45:00-04:00,1.09364,1.09386,1.09359,1.09378,1.0950276564972052,1.0938113333333332,1.0939077777777695,1.0940573333333248,1.0943430000000043,1.0954346000000006,1.0973625000000014,1.0977816000000054,1.0939176613717954,1.0940405207360469,929,-287973,-288399.6,-0.03519042952602188,-352.93587010010424,-0.03472983841486135
2023-08-02T17:00:00-04:00,1.09378,1.09395,1.0936299999999999,1.09374,1.094934197107373,1.0937777777777777,1.0938466666666582,1.0939771111111027,1.0943420000000044,1.0953428000000005,1.0973181000000012,1.097750850000005,1.0938821290974363,1.0939764165888373,-201,-288174,-288466.4,-0.03868045220750604,-352.9432207556291,-0.050260899761493796
2023-08-02T17:15:00-04:00,1.09374,1.09385,1.09373,1.09378,1.0948463452809305,1.0937644444444445,1.0937899999999916,1.0939057777777692,1.0943030000000045,1.0952500000000005,1.0972721000000012,1.0977210500000052,1.093861703277949,1.0939287332710694,130,-288044,-288303,-0.043427897071521206,-352.93846642644667,-0.0466055615970182
2023-08-02T17:30:00-04:00,1.09378,1.094,1.09378,1.09398,1.0947637645640746,1.0938024444444443,1.093812222222214,1.093861333333325,1.0942810000000045,1.0951666000000004,1.0972289000000013,1.0976934000000051,1.0938853626223592,1.0938997866168552,370,-287674,-288153.4,-0.04373795694001119,-352.8708111392774,0.018285212748448316
2023-08-02T17:45:00-04:00,1.09398,1.09408,1.09382,1.09389,1.0946861386902302,1.093818,1.0938022222222137,1.0938317777777695,1.0942230000000044,1.0950840000000006,1.0971835000000012,1.0976651500000052,1.0938862900978874,1.093886629293484,-4012,-291686,-288710.2,-0.04042731981664054,-353.2008720179038,-0.008226841441335626
2023-08-02T18:00:00-04:00,1.09389,1.09428,1.09389,1.09426,1.0946131703688164,1.0939095555555556,1.0938344444444361,1.0938171111111028,1.0941645000000044,1.0950130000000005,1.0971438000000011,1.0976394000000051,1.09396103207831,1.093895303434787,537,-291149,-289345.4,-0.03443185695284506,-353.01923583876334,0.02650895362762448
2023-08-02T18:15:00-04:00,1.09426,1.0944,1.09423,1.09436,1.0945445801466875,1.0940146666666666,1.0939088888888806,1.0938295555555473,1.0941155000000042,1.0949392000000004,1.097099100000001,1.0976139000000054,1.094040825662648,1.0939270427478294,581,-290568,-289824.2,-0.02621242816389206,-352.9661405963164,0.06126050343332648
2023-08-02T18:30:00-04:00,1.09436,1.09444,1.09433,1.0944,1.0944801053378863,1.094112888888889,1.0939811111111029,1.0938677777777694,1.0940750000000043,1.0948814000000004,1.097046700000001,1.0975885500000053,1.0941126605301184,1.0939772341982632,537,-290031,-290221.6,-0.015633221640512555,-352.9465126859395,0.059428571428575036
2023-08-02T18:45:00-04:00,1.0944,1.09446,1.09435,1.09444,1.09347,1.0942046666666667,1.0940699999999917,1.093919333333325,1.0940670000000046,1.0948256000000005,1.096972200000001,1.0975624000000053,1.0941781284240948,1.0940357873586104,359,-289672,-290621.2,-0.005975816441004821,-352.93339134091025,0.0731502139643881
2023-08-02T19:00:00-04:00,1.09444,1.09457,1.09438,1.09455,1.0934898,1.0943006666666666,1.094155555555547,1.0939899999999916,1.0940565000000047,1.0947610000000005,1.0969123000000012,1.0975377000000053,1.0942525027392758,1.0941090298868879,437,-289235,-290131,0.0025592044530284505,-352.8894693351357,0.07039806908152804
2023-08-02T19:15:00-04:00,1.09455,1.09455,1.09439,1.09439,1.0935330079999999,1.0943475555555555,1.0942277777777694,1.0940686666666584,1.0940560000000046,1.0946912000000004,1.096853500000001,1.0975116000000054,1.0942800021914205,1.09417282390951,-362,-289597,-289820.6,0.009745154843093306,-352.9423860589034,0.0594291147804816
2023-08-02T19:30:00-04:00,1.09439,1.09442,1.09425,1.09431,1.0935744876799998,1.0943640000000001,1.0942866666666582,1.094144222222214,1.0940635000000045,1.0946268000000003,1.0967937000000012,1.0974849000000053,1.0942860017531364,1.0942218591276078,-590,-290187,-289744.4,0.015346829199754861,-352.9855151079628,0.048455813783386
2023-08-02T19:45:00-04:00,1.09431,1.09453,1.0943,1.09434,1.0936143081727998,1.0943746666666667,1.0943266666666582,1.0942133333333253,1.0940660000000044,1.0945614000000004,1.0967280000000013,1.0974584500000055,1.0942968014025092,1.0942586873020859,808,-289379,-289614,0.019681740767741245,-352.9633641635319,0.0329073657653831
2023-08-02T20:00:00-04:00,1.09434,1.09438,1.09404,1.09419,1.0936525358458877,1.0943473333333333,1.0943599999999916,1.0942713333333252,1.0940610000000046,1.0944964000000004,1.0966599000000015,1.0974290500000055,1.0942754411220073,1.0942781498416685,-1547,-290926,-289864.8,0.02203650756832635,-353.175409780068,0.02742506102075775
2023-08-02T20:15:00-04:00,1.09419,1.09422,1.09379,1.09398,1.0936892344120521,1.0942713333333334,1.0943288888888805,1.0943059999999918,1.0940710000000045,1.0944196000000002,1.0965867000000014,1.0973981500000054,1.0942163528976059,1.0942709198733345,-1496,-292422,-290502.2,0.024208712002530493,-353.4625262772029,-0.025588068649138044
2023-08-02T20:30:00-04:00,1.09398,1.09411,1.09371,1.09387,1.09457,1.0941795555555556,1.094274444444436,1.094315333333325,1.0940655000000044,1.0943298000000004,1.0965122000000014,1.0973670000000053,1.0941470823180848,1.0942443358986673,-1537,-293959,-291374.6,0.020252192681825678,-353.6170720641461,-0.044775028327068006
2023-08-02T20:45:00-04:00,1.09387,1.09415,1.09375,1.094,1.0945528,1.0941246666666666,1.0942299999999916,1.0943039999999917,1.0940670000000046,1.0942700000000003,1.0964445000000014,1.0973364000000054,1.0941176658544678,1.0942106687189335,1621,-292338,-291804.8,0.016874636294380102,-353.4244257716248,-0.036549707602335155
2023-08-02T21:00:00-04:00,1.094,1.09425,1.09376,1.0941,1.094535944,1.0940986666666666,1.0941922222222136,1.094277111111103,1.0940875000000045,1.0942260000000001,1.0963875000000014,1.0973071500000053,1.0941141326835742,1.0941741349751464,2047,-290291,-291987.2,0.013566660747345964,-353.23731425425734,-0.031066116004532632
2023-08-02T21:15:00-04:00,1.0941,1.09461,1.094,1.09456,1.09371,1.094172222222222,1.0941933333333247,1.0942437777777694,1.0941280000000044,1.0941978,1.0963377000000012,1.0972807500000052,1.0942033061468592,1.094159707980117,2075,-288216,-291445.2,0.010876420104050244,-352.36490771006595,0.0009136174683719806
2023-08-02T21:30:00-04:00,1.09456,1.0949,1.09453,1.09463,1.093728,1.0942595555555554,1.0942199999999913,1.0942219999999918,1.0941775000000047,1.0941676,1.096290000000001,1.0972555500000054,1.0942886449174873,1.0941741663840931,2353,-285863,-290133.4,0.007777278248584684,-352.214427151668,0.021930024945405018
2023-08-02T21:45:00-04:00,1.09463,1.09493,1.09432,1.09438,1.09377488,1.0942915555555552,1.0942277777777691,1.0942126666666585,1.0942075000000044,1.094125,1.0962376000000011,1.0972292000000052,1.0943069159339898,1.094206133107274,-2164,-288027,-288947,0.004465154171875014,-352.7086580790135,0.006396724876864371
2023-08-02T22:00:00-04:00,1.09438,1.09448,1.094,1.09418,1.0938441872,1.094282,1.0942099999999912,1.0942086666666584,1.0942295000000044,1.0940962,1.0961825000000012,1.0972014500000054,1.0942815327471918,1.0942389064858191,-1987,-290014,-288482.2,0.0015362300045740447,-353.07178606015344,-0.01462068461357165
2023-08-02T22:15:00-04:00,1.09418,1.0942399999999999,1.09386,1.09396,1.09493,1.0942319999999999,1.0941844444444357,1.0942071111111027,1.0942385000000043,1.0940752,1.0961249000000013,1.0971749000000053,1.0942172261977534,1.0942595251886549,-1401,-291415,-288707,-0.002894003320425805,-353.3534764584424,-0.02102011533645459
2023-08-02T22:30:00-04:00,1.09396,1.09418,1.09392,1.09416,1.0949086,1.094227111111111,1.0942044444444354,1.094209333333325,1.0942475000000047,1.0940872,1.0960622000000013,1.0971498500000052,1.0942057809582026,1.0942600201509236,1626,-289789,-289021.6,-0.004821808500179673,-353.05620781973533,0.01645368288269155
2023-08-02T22:45:00-04:00,1.09416,1.09418,1.09344,1.09351,1.094887628,1.0940882222222221,1.0941644444444356,1.0941982222222137,1.0942285000000047,1.0941176,1.0960059000000013,1.0971229500000053,1.094066624766562,1.0942156161207386,-1751,-291540,-290157,-0.007071840323453618,-354.0964121774162,-0.03291067494308428
2023-08-02T23:00:00-04:00,1.09351,1.09352,1.09324,1.09341,1.09482972288,1.0939373333333333,1.09409888888888,1.0941724444444358,1.0941860000000045,1.0941452,1.0959506000000012,1.097095400000005,1.0939352998132497,1.0941412928965906,-2082,-293622,-291276,-0.009187056477502861,-354.2868082414668,-0.053930530164542086
2023-08-02T23:15:00-04:00,1.09341,1.09345,1.09324,1.09325,1.0947343395072,1.0937675555555555,1.0940044444444357,1.094131333333325,1.0941305000000046,1.0941558,1.0958949000000013,1.097067700000005,1.0937982398505997,1.094044634317272,-1280,-294902,-292253.6,-0.011646444243891536,-354.4741121805198,-0.07768942509825585
2023-08-02T23:30:00-04:00,1.09325,1.09332,1.0930199999999999,1.09312,1.094644679136768,1.0935906666666666,1.0938444444444357,1.094063333333325,1.0940665000000047,1.0941606000000001,1.0958407000000014,1.097039950000005,1.0936625918804797,1.0939337074538173,-1050,-295952,-293161,-0.015207351409480527,-354.59896925804094,-0.13155971349216908
2023-08-02T23:45:00-04:00,1.09312,1.09351,1.09303,1.09347,1.0945147048058266,1.0935157777777778,1.093715555555547,1.0939655555555472,1.0940180000000046,1.0941564000000001,1.0957912000000014,1.0970143500000051,1.0936240735043836,1.0938173659630535,1214,-294738,-294150.8,-0.021123143618188404,-354.21026536459846,-0.10597188090953563
2023-08-03T00:00:00-04:00,1.09347,1.09359,1.09317,1.09352,1.0943951284213604,1.0934766666666667,1.0936199999999914,1.0938566666666583,1.0939665000000045,1.0941482,1.0957450000000015,1.096989450000005,1.093603258803507,1.0937246927704425,2224,-292514,-294345.6,-0.0272657470135226,-354.10857075935075,-0.07858330744347128
2023-08-03T00:15:00-04:00,1.09352,1.09356,1.09323,1.09331,1.0942851181476516,1.0934146666666669,1.0935233333333245,1.0937415555555472,1.0939125000000045,1.094138,1.0956921000000015,1.096964650000005,1.0935446070428056,1.0936465542163538,-1680,-294194,-294460,-0.031650694042965014,-354.4311986033774,-0.07951159772614437
2023-08-03T00:30:00-04:00,1.09331,1.09332,1.09229,1.09231,1.0941839086958394,1.093172,1.093339999999991,1.0936086666666582,1.0938125000000045,1.0941090000000002,1.0956287000000013,1.0969348500000051,1.0932976856342445,1.0935464433730826,-1672,-295866,-294652.8,-0.03969428694811753,-355.9604995335804,-0.15082818384585828
2023-08-03T00:45:00-04:00,1.09231,1.09251,1.09223,1.09232,1.0939945178262553,1.092968,1.0931355555555466,1.0934668888888806,1.0937115000000044,1.0940642,1.0955649000000012,1.096903900000005,1.0931021485073955,1.093434354698466,1526,-294340,-294330.4,-0.04602811581212459,-355.94652914056,-0.16816553337720844
2023-08-03T01:00:00-04:00,1.09232,1.09239,1.09191,1.09232,1.0937827756871048,1.0928048888888888,1.0930033333333244,1.093324444444436,1.0936180000000044,1.0940222000000002,1.0955041000000012,1.096872250000005,1.0929457188059164,1.0932986837587724,0,-294340,-294250.8,-0.054061232531608765,-355.94652914056,-0.10882387906832351
2023-08-03T01:15:00-04:00,1.09232,1.09294,1.0923,1.09281,1.0935205870909102,1.0927662222222223,1.0929366666666578,1.0931877777777692,1.0935595000000045,1.0939774000000002,1.0954486000000012,1.0968426000000049,1.0929185750447332,1.0931617470070176,1877,-292463,-294240.6,-0.054456378942471524,-355.10453228982016,-0.054874200894443434
2023-08-03T01:30:00-04:00,1.09281,1.09322,1.0927,1.09277,1.0932951048981827,1.0927328888888888,1.0928833333333245,1.0930597777777693,1.0935045000000045,1.0939242,1.0953905000000013,1.096813950000005,1.0928888600357867,1.0930305976056138,-2351,-294814,-294364.6,-0.05504277136862371,-355.1905856751297,-0.043905785501947035
2023-08-03T01:45:00-04:00,1.09277,1.09408,1.09269,1.09395,1.09191,1.0929462222222222,1.0929755555555467,1.0929868888888805,1.0935020000000044,1.0938964000000002,1.095341000000001,1.0967909500000048,1.0931010880286294,1.0929912780844908,2767,-292047,-293600.8,-0.04898963771175175,-352.20271082497834,0.07592944964870155
2023-08-03T02:00:00-04:00,1.09395,1.09433,1.09344,1.09398,1.0919534,1.093147111111111,1.0930322222222133,1.0929662222222138,1.0934960000000045,1.0938718,1.0952835000000012,1.0967690000000048,1.0932768704229034,1.0930262224675924,4315,-287732,-292279.2,-0.04103811092303083,-352.08437817723404,0.04664051139949066
2023-08-03T02:15:00-04:00,1.09398,1.09425,1.09347,1.09368,1.0920484639999999,1.0932766666666667,1.0930499999999912,1.092975555555547,1.0934520000000043,1.0938534000000002,1.0952230000000012,1.0967448500000048,1.0933574963383228,1.0931085779740735,-2907,-290639,-291539,-0.037289449389395435,-352.88155911290005,0.014631648255170273
2023-08-03T02:30:00-04:00,1.09368,1.0939699999999999,1.09294,1.09295,1.0921397254399998,1.0932566666666668,1.0930099999999912,1.0929902222222139,1.0933680000000043,1.0938172000000002,1.095158800000001,1.0967161500000049,1.0932759970706583,1.0931800623792585,-3400,-294039,-291854.2,-0.03549343937516495,-355.1509614975095,-0.0329275319900043
2023-08-03T02:45:00-04:00,1.09295,1.09305,1.09203,1.09216,1.09433,1.0930866666666665,1.0929933333333244,1.0930122222222136,1.0932570000000044,1.0937724000000002,1.095086200000001,1.0966819000000048,1.0930527976565265,1.0932128499034066,-3775,-297814,-292454.2,-0.0352577057359115,-357.87958586275977,-0.013732365354146027
2023-08-03T03:00:00-04:00,1.09216,1.09246,1.09149,1.09195,1.094284,1.092878,1.0929522222222134,1.093007555555547,1.0931455000000043,1.0937282000000002,1.0950227000000012,1.0966481000000048,1.0928322381252211,1.0931590799227249,-6038,-303852,-294815.2,-0.02796957279854535,-359.04056960140633,-0.033872857770614974
2023-08-03T03:15:00-04:00,1.09195,1.09215,1.0913599999999999,1.09201,1.09417224,1.0926895555555556,1.0929177777777688,1.092984666666658,1.0930480000000045,1.0936826000000002,1.0949613000000011,1.0966116000000048,1.092667790500177,1.0930372639381796,6167,-297685,-296805.8,-0.021354899080350036,-358.70170793191625,-0.028379961915925046
2023-08-03T03:30:00-04:00,1.09201,1.09278,1.09175,1.09224,1.0940035056,1.092554,1.0928544444444355,1.0929455555555472,1.0929520000000044,1.0936416,1.0948902000000011,1.0965771500000048,1.0925822324001415,1.0928822111505432,5323,-292362,-297150.4,-0.0145949148701734,-357.5805735100694,-0.05215911274603631
2023-08-03T03:45:00-04:00,1.09224,1.09245,1.09168,1.09188,1.0938448952639999,1.092359111111111,1.0927555555555466,1.092894666666658,1.092870500000004,1.0936036000000002,1.0948193000000013,1.0965372000000047,1.0924417859201132,1.0927153689204343,-4254,-296616,-297665.8,-0.013171585278371874,-358.98268293656963,-0.08144440275630346
2023-08-03T04:00:00-04:00,1.09188,1.09232,1.0914,1.09218,1.09369580154816,1.092244,1.09255888888888,1.0928077777777692,1.092809000000004,1.0935676,1.0947535000000013,1.0965020000000048,1.0923894287360905,1.0925826951363469,5203,-291413,-296385.6,-0.012775827367600797,-357.5531302384711,-0.16179898532840162
2023-08-03T04:15:00-04:00,1.09218,1.09227,1.09144,1.09177,1.0935556534552704,1.0920862222222223,1.0923133333333241,1.0926799999999914,1.0927350000000042,1.0935236000000002,1.0946854000000013,1.0964638000000047,1.0922655429888724,1.0924693561090772,-3664,-295077,-294630.6,-0.02557962693823994,-358.92858117146756,-0.2020146620596396
2023-08-03T04:30:00-04:00,1.09177,1.09192,1.09122,1.09168,1.0934239142479543,1.0919595555555557,1.092091111111102,1.092514666666658,1.0926630000000042,1.0934834,1.0946094000000013,1.0964239000000047,1.0921484343910979,1.0923654848872615,-2894,-297971,-294687.8,-0.039788411069518886,-359.1671479025554,-0.18286884646331666
2023-08-03T04:45:00-04:00,1.09168,1.09246,1.09164,1.09246,1.093247601108118,1.0920333333333332,1.0920366666666574,1.0923511111111026,1.0926125000000042,1.0934576,1.0945440000000013,1.0963889500000048,1.0922107475128784,1.0922911879098087,3796,-294175,-295050.4,-0.04807868308325303,-356.454924540398,-0.04483279198500402
2023-08-03T05:00:00-04:00,1.09246,1.09383,1.09235,1.09349,1.09122,1.0923239999999999,1.0921844444444355,1.0922368888888803,1.092611000000004,1.0934546,1.0944954000000013,1.0963700500000046,1.0924665980103028,1.0922961503278468,3969,-290206,-293768.4,-0.043223709498884925,-352.71284702726217,0.12177702900674382
2023-08-03T05:15:00-04:00,1.09349,1.09356,1.09267,1.09279,1.0912722000000001,1.0924451111111113,1.0922777777777686,1.0921806666666583,1.0925850000000041,1.0934348,1.0944347000000012,1.0963459500000048,1.0925312784082422,1.0923245202622769,-2802,-293008,-294087.4,-0.03427760545745201,-354.5065534168957,0.07692659920325581
2023-08-03T05:30:00-04:00,1.09279,1.09296,1.0924,1.0926,1.0913233560000002,1.0925095555555555,1.0923433333333241,1.0921866666666582,1.0925995000000042,1.093412,1.0943774000000013,1.0963189000000049,1.0925450227265938,1.0923804162098214,-2438,-295446,-294161.2,-0.025235025692542264,-354.93044089756427,0.05402880925999675
2023-08-03T05:45:00-04:00,1.0926,1.0933599999999999,1.09245,1.09316,1.0913734888800002,1.0926728888888888,1.0924455555555463,1.092257555555547,1.0926415000000043,1.0933996000000001,1.0943248000000012,1.0962950000000047,1.0926680181812751,1.0924843329678569,2613,-292833,-293133.6,-0.018413477357819504,-353.5911767569824,0.08423057203543267
2023-08-03T06:00:00-04:00,1.09316,1.09332,1.0922,1.09232,1.0914226191024001,1.0926477777777777,1.092494444444435,1.0923491111111026,1.0926415000000043,1.0933664,1.0942665000000011,1.0962640500000047,1.09259841454502,1.0925618663742853,-2599,-295432,-293385,-0.017681296482993374,-355.5882860547978,0.040297468586291164
2023-08-03T06:15:00-04:00,1.09232,1.09263,1.09216,1.09232,1.091470766720352,1.0926128888888889,1.0925099999999908,1.0924142222222135,1.0926170000000044,1.0933350000000002,1.0942095000000012,1.0962361500000046,1.0925427316360161,1.0925770930994279,0,-295432,-294430.2,-0.013654301671459817,-355.5882860547978,0.012818399897455457
2023-08-03T06:30:00-04:00,1.09232,1.09288,1.09218,1.09283,1.091517951385945,1.092676888888889,1.0926277777777686,1.0924842222222135,1.0926200000000041,1.0933064000000001,1.0941597000000012,1.0962145000000048,1.092600185308813,1.092590874479542,2521,-292911,-294410.8,-0.007792489661104315,-354.41124086657453,0.09709004643835799
2023-08-03T06:45:00-04:00,1.09283,1.09356,1.0928,1.09342,1.091564192358226,1.0928353333333334,1.092821111111102,1.092579777777769,1.0925935000000042,1.0932876000000002,1.094113400000001,1.0961942500000048,1.0927641482470505,1.0926346995836334,2023,-290888,-293499.2,0.004475760726913702,-353.319058184913,0.1593873662611823
2023-08-03T07:00:00-04:00,1.09342,1.09367,1.09239,1.09313,1.0916095085110615,1.0928971111111112,1.0928955555555462,1.092669777777769,1.0925510000000043,1.0932622,1.0940718000000011,1.0961763500000048,1.0928373185976403,1.0926685596669063,-6989,-297877,-294508,0.021320549139363605,-355.1727008839681,0.06132947659410399
2023-08-03T07:15:00-04:00,1.09313,1.09418,1.0927499999999999,1.0932,1.0916539183408402,1.0929579999999999,1.092863333333324,1.0927435555555467,1.0925270000000042,1.0932374,1.0940315000000012,1.0961565000000049,1.0929098548781122,1.092730847733525,4306,-293571,-294135.8,0.0314937705445183,-354.89696057860635,-0.026520590037414467
2023-08-03T07:30:00-04:00,1.0932,1.09461,1.0931,1.09437,1.0917549616072066,1.0932593333333334,1.0930388888888798,1.0928493333333245,1.0925980000000044,1.0932338,1.0939974000000012,1.0961423000000048,1.0932018839024897,1.0928626781868196,5592,-287979,-292645.2,0.03653969442471615,-348.9121087674093,0.14458404634011449
2023-08-03T07:45:00-04:00,1.09437,1.09488,1.09333,1.0935,1.0919262639107743,1.0933515555555553,1.0931388888888796,1.0929515555555467,1.0926650000000042,1.093216,1.0939536000000012,1.096122150000005,1.0932615071219918,1.0929949425494552,-4487,-292466,-292556.2,0.04063984770854499,-352.4791747505783,0.0823723228994967
2023-08-03T08:00:00-04:00,1.0935,1.09366,1.09285,1.0936299999999999,1.0921625627979124,1.0934497777777776,1.093191111111102,1.0930255555555468,1.0927490000000044,1.0932023999999998,1.093914600000001,1.096102750000005,1.0933352056975933,1.0931091540395639,4789,-287677,-291914,0.043657256112380666,-351.90983775926617,0.04299462109846413
2023-08-03T08:15:00-04:00,1.0936299999999999,1.0936299999999999,1.09253,1.09273,1.0923799577740794,1.0933575555555555,1.0932366666666575,1.093093777777769,1.0927850000000043,1.0931701999999999,1.093865800000001,1.096079550000005,1.0932141645580746,1.0931845232316508,-4394,-292071,-290752.8,0.036321707046274396,-355.5258687752401,0.03753478834041503
2023-08-03T08:30:00-04:00,1.09273,1.09561,1.09216,1.09521,1.09561,1.0937522222222222,1.0935577777777687,1.0932326666666579,1.0929335000000042,1.0931906,1.093843500000001,1.0960679000000046,1.0936133316464598,1.0933252185853202,12554,-279517,-287942,0.048817236440841016,-327.03399978655995,0.26457448366779507
2023-08-03T08:45:00-04:00,1.09521,1.09534,1.09369,1.0937999999999999,1.09561,1.0938006666666666,1.0936655555555463,1.0933579999999912,1.0930295000000043,1.093187,1.0938033000000011,1.0960458500000048,1.0936506653171678,1.093414974868256,-7996,-287513,-287848.8,0.0555582906764334,-337.3282447258876,0.08876037444066465
2023-08-03T09:00:00-04:00,1.0937999999999999,1.09402,1.09238,1.09256,1.09561,1.0935795555555554,1.0935699999999908,1.0934442222222134,1.0930485000000043,1.0931608,1.093745300000001,1.0960195000000048,1.0934325322537342,1.0934491798946044,-6568,-294081,-288171.8,0.050123839211698905,-344.774139770685,-0.07865230195168214
2023-08-03T09:15:00-04:00,1.09256,1.09334,1.09232,1.09288,1.0955409999999999,1.0934415555555554,1.0935422222222129,1.0935144444444358,1.0931040000000043,1.0931384,1.093704200000001,1.095994050000005,1.0933220258029874,1.093446543915683,5562,-288519,-288340.2,0.042132365594530666,-343.14508507345965,-0.02287010694060738
2023-08-03T09:30:00-04:00,1.09288,1.0933599999999999,1.0916,1.09196,1.0954733799999998,1.093125111111111,1.0934044444444353,1.0935479999999913,1.0931180000000045,1.0930955999999998,1.0936608000000012,1.095965400000005,1.0930496206423899,1.093413635132546,-6930,-295449,-289015.8,0.030600277772557208,-348.9788454131129,-0.1134284668861972
2023-08-03T09:45:00-04:00,1.09196,1.09233,1.09154,1.09183,1.0953184447999997,1.0928102222222222,1.0931222222222128,1.09346088888888,1.0930865000000043,1.093041,1.0936194000000012,1.095936800000005,1.092805696513912,1.0932521081060367,-5969,-301418,-293396,0.017412942909431565,-349.689466681291,-0.23209700558311966
2023-08-03T10:00:00-04:00,1.09183,1.09373,1.09159,1.09223,1.0950917381119998,1.0926317777777779,1.0929811111111016,1.093323999999991,1.0930235000000044,1.0929929999999999,1.0935803000000013,1.095917250000005,1.0926905572111296,1.093060086484829,10326,-291092,-294111.8,-0.0011631979840545988,-345.9064601692886,-0.11614083219020416
2023-08-03T10:15:00-04:00,1.09223,1.09429,1.0917,1.09417,1.0948786338252798,1.0928695555555556,1.0930411111111016,1.0932182222222133,1.0930925000000045,1.0929887999999999,1.0935569000000012,1.095909400000005,1.0929864457689038,1.0929708691878628,7333,-283759,-292047.4,0.002003952142240798,-332.88171263442837,0.04937684591682809
2023-08-03T10:30:00-04:00,1.09417,1.09479,1.09355,1.09398,1.09154,1.0930573333333335,1.0931799999999905,1.0931457777777687,1.0931615000000046,1.0929848,1.0935405000000011,1.095899200000005,1.093185156615123,1.0929434953502901,-6505,-290264,-292396.4,0.00002178095943680928,-334.011290305175,0.11439239336340846
2023-08-03T10:45:00-04:00,1.09398,1.09398,1.09304,1.09317,1.091605,1.0930553333333335,1.0929533333333241,1.0930555555555466,1.0931620000000044,1.0929689999999999,1.093522100000001,1.095886850000005,1.0931821252920984,1.0929699962802317,-5622,-295886,-292483.8,0.0015638340507260278,-338.17390753766546,-0.1862656476840096
2023-08-03T11:00:00-04:00,1.09317,1.09445,1.09296,1.0944,1.0916687,1.0933446666666666,1.0930199999999908,1.0930351111111023,1.0932660000000045,1.0929738,1.093530500000001,1.0958732000000049,1.0934257002336787,1.093093997024185,5000,-290886,-290377.4,-0.011246800629242415,-332.54806709198886,0.054854635216690074
2023-08-03T11:15:00-04:00,1.0944,1.0954599999999999,1.09439,1.09477,1.091731126,1.0936946666666667,1.0932655555555462,1.093091999999991,1.0933885000000045,1.0929989999999998,1.093558300000001,1.0958590500000052,1.093694560186943,1.093294797619348,4622,-286264,-289411.8,-0.013044373954876997,-330.9854391680123,0.20227722047302166
2023-08-03T11:30:00-04:00,1.09477,1.09542,1.09471,1.09486,1.09188028096,1.0940135555555555,1.0934855555555463,1.0931808888888799,1.0934900000000043,1.0930279999999999,1.0935866000000012,1.095848100000005,1.0939276481495543,1.0934830380954779,4089,-282175,-289095,-0.0030702058082340794,-330.6492863687945,0.18117268135567222
2023-08-03T11:45:00-04:00,1.09486,1.09487,1.0942,1.09465,1.0920234697215998,1.0942464444444444,1.0937844444444351,1.093301777777769,1.0935515000000045,1.093056,1.0936059000000011,1.0958349500000049,1.0940721185196434,1.093660430476382,-3785,-285960,-288234.2,0.0051906316067692896,-331.3752695995273,0.24634602000071973
2023-08-03T12:00:00-04:00,1.09465,1.09517,1.09445,1.09486,1.0921609309327358,1.0944615555555557,1.0941211111111018,1.0935353333333244,1.0936380000000043,1.0930907999999997,1.0936257000000011,1.095825650000005,1.0942296948157146,1.0938699443811053,2914,-283046,-285666.2,0.025437725252629925,-330.8162415997099,0.27751573047084854
2023-08-03T12:15:00-04:00,1.09486,1.09535,1.09482,1.09535,1.0922928936954264,1.0947073333333335,1.0944677777777683,1.09382488888888,1.0937455000000045,1.0931284,1.0936424000000011,1.095818500000005,1.0944537558525718,1.094075555504884,2281,-280765,-283642,0.04795344501579529,-329.7953896186345,0.285654120469133
2023-08-03T12:30:00-04:00,1.09535,1.09589,1.09525,1.09579,1.0924195779476094,1.0949717777777779,1.0946477777777686,1.0941013333333245,1.0938165000000044,1.0931737999999998,1.0936610000000013,1.095812000000005,1.0947210046820575,1.094280844403907,2251,-278514,-282092,0.0692186132769987,-328.89116722396614,0.14805743166052393
2023-08-03T12:45:00-04:00,1.09579,1.09629,1.09551,1.09553,1.0926278032707528,1.0951482222222222,1.0948199999999906,1.0943682222222135,1.0939180000000044,1.0932181999999997,1.093678100000001,1.095800500000005,1.094882803745646,1.094471875523125,-2360,-280874,-281831.8,0.07659806389217991,-329.45112853042116,0.14168449148978413
2023-08-03T13:00:00-04:00,1.09553,1.0957,1.09528,1.09529,1.0929207790090927,1.0952422222222222,1.095055555555546,1.0946224444444357,1.0940010000000044,1.0932777999999999,1.0936934000000011,1.095792200000005,1.0949642429965167,1.0946503004184998,-1924,-282798,-281199.4,0.08077514892071809,-329.87262314946366,0.19393141048511411
2023-08-03T13:15:00-04:00,1.09529,1.09535,1.09443,1.09443,1.0931903166883652,1.095117111111111,1.0950588888888795,1.0948099999999912,1.0940860000000046,1.0933199999999998,1.0936921000000013,1.095783150000005,1.0948573943972133,1.0947758403347994,-1957,-284755,-281541.2,0.08880734903348192,-331.40922076288126,0.002741228070173108
2023-08-03T13:30:00-04:00,1.09443,1.09522,1.09433,1.09518,1.093438291353296,1.0951413333333333,1.095104444444435,1.0949373333333245,1.0940845000000043,1.0933771999999997,1.0936997000000013,1.095778000000005,1.0949219155177707,1.0948694722678394,2029,-282726,-281933.4,0.08526389547772414,-330.01877093968557,0.03745078875015039
2023-08-03T13:45:00-04:00,1.09518,1.09534,1.09464,1.0947,1.0936664280450323,1.0950604444444445,1.0950866666666572,1.095025111111102,1.0941295000000044,1.0934149999999998,1.093696200000001,1.095766300000005,1.0948775324142166,1.0949007778142712,-1669,-284395,-283109.6,0.08684567070817467,-330.75026713209235,-0.014613740569564874
2023-08-03T14:00:00-04:00,1.0947,1.09504,1.09444,1.09482,1.0938763138014298,1.0950071111111113,1.0951055555555462,1.0950822222222132,1.0942425000000042,1.093456,1.0936901000000012,1.095754450000005,1.0948660259313732,1.0948974222514167,1739,-282656,-283466,0.08203709643525622,-330.5596395628955,0.015530078107157858
2023-08-03T14:15:00-04:00,1.09482,1.09522,1.09469,1.09487,1.0940694086973155,1.0949600000000002,1.0951066666666573,1.0950924444444357,1.0943420000000041,1.0934743999999998,1.0936854000000011,1.0957422500000051,1.0948668207450984,1.094877937801133,1315,-281341,-283174.6,0.07398697634271593,-330.4995840286523,0.0009133587856041424
2023-08-03T14:30:00-04:00,1.09487,1.09487,1.09453,1.09475,1.0942470560015303,1.0948886666666666,1.095039999999991,1.095088666666658,1.0944815000000043,1.0934898,1.0936808000000011,1.0957302500000052,1.0948434565960787,1.094875150240906,-1581,-282922,-282808,0.06483885579730467,-330.6728648747803,-0.05477701191401433
2023-08-03T14:45:00-04:00,1.09475,1.09476,1.09423,1.09431,1.09629,1.0947426666666666,1.0948755555555463,1.0950428888888801,1.0946055000000043,1.0935024,1.0936779000000012,1.0957158000000051,1.094736765276863,1.0948381201927244,-1701,-284623,-283187.4,0.04510540838525598,-331.35652781152385,-0.1350623750901311
2023-08-03T15:00:00-04:00,1.09431,1.09444,1.09393,1.09395,1.0962488,1.0945575555555556,1.094699999999991,1.0949655555555469,1.0946915000000044,1.0935224,1.0936698000000014,1.095698650000005,1.0945794122214902,1.0947784961541793,-1308,-285931,-283494.6,0.019068078653014513,-331.7868263558119,-0.14422243115203737
2023-08-03T15:15:00-04:00,1.09395,1.0942,1.09383,1.09418,1.0961560479999999,1.0944535555555555,1.0945766666666574,1.0948597777777689,1.0946920000000042,1.0935628,1.0936676000000012,1.095686000000005,1.0944995297771922,1.094705196923343,1281,-284650,-283893.4,-0.0017487377114196567,-331.5174996041323,-0.10134302330891054
2023-08-03T15:30:00-04:00,1.09418,1.09435,1.09396,1.09406,1.0960164851199998,1.0943502222222223,1.0945355555555463,1.0947455555555465,1.0946960000000043,1.093605,1.0936666000000013,1.095674350000005,1.0944116238217538,1.094614157538674,-1093,-285743,-284773.8,-0.012506579548238582,-331.63737019215245,-0.033807552790035125
2023-08-03T15:45:00-04:00,1.09406,1.09445,1.09401,1.0944,1.0958852960127998,1.0943231111111111,1.0944488888888797,1.0946273333333245,1.0947575000000043,1.0936528,1.0936677000000012,1.095664600000005,1.094409299057403,1.094527326030939,1474,-284269,-285043.2,-0.014607418027814855,-331.17929659472634,-0.07122116912288418
2023-08-03T16:00:00-04:00,1.0944,1.09472,1.09434,1.09472,1.0957619782520318,1.0943773333333333,1.094451111111102,1.0945424444444356,1.0947735000000043,1.0937024000000002,1.093672000000001,1.095652250000005,1.0944714392459225,1.0944742608247506,1378,-282891,-284696.8,-0.025550383712355604,-330.77637261811833,0.0018269845619721366
2023-08-03T16:15:00-04:00,1.09472,1.0949,1.09468,1.0949,1.09564605955691,1.094467111111111,1.0944599999999909,1.0944944444444356,1.094780000000004,1.0937628000000001,1.0936832000000012,1.0956416500000048,1.094557151396738,1.0944698086598004,661,-282230,-283956.6,-0.02589779981780017,-330.6676872921902,0.007307137246312637
2023-08-03T16:30:00-04:00,1.0949,1.095,1.09472,1.09473,1.0955370959834954,1.094521111111111,1.0944444444444352,1.0944679999999911,1.0947735000000043,1.0938138000000002,1.0936907000000011,1.095630800000005,1.0945917211173903,1.0944882469278399,-769,-282999,-283626.4,-0.026545943446517582,-330.7870863240652,-0.012786906208045611
2023-08-03T16:45:00-04:00,1.09473,1.09499,1.09457,1.09491,1.0954346702244857,1.0946142222222224,1.0944622222222131,1.0944533333333246,1.0947865000000043,1.0938766000000002,1.0937001000000008,1.095618600000005,1.0946553768939122,1.0945369975422716,1068,-281931,-282864,-0.0263979977711185,-330.61148138038044,0.0146152089518301
2023-08-03T17:00:00-04:00,1.09491,1.09492,1.09403,1.09417,1.0953383900110165,1.0945557777777777,1.0944466666666577,1.09445288888888,1.0947520000000044,1.0939264,1.093704900000001,1.095600900000005,1.09455830151513,1.0945667980338167,-163,-282094,-282429,-0.029608654234970933,-330.7216456861225,-0.012793449753708452
2023-08-03T17:15:00-04:00,1.09417,1.09477,1.09408,1.09474,1.0952478866103554,1.0946144444444443,1.0945344444444354,1.0944695555555468,1.0947215000000043,1.0939720000000002,1.093714800000001,1.095585100000005,1.094594641212104,1.094591438427053,174,-281920,-282234.8,-0.025159005436188635,-330.63100163629474,0.07221536633301964
2023-08-03T17:30:00-04:00,1.09474,1.09482,1.09461,1.09479,1.0951628134137341,1.0946655555555556,1.0946022222222132,1.0944979999999913,1.0946715000000045,1.093998,1.093726300000001,1.095566800000005,1.094633712969683,1.0946067507416424,328,-281592,-282107.2,-0.015050532379785165,-330.61602091027765,0.05574951104937026
2023-08-03T17:45:00-04:00,1.09479,1.09497,1.09435,1.09489,1.09508284460891,1.094723111111111,1.0946944444444355,1.0945479999999912,1.0946395000000044,1.0940400000000001,1.093737400000001,1.095549950000005,1.0946849703757464,1.0946254005933134,4256,-277336,-280974.6,-0.004650187573339737,-330.22727055632856,0.07586421220041738
2023-08-03T18:00:00-04:00,1.09489,1.0950199999999999,1.09474,1.09501,1.09383,1.0947862222222224,1.0947622222222133,1.0946079999999914,1.0946255000000042,1.0940882,1.093750100000001,1.0955341000000047,1.0947499763005972,1.0946443204746505,1120,-276216,-279831.6,0.00629029311215623,-330.10451849904416,0.0557383040935672
2023-08-03T18:15:00-04:00,1.09501,1.09513,1.09496,1.09512,1.0938538,1.0948577777777777,1.0948066666666578,1.0946799999999914,1.0946600000000042,1.0941274,1.093763500000001,1.095517800000005,1.0948239810404778,1.0946974563797203,861,-275355,-278483.8,0.01360731837095375,-330.0180261382438,0.036539023677303606
2023-08-03T18:30:00-04:00,1.09512,1.09522,1.09512,1.09516,1.093904848,1.0949284444444445,1.0948355555555467,1.0947402222222136,1.0946590000000043,1.0941842000000002,1.093775300000001,1.095502100000005,1.0948911848323823,1.0947567651037757,1862,-273493,-276798.4,0.014450791618181318,-329.95001532664355,0.023746460863999175
2023-08-03T18:45:00-04:00,1.09516,1.0952,1.0951,1.09518,1.09398375712,1.0949973333333332,1.0948855555555468,1.0947968888888804,1.0946830000000045,1.0942414000000003,1.093788200000001,1.095485850000005,1.0949489478659058,1.0948198120830201,876,-272617,-275003.4,0.017008607834769113,-329.9340176642014,0.041106026143438244
2023-08-03T19:00:00-04:00,1.09518,1.09523,1.09504,1.09512,1.0940579316927999,1.0950442222222223,1.09490888888888,1.0948397777777692,1.0946980000000044,1.0942872000000003,1.093796800000001,1.095470300000005,1.0949831582927247,1.094879449666416,-690,-273307,-274197.6,0.01874392638513258,-329.9718196693512,0.019179658602080853
2023-08-03T19:15:00-04:00,1.09512,1.09529,1.09508,1.09528,1.094151697157376,1.0951184444444444,1.0950322222222133,1.0948937777777692,1.0947185000000044,1.0943244000000003,1.093806000000001,1.095452550000005,1.09504252663418,1.0949379597331323,417,-272890,-273532.4,0.020122457288892944,-329.91089483919563,0.10144675873035673
2023-08-03T19:30:00-04:00,1.09528,1.09534,1.09516,1.0952,1.0942655274416384,1.0951520000000001,1.0950833333333245,1.0949491111111027,1.0947410000000042,1.0943658000000003,1.093814000000001,1.095430350000005,1.095074021307344,1.0949879677865058,-683,-273573,-273176,0.028095349325963227,-329.960781626136,0.0420191095602522
2023-08-03T19:45:00-04:00,1.0952,1.09524,1.09505,1.09509,1.0943944641486418,1.0951533333333334,1.0951166666666579,1.0950053333333247,1.0947800000000043,1.0944036000000001,1.093820500000001,1.095396350000005,1.0950772170458751,1.0950251742292043,-957,-274530,-273383.4,0.029813078868245965,-330.0569010563771,0.027402515550924558
2023-08-03T20:00:00-04:00,1.09509,1.09524,1.09468,1.09481,1.0945079284508048,1.095092,1.095107777777769,1.0950497777777692,1.0948230000000043,1.0944124000000002,1.093823100000001,1.095367700000005,1.0950237736367001,1.095040139383363,-1423,-275953,-274050.6,0.027820295506004584,-330.42074329765387,-0.007306670076433063
2023-08-03T20:15:00-04:00,1.09481,1.09509,1.09465,1.09498,1.0946077770367082,1.0950664444444445,1.0951044444444356,1.0950888888888801,1.0948630000000044,1.0944420000000001,1.093829000000001,1.095341250000005,1.0950150189093601,1.0950465115066903,1381,-274572,-274303.6,0.02416116606892414,-330.20630426257014,-0.0027397010072944075
2023-08-03T20:30:00-04:00,1.09498,1.09533,1.09486,1.0951899999999999,1.09465,1.0950835555555556,1.0951122222222134,1.0951048888888804,1.0949195000000043,1.0944732000000001,1.093837800000001,1.0953157500000053,1.095050015127488,1.0950480092053518,1436,-273136,-274352.8,0.021411376343251708,-329.93090197211757,0.006391993571461798
2023-08-03T20:45:00-04:00,1.0951899999999999,1.09555,1.095,1.09553,1.09465,1.095167111111111,1.0951533333333243,1.0951188888888803,1.0949760000000044,1.0945292,1.093849700000001,1.095288850000005,1.0951460121019905,1.0950624073642812,2149,-270987,-273835.6,0.018761481296108332,-329.2637483275445,0.033785017714304894
2023-08-03T21:00:00-04:00,1.09553,1.09589,1.09539,1.09552,1.094776,1.0952404444444446,1.0951911111111023,1.0951337777777692,1.0950160000000042,1.0945354000000003,1.093863000000001,1.0952614500000053,1.0952208096815923,1.0950911258914247,-2195,-273182,-273566,0.017177617434164936,-329.28378429187194,0.031045125002283364
2023-08-03T21:15:00-04:00,1.09552,1.09584,1.0955,1.09579,1.09495424,1.095360222222222,1.0952655555555468,1.0951653333333247,1.0950605000000044,1.0945752,1.0938811000000008,1.095233900000005,1.095334647745274,1.0951533007131395,2390,-270792,-272533.8,0.018094364655755747,-328.6947489479257,0.0611805098984539
2023-08-03T21:30:00-04:00,1.09579,1.09616,1.0956299999999999,1.096,1.0951039616,1.0955071111111112,1.095345555555547,1.0952135555555471,1.0951240000000042,1.094644,1.0939024000000008,1.0952073000000053,1.0954677181962191,1.0952438405705114,3164,-267628,-271145,0.021346067631841794,-328.0883918904602,0.06573661529472408
2023-08-03T21:45:00-04:00,1.096,1.09601,1.09544,1.09567,1.095294048512,1.095572,1.095397777777769,1.0952706666666583,1.0951620000000042,1.0946998,1.0939191000000008,1.0951818000000053,1.0955081745569752,1.0953354724564088,-2279,-269907,-270499.2,0.020819065881538694,-328.77458714593496,0.042914536157776705
2023-08-03T22:00:00-04:00,1.09567,1.09611,1.09525,1.09548,1.09616,1.0955884444444444,1.0954411111111024,1.0953282222222138,1.0952275000000042,1.0947702,1.0939329000000009,1.0951602000000054,1.0955025396455802,1.0954067779651266,-2494,-272401,-270782,0.020896815127234385,-329.2070713793262,0.03561351121826631
2023-08-03T22:15:00-04:00,1.09548,1.09591,1.0954,1.09564,1.0961418,1.0956282222222222,1.0955333333333246,1.0953966666666584,1.0952725000000043,1.0948463999999998,1.0939437000000007,1.0951407000000053,1.0955300317164642,1.0954686223721009,2277,-270124,-270170.4,0.019525925655539712,-328.8745048331548,0.07581224139347342
2023-08-03T22:30:00-04:00,1.09564,1.09589,1.09555,1.09575,1.096123964,1.0956715555555556,1.0956188888888803,1.0954673333333251,1.0953205000000044,1.0949167999999998,1.0939549000000008,1.0951224500000054,1.0955740253731714,1.0955164978976806,2180,-267944,-269600.8,0.02371615393996137,-328.65563732192834,0.07032091910353955
2023-08-03T22:45:00-04:00,1.09575,1.09582,1.09542,1.09556,1.09610648472,1.0956597777777777,1.0956599999999912,1.0955302222222139,1.0953540000000044,1.0949445999999998,1.0939667000000008,1.0951021500000053,1.095571220298537,1.0955371983181441,-2208,-270152,-270105.6,0.02566301929808793,-329.0384983760007,0.033784092257982956
2023-08-03T23:00:00-04:00,1.09556,1.09601,1.09543,1.0959,1.0960893550256,1.095707777777778,1.0957011111111026,1.0955908888888806,1.0953985000000042,1.0949829999999998,1.0939839000000007,1.0950832000000055,1.0956369762388296,1.095562958654515,2018,-268134,-269751,0.027752925925439577,-328.4122250545943,0.033773607295117754
2023-08-03T23:15:00-04:00,1.0959,1.0959699999999999,1.09568,1.09575,1.096072567925088,1.0957175555555556,1.095726666666658,1.0956479999999917,1.0954300000000043,1.0950346,1.094001800000001,1.0950633500000053,1.0956595809910636,1.0955943669236117,-1591,-269725,-269215.8,0.026543532959194403,-328.62999127413997,0.020994596173502304
2023-08-03T23:30:00-04:00,1.09575,1.09584,1.09547,1.09549,1.0960561165665863,1.0956702222222223,1.0956933333333247,1.0956799999999918,1.0954465000000044,1.0950563999999998,1.094015100000001,1.0950386500000053,1.0956256647928508,1.0956134935388888,-1347,-271072,-269405.4,0.02466083205221429,-328.94960797502966,-0.027377508464210016
2023-08-03T23:45:00-04:00,1.09549,1.09554,1.09536,1.09542,1.0960399942352546,1.0956155555555558,1.0956288888888803,1.0956819999999918,1.0954585000000043,1.0950693999999999,1.0940342000000007,1.0950200500000054,1.0955845318342807,1.0956155948311106,-1327,-272399,-270296.4,0.020152710248455146,-329.0344010813109,-0.052919708029199354
2023-08-04T00:00:00-04:00,1.09542,1.09554,1.09525,1.09526,1.0960241943505495,1.0955417777777778,1.0955833333333247,1.0956666666666586,1.0954655000000042,1.0950773999999999,1.0940527000000009,1.0950016500000055,1.0955196254674247,1.0956052758648882,-1177,-273576,-270981.2,0.013049660435133212,-329.206316876166,-0.03742002610275188
2023-08-04T00:15:00-04:00,1.09526,1.09532,1.09505,1.09516,1.0960087104635385,1.095457111111111,1.0955477777777691,1.0956359999999918,1.0954595000000042,1.0950875999999998,1.094071800000001,1.0949833500000055,1.0954477003739398,1.0955674206919102,-1173,-274749,-272304.2,0.008220141563944607,-329.31341473420883,-0.02921093949685051
2023-08-04T00:30:00-04:00,1.09516,1.09538,1.09506,1.09508,1.095970362044997,1.0953635555555554,1.095485555555547,1.0955877777777698,1.0954535000000043,1.095092,1.0940914000000008,1.0949660500000054,1.0953741602991518,1.095510336553528,-1175,-275924,-273544,0.005438120836005525,-329.39924694137477,-0.051111679018646085
2023-08-04T00:45:00-04:00,1.09508,1.09522,1.09493,1.0950199999999999,1.095933547563197,1.0952704444444443,1.095404444444436,1.095529999999992,1.0954500000000043,1.0950853999999999,1.0941069000000008,1.0949490500000054,1.0953033282393214,1.0954458692428222,-1326,-277250,-274779.6,0.0005607698458608211,-329.47189916769634,-0.06662103582022537
2023-08-04T01:00:00-04:00,1.0950199999999999,1.09524,1.09478,1.09517,1.0958733347094052,1.0952235555555554,1.0953611111111023,1.0954764444444363,1.0954680000000043,1.095073,1.0941234000000006,1.0949342000000053,1.0952766625914572,1.0953842953942574,1777,-275473,-275394.4,-0.005081687363477548,-329.2284789561932,-0.03559823286721973
2023-08-04T01:15:00-04:00,1.09517,1.09564,1.09517,1.09543,1.0957858679326529,1.0952373333333334,1.0953088888888802,1.0954215555555475,1.0954905000000044,1.095071,1.0941446000000008,1.0949183500000055,1.0953073300731657,1.0953418363154057,1978,-273495,-275378.2,-0.00896335067596129,-328.7588897599955,-0.042887124737676106
2023-08-04T01:30:00-04:00,1.09543,1.0956299999999999,1.09531,1.09549,1.0957053984980407,1.0952735555555557,1.0952799999999914,1.095367999999992,1.0955055000000042,1.095075,1.0941764000000007,1.0949025500000054,1.0953438640585327,1.0953210690523243,1857,-271638,-274756,-0.014922648259161727,-328.6571762776184,-0.02372804015513821
2023-08-04T01:45:00-04:00,1.09549,1.09583,1.09505,1.09521,1.09478,1.0952595555555555,1.0952488888888803,1.0953206666666584,1.0954895000000042,1.0950905999999998,1.0942053000000007,1.0948851000000055,1.0953170912468262,1.0953096552418589,-2184,-273822,-274335.6,-0.019938866314262792,-329.21539223577423,-0.02555933874339866
2023-08-04T02:00:00-04:00,1.09521,1.09583,1.09513,1.09533,1.0948010000000001,1.0952757777777777,1.0952388888888802,1.0952875555555475,1.0954800000000042,1.0950935999999998,1.0942354000000007,1.0948697500000053,1.095319672997461,1.0953129241934871,3822,-270000,-272885.6,-0.02053021240472581,-328.79662323256974,-0.00821602672948691
2023-08-04T02:15:00-04:00,1.09533,1.09564,1.09508,1.09527,1.09482158,1.095282,1.0952399999999913,1.0952633333333253,1.0954540000000041,1.095105,1.0942600000000007,1.0948543000000055,1.0953097383979689,1.0953195393547894,-2130,-272130,-272217,-0.02081298438096145,-328.9133003983553,0.0009130252177624959
2023-08-04T02:30:00-04:00,1.09527,1.09528,1.09477,1.09489,1.09583,1.095212,1.0952099999999914,1.0952435555555475,1.0953985000000042,1.0951064,1.0942812000000008,1.0948358500000055,1.0952257907183751,1.0953032314838311,-2317,-274447,-272407.4,-0.020279108345037603,-329.7171752420013,-0.02465393184557439
2023-08-04T02:45:00-04:00,1.09489,1.09503,1.09461,1.09482,1.0958088000000001,1.095134,1.0951811111111025,1.0952237777777698,1.0953560000000042,1.0951054,1.0942899000000006,1.0948154500000054,1.0951446325747,1.0952633851870648,-2192,-276639,-273407.6,-0.018254307412092597,-329.8573171740676,-0.023742557621374602
2023-08-04T03:00:00-04:00,1.09482,1.09526,1.0944099999999999,1.0950199999999999,1.095760848,1.0951017777777776,1.0951811111111025,1.0952102222222142,1.0953330000000043,1.0951107999999998,1.094300300000001,1.0947919000000055,1.09511970605976,1.0952239081496515,4254,-272385,-273120.2,-0.01597677433473056,-329.0802031279231,0
2023-08-04T03:15:00-04:00,1.0950199999999999,1.09508,1.09461,1.09488,1.09567979712,1.0950415555555557,1.0951488888888803,1.0951922222222144,1.0952950000000043,1.0951222,1.0943123000000008,1.0947676500000054,1.0950717648478079,1.0951743265197211,-2928,-275313,-274182.8,-0.014646845384987176,-329.4545524548755,-0.026479907229005676
2023-08-04T03:30:00-04:00,1.09488,1.09542,1.09487,1.09489,1.0956036092928,1.0949897777777777,1.0950888888888803,1.0951619999999922,1.0952520000000043,1.095141,1.0943317000000008,1.0947452500000054,1.0950354118782464,1.0951194612157764,3006,-272307,-274218.2,-0.01394299934899042,-329.4270973913073,-0.04929571036031376
2023-08-04T03:45:00-04:00,1.09489,1.09497,1.0945799999999999,1.09475,1.095531992735232,1.094922,1.0950066666666582,1.0951213333333256,1.0952115000000044,1.0951524,1.0943576000000008,1.0947219000000055,1.094978329502597,1.0950699689726209,-2593,-274900,-274308.8,-0.01580449212780288,-329.7586558127013,-0.06754968096469935
2023-08-04T04:00:00-04:00,1.09475,1.09523,1.09445,1.09498,1.0954646731711182,1.0949166666666665,1.0949811111111027,1.0950813333333256,1.0951655000000042,1.0951708,1.0943879000000007,1.0947053000000055,1.0949786636020775,1.0950367751780965,2544,-272356,-273452.2,-0.01793974662590243,-329.224177621333,-0.0210005387094669
2023-08-04T04:15:00-04:00,1.09498,1.09525,1.09467,1.09478,1.095401392780851,1.0948764444444445,1.0949199999999917,1.0950291111111035,1.0951170000000043,1.0951784,1.0944156000000007,1.0946884500000056,1.094938930881662,1.095000620142477,-2039,-274395,-273854.2,-0.01699706366901278,-329.59660451497484,-0.05021317776376329
2023-08-04T04:30:00-04:00,1.09478,1.0949,1.09381,1.09395,1.095341909214,1.0946824444444445,1.094773333333325,1.0949539999999924,1.0950400000000042,1.0951629999999999,1.094432700000001,1.0946614500000056,1.0947411447053295,1.094934496113981,-2744,-277139,-274219.4,-0.02177307730922015,-331.6769494244546,-0.12051822838204168
2023-08-04T04:45:00-04:00,1.09395,1.09429,1.09376,1.09402,1.09525,1.0945317777777777,1.0946766666666585,1.0948715555555482,1.0949700000000042,1.0951454,1.094454100000001,1.0946367000000055,1.0945969157642637,1.0948467968911846,2441,-274698,-274697.6,-0.0267973395745449,-331.5207539859062,-0.07946003708134391
2023-08-04T05:00:00-04:00,1.09402,1.09423,1.09379,1.09419,1.095101,1.0944344444444445,1.0946066666666585,1.094791555555548,1.0949165000000043,1.0951345999999997,1.094474200000001,1.0946138500000056,1.0945155326114109,1.0947542375129473,2169,-272529,-274223.4,-0.02784254220393717,-331.18371261554734,-0.0575437058146461
2023-08-04T05:15:00-04:00,1.09419,1.09437,1.09413,1.09423,1.0949669000000002,1.0943591111111113,1.0945188888888806,1.0946991111111037,1.0948700000000042,1.0951209999999998,1.0944988000000009,1.0945921000000054,1.0944584260891288,1.0946501900103576,1596,-270933,-273938.8,-0.028752779159639107,-331.12536808671774,-0.07214480100818674
2023-08-04T05:30:00-04:00,1.09423,1.09428,1.09351,1.09422,1.0948462100000003,1.0942993333333333,1.0944455555555475,1.0946042222222148,1.0948270000000044,1.0951219999999997,1.094524200000001,1.0945668000000055,1.094410740871303,1.0945445520082857,-2302,-273235,-273706.8,-0.031972518682695523,-331.1464057113489,-0.06028057869356504
2023-08-04T05:45:00-04:00,1.09422,1.09459,1.09398,1.09445,1.0946858648000002,1.0943002222222222,1.0943966666666585,1.0945288888888816,1.0947985000000044,1.0951161999999999,1.094544100000001,1.0945440500000054,1.0944185926970424,1.0944800416066285,1872,-271363,-272551.6,-0.033160816476172694,-330.752919940663,-0.04018668542045283
2023-08-04T06:00:00-04:00,1.09445,1.09463,1.09399,1.09411,1.09351,1.0942428888888889,1.0943255555555473,1.0944586666666594,1.0947455000000046,1.0951025999999997,1.094550300000001,1.0945228500000053,1.094356874157634,1.0944320332853024,-2078,-273441,-272300.2,-0.0363287122095692,-331.3984679328052,-0.058460835807259554
2023-08-04T06:15:00-04:00,1.09411,1.09459,1.09392,1.09452,1.0935324,1.0942817777777776,1.0942744444444363,1.0943922222222149,1.0947000000000044,1.0950951999999998,1.094567600000001,1.0945011500000055,1.0943894993261072,1.0944068266282418,1704,-271737,-272141.8,-0.03560331856835526,-330.7599215343626,-0.04200989972420747
2023-08-04T06:30:00-04:00,1.09452,1.09487,1.09413,1.09462,1.093554352,1.0943508888888887,1.0942566666666584,1.0943397777777704,1.0946565000000046,1.0950874,1.094587800000001,1.0944826000000054,1.0944355994608856,1.0944022613025932,2113,-269624,-271880,-0.03536967421247912,-330.56686887200834,-0.014614808454681306
2023-08-04T06:45:00-04:00,1.09462,1.0948,1.09391,1.09444,1.09360697792,1.0943875555555556,1.0943111111111028,1.0943128888888816,1.0946180000000045,1.0950737999999998,1.094600600000001,1.0944627000000053,1.0944364795687085,1.0944074090420743,-1701,-271325,-271498,-0.033909630291300064,-330.84658237989214,0.044791809497701125
2023-08-04T07:00:00-04:00,1.09444,1.09448,1.09402,1.09409,1.0936574988032,1.0943433333333332,1.0943188888888808,1.094297333333326,1.0945560000000045,1.0950524,1.0946183000000012,1.0944424000000055,1.0943671836549669,1.0943971272336592,-1775,-273100,-271845.4,-0.02775983242280563,-331.41422427894565,0.006398420504196861
2023-08-04T07:15:00-04:00,1.09409,1.09456,1.09392,1.09412,1.093705998851072,1.0943035555555556,1.0943111111111028,1.0942944444444371,1.0944985000000045,1.0950311999999998,1.094636300000001,1.0944229000000054,1.0943177469239735,1.094389301786927,1928,-271172,-271391.6,-0.021583416139893955,-331.3613584269591,-0.006397426406749696
2023-08-04T07:30:00-04:00,1.09412,1.09453,1.0941,1.0943,1.0937525588970292,1.0943013333333333,1.0943188888888808,1.0943033333333259,1.0944690000000046,1.0950148,1.0946510000000012,1.0944053500000053,1.0943141975391788,1.0943742414295414,1895,-269277,-270899.6,-0.01635901422995534,-331.04960103288886,0.006397192546358123
2023-08-04T07:45:00-04:00,1.0943,1.0944,1.09376,1.09378,1.09487,1.0941935555555555,1.0942699999999919,1.094305999999993,1.0944170000000046,1.0949847999999998,1.094654600000001,1.0943840000000054,1.094207358031343,1.0943285931436328,-2778,-272055,-271385.8,-0.015641887364268484,-332.36967779428903,-0.04021129206192502
2023-08-04T08:00:00-04:00,1.09378,1.09476,1.09348,1.09452,1.0948478,1.0942435555555554,1.0942777777777697,1.094299333333326,1.0943920000000045,1.0949712,1.0946685000000012,1.0943701500000054,1.0942698864250744,1.094295274514906,2961,-269094,-270939.6,-0.011595597762634902,-330.36640474120713,0.006395906619764676
2023-08-04T08:15:00-04:00,1.09452,1.09538,1.09447,1.09488,1.09348,1.0943640000000001,1.0943633333333254,1.094308222222215,1.0943920000000047,1.0949669999999998,1.094685300000001,1.0943584000000053,1.0943919091400596,1.0943002196119245,3909,-265185,-269356.6,-0.007057476225411693,-329.08069045549234,0.07037683596714768
2023-08-04T08:30:00-04:00,1.09488,1.0984,1.09332,1.09795,1.0984,1.0950813333333334,1.0947444444444365,1.0943948888888815,1.0945450000000045,1.0950297999999998,1.094721100000001,1.0943592500000054,1.0951035273120477,1.0944573756895393,25007,-240178,-263157.8,0.014669933032769368,-258.9620564499414,0.3133793809158393
2023-08-04T08:45:00-04:00,1.09795,1.09979,1.09786,1.0988499999999999,1.09332,1.0959024444444443,1.0952144444444365,1.0945739999999926,1.0947500000000046,1.0951072,1.0947746000000012,1.0943641000000055,1.0958528218496382,1.0947651005516312,12613,-227565,-254815.4,0.03699474765952529,-248.62306104942337,0.38643547532476624
2023-08-04T09:00:00-04:00,1.0988499999999999,1.10219,1.09861,1.1021,1.09332,1.0972795555555557,1.0960655555555479,1.0949331111111038,1.0951060000000046,1.0952453999999998,1.094859300000001,1.0943869500000054,1.0971022574797105,1.0953440804413048,10898,-216667,-243737.8,0.07332663683705154,-216.39072724589954,0.6999013193962209
2023-08-04T09:15:00-04:00,1.1021,1.10235,1.10105,1.10214,1.0936748,1.0984944444444444,1.0969599999999922,1.0954695555555483,1.0954740000000045,1.0953776,1.0949534000000012,1.0944096000000054,1.0981098059837684,1.0961120643530435,9908,-206759,-231270.8,0.11247047286049618,-216.03112285428517,0.7357712802420177
2023-08-04T09:30:00-04:00,1.10214,1.10299,1.10204,1.10258,1.094195312,1.0996184444444443,1.097899999999992,1.0961768888888817,1.0959055000000046,1.0955188,1.0950271000000011,1.0944353000000056,1.0990038447870147,1.0970344514824346,9406,-197353,-217704.4,0.15601384665279106,-212.27602822020967,0.7732241436039842
2023-08-04T09:45:00-04:00,1.10258,1.10282,1.10112,1.10123,1.09489888704,1.1002844444444444,1.098669999999992,1.0969619999999929,1.0962660000000046,1.0956276,1.095101400000001,1.0944523500000054,1.0994490758296118,1.0979035611859476,-7461,-204814,-210631.6,0.18920177555068865,-221.41128371187443,0.6332815498492077
2023-08-04T10:00:00-04:00,1.10123,1.10151,1.10025,1.10111,1.0955461760768,1.1007724444444444,1.0994844444444363,1.0978159999999928,1.0966120000000044,1.0957298,1.0951869000000012,1.0944661000000055,1.0997812606636894,1.0986892489487579,-8458,-213272,-207773,0.22045970652009292,-222.3329440371463,0.6701530472307099
2023-08-04T10:15:00-04:00,1.10111,1.10253,1.10111,1.1017,1.096141681990656,1.1012155555555554,1.1002822222222142,1.0986593333333259,1.0969855000000046,1.0958504,1.0952751000000012,1.0944896500000054,1.1001650085309516,1.099301799159006,6217,-207055,-205850.6,0.2599902578545227,-219.0017328048451,0.6559953221503457
2023-08-04T10:30:00-04:00,1.1017,1.10283,1.1016,1.10266,1.0966895474314036,1.101691111111111,1.1011466666666587,1.0994966666666592,1.0974075000000043,1.0959940000000001,1.0953821000000012,1.0945214500000053,1.1006640068247613,1.0998126393272047,5749,-201306,-204760,0.2974954399224387,-213.9921657720772,0.710580154902811
2023-08-04T10:45:00-04:00,1.10266,1.10277,1.10174,1.10233,1.0971935836368913,1.1019277777777776,1.1016333333333252,1.1002433333333257,1.0978015000000043,1.0961278,1.095487100000001,1.0945532500000055,1.100997205459809,1.1002113114617635,-6370,-207676,-206824.6,0.33007989421503636,-215.89855577443478,0.3989252698210347
2023-08-04T11:00:00-04:00,1.10233,1.10351,1.10184,1.10347,1.09765729694594,1.102295111111111,1.1021466666666584,1.1009386666666592,1.0982695000000045,1.0962822,1.0955995000000014,1.0945899000000054,1.1014917643678472,1.1006198491694108,4959,-202717,-206405.2,0.34110453392337753,-210.77009152144376,0.4204395504391017
2023-08-04T11:15:00-04:00,1.10347,1.10411,1.10334,1.10365,1.0982425672513458,1.1025957777777777,1.1023188888888809,1.1015055555555482,1.0987260000000043,1.096444,1.0956943000000012,1.0946256000000054,1.1019234114942777,1.1010482793355283,4112,-198605,-203471.8,0.34330427273981395,-210.0993347269679,0.14064059522728792
2023-08-04T11:30:00-04:00,1.10365,1.10417,1.10342,1.1040699999999999,1.0989466591811843,1.1029459999999998,1.1025333333333254,1.1019557777777702,1.0991985000000042,1.0966074000000001,1.095795200000001,1.0946678500000053,1.1023527291954223,1.1014858234684224,3633,-194972,-201055.2,0.31970757312321463,-208.7167768508301,0.17511386938138418
2023-08-04T11:45:00-04:00,1.1040699999999999,1.10419,1.10341,1.1034599999999999,1.0996779268958186,1.1031313333333332,1.1026311111111031,1.1022526666666592,1.0996495000000042,1.0967616,1.0958981000000012,1.0947101000000055,1.1025741833563378,1.1018678587747377,-2979,-197951,-200384.2,0.29330245939048527,-210.36267792594307,0.07981280269912315
2023-08-04T12:00:00-04:00,1.1034599999999999,1.10392,1.10287,1.10334,1.1003998585924877,1.1032731111111111,1.1028655555555475,1.1024991111111038,1.1001120000000042,1.0969186,1.0959875000000012,1.0947590000000056,1.1027273466850702,1.10221388701979,-2751,-200702,-198989.4,0.2615653655799816,-210.66184599728206,0.19160393378313853
2023-08-04T12:15:00-04:00,1.10334,1.10381,1.10311,1.10373,1.1010062812176897,1.1034460000000001,1.1031566666666588,1.1027011111111038,1.1005925000000043,1.0970848,1.0960771000000014,1.0948177000000054,1.1029278773480562,1.1025011096158317,2322,-198380,-198122,0.24245681960143423,-209.8410835849701,0.23794171336197714
2023-08-04T12:30:00-04:00,1.10373,1.10379,1.10316,1.10348,1.1015156762228593,1.1035106666666665,1.1033544444444365,1.1029082222222149,1.1010515000000043,1.0972492,1.0961633000000013,1.0948749500000055,1.1030383018784449,1.1027240876926652,-2053,-200433,-198487.6,0.22339720004023464,-210.30609767356077,0.16156848506854088
2023-08-04T12:45:00-04:00,1.10348,1.1038999999999999,1.10334,1.10338,1.1019435680272018,1.1035157777777778,1.1034344444444364,1.103088444444437,1.101531500000004,1.0974135999999999,1.0962506000000012,1.0949282500000055,1.103106641502756,1.1028748701541318,-1837,-202270,-199947.2,0.1993002199842462,-210.47257101245225,0.06529664629169953
2023-08-04T13:00:00-04:00,1.10338,1.10373,1.10324,1.10365,1.1023029971428495,1.103558888888889,1.1035811111111031,1.1032784444444372,1.1019880000000042,1.0975849999999998,1.0963385000000012,1.0949821000000055,1.1032153132022047,1.1030030961233053,2124,-200146,-200386.2,0.16553789441495978,-209.95282260301943,0.11974635544709732
2023-08-04T13:15:00-04:00,1.10365,1.1038999999999999,1.10327,1.10328,1.1026049175999937,1.1034986666666666,1.1035599999999919,1.1034173333333261,1.1024080000000043,1.0977502,1.0964178000000013,1.0950301000000053,1.1032282505617637,1.103103276898644,-1635,-201781,-200602,0.13624398523298642,-210.500958334456,-0.017218411012525258
2023-08-04T13:30:00-04:00,1.10328,1.10357,1.10315,1.10339,1.1028585307839947,1.1034646666666668,1.103531111111103,1.103492222222215,1.1026800000000043,1.0979146,1.0964938000000013,1.0950774000000054,1.103260600449411,1.103169821518915,1495,-200286,-200983.2,0.09871045351202049,-210.35190279098555,-0.023558193267786614
2023-08-04T13:45:00-04:00,1.10339,1.10345,1.10278,1.10284,1.10419,1.1033264444444446,1.1033944444444364,1.1035002222222148,1.1028795000000042,1.0980628,1.0965669000000013,1.0951225000000053,1.1031764803595288,1.1031974572151317,-1518,-201804,-201257.4,0.07022668424014011,-211.10857087751893,-0.11140597969330228
2023-08-04T14:00:00-04:00,1.10284,1.10284,1.10211,1.10228,1.1041618,1.1031035555555557,1.1032633333333253,1.1034659999999925,1.1028885000000044,1.0981986,1.0966368000000013,1.0951651000000053,1.102997184287623,1.1031755657721054,-2615,-204419,-201687.2,0.0391755221426538,-212.43641535178566,-0.10693636380113089
2023-08-04T14:15:00-04:00,1.10228,1.10232,1.10165,1.10186,1.1040797279999999,1.102822888888889,1.1030988888888809,1.1033695555555483,1.1028745000000044,1.0983315999999999,1.0967111000000012,1.0952016000000055,1.1027697474300984,1.103086452617684,-2588,-207007,-203059.4,0.02570421030068578,-213.42251688678553,-0.13413816230716968
2023-08-04T14:30:00-04:00,1.10186,1.10192,1.10121,1.10127,1.1039339443199998,1.102457111111111,1.1028255555555475,1.1032226666666591,1.1028090000000044,1.0984504,1.0967720000000012,1.0952358500000055,1.1024697979440787,1.102934762094147,-2368,-209375,-204578.2,0.010691418711809193,-214.69048196401877,-0.22288059579789699
2023-08-04T14:45:00-04:00,1.10127,1.1015,1.10084,1.10091,1.1037160287744,1.1020740000000002,1.1025399999999919,1.103024444444437,1.1027930000000044,1.0985631999999999,1.0968341000000013,1.0952651500000052,1.102157838355263,1.1027142096753173,-3125,-212500,-207021,-0.007669357419010003,-215.7120298133198,-0.23289955413781502
2023-08-04T15:00:00-04:00,1.10091,1.10108,1.10064,1.10091,1.10342842589696,1.101748,1.1022655555555476,1.1027986666666592,1.1027830000000045,1.0986835999999998,1.0968950000000013,1.0952925500000052,1.1019082706842105,1.102460567740254,0,-212500,-209160.2,-0.02959393732347549,-215.7120298133198,-0.22385760118907105
2023-08-04T15:15:00-04:00,1.10091,1.10101,1.10067,1.10082,1.1030938147893248,1.101458888888889,1.101951111111103,1.102536222222215,1.1027390000000044,1.0988035999999999,1.0969545000000014,1.0953199500000053,1.1016906165473683,1.102199254192203,-1770,-214270,-211130.4,-0.051557922447370466,-215.85672829003474,-0.25642187287637475
2023-08-04T15:30:00-04:00,1.10082,1.10088,1.10052,1.10065,1.1027993570146057,1.1011986666666667,1.1016588888888807,1.1022482222222147,1.1026385000000043,1.0989162,1.0970135000000012,1.0953471500000054,1.1014824932378946,1.1019418033537622,-1779,-216049,-212938.8,-0.07423312803926596,-216.13145985377813,-0.23838010296571424
2023-08-04T15:45:00-04:00,1.10065,1.10077,1.10037,1.10076,1.102480247032561,1.101018888888889,1.1013666666666586,1.1019564444444367,1.1025600000000044,1.0990338,1.0970780000000013,1.0953779500000054,1.1013379945903157,1.1017154426830094,1536,-214513,-213966.4,-0.08888925360382821,-215.97795056381304,-0.23835633819412283
2023-08-04T16:00:00-04:00,1.10076,1.1008,1.1004,1.10078,1.1021426075073513,1.1009015555555557,1.1011377777777698,1.1016759999999926,1.1024255000000045,1.0991516,1.0971463000000012,1.0954080500000052,1.1012263956722526,1.1015291541464074,1366,-213147,-214095.8,-0.10587431398929889,-215.95313134799835,-0.18679046824561593
2023-08-04T16:15:00-04:00,1.10078,1.10078,1.10062,1.10074,1.101858990306175,1.100822,1.1009666666666587,1.1014162222222148,1.1022800000000044,1.0992714,1.0972119000000011,1.095439750000005,1.101129116537802,1.101373323317126,-518,-213665,-214328.8,-0.11314405434275997,-215.97195436440492,-0.13971041840547546
2023-08-04T16:30:00-04:00,1.10074,1.1009,1.10072,1.10083,1.101620751857187,1.1007946666666666,1.1008522222222143,1.101196444444437,1.1021180000000044,1.0993883999999996,1.0972796000000011,1.0954731000000053,1.1010692932302417,1.1012490586537005,596,-213069,-214088.6,-0.11412991117826594,-215.92322351061568,-0.09347830032854322
2023-08-04T16:45:00-04:00,1.10083,1.10112,1.1008,1.1008,1.101420631560037,1.1007842222222224,1.100799999999992,1.1010246666666592,1.1019850000000044,1.0995087999999997,1.0973436000000012,1.095505650000005,1.1010154345841934,1.1011556469229604,-763,-213832,-213645.2,-0.10963498502338832,-215.9440169119583,-0.042677999037472235
2023-08-06T17:00:00-04:00,1.1008,1.10166,1.1008,1.10123,1.10037,1.1008702222222222,1.1008355555555476,1.1009184444444369,1.1018795000000046,1.0996543999999997,1.0974087000000012,1.0955403500000052,1.1010583476673548,1.101099717538368,115,-213717,-213486,-0.10037193837905357,-215.8990950369583,0.029066862867979756
2023-08-06T17:15:00-04:00,1.10123,1.10164,1.10101,1.10137,1.1003958,1.100977111111111,1.1008866666666586,1.1008682222222148,1.1017615000000045,1.0998013999999998,1.097473400000001,1.0955783000000052,1.1011206781338838,1.1010785740306943,145,-213572,-213571,-0.08769192738108028,-215.88066110399242,0.04178361537272846
2023-08-06T17:30:00-04:00,1.10137,1.10166,1.10111,1.10124,1.100421084,1.1010477777777778,1.1009333333333253,1.100861555555548,1.1016495000000046,1.0999423999999998,1.097538500000001,1.095614600000005,1.1011445425071071,1.1010816592245551,-732,-214304,-213698.8,-0.073943864383561,-215.96706258578325,0.038153376573834684
2023-08-06T17:45:00-04:00,1.10124,1.10132,1.10097,1.10106,1.10044586232,1.101073111111111,1.100978888888881,1.1008868888888814,1.1015335000000044,1.1000789999999998,1.0976000000000012,1.095650050000005,1.1011276340056857,1.1010933273796442,-121,-214425,-213970,-0.06131222159517641,-215.98684029091567,0.0372507154863055
2023-08-06T18:00:00-04:00,1.10106,1.10143,1.1008,1.10104,1.1004701450735999,1.1010853333333332,1.101009999999992,1.1009288888888815,1.1014030000000044,1.1002153999999997,1.0976687000000012,1.095686800000005,1.1011101072045486,1.101112261903715,-1229,-215654,-214334.4,-0.04766184601111201,-216.00916423329835,0.025436970820165883
2023-08-06T18:15:00-04:00,1.10104,1.10117,1.10076,1.10076,1.1004939421721278,1.1010353333333331,1.1010077777777696,1.100963333333326,1.1012770000000045,1.1003415999999997,1.0977289000000012,1.0957218500000052,1.1010400857636389,1.1011086095229718,-1853,-217507,-215092.4,-0.03517256825007955,-216.4803914366698,-0.0018168934755474321
2023-08-06T18:30:00-04:00,1.10076,1.10077,1.10032,1.10038,1.10166,1.1009097777777777,1.1009677777777698,1.1009795555555482,1.1011265000000043,1.1004669999999996,1.0977848000000012,1.0957555500000051,1.1009080686109112,1.1010660876183773,-750,-218257,-216029.4,-0.02626922518083839,-216.73930346108932,-0.03270527099952195
2023-08-06T18:45:00-04:00,1.10038,1.10054,1.10026,1.10053,1.1016332,1.1008222222222221,1.1009344444444364,1.1009797777777703,1.1010110000000044,1.1005871999999997,1.097841200000001,1.095789300000005,1.100832454888729,1.1010036700947017,639,-217618,-216692.2,-0.015811056148886938,-216.65219718871063,-0.027252164276043257
2023-08-06T19:00:00-04:00,1.10053,1.10054,1.10018,1.10026,1.101578272,1.1006873333333334,1.1008744444444365,1.1009588888888815,1.1009100000000043,1.1006999999999996,1.097893700000001,1.095821900000005,1.1007179639109832,1.1009217360757613,-1479,-219097,-217626.6,-0.009831110772553213,-217.01504963253313,-0.049055232558138165
2023-08-06T19:15:00-04:00,1.10026,1.10038,1.10014,1.10023,1.10149437568,1.1005584444444443,1.100763333333325,1.1009095555555481,1.1008285000000044,1.1008157999999997,1.0979448000000012,1.095854150000005,1.1006203711287865,1.1008237888606085,-636,-219733,-218442.4,-0.0061422856134378,-217.03239098821268,-0.0908075515559774
2023-08-06T19:30:00-04:00,1.10023,1.1002399999999999,1.10012,1.10016,1.1013860256256,1.1004377777777776,1.1006288888888807,1.1008337777777701,1.1007730000000042,1.1009371999999997,1.097994800000001,1.095885050000005,1.1005282969030292,1.1007214310884865,-467,-220200,-218981,-0.008508988944127797,-217.0621029575282,-0.10986317041502251
2023-08-06T19:45:00-04:00,1.10016,1.10027,1.10009,1.1002399999999999,1.1012594230630401,1.10036,1.10051777777777,1.1007437777777702,1.1007395000000042,1.1010595999999997,1.098045400000001,1.095916800000005,1.1004706375224234,1.1006339448707891,997,-219203,-219170.2,-0.014319272182720317,-216.98960441186225,-0.09080672696234353
2023-08-06T20:00:00-04:00,1.1002399999999999,1.10097,1.10004,1.10081,1.1011190922954752,1.1004184444444443,1.100489999999992,1.1006548888888812,1.1007345000000044,1.1011897999999996,1.0981023000000012,1.095949550000005,1.1005385100179388,1.100575155896631,1729,-217474,-219141.4,-0.017793178632384214,-216.09386348261017,-0.022705392984929202
2023-08-06T20:15:00-04:00,1.10081,1.10099,1.10066,1.1007,1.10004,1.1004604444444444,1.1004522222222142,1.1005704444444366,1.1007285000000042,1.1013281999999995,1.098156500000001,1.095981250000005,1.100570808014351,1.1005457247173047,-1451,-218925,-219107,-0.020155402958567666,-216.2388567148665,-0.030879895371649254
2023-08-06T20:30:00-04:00,1.1007,1.10111,1.10067,1.1011,1.10004,1.10059,1.100489999999992,1.10051577777777,1.1007510000000043,1.1014597999999998,1.0982155000000011,1.0960147500000048,1.1006766464114808,1.1005569797738435,995,-217930,-218746.4,-0.020821373552864043,-215.877268634554,0.03088775028162424
2023-08-06T20:45:00-04:00,1.1011,1.10117,1.10079,1.101,1.1000827999999998,1.100692,1.1005588888888809,1.1005017777777701,1.1007630000000042,1.1015821999999995,1.0982746000000012,1.0960475500000049,1.1007413171291847,1.1005995838190745,-1704,-219634,-218633.2,-0.020154853646711046,-216.0320229711265,0.0563441720133104
2023-08-06T21:00:00-04:00,1.101,1.101,1.1001,1.10027,1.10117,1.1006342222222223,1.1005299999999918,1.1005042222222143,1.1007375000000041,1.1016285999999995,1.0983292000000011,1.0960761500000047,1.1006470537033477,1.1006348670552595,-1799,-221433,-219079.2,-0.019034822043645788,-217.22482042798373,-0.023624980691114912
2023-08-06T21:15:00-04:00,1.10027,1.10037,1.09962,1.09964,1.10117,1.1004562222222223,1.100461111111103,1.1004984444444366,1.1006825000000042,1.1016443999999996,1.098375800000001,1.0961024000000048,1.100445642962678,1.1006162936442074,-1945,-223378,-220260,-0.022189640306078607,-218.33850161532888,-0.05635031719775916
2023-08-06T21:30:00-04:00,1.09964,1.09989,1.09951,1.09971,1.101108,1.100306,1.1004033333333252,1.100488666666659,1.1006265000000042,1.1015965999999997,1.098421000000001,1.0961294000000048,1.1002985143701425,1.1005618349153656,2095,-221283,-220731.6,-0.022731441901735736,-218.20513978782168,-0.047262845041498226
2023-08-06T21:45:00-04:00,1.09971,1.10012,1.09962,1.10006,1.10101212,1.1002373333333333,1.1003922222222142,1.1004691111111033,1.100589500000004,1.1015549999999996,1.098466300000001,1.0961580000000049,1.100250811496114,1.1004766679322924,1624,-219659,-221077.4,-0.020945294317673852,-217.688276251071,-0.00908958696916712
2023-08-06T22:00:00-04:00,1.10006,1.1002399999999999,1.09974,1.09981,1.1009219928,1.1001208888888887,1.1003444444444364,1.1004262222222145,1.1005185000000042,1.1014995999999995,1.098509200000001,1.0961861000000048,1.1001626491968912,1.1003609343458336,-1420,-221079,-221366.4,-0.019842849477948628,-218.01098592145271,-0.03908238202573352
2023-08-06T22:15:00-04:00,1.09981,1.10019,1.09972,1.1001,1.100837273232,1.100072,1.1002655555555476,1.1003733333333254,1.1004550000000042,1.1014769999999996,1.098552300000001,1.0962167000000047,1.100150119357513,1.1002615474766668,1289,-219790,-221037.8,-0.016226411665093646,-217.67109994114688,-0.06449796059265345
2023-08-06T22:30:00-04:00,1.1001,1.10038,1.10002,1.10004,1.10075763683808,1.1000268888888889,1.1001922222222142,1.1003195555555478,1.1003950000000042,1.1014555999999995,1.098592700000001,1.0962475500000048,1.1001280954860104,1.1001980379813332,-1441,-221231,-220608.4,-0.017469278389140044,-217.7496927963421,-0.05996184246389615
2023-08-06T22:45:00-04:00,1.10004,1.10017,1.09977,1.10004,1.1006827786277953,1.0999964444444443,1.1000744444444366,1.1002537777777701,1.1003440000000042,1.1014223999999997,1.098636400000001,1.096277750000005,1.1001104763888083,1.1001604303850665,0,-221231,-220598,-0.01827510370868541,-217.7496927963421,-0.09626736899464726
2023-08-06T23:00:00-04:00,1.10004,1.10014,1.09992,1.10003,1.1006124119101275,1.0999875555555556,1.0999666666666588,1.100168666666659,1.1002935000000043,1.1013697999999996,1.0986819000000012,1.0963074000000048,1.1000943811110466,1.100129144308053,-1229,-222460,-221158.2,-0.023542741110491986,-217.76086511734843,-0.08810172570389786
2023-08-06T23:15:00-04:00,1.10003,1.10022,1.09996,1.10012,1.1005462671955197,1.1000182222222223,1.0999499999999918,1.1000897777777703,1.1002615000000044,1.1013255999999996,1.0987267000000012,1.0963352000000048,1.1000995048888373,1.1001165154464423,1128,-221332,-221208.8,-0.027559953068147566,-217.66857672521374,-0.013633017350295335
2023-08-06T23:30:00-04:00,1.10012,1.1002,1.09969,1.09973,1.1004840911637885,1.0999742222222222,1.0999599999999918,1.100028666666659,1.1002290000000046,1.1012507999999996,1.098766500000001,1.0963607000000046,1.1000256039110698,1.1000916123571536,-1413,-222745,-221799.8,-0.028011301469174084,-218.16949480687742,0.008184496744402307
2023-08-06T23:45:00-04:00,1.09973,1.09979,1.0995,1.09957,1.1004256456939612,1.0998962222222224,1.0999444444444364,1.0999791111111032,1.1001810000000043,1.1011691999999995,1.0988066000000012,1.0963866500000048,1.0999344831288558,1.1000528898857227,-1354,-224099,-222373.4,-0.025142669173875695,-218.36648861444857,-0.01273062898400751
2023-08-07T00:00:00-04:00,1.09957,1.09957,1.09932,1.09948,1.1003515940384443,1.0998033333333332,1.099879999999992,1.0999402222222145,1.1001420000000044,1.1010773999999994,1.098842400000001,1.0964131500000045,1.0998435865030847,1.099999511908578,-1557,-225656,-223258.4,-0.02268959576825628,-218.49392934127803,-0.05272439685108311
2023-08-07T00:15:00-04:00,1.09948,1.09952,1.09916,1.09924,1.1002484346346,1.0996753333333333,1.0998166666666587,1.0999102222222146,1.1000925000000046,1.1009929999999997,1.098877300000001,1.0964395500000048,1.0997228692024676,1.0999252095268621,-1147,-226803,-224127,-0.025729284981849627,-218.74430224483245,-0.05182713377764882
2023-08-07T00:30:00-04:00,1.09924,1.09952,1.09924,1.09945,1.100117822478448,1.099602,1.0997444444444364,1.0998691111111036,1.1000570000000045,1.1009151999999995,1.098916900000001,1.0964660000000048,1.099668295361974,1.0998389676214895,948,-225855,-225031.6,-0.025626263456747157,-218.56319529821477,-0.05908553767839645
2023-08-07T00:45:00-04:00,1.09945,1.09971,1.09945,1.09965,1.1000028837810343,1.0995831111111112,1.099701111111103,1.0998173333333257,1.1000275000000044,1.1008335999999996,1.098959200000001,1.0964967000000048,1.0996646362895792,1.0997667740971913,1214,-224641,-225410.8,-0.027509881696416928,-218.34235760664174,-0.03545325624521749
2023-08-07T01:00:00-04:00,1.09965,1.09974,1.09919,1.09927,1.0999017377273101,1.0994968888888887,1.0996155555555474,1.0997515555555482,1.0999505000000043,1.1007493999999993,1.0989993000000011,1.0965260000000048,1.0995857090316634,1.0996970192777529,-1579,-226220,-225835,-0.030311924508232328,-218.88800394865973,-0.06999745463800748
2023-08-07T01:15:00-04:00,1.09927,1.09945,1.09905,1.0992899999999999,1.0998127292000328,1.0994317777777778,1.0995333333333255,1.0996822222222147,1.0998800000000044,1.1006675999999995,1.099040600000001,1.0965562000000046,1.0995265672253307,1.0996336154222022,1233,-224987,-225701.2,-0.03055203196742583,-218.86557087944118,-0.06727089261203648
2023-08-07T01:30:00-04:00,1.0992899999999999,1.09936,1.09849,1.09862,1.09974,1.0992491111111111,1.0993666666666586,1.0995922222222148,1.0997560000000042,1.1005669999999994,1.099076000000001,1.0965837000000047,1.0993452537802646,1.0995580923377617,-2166,-227153,-225771.2,-0.03436926042416965,-220.18571388083288,-0.13634876195324663
2023-08-07T01:45:00-04:00,1.09862,1.0988,1.09818,1.0983,1.09954,1.099035777777778,1.0992077777777698,1.0994848888888815,1.0996210000000044,1.1004673999999992,1.099108800000001,1.0966078500000047,1.0991362030242118,1.0994516738702091,-2190,-229343,-226468.8,-0.038798930604224575,-220.82360505339457,-0.13003191692506727
2023-08-07T02:00:00-04:00,1.0983,1.09863,1.098,1.09823,1.09936,1.0988402222222222,1.099058888888881,1.099356444444437,1.0995190000000044,1.1003641999999993,1.0991394000000012,1.0966314000000048,1.0989549624193695,1.0993097390961672,-3264,-232607,-228062,-0.04044927275731929,-221.03163564612885,-0.12186582027518911
2023-08-07T02:15:00-04:00,1.09823,1.09827,1.09753,1.09753,1.0990879999999998,1.0985344444444445,1.0988422222222143,1.0992017777777705,1.0994135000000045,1.1002579999999993,1.099160400000001,1.096652500000005,1.0986699699354956,1.0991265912769337,-2584,-235191,-229856.2,-0.04714155590497913,-222.678649477476,-0.1773565685596935
2023-08-07T02:30:00-04:00,1.09753,1.09768,1.09708,1.09733,1.0987763999999998,1.0982319999999999,1.098629999999992,1.0990211111111037,1.0992945000000045,1.1001589999999992,1.099178800000001,1.096677600000005,1.0984019759483965,1.0989016730215468,-3074,-238265,-232511.8,-0.05669768167141881,-223.23881639774237,-0.1737564135220769
2023-08-07T02:45:00-04:00,1.09733,1.09808,1.09733,1.09801,1.0984371199999998,1.0981079999999999,1.098469999999992,1.0988417777777704,1.0991920000000044,1.1000819999999993,1.099206800000001,1.096706050000005,1.0983235807587173,1.0986973384172374,2723,-235542,-234189.6,-0.060527033993123265,-221.55141151498145,-0.1309745781981998
2023-08-07T03:00:00-04:00,1.09801,1.09846,1.0976299999999999,1.09826,1.09708,1.098066,1.0983155555555475,1.098663333333326,1.0991145000000044,1.1000217999999993,1.099236100000001,1.096735750000005,1.098310864606974,1.0985322707337897,4044,-231498,-234620.6,-0.06356007468964708,-220.6306548734205,-0.1264038557722914
2023-08-07T03:15:00-04:00,1.09826,1.09899,1.09821,1.09881,1.0971076,1.0981648888888889,1.0982644444444365,1.098504444444437,1.0990500000000043,1.0999797999999992,1.099271500000001,1.0967657500000048,1.0984106916855791,1.0984234165870315,3286,-228212,-233741.6,-0.06687289600555392,-218.98505182860399,-0.04184595231379961
2023-08-07T03:30:00-04:00,1.09881,1.09917,1.09865,1.09905,1.0971828959999999,1.098322,1.0982377777777699,1.0983835555555481,1.0990005000000045,1.0999425999999992,1.099313100000001,1.0967971500000049,1.0985385533484633,1.0983971332696252,2897,-225315,-231766.4,-0.06432828351732188,-218.35229457302745,-0.021832273558369125
2023-08-07T03:45:00-04:00,1.09905,1.09949,1.09862,1.09926,1.09730212224,1.0985264444444445,1.098308888888881,1.0983193333333259,1.0989615000000044,1.0999113999999992,1.0993575000000009,1.096823700000005,1.0986828426787707,1.0984533066157,2822,-222493,-228612,-0.06122377354194777,-217.81308343613696,0.05825490160382789
2023-08-07T04:00:00-04:00,1.09926,1.09926,1.09835,1.09845,1.0974771524608,1.0985546666666666,1.0983255555555476,1.0982904444444368,1.0988825000000042,1.099867399999999,1.099391800000001,1.096846050000005,1.0986362741430165,1.0985158452925599,-2367,-224860,-226475.6,-0.05588516696624417,-219.5572294980331,0.013657470636426519
2023-08-07T04:15:00-04:00,1.09845,1.09852,1.09809,1.09817,1.0976381802639361,1.0985235555555555,1.0983188888888809,1.0982911111111036,1.0987850000000043,1.099815599999999,1.099424700000001,1.096868500000005,1.0985430193144132,1.0985622762340477,-2451,-227311,-225638.2,-0.04901234278970887,-220.1820007666385,-0.005463336459571217
2023-08-07T04:30:00-04:00,1.09817,1.09825,1.0976,1.09791,1.09949,1.0984417777777777,1.0983611111111033,1.098310444444437,1.0986940000000043,1.099758199999999,1.099454900000001,1.096893300000005,1.0984164154515306,1.098563420987238,-2924,-230235,-226042.8,-0.042351413584325925,-220.87427973983978,0.03462319936585305
2023-08-07T04:45:00-04:00,1.09791,1.09793,1.09733,1.09747,1.0994522,1.0982635555555555,1.0983766666666588,1.0983382222222147,1.0985890000000045,1.099692799999999,1.099482100000001,1.0969198500000048,1.0982271323612245,1.0985011367897901,-2437,-232672,-227514.2,-0.03310599509756987,-221.85093538556666,0.01275824045638313
2023-08-07T05:00:00-04:00,1.09747,1.09774,1.09714,1.0974,1.099367312,1.098068222222222,1.098308888888881,1.0983382222222147,1.0984850000000042,1.099624199999999,1.099506300000001,1.0969471000000046,1.0980617058889797,1.0983769094318319,-2728,-235400,-230095.6,-0.02306540587893052,-222.02493558602777,-0.055555049589712246
2023-08-07T05:15:00-04:00,1.0974,1.09756,1.09724,1.0974,1.09923367328,1.0978864444444443,1.0982133333333255,1.0983157777777701,1.0983930000000042,1.099556199999999,1.099532500000001,1.0969740500000047,1.0979293647111836,1.0982355275454654,0,-235400,-232203.6,-0.01960367796535594,-222.02493558602777,-0.07830568353578232
2023-08-07T05:30:00-04:00,1.0974,1.0975,1.0970199999999999,1.09707,1.0991080528832,1.0976577777777776,1.0980199999999922,1.0982559999999926,1.0982740000000042,1.0994729999999988,1.099563700000001,1.0969982000000047,1.097757491768947,1.0980784220363722,-2199,-237599,-234261.2,-0.021031930293939665,-222.6861985712655,-0.1583531274742744
2023-08-07T05:45:00-04:00,1.09707,1.09722,1.09657,1.09662,1.098941008652544,1.0973777777777776,1.0977499999999922,1.0981337777777702,1.098122500000004,1.0993779999999989,1.099589700000001,1.0970219000000048,1.0975299934151577,1.0979011376290977,-2140,-239739,-236162,-0.0287051049121406,-223.56399123718484,-0.22110004094446606
2023-08-07T06:00:00-04:00,1.09662,1.09688,1.09653,1.0968,1.0987039077872895,1.0971877777777777,1.097476666666659,1.0979537777777701,1.0979990000000042,1.099289199999999,1.099615800000001,1.0970450000000047,1.0973839947321262,1.097732510103278,2344,-237395,-237106.6,-0.036839879874409356,-223.17924538173796,-0.2237869111947953
2023-08-07T06:15:00-04:00,1.0968,1.09712,1.09665,1.0971,1.0984430388528148,1.0971124444444444,1.097326666666659,1.0977573333333257,1.097889500000004,1.0992099999999987,1.099644500000001,1.0970716500000046,1.097327195785701,1.0975856080826225,2067,-235328,-237092.2,-0.04710483721242839,-222.61387339049077,-0.12290045063498224
2023-08-07T06:30:00-04:00,1.0971,1.09729,1.09692,1.09706,1.098213474190477,1.0970591111111112,1.0972033333333258,1.0975553333333259,1.097811500000004,1.0991303999999988,1.099672900000001,1.0970985500000048,1.0972737566285606,1.0974544864660978,-2008,-237336,-237479.4,-0.05009791865893915,-222.68708458363642,-0.10107724669223948
2023-08-07T06:45:00-04:00,1.09706,1.09737,1.09704,1.0973,1.0980114572876198,1.0970784444444444,1.097135555555548,1.097378444444437,1.097761500000004,1.0990611999999989,1.099701400000001,1.0971227500000047,1.0972790053028485,1.097358789172878,1710,-235626,-237084.8,-0.05230001652651034,-222.3129938319911,-0.05556010966290492
2023-08-07T07:00:00-04:00,1.0973,1.09772,1.09716,1.09764,1.0978336824131054,1.0971793333333333,1.097154444444437,1.0972593333333258,1.097732000000004,1.0990063999999988,1.0997367000000011,1.0971435000000047,1.0973512042422788,1.0973230313383024,2025,-233601,-235857.2,-0.05189809338247983,-221.68554463851618,0.015490172852105615
2023-08-07T07:15:00-04:00,1.09764,1.09844,1.09762,1.0980699999999999,1.09653,1.0973624444444445,1.0972288888888813,1.0972097777777703,1.097759000000004,1.0989571999999987,1.099772200000001,1.0971699000000046,1.0974949633938231,1.0973452250706417,2100,-231501,-234678.4,-0.04573865719018587,-220.86287053771824,0.06105339894295138
2023-08-07T07:30:00-04:00,1.0980699999999999,1.09808,1.09756,1.09792,1.0965682,1.0975006666666667,1.0972866666666592,1.0972017777777705,1.097788500000004,1.098910399999999,1.099805200000001,1.0971965000000048,1.0975799707150584,1.097395780056513,-2236,-233737,-234360.2,-0.042692739804816554,-221.16831554577757,0.04738472753782358
2023-08-07T07:45:00-04:00,1.09792,1.0985,1.09771,1.09839,1.096605636,1.0977213333333333,1.0974333333333257,1.0972477777777705,1.097807500000004,1.0988735999999988,1.099844700000001,1.0972226500000049,1.0977419765720466,1.0974894240452104,2469,-231268,-233146.6,-0.03827075026782275,-220.1113806142708,0.12032049003254011
2023-08-07T08:00:00-04:00,1.09839,1.09852,1.09796,1.09831,1.09668141056,1.0978966666666667,1.0976211111111036,1.0973448888888817,1.097810000000004,1.098836599999999,1.099886900000001,1.0972526000000047,1.0978555812576374,1.097604739236168,-2269,-233537,-232728.8,-0.028276524368580514,-220.276640676726,0.15410990133318464
2023-08-07T08:15:00-04:00,1.09831,1.09871,1.09802,1.09861,1.0967917259264,1.0980944444444443,1.0978222222222147,1.097478444444437,1.097800000000004,1.098803999999999,1.099931800000001,1.0972840500000047,1.0980064650061099,1.0977357913889343,2474,-231063,-232221.2,-0.011667847186533648,-219.6008751824662,0.16502552881109495
2023-08-07T08:30:00-04:00,1.09861,1.09862,1.09801,1.0984,1.096945187852288,1.09821,1.0979666666666592,1.0976259999999929,1.097767500000004,1.0987557999999988,1.099972800000001,1.0973119000000047,1.0980851720048879,1.0978538331111474,-2468,-233531,-232627.2,0.004684572142655494,-220.07263495162917,0.1184942120134973
2023-08-07T08:45:00-04:00,1.0984,1.09965,1.0984,1.09954,1.097086372824105,1.0985246666666666,1.0982422222222148,1.097817111111104,1.097781500000004,1.0987325999999988,1.100030400000001,1.0973425000000048,1.0983761376039103,1.0980130664889176,2469,-231062,-232092.2,0.024784329918971407,-217.51012584747787,0.2260587388110074
2023-08-07T09:00:00-04:00,1.09954,1.09995,1.09938,1.0999,1.0973427355416945,1.0988562222222222,1.0985311111111036,1.0980366666666594,1.0978540000000039,1.098708599999999,1.1000842000000008,1.0973763500000047,1.0986809100831283,1.098200853191134,2724,-228338,-231506.2,0.04787571571790389,-216.61826197713174,0.23694522919895725
2023-08-07T09:15:00-04:00,1.0999,1.10054,1.09961,1.1002399999999999,1.0976556072766912,1.099198,1.0988199999999926,1.0982764444444373,1.097957500000004,1.098693399999999,1.100137800000001,1.0974115500000046,1.0989927280665026,1.098428282552907,2732,-225606,-229920,0.06688548365576161,-215.77374883957432,0.23687183411682664
2023-08-07T09:30:00-04:00,1.1002399999999999,1.10116,1.10002,1.10015,1.0980594222579545,1.099464,1.0990511111111037,1.0985222222222149,1.098069500000004,1.098690999999999,1.100159800000001,1.0974404500000048,1.099224182453202,1.0986718260423252,-4843,-230449,-229797.2,0.08115163946893021,-216.1699078594242,0.1894232608121597
2023-08-07T09:45:00-04:00,1.10015,1.10045,1.09915,1.09928,1.0985555146966817,1.0995097777777778,1.0992022222222149,1.0987693333333262,1.098160000000004,1.0986837999999992,1.1001641000000009,1.0974693500000048,1.0992353459625617,1.09890186083386,-3955,-234404,-229971.8,0.08622472807625639,-219.2975268204747,0.12387059166424037
2023-08-07T10:00:00-04:00,1.09928,1.09977,1.09858,1.09966,1.10116,1.0996013333333334,1.0993433333333258,1.0989895555555482,1.0982730000000038,1.098682799999999,1.100139700000001,1.0974995000000047,1.0993202767700494,1.099090688667088,4308,-230096,-229778.6,0.09256440875095989,-217.8083338941955,0.11562377661851478
2023-08-07T10:15:00-04:00,1.09966,1.10052,1.09962,1.10018,1.1011084,1.0997686666666666,1.0995511111111036,1.0991935555555483,1.0984120000000037,1.0986851999999991,1.100120100000001,1.0975367500000046,1.0994922214160394,1.0992529509336701,3205,-226891,-229489.2,0.09679766093661069,-216.2927745394863,0.1702615837058789
2023-08-07T10:30:00-04:00,1.10018,1.10058,1.09944,1.10046,1.101057832,1.0999504444444443,1.0997566666666592,1.0993808888888816,1.0985815000000039,1.098698199999999,1.1000989000000008,1.0975630000000047,1.0996857771328314,1.0993915607469358,3362,-223529,-229073.8,0.10309206847398474,-215.4371327354177,0.16839460773157963
2023-08-07T10:45:00-04:00,1.10046,1.10081,1.09985,1.10017,1.10100827536,1.1000331111111112,1.0999533333333258,1.099561333333326,1.0987590000000038,1.098699599999999,1.1000883000000008,1.0975948500000048,1.0997826217062652,1.0995032485975484,-4298,-227827,-228549.4,0.10384105271395705,-216.56976817877737,0.16114348142753543
2023-08-07T11:00:00-04:00,1.10017,1.1004099999999999,1.09941,1.09999,1.1009597098528,1.1000404444444445,1.1000033333333257,1.0997215555555482,1.098918500000004,1.0986985999999992,1.100077100000001,1.0976320000000048,1.0998240973650122,1.0996209988780385,-3549,-231376,-227943.8,0.10369154376787287,-217.15042389562134,0.0409262055041255
2023-08-07T11:15:00-04:00,1.09999,1.10063,1.09991,1.09999,1.100912115655744,1.1000377777777777,1.1000133333333257,1.0998555555555483,1.099063000000004,1.098697599999999,1.100060000000001,1.0976675500000048,1.0998572778920097,1.0997283991024305,0,-231376,-228199.8,0.09394948341243928,-217.15042389562134,0.008182562051088596
2023-08-07T11:30:00-04:00,1.09999,1.10034,1.09998,1.10021,1.100865473342629,1.1000771111111112,1.1000099999999924,1.099947333333326,1.0992205000000037,1.098701199999999,1.1000355000000008,1.0977088000000048,1.0999278223136078,1.099815519281944,2301,-229075,-228636.6,0.08328325708917603,-216.69021971194718,-0.002726677815746973
2023-08-07T11:45:00-04:00,1.10021,1.10029,1.09977,1.09989,1.1008197638757764,1.1000531111111111,1.0999811111111033,1.0999922222222147,1.0993500000000038,1.0986965999999991,1.1000111000000008,1.0977491000000048,1.0999202578508862,1.0998624154255552,-2472,-231547,-230240.2,0.0678296504553239,-217.4092097229448,-0.023633140935320363
2023-08-07T12:00:00-04:00,1.09989,1.09997,1.09957,1.09972,1.1007749685982609,1.1000008888888888,1.1000299999999923,1.100007555555548,1.0994540000000037,1.0986963999999992,1.0999736000000009,1.0977865500000048,1.099880206280709,1.0998819323404438,-2587,-234134,-231501.6,0.053428984282127626,-217.8090587987615,0.04002619896659595
2023-08-07T12:15:00-04:00,1.09972,1.0997999999999999,1.09922,1.0997999999999999,1.1007310692262957,1.0999548888888888,1.1000455555555477,1.1000159999999923,1.0995405000000038,1.098700999999999,1.099935100000001,1.0978147000000047,1.099864165024567,1.099889945872355,2085,-232049,-231636.2,0.04879838259827566,-217.65738382695076,0.012731207827856514
2023-08-07T12:30:00-04:00,1.0997999999999999,1.09985,1.09949,1.09957,1.1006880478417698,1.0998597777777779,1.0999777777777702,1.100008888888881,1.0996230000000038,1.098702799999999,1.099890100000001,1.0978426500000047,1.0998053320196537,1.0998795566978836,-1518,-233567,-232074.4,0.04148047801751122,-217.97484154653608,-0.055445472559035744
2023-08-07T12:45:00-04:00,1.09957,1.10029,1.09955,1.10006,1.1006458868849345,1.0998762222222223,1.0999333333333259,1.099993555555548,1.0997065000000037,1.098719199999999,1.099856100000001,1.0978771000000045,1.099856265615723,1.0998652453583067,1974,-231593,-232578,0.031118301510878243,-217.09517040236136,-0.036348436108532424
2023-08-07T13:00:00-04:00,1.10006,1.10015,1.09964,1.09978,1.1006045691472357,1.0998455555555555,1.0998899999999923,1.0999753333333255,1.0997800000000038,1.098725799999999,1.0998205000000008,1.0979040000000047,1.0998410124925784,1.0998493962866451,-2196,-233789,-233026.4,0.018914077347905386,-217.65412173228893,-0.03544906696238876
2023-08-07T13:15:00-04:00,1.09978,1.09994,1.09954,1.09958,1.1005640777642909,1.0997835555555555,1.0998444444444369,1.0999382222222145,1.0998285000000037,1.098724399999999,1.099779000000001,1.0979280500000046,1.0997888099940627,1.0998311170293158,-1377,-235166,-233232.8,0.008049298598481046,-217.90453545139636,-0.03727306611878485
2023-08-07T13:30:00-04:00,1.09958,1.10054,1.09957,1.10048,1.09858,1.0999106666666665,1.0998988888888812,1.0999088888888813,1.0999325000000035,1.098748599999999,1.099749000000001,1.0979561500000046,1.09992704799525,1.0998436936234524,1201,-233965,-233616,0.004407489268354018,-216.92152375602186,0.044545859507802744
2023-08-07T13:45:00-04:00,1.10048,1.1006799999999999,1.10034,1.10059,1.0986192,1.1000488888888889,1.0999411111111035,1.0999015555555478,1.0999850000000035,1.098774599999999,1.099721100000001,1.0979858500000048,1.1000596383962,1.0998945548987618,1289,-232676,-233437.8,0.0003809649150863936,-216.79267997876096,0.03453886076294953
2023-08-07T14:00:00-04:00,1.10059,1.10101,1.10059,1.1007,1.0987016319999998,1.1002006666666668,1.1000311111111034,1.0999211111111034,1.1000250000000036,1.098816199999999,1.0996916000000008,1.0980150500000045,1.10018771071696,1.0999608439190092,1784,-230892,-233297.6,-0.0001861439626156394,-216.61437561473792,0.0736437280091625
2023-08-07T14:15:00-04:00,1.1007,1.10074,1.10044,1.10053,1.0988401340799998,1.1003004444444442,1.1001211111111036,1.0999673333333255,1.1000395000000036,1.0988607999999989,1.099664100000001,1.0980409500000048,1.100256168573568,1.100043875135207,-1242,-232134,-232966.6,0.0029046323910975093,-216.8061989998565,0.07365511221037876
2023-08-07T14:30:00-04:00,1.10053,1.1008499999999999,1.10053,1.10062,1.0989703260351997,1.1004002222222222,1.1002122222222146,1.100040888888881,1.1000630000000038,1.0989085999999988,1.0996364000000007,1.0980651000000048,1.1003289348588543,1.1001519001081657,1238,-230896,-232112.6,0.009440982174053675,-216.7049568710641,0.07455901072922741
2023-08-07T14:45:00-04:00,1.10062,1.10072,1.10046,1.10067,1.0990927064730878,1.1004917777777778,1.100334444444437,1.1001279999999922,1.1001325000000037,1.098971399999999,1.099614700000001,1.0980908000000047,1.1003971478870835,1.100245920086532,1529,-229367,-231193,0.015098305639666828,-216.6354960217245,0.10003910619606764
2023-08-07T15:00:00-04:00,1.10067,1.10079,1.10063,1.10065,1.0992077440847026,1.1005548888888887,1.1003999999999925,1.10021977777777,1.1001820000000038,1.099037799999999,1.0995984000000008,1.0981176000000046,1.1004477183096668,1.1003235360692254,-1489,-230856,-230829,0.018984300944281426,-216.66255226928297,0.05363343817608752
2023-08-07T15:15:00-04:00,1.10065,1.10078,1.10032,1.10034,1.0993158794396205,1.1005428888888888,1.100462222222215,1.1003059999999922,1.1001900000000038,1.0990843999999989,1.0995832000000008,1.0981471500000046,1.1004261746477335,1.1003712288553804,-1487,-232343,-231119.2,0.018585542404630298,-217.08136842337348,0.050919274764054265
2023-08-07T15:30:00-04:00,1.10034,1.10051,1.10031,1.10039,1.0994175266732433,1.1005284444444445,1.1005522222222146,1.1003922222222147,1.1001865000000037,1.099126999999999,1.099574400000001,1.0981732000000046,1.1004189397181867,1.100403783084304,1204,-231139,-230920.2,0.023220896296529448,-217.02665806112194,0.07366449007802774
2023-08-07T15:45:00-04:00,1.10039,1.10057,1.10029,1.10045,1.0995130750728488,1.1005079999999998,1.1005488888888815,1.1004595555555479,1.100200500000004,1.099159799999999,1.099569800000001,1.0982019500000044,1.1004251517745494,1.100423026467443,1190,-229949,-230730.8,0.031171848557496683,-216.9617719752797,-0.0027260831637080634
2023-08-07T16:00:00-04:00,1.10045,1.10045,1.1000699999999999,1.1000699999999999,1.0996028905684778,1.1004122222222221,1.1004911111111035,1.1004908888888811,1.1002045000000038,1.0991801999999988,1.099561400000001,1.0982282000000045,1.1003541214196395,1.1004144211739544,-569,-230518,-230961,0.02787819294278606,-217.1582552321292,-0.04724738549324235
2023-08-07T16:15:00-04:00,1.1000699999999999,1.10022,1.09996,1.1,1.099687317134369,1.1003139999999998,1.100413333333326,1.100493555555548,1.1002050000000039,1.0991949999999988,1.099553200000001,1.0982538500000045,1.1002832971357117,1.1003815369391634,-400,-230918,-230973.4,0.022472211630322834,-217.18370815785204,-0.06359589352229698
2023-08-07T16:30:00-04:00,1.1,1.10033,1.09991,1.10022,1.099766678106307,1.1002753333333335,1.1003788888888812,1.1004768888888812,1.1002055000000037,1.099230399999999,1.0995489000000012,1.0982812000000046,1.1002706377085694,1.1003504295513304,443,-230475,-230599.8,0.017113682636189884,-217.09510815785208,-0.028168246208647878
2023-08-07T16:45:00-04:00,1.10022,1.10032,1.10015,1.10023,1.0998412774199284,1.1002455555555557,1.100335555555548,1.1004335555555478,1.1002225000000037,1.099271599999999,1.0995436000000012,1.0983108000000046,1.1002625101668555,1.1003191436410642,450,-230025,-230377,0.014300343572036613,-217.09101806677936,-0.0354345732405272
2023-08-07T17:00:00-04:00,1.10023,1.10035,1.09998,1.10027,1.09991,1.1002324444444445,1.1002911111111038,1.1003819999999922,1.1002500000000037,1.099318799999999,1.099538500000001,1.0983424000000048,1.1002640081334845,1.1002869149128514,420,-229605,-230308.2,0.009474254611399065,-217.07574853222746,-0.03634150108569834
2023-08-07T17:15:00-04:00,1.10027,1.10049,1.10027,1.1004,1.0999759999999998,1.1002542222222225,1.100263333333326,1.1003364444444368,1.1002800000000037,1.099377399999999,1.099535100000001,1.0983735000000048,1.1002912065067876,1.1002743319302808,264,-229341,-230072.8,0.004076969020464472,-217.04455618853,-0.022713850906270063
2023-08-07T17:30:00-04:00,1.1004,1.10052,1.1002,1.10021,1.09998,1.1002435555555556,1.1002488888888815,1.100303555555548,1.1003120000000037,1.099433599999999,1.099528900000001,1.0984042500000046,1.10027496520543,1.1002726655442245,-1371,-230712,-230031.6,-0.0016965429904551368,-217.28127919834478,-0.011814530054363698
2023-08-07T17:45:00-04:00,1.10021,1.10027,1.10016,1.1002399999999999,1.1000418,1.1002417777777778,1.1002322222222147,1.1002742222222146,1.1003210000000039,1.099490399999999,1.099523300000001,1.0984334500000046,1.100267972164344,1.1002721324353792,506,-230206,-229977.8,-0.005504949260752748,-217.26748183238738,-0.013631530639145621
2023-08-07T18:00:00-04:00,1.1002399999999999,1.10028,1.10002,1.1002,1.10101,1.1002353333333335,1.100204444444437,1.1002479999999923,1.100342000000004,1.099552999999999,1.0995130000000009,1.0984608500000048,1.1002543777314753,1.1002705059483033,-246,-230452,-230063.2,-0.007837580745027675,-217.276425335623,-0.022717979008574807
2023-08-07T18:15:00-04:00,1.1002,1.10021,1.10009,1.10017,1.1009902,1.1002284444444446,1.1002155555555482,1.1002328888888815,1.1003715000000038,1.099623999999999,1.099501000000001,1.0984872000000048,1.1002375021851802,1.1002652047586423,-351,-230803,-230302.8,-0.012069930293641886,-217.28599632271624,0.009090330615343664
2023-08-07T18:30:00-04:00,1.10017,1.10029,1.10016,1.10029,1.100970796,1.1002433333333332,1.1002477777777706,1.1002297777777703,1.100362000000004,1.099693799999999,1.099491500000001,1.0985150000000046,1.1002480017481442,1.1002565638069137,269,-230534,-230541.4,-0.013142793836606222,-217.25665540267664,0.026363636363627402
2023-08-07T18:45:00-04:00,1.10029,1.10032,1.10015,1.10018,1.10095178008,1.1002297777777779,1.1002433333333261,1.1002286666666592,1.1003415000000039,1.0997553999999992,1.0994827000000011,1.0985413500000045,1.1002344013985152,1.1002484510455308,-322,-230856,-230570.2,-0.010208842008076669,-217.2888469158232,-0.00363563650906546
2023-08-07T19:00:00-04:00,1.10018,1.1004099999999999,1.10017,1.10038,1.1009331444783998,1.100257111111111,1.1002599999999927,1.100234222222215,1.100325500000004,1.099821799999999,1.099476100000001,1.0985724000000046,1.100263521118812,1.1002475608364244,402,-230454,-230619.8,-0.007846035933983371,-217.21576796510604,0.013633512992726289
2023-08-07T19:15:00-04:00,1.10038,1.10049,1.10031,1.10032,1.1009148815888319,1.100269111111111,1.1002655555555483,1.1002464444444373,1.1003150000000042,1.099882199999999,1.099471700000001,1.0986003000000046,1.1002748168950496,1.1002516486691392,-223,-230677,-230664.8,-0.005383689584170861,-217.2279274009373,0.004544339116751658
2023-08-07T19:30:00-04:00,1.10032,1.10049,1.10031,1.10043,1.1008969839570553,1.100302,1.1002688888888816,1.100257111111104,1.100305500000004,1.099937999999999,1.099472200000001,1.0986285000000044,1.1003058535160397,1.100265318935311,348,-230329,-230570,-0.003496816728040166,-217.19313752162944,0.0027262813522332327
2023-08-07T19:45:00-04:00,1.10043,1.10047,1.10022,1.10026,1.1008794442779142,1.1003002222222222,1.1002744444444372,1.100262444444437,1.100285000000004,1.099981799999999,1.099469500000001,1.0986553500000047,1.1002966828128318,1.1002750551482487,-559,-230888,-230640.8,-0.0032112356892948207,-217.27949467292484,0.0045445869425023875
2023-08-07T20:00:00-04:00,1.10026,1.10053,1.09986,1.09997,1.100862255392356,1.1002393333333333,1.1002444444444373,1.1002626666666593,1.100251000000004,1.1000227999999992,1.0994666000000008,1.0986801500000045,1.1002313462502653,1.1002744441185985,-1290,-232178,-230905.2,-0.0023630563404816044,-217.61950521588756,-0.024540100341742938
2023-08-07T20:15:00-04:00,1.09997,1.10001,1.09961,1.0996299999999999,1.1008221651766616,1.1001164444444445,1.100181111111104,1.1002468888888814,1.100215500000004,1.100047599999999,1.0994606000000011,1.0987027000000045,1.1001110770002123,1.1002439552948786,-1212,-233390,-231492.4,-0.003492803396454562,-217.9941336148439,-0.05180876204328135
2023-08-07T20:30:00-04:00,1.0996299999999999,1.09964,1.09918,1.0992,1.1007494352660618,1.0999202222222224,1.1000733333333261,1.100208444444437,1.1001560000000041,1.100065399999999,1.099451000000001,1.0987229000000045,1.09992886160017,1.1001747642359028,-1496,-234886,-232334.2,-0.0076481885217523065,-218.57913038648516,-0.08816819218849245
2023-08-07T20:45:00-04:00,1.0992,1.0994599999999999,1.09894,1.09919,1.100623880444777,1.0997435555555555,1.0999511111111038,1.1001448888888814,1.100093000000004,1.100076999999999,1.099440500000001,1.0987429500000045,1.0997810892801358,1.100069811388722,-1943,-236829,-233634.2,-0.011362500113376481,-218.59680687847944,-0.09997364331222686
2023-08-07T21:00:00-04:00,1.09919,1.09919,1.09882,1.09904,1.1004554924002994,1.0995613333333334,1.0998244444444372,1.1000548888888815,1.100041500000004,1.100089799999999,1.099422800000001,1.0987625500000044,1.0996328714241086,1.0999370491109772,-2073,-238902,-235237,-0.016622728984313263,-218.87969700666451,-0.10361940773327263
2023-08-07T21:15:00-04:00,1.09904,1.09907,1.09826,1.09844,1.1002592333122634,1.0992844444444443,1.0996088888888815,1.0999277777777703,1.099963500000004,1.100067799999999,1.099400200000001,1.0987783500000043,1.099394297139287,1.0997696392887817,-2928,-241830,-237167.4,-0.025386083629221567,-220.4781829580401,-0.1763027317835503
2023-08-07T21:30:00-04:00,1.09844,1.09879,1.09799,1.09832,1.0999793406485465,1.0990266666666666,1.0993866666666594,1.0997688888888812,1.0998685000000041,1.100036199999999,1.099372400000001,1.0987939500000043,1.0991794377114295,1.0995833114310252,-3142,-244972,-239483.8,-0.036843670703052424,-220.82143338592,-0.18176530463865073
2023-08-07T21:45:00-04:00,1.09832,1.09834,1.09786,1.09793,1.099661046144779,1.0987353333333334,1.0991088888888816,1.0995759999999923,1.099753500000004,1.0999899999999991,1.099341700000001,1.0988081500000044,1.0989295501691436,1.09938344914482,-2932,-247904,-242087.4,-0.048663580901486106,-221.8625507287706,-0.2271839190134717
2023-08-07T22:00:00-04:00,1.09793,1.0983,1.09768,1.09823,1.0993368578387188,1.0985595555555556,1.098883333333326,1.0993624444444368,1.0996515000000042,1.0999515999999991,1.099321300000001,1.0988252500000046,1.098789640135315,1.0991851593158557,2395,-245509,-243823.4,-0.06001307738581076,-221.208137423733,-0.18450184501844802
2023-08-07T22:15:00-04:00,1.09823,1.09855,1.09819,1.09848,1.099005486270975,1.098478888888889,1.0987177777777706,1.0991411111111034,1.0995555000000041,1.0999355999999991,1.099309700000001,1.0988427500000044,1.098727712108252,1.0990041274526845,1944,-243565,-244756,-0.06845373039672709,-220.7656071705076,-0.13545823977017477
2023-08-07T22:30:00-04:00,1.09848,1.09895,1.09845,1.09876,1.09768,1.0984873333333336,1.098621111111104,1.098943555555548,1.0994830000000042,1.0999175999999993,1.0993002000000012,1.0988606000000045,1.0987341696866015,1.0988721019621475,1766,-241799,-244749.8,-0.07236073654786264,-220.31545787329682,-0.07911752134808313
2023-08-07T22:45:00-04:00,1.09876,1.09894,1.09862,1.09884,1.0977054,1.0985311111111113,1.098581111111104,1.098782444444437,1.0994130000000042,1.0998907999999994,1.0992880000000012,1.0988771500000043,1.0987553357492812,1.098787281569718,1286,-240513,-243858,-0.07361673560404992,-220.2218250508423,-0.03275109170304912
2023-08-07T23:00:00-04:00,1.09884,1.09895,1.09853,1.09893,1.097730292,1.0986008888888887,1.0985522222222148,1.0986711111111034,1.099349500000004,1.0998601999999993,1.0992792000000011,1.0988942000000044,1.0987902685994249,1.098759425255774,1747,-238766,-242030.4,-0.07040267784836728,-220.07873779519102,-0.023653781420857813
2023-08-07T23:15:00-04:00,1.09893,1.09905,1.09863,1.0987,1.09775468616,1.0986304444444444,1.0985144444444372,1.0985973333333257,1.099276000000004,1.0998307999999994,1.0992652000000012,1.0989087500000043,1.0987722148795398,1.098755940204619,-1463,-240229,-240974.4,-0.06836702736604902,-220.38493564218757,-0.0309360896782653
2023-08-07T23:30:00-04:00,1.0987,1.0988,1.09833,1.09834,1.0978064987136,1.0985955555555558,1.098503333333326,1.098554444444437,1.099178500000004,1.0997977999999995,1.0992482000000012,1.0989204500000043,1.0986857719036318,1.098747552163695,-1396,-241625,-240586.4,-0.06681291603717728,-220.84234894882258,-0.00910381996285541
2023-08-07T23:45:00-04:00,1.09834,1.09845,1.09812,1.09817,1.0978562387650561,1.0985288888888889,1.0984866666666595,1.0985275555555483,1.099078000000004,1.0997613999999993,1.0992295000000012,1.0989329500000045,1.0985826175229054,1.0987172417309556,-1249,-242874,-240801.4,-0.06009079038209844,-221.03566795750842,-0.01365722193894971
2023-08-08T00:00:00-04:00,1.09817,1.09837,1.098,1.09834,1.097903989214454,1.0984995555555557,1.0985322222222151,1.0985177777777704,1.098976000000004,1.0997239999999995,1.099212600000001,1.0989472500000044,1.0985340940183244,1.0986729933847643,1072,-241802,-241059.2,-0.05194129957208813,-220.86971915176795,0.03734300000911
2023-08-08T00:15:00-04:00,1.09834,1.09866,1.09834,1.09865,1.0979498296458758,1.0985231111111113,1.0985788888888817,1.0985231111111038,1.098892500000004,1.0996991999999994,1.0991979000000012,1.0989623000000044,1.0985572752146595,1.0986263947078112,1200,-240602,-241426.4,-0.037897285616399316,-220.53102621515472,0.03824335521701874
2023-08-08T00:30:00-04:00,1.09865,1.0988499999999999,1.09854,1.0988499999999999,1.0979938364600408,1.0985773333333333,1.0986199999999926,1.0985442222222148,1.098813500000004,1.0996817999999995,1.0991891000000011,1.0989778000000043,1.0986158201717275,1.0985951157662488,2084,-238518,-241084.2,-0.02588758357970483,-220.15165152803877,0.033682907290071874
2023-08-08T00:45:00-04:00,1.0988499999999999,1.09925,1.09878,1.0992,1.0980360830016391,1.0986933333333333,1.0986688888888816,1.098577333333326,1.098760500000004,1.0996697999999996,1.0991854000000012,1.0989960000000043,1.098732656137382,1.0986044926129988,1321,-237197,-240198.6,-0.014006215257761457,-219.73089346278866,0.04004514179620627
2023-08-08T01:00:00-04:00,1.0992,1.09941,1.09901,1.09939,1.0981089180215409,1.0988375555555554,1.0987299999999929,1.0986259999999926,1.098731500000004,1.0996661999999995,1.0991845000000011,1.0990134500000044,1.0988641249099056,1.098660794090399,1549,-235648,-238753.4,-0.004502786613584029,-219.4631441905905,0.05005278293473576
2023-08-08T01:15:00-04:00,1.09939,1.0995,1.09905,1.09912,1.0982130045798175,1.0989155555555556,1.098751111111104,1.0986697777777703,1.098706000000004,1.0996473999999994,1.099183300000001,1.0990303000000043,1.0989152999279246,1.098737035272319,-1337,-236985,-237790,0.0017292377704351085,-219.79149900553332,0.017289545284971244
2023-08-08T01:30:00-04:00,1.09912,1.09945,1.09896,1.09904,1.0983417041218357,1.0989733333333331,1.0987888888888817,1.0987117777777704,1.098698000000004,1.0996325999999994,1.099179200000001,1.0990480500000044,1.0989402399423396,1.0988136282178549,-1441,-238426,-237354.8,0.005287528886625347,-219.89638291265913,0.030945663056339945
2023-08-08T01:45:00-04:00,1.09904,1.09992,1.09903,1.0999,1.0984575337096523,1.0991955555555557,1.098962222222215,1.098780222222215,1.0987335000000038,1.0996389999999994,1.099181700000001,1.0990704500000044,1.0991321919538717,1.0989169025742838,2634,-235792,-236809.6,0.013175082106157705,-217.83527503669447,0.14203252180563447
2023-08-08T02:00:00-04:00,1.0999,1.1000699999999999,1.09933,1.0995,1.098633029664494,1.0993031111111111,1.099109999999993,1.098868444444437,1.098756500000004,1.0996193999999995,1.099184000000001,1.0990916500000045,1.0992057535630972,1.0990115220594268,-3387,-239179,-237206,0.022388670968706347,-219.06702337745327,0.12111057486544262
2023-08-08T02:15:00-04:00,1.0995,1.10027,1.09945,1.10002,1.0988342055114648,1.099485111111111,1.0992966666666595,1.0989817777777704,1.0988355000000039,1.0996079999999995,1.0991913000000009,1.0991159500000045,1.0993686028504779,1.0991124176475413,2997,-236182,-237312.8,0.03497702073466765,-217.64961546476547,0.15295810040605856
2023-08-08T02:30:00-04:00,1.10002,1.10111,1.10002,1.10081,1.0990639326296305,1.0997877777777776,1.0995366666666593,1.0991388888888813,1.098960000000004,1.0996101999999994,1.099213200000001,1.0991446000000045,1.0996568822803823,1.0992607341180327,3139,-233043,-236524.4,0.04718011294132007,-215.39528372534235,0.1966049242252002
2023-08-08T02:45:00-04:00,1.10081,1.10081,1.09965,1.09977,1.099432224756297,1.0998344444444446,1.0996388888888817,1.0993088888888813,1.099052000000004,1.0995949999999994,1.0992279000000011,1.0991683500000045,1.0996795058243058,1.099408587294426,-3007,-236050,-236049.2,0.051085468719169747,-218.23617361551456,0.0837238931610349
2023-08-08T03:00:00-04:00,1.09977,1.09982,1.09911,1.09945,1.10111,1.0997966666666665,1.0996666666666597,1.0994497777777703,1.099113000000004,1.0995715999999995,1.0992401000000012,1.0991897500000045,1.0996336046594446,1.0995088698355406,-4877,-240927,-237076.2,0.049955611861178854,-219.65523396449606,0.02274381368268591
2023-08-08T03:15:00-04:00,1.09945,1.09948,1.0980699999999999,1.09821,1.10107,1.0995053333333333,1.0995355555555484,1.0995348888888814,1.099099500000004,1.0995223999999995,1.0992469000000011,1.0992036500000042,1.0993488837275556,1.0995374958684323,-4590,-245517,-238343.8,0.04103469296793135,-224.83200416778007,-0.10733224788293334
2023-08-08T03:30:00-04:00,1.09821,1.09823,1.09735,1.09808,1.10095,1.099214222222222,1.0994199999999925,1.099559555555548,1.0990655000000038,1.0994709999999994,1.099254400000001,1.0992166000000043,1.0990951069820445,1.0994827966947456,-4707,-250224,-241152.2,0.03084912654100541,-225.38919268363753,-0.09462115146664166
2023-08-08T03:45:00-04:00,1.09808,1.09835,1.09766,1.09789,1.100734,1.0989082222222222,1.099292222222215,1.0995106666666592,1.0990180000000038,1.0994219999999995,1.099253200000001,1.0992300000000044,1.0988540855856357,1.0993222373557963,-3644,-253868,-245317.2,0.023428021768754255,-226.0197114072275,-0.10463677391177613
2023-08-08T04:00:00-04:00,1.09789,1.09799,1.0975,1.09761,1.1005309600000002,1.0985717777777777,1.0990377777777702,1.099390444444437,1.0989520000000037,1.0993663999999994,1.099246700000001,1.0992414000000044,1.0986052684685086,1.0991073898846369,-4039,-257907,-249688.6,0.01574661896195799,-227.0497963884189,-0.2082007455223316
2023-08-08T04:15:00-04:00,1.09761,1.09839,1.0975,1.09799,1.1003401024000001,1.0983622222222222,1.0988699999999925,1.0992311111111035,1.0989165000000036,1.0993171999999993,1.0992385000000011,1.0992550000000043,1.0984822147748068,1.0988771119077092,2781,-255126,-252528.4,0.0024396553631816746,-226.0869953935299,-0.13733515234196456
2023-08-08T04:30:00-04:00,1.09799,1.09844,1.09767,1.0982399999999999,1.1001606962560002,1.0982362222222224,1.0986722222222147,1.099058444444437,1.0989115000000038,1.0992805999999995,1.099230400000001,1.0992717500000044,1.0984337718198454,1.0986940895261672,2871,-252255,-253876,-0.007033107606319947,-225.43330091543848,-0.16181523972292458
2023-08-08T04:45:00-04:00,1.0982399999999999,1.09873,1.09818,1.09853,1.0999920544806403,1.0982077777777777,1.0984188888888815,1.0988582222222147,1.0989295000000037,1.0992511999999994,1.099223100000001,1.0992903000000043,1.0984530174558762,1.0985656716209333,2431,-249824,-253796,-0.021415484669205585,-224.79137383210488,-0.2071202114806424
2023-08-08T05:00:00-04:00,1.09853,1.09864,1.09768,1.09768,1.099833531211802,1.09806,1.0981866666666593,1.0986371111111037,1.0988965000000037,1.0992003999999995,1.0992154000000012,1.0993036000000045,1.098298413964701,1.0984545372967465,-2858,-252682,-253558.8,-0.04777635207055114,-227.00278362519205,-0.19003973558106926
2023-08-08T05:15:00-04:00,1.09768,1.09793,1.09711,1.09755,1.0996845193390938,1.0979326666666667,1.0979755555555482,1.0984246666666593,1.0988415000000038,1.0991467999999995,1.099209200000001,1.0993169500000044,1.0981487311717608,1.0983632298373969,-3452,-256134,-253204.2,-0.06455770367485582,-227.41160951251794,-0.1728136795670574
2023-08-08T05:30:00-04:00,1.09755,1.09781,1.09741,1.09742,1.0994785577919663,1.0978215555555557,1.0978877777777702,1.0982282222222146,1.098770000000004,1.0990897999999998,1.099204300000001,1.0993296000000046,1.0980029849374087,1.0982673838699173,-2447,-258581,-253895.2,-0.0777056675729189,-227.70144596643794,-0.0719352400724676
2023-08-08T05:45:00-04:00,1.09742,1.09744,1.09669,1.09707,1.0992890731686091,1.0976579999999998,1.0977755555555482,1.0980488888888815,1.0986635000000038,1.0990231999999998,1.099200300000001,1.0993412000000045,1.097816387949927,1.0981439070959336,-3011,-261592,-255762.6,-0.08037284261263515,-228.66174375579865,-0.09197872650444006
2023-08-08T06:00:00-04:00,1.09707,1.09718,1.09625,1.09647,1.0990291658517481,1.0973968888888888,1.0976177777777703,1.0978886666666592,1.0985175000000038,1.0989483999999998,1.099191000000001,1.0993486500000045,1.0975471103599417,1.0979627256767466,-3242,-264834,-258764.6,-0.08320423203705458,-230.43483024982345,-0.12933900481833124
2023-08-08T06:15:00-04:00,1.09647,1.09689,1.09642,1.09642,1.0986956659495384,1.0971573333333333,1.097485555555548,1.0977484444444368,1.098382500000004,1.0988719999999998,1.099181200000001,1.0993568500000044,1.0973216882879533,1.0977673805413972,-2600,-267434,-261715,-0.08372216829640314,-230.55339254518972,-0.1084173795792699
2023-08-08T06:30:00-04:00,1.09642,1.09643,1.09557,1.09581,1.0984021860355937,1.0968222222222221,1.0972433333333258,1.0976019999999926,1.0982210000000039,1.0987841999999999,1.099168600000001,1.0993661500000043,1.0970193506303627,1.0975415044331176,-3565,-270999,-264688,-0.08577203940756781,-232.53680218748008,-0.19854461333892573
2023-08-08T06:45:00-04:00,1.09581,1.09599,1.09518,1.09536,1.0980056799906106,1.0964455555555557,1.096923333333326,1.0974091111111037,1.097994000000004,1.0986879999999999,1.099156000000001,1.0993728500000044,1.09668748050429,1.0972784035464938,-2655,-273654,-267702.6,-0.0937779978818031,-233.6270915624631,-0.2622377622377617
2023-08-08T07:00:00-04:00,1.09536,1.09539,1.09501,1.0953,1.097553571192113,1.0961208888888891,1.096564444444437,1.0971668888888813,1.0977840000000039,1.0985881999999998,1.0991410000000008,1.0993784000000044,1.096409984403432,1.0969971228371949,-2735,-276389,-270662,-0.10062380775144662,-233.77690532232276,-0.294029293692486
2023-08-08T07:15:00-04:00,1.0953,1.09571,1.09471,1.09478,1.0970957283775327,1.0957640000000002,1.0962422222222148,1.0968917777777702,1.0975220000000039,1.0984801999999998,1.099117800000001,1.0993811500000046,1.0960839875227457,1.0967044982697556,-3423,-279812,-273657.6,-0.1143317747235817,-235.40199433903007,-0.2641935718970832
2023-08-08T07:30:00-04:00,1.09478,1.0948,1.09366,1.09451,1.096618582702026,1.0954175555555556,1.0959044444444368,1.0965755555555483,1.097207000000004,1.0983627999999999,1.099092300000001,1.0993826000000044,1.0957691900181965,1.0963939986158042,-4228,-284040,-276978.8,-0.11933634049953286,-236.44472438524937,-0.27698054758324736
2023-08-08T07:45:00-04:00,1.09451,1.0945799999999999,1.09404,1.09413,1.0960268661616208,1.0950626666666667,1.0955388888888813,1.0962346666666591,1.096925000000004,1.0982389999999997,1.099060600000001,1.0993810000000044,1.0954413520145572,1.096078398892643,-3267,-287307,-280240.4,-0.12154992540652279,-237.57898537875346,-0.2997940624373544
2023-08-08T08:00:00-04:00,1.09413,1.09462,1.09398,1.09425,1.0955534929292967,1.094804888888889,1.095225555555548,1.0958951111111037,1.0966650000000038,1.0981153999999997,1.099026700000001,1.0993817000000043,1.0952030816116458,1.0957815191141143,4138,-283169,-282143.4,-0.12651550509579493,-237.12514534146393,-0.2570483196149785
2023-08-08T08:15:00-04:00,1.09425,1.09468,1.09345,1.09414,1.0951747943434373,1.0945877777777777,1.0949666666666589,1.095575555555548,1.0964615000000038,1.0979929999999998,1.0989874000000008,1.0993798000000043,1.0949904652893165,1.0954976152912912,-4772,-287941,-284453.8,-0.13020552870814545,-237.60485290372142,-0.21250011400222216
2023-08-08T08:30:00-04:00,1.09414,1.09509,1.0937,1.09457,1.09345,1.0945084444444446,1.0947611111111035,1.0952793333333257,1.0962860000000039,1.0978849999999998,1.0989539000000008,1.0993795500000043,1.0949063722314532,1.0952620922330327,4952,-282989,-285089.2,-0.13174627993621063,-235.6587034164522,-0.16873096076320274
2023-08-08T08:45:00-04:00,1.09457,1.09479,1.0942399999999999,1.09432,1.09345,1.0944202222222223,1.0945955555555478,1.095017555555548,1.0961075000000038,1.0977787999999997,1.098913200000001,1.0993789500000044,1.0947890977851624,1.0950660737864257,-3539,-286528,-285586.8,-0.13459142555769463,-236.4670117018979,-0.13597247698049766
2023-08-08T09:00:00-04:00,1.09432,1.09561,1.09404,1.09511,1.0934828,1.094523111111111,1.09456777777777,1.0948233333333257,1.0959825000000039,1.097697,1.0988812000000008,1.0993840500000043,1.09485327822813,1.0949484590291403,5034,-281494,-284424.2,-0.12891630020231024,-232.83291929748205,-0.022823546596540085
2023-08-08T09:15:00-04:00,1.09511,1.09544,1.09463,1.09475,1.0935678880000002,1.0945595555555556,1.094506666666659,1.094679555555548,1.0958205000000039,1.0976082,1.098842600000001,1.0993872000000042,1.094832622582504,1.0948743672233117,-3513,-285007,-284791.8,-0.1220713987761694,-233.9877621899773,-0.0502145530904821
2023-08-08T09:30:00-04:00,1.09475,1.09491,1.09377,1.09399,1.0936495724800002,1.0944562222222225,1.094418888888881,1.0945699999999923,1.095608000000004,1.0975072,1.098798500000001,1.0993856500000043,1.0946640980660032,1.0948090937786492,-5890,-290897,-285383,-0.11666463859797022,-238.0767322744708,-0.07216061674492304
2023-08-08T09:45:00-04:00,1.09399,1.09418,1.09333,1.09382,1.09561,1.0943364444444443,1.0943422222222146,1.0944862222222143,1.0953725000000039,1.0974148,1.098741300000001,1.0993858500000042,1.0944952784528026,1.094726875022919,-5088,-295985,-287982.2,-0.10623759561622259,-238.86737935533992,-0.06304190916483901
2023-08-08T10:00:00-04:00,1.09382,1.09398,1.09289,1.09381,1.0955644,1.09423,1.094306666666659,1.0944284444444368,1.095179000000004,1.0973246,1.098680400000001,1.0993823000000043,1.0943582227622421,1.0946407000183351,-5216,-301201,-290916.8,-0.09212973550120188,-238.91506544628754,-0.02924698162010894
2023-08-08T10:15:00-04:00,1.09381,1.09448,1.09357,1.09444,1.095457424,1.0942566666666667,1.09432777777777,1.0943804444444365,1.095023500000004,1.0972548,1.0986224000000009,1.099380100000004,1.0943745782097938,1.094544960014668,4876,-296325,-293883,-0.07522386709788398,-236.1066435082904,0.017363490975566324
2023-08-08T10:30:00-04:00,1.09444,1.09525,1.09408,1.09504,1.09535472704,1.0943991111111113,1.0944277777777702,1.0943646666666589,1.094904500000004,1.0971909999999998,1.098571300000001,1.0993655500000044,1.094507662567835,1.094479968011734,4034,-292291,-295339.8,-0.05710245173926379,-233.89510153248568,0.08225638400937019
2023-08-08T10:45:00-04:00,1.09504,1.0952,1.09418,1.09455,1.0952561379583998,1.0944235555555555,1.094425555555548,1.0943659999999924,1.0947785000000039,1.0971123999999999,1.098524000000001,1.0993440500000045,1.0945161300542678,1.0944503744093872,-4606,-296897,-296539.8,-0.040882647664398954,-235.95615866281923,-0.0018272015494788844
2023-08-08T11:00:00-04:00,1.09455,1.09487,1.09414,1.0948499999999999,1.09525,1.0945084444444446,1.0944844444444368,1.094394444444437,1.0946975000000039,1.0970342,1.098475900000001,1.0993078000000045,1.0945829040434143,1.0944678995275097,3955,-292942,-295931.2,-0.028672812414684827,-234.8721515366031,0.04843190291687253
2023-08-08T11:15:00-04:00,1.0948499999999999,1.09506,1.09463,1.09499,1.0952,1.0946095555555555,1.0944711111111034,1.0944273333333256,1.0946260000000039,1.0969571999999999,1.0984240000000012,1.0992720500000042,1.0946643232347315,1.0945291196220075,3234,-289708,-293632.6,-0.01611644556009541,-234.45861543576729,-0.010957803325704268
2023-08-08T11:30:00-04:00,1.09499,1.09557,1.09478,1.09514,1.09289,1.0947433333333334,1.0945144444444368,1.094464666666659,1.094592500000004,1.0968814,1.0983708000000012,1.0992348500000044,1.0947594585877851,1.0946060956976056,3072,-286636,-291694.8,-0.010275078019864263,-234.03778967480116,0.03562457182006052
2023-08-08T11:45:00-04:00,1.09514,1.0951899999999999,1.09488,1.09501,1.0929436,1.0948424444444445,1.09462777777777,1.094504666666659,1.0945750000000039,1.0968076,1.098319200000001,1.0992037500000043,1.094809566870228,1.0946664765580842,-2153,-288789,-290994.4,-0.004419916421579559,-234.2933643045288,0.0932366840647557
2023-08-08T12:00:00-04:00,1.09501,1.09522,1.0949,1.09501,1.092996128,1.0949188888888888,1.0947599999999922,1.094571555555548,1.094560500000004,1.096741,1.098269400000001,1.0991732500000044,1.0948496534961825,1.0947331812464671,0,-288789,-289372.8,0.006421157453055835,-234.2933643045288,0.1087930372456185
2023-08-08T12:15:00-04:00,1.09501,1.09571,1.09488,1.09549,1.09304760544,1.0950648888888888,1.094946666666659,1.0946639999999923,1.0945960000000041,1.0966874,1.098224400000001,1.0991422000000044,1.094977722796946,1.0948121449971735,2352,-286437,-288071.8,0.020851187861069383,-233.26236002146283,0.1535915744050727
2023-08-08T12:30:00-04:00,1.09549,1.09577,1.09515,1.09518,1.0931541012224,1.0951115555555555,1.0950288888888808,1.0947755555555478,1.0946295000000041,1.0966242,1.098174100000001,1.0991048000000045,1.0950181782375568,1.0948829159977387,-1877,-288314,-287793,0.031626433956727616,-233.79351046555638,0.06761448777456625
2023-08-08T12:45:00-04:00,1.09518,1.09518,1.09476,1.09482,1.093311055149056,1.0950697777777778,1.0950044444444367,1.0948735555555478,1.094664000000004,1.0965476,1.0981234000000009,1.0990672500000043,1.0949785425900453,1.0949267327981906,-1494,-289808,-288427.4,0.03374890864199956,-234.2846078194162,-0.020090590298081256
2023-08-08T13:00:00-04:00,1.09482,1.0956,1.09478,1.09512,1.0934585918401125,1.095092888888889,1.09506777777777,1.0949615555555479,1.0947075000000042,1.096473,1.0980774000000009,1.0990255000000044,1.0950068340720363,1.0949661862385522,2276,-287532,-288176,0.030171738790283557,-233.66094365544365,0.05207619569687831
2023-08-08T13:15:00-04:00,1.09512,1.09529,1.09498,1.09528,1.0935972763297057,1.0951353333333333,1.0951155555555478,1.0950326666666588,1.0947645000000041,1.0963946,1.098032200000001,1.0989836500000043,1.095061467257629,1.0950085489908417,1809,-285723,-287562.8,0.03235834903284645,-233.39664385268242,0.03927478650044778
2023-08-08T13:30:00-04:00,1.09528,1.0961,1.09525,1.09603,1.0937276397499234,1.0953182222222222,1.0952311111111035,1.0950895555555475,1.0948375000000041,1.0963274,1.097996800000001,1.0989434500000044,1.0952551738061034,1.0950640391926731,2021,-283702,-287015.8,0.03491317592930503,-232.01275114944667,0.09497803632911278
2023-08-08T13:45:00-04:00,1.09603,1.0961,1.0956,1.09595,1.0939174285699296,1.095462,1.0953211111111034,1.0951479999999922,1.094919000000004,1.096264,1.0979557000000009,1.0989059000000045,1.0953941390448827,1.0951392313541384,-1815,-285517,-286456.4,0.03767717579958189,-232.14522927504555,0.0739631462644025
2023-08-08T14:00:00-04:00,1.09595,1.09605,1.09539,1.09573,1.0940920342843352,1.0955437777777777,1.0954011111111033,1.0952273333333253,1.094950000000004,1.0961977999999999,1.097915200000001,1.0988678500000044,1.0954613112359062,1.0952357850833105,-1951,-287468,-285988.4,0.03693119672849791,-232.53687122951408,0.06575282417512661
2023-08-08T14:15:00-04:00,1.09573,1.09583,1.09555,1.09567,1.0942526715415883,1.0955975555555555,1.0954744444444366,1.0953086666666587,1.094996000000004,1.0961132,1.0978761000000012,1.0988275500000044,1.095503048988725,1.095335028066648,-1643,-289111,-286304.2,0.04052243411219249,-232.6268386484953,0.060273422160517516
2023-08-08T14:30:00-04:00,1.09567,1.09573,1.09525,1.09534,1.0944004578182613,1.0955706666666667,1.0954577777777699,1.0953771111111033,1.0950635000000042,1.0960299999999998,1.097824700000001,1.0987868500000044,1.09547043919098,1.0954168224533185,-1789,-290900,-287339.6,0.040969312806499396,-233.16565964386788,-0.013692502898255072
2023-08-08T14:45:00-04:00,1.09534,1.09594,1.09521,1.09594,1.0945364211928004,1.0956671111111111,1.0955422222222144,1.0954393333333254,1.0951695000000043,1.0959484,1.0977782000000011,1.0987496500000047,1.095564351352784,1.0954786579626545,1943,-288957,-288390.6,0.036595743570916855,-232.101332585603,0.06939498529920853
2023-08-08T15:00:00-04:00,1.09594,1.09602,1.09573,1.0957999999999999,1.0946615074973765,1.0957186666666665,1.0956511111111034,1.0955053333333253,1.0952690000000043,1.0958481999999998,1.0977292000000012,1.0987104000000045,1.095611481082227,1.0955221263701236,-1272,-290229,-289333,0.03364466313843112,-232.26382323290125,0.08951243126723854
2023-08-08T15:15:00-04:00,1.0957999999999999,1.09621,1.09565,1.09601,1.0947765868975863,1.0957904444444442,1.0957499999999922,1.0955751111111032,1.0953475000000044,1.0957729999999999,1.097684000000001,1.0986740500000045,1.0956911848657815,1.0955681010960987,1516,-288713,-289582,0.034941366587275355,-231.97329576438503,0.08126963255166879
2023-08-08T15:30:00-04:00,1.09601,1.09604,1.0957,1.09599,1.0949199282078277,1.0958384444444444,1.095828888888881,1.095645999999992,1.0953950000000046,1.0957038,1.097637700000001,1.0986370500000044,1.0957509478926253,1.0956176808768787,-1473,-290186,-289797,0.03614320604263186,-232.00017508117946,0.06482360674895811
2023-08-08T15:45:00-04:00,1.09599,1.09605,1.09568,1.09571,1.095048935387045,1.0958146666666668,1.0957933333333254,1.0957131111111031,1.0954530000000045,1.0956538,1.0975881000000012,1.0986014000000044,1.0957427583141002,1.0956721447015025,-1393,-291579,-289932.8,0.03715503784002121,-232.3560542406609,-0.029196281123700808
2023-08-08T16:00:00-04:00,1.09571,1.09578,1.09555,1.09555,1.0951650418483405,1.095766,1.095748888888881,1.0957544444444367,1.0954880000000045,1.0956032,1.0975371000000012,1.0985677500000046,1.09570420665128,1.0957001157612019,-690,-292269,-290595.2,0.0284247374768333,-232.456810827714,-0.036498015420407495
2023-08-08T16:15:00-04:00,1.09555,1.09573,1.09532,1.09535,1.0952695376635064,1.0956862222222223,1.0957066666666588,1.0957655555555477,1.0955060000000043,1.0955523999999999,1.097487200000001,1.0985352000000044,1.0956333653210242,1.0957044926089612,-476,-292745,-291098.4,0.020773645507749388,-232.54370782009227,-0.03468007629617213
2023-08-08T16:30:00-04:00,1.09535,1.09561,1.09531,1.0956,1.09621,1.0956648888888887,1.095698888888881,1.0957553333333254,1.0955290000000044,1.0955122,1.0974393000000011,1.0985068500000044,1.0956266922568194,1.0956915940871688,518,-292227,-291801.2,0.01693491879437645,-232.42548076937794,-0.00638878494437326
2023-08-08T16:45:00-04:00,1.0956,1.09566,1.0955,1.0956299999999999,1.0961919999999998,1.0956511111111111,1.0957311111111034,1.09573577777777,1.0955600000000045,1.095465,1.0973911000000012,1.0984804500000045,1.0956273538054555,1.095666875269735,622,-291605,-292085,0.01443957957464815,-232.40844900596065,0.026475797469269948
2023-08-08T17:00:00-04:00,1.0956299999999999,1.0956299999999999,1.09494,1.09543,1.0961743599999998,1.0955908888888888,1.0956744444444366,1.0957119999999922,1.0955810000000046,1.0954088,1.0973447000000012,1.0984530500000043,1.0955878830443644,1.0956359002157878,-163,-291768,-292122.8,0.013435257576016183,-232.43820357639044,-0.04653539427341009
2023-08-08T17:15:00-04:00,1.09543,1.09555,1.09511,1.09536,1.0961249855999997,1.0955279999999996,1.0956255555555476,1.0956873333333257,1.0955745000000046,1.0953454,1.0972983000000012,1.0984257500000043,1.0955423064354914,1.0956035201726302,-252,-292020,-292073,0.006619730186515849,-232.4543068417748,-0.04015331264829312
2023-08-08T17:30:00-04:00,1.09536,1.09568,1.0953,1.09562,1.0960775861759997,1.0955268888888887,1.0955822222222145,1.0956624444444367,1.0955965000000045,1.0953042,1.0972523000000012,1.0984006000000044,1.0955578451483932,1.095588416138104,413,-291607,-291845.4,0.0044116796940913755,-232.35627514443323,-0.03558361693779167
2023-08-08T17:45:00-04:00,1.09562,1.09565,1.09525,1.09539,1.0960320827289598,1.0954884444444444,1.0955155555555478,1.09562577777777,1.0956250000000047,1.095261,1.097203900000001,1.0983737500000046,1.0955242761187145,1.0955679329104828,-544,-292151,-291830.2,-0.00216018206352981,-232.47047532332735,-0.05474502504584293
2023-08-08T18:00:00-04:00,1.09539,1.09567,1.09527,1.09561,1.0959883994198014,1.0955073333333334,1.0955044444444364,1.0955804444444368,1.0956495000000046,1.0952248,1.097157300000001,1.0983479000000045,1.0955414208949716,1.095550746328386,425,-291726,-291854.4,-0.009062022043260906,-232.38511759685554,-0.009126502450464903
2023-08-08T18:15:00-04:00,1.09561,1.09561,1.09541,1.09552,1.0959464634430094,1.0955104444444443,1.0955011111111033,1.0955457777777702,1.0956615000000045,1.0951937999999999,1.0971085000000012,1.0983218000000046,1.0955371367159774,1.0955405970627088,-938,-292664,-292033.6,-0.012534492672219202,-232.46217056278311,-0.0027383506001528446
2023-08-08T18:30:00-04:00,1.09552,1.09558,1.0954,1.0954,1.095906204905289,1.0954902222222223,1.0955066666666586,1.0955219999999923,1.0956300000000048,1.0951724,1.097060400000001,1.0982946500000044,1.095509709372782,1.0955340776501665,-383,-293047,-292239,-0.014425022263108843,-232.504123242789,0.004564750992822702
2023-08-08T18:45:00-04:00,1.0954,1.0954,1.09518,1.09518,1.0958675567090774,1.095424888888889,1.095459999999992,1.0954975555555477,1.0955915000000045,1.0951476,1.0970098000000013,1.0982665500000044,1.0954437674982256,1.0955112621201333,-246,-293293,-292576.2,-0.012282801730261285,-232.55352985224673,-0.0383351588170742
2023-08-08T19:00:00-04:00,1.09518,1.09553,1.09518,1.09551,1.0958304544407143,1.0954348888888887,1.0954466666666587,1.0954837777777702,1.0955805000000045,1.0951416,1.096962900000001,1.0982379500000043,1.0954570139985804,1.0954978096961063,669,-292624,-292670.8,-0.011192080440138943,-232.35194655087165,-0.010952602612186411
2023-08-08T19:15:00-04:00,1.09551,1.09557,1.09539,1.09551,1.0957948362630856,1.0954475555555556,1.0954555555555476,1.0954739999999923,1.0955725000000045,1.0951446,1.096916300000001,1.0982086500000046,1.0954676111988644,1.0954830477568849,0,-292624,-292850.4,-0.011331274839867274,-232.35194655087165,0.007303068201535472
2023-08-08T19:30:00-04:00,1.09551,1.09579,1.09541,1.09578,1.09494,1.0955124444444446,1.0955022222222146,1.0954742222222145,1.0955945000000047,1.0951541999999999,1.0968712000000012,1.0981813500000046,1.0955300889590915,1.095481638205508,579,-292045,-292726.6,-0.008614683297122859,-232.20924589090507,0.038343558282216535
2023-08-08T19:45:00-04:00,1.09578,1.09595,1.09573,1.09591,1.094957,1.0955939999999997,1.0955344444444366,1.09547977777777,1.0955930000000047,1.0951768,1.096828500000001,1.0981556000000046,1.0956060711672733,1.095500910564406,927,-291118,-292340.8,-0.006071853892770297,-232.09926943577725,0.02646903123344786
2023-08-08T20:00:00-04:00,1.09591,1.09628,1.09589,1.09612,1.09499672,1.095711111111111,1.0956155555555478,1.0955108888888812,1.0956090000000045,1.0952089999999999,1.096785900000001,1.0981310000000046,1.0957088569338187,1.0955539284515248,1329,-289789,-291640,-0.002290509640315089,-231.84460436291536,0.0666429308282801
2023-08-08T20:15:00-04:00,1.09612,1.09631,1.09601,1.09626,1.0950737168,1.0958400000000001,1.09568777777777,1.0955591111111036,1.0956215000000047,1.0952516,1.0967453000000011,1.0981085000000046,1.0958190855470549,1.0956263427612196,1213,-288576,-290830.4,0.003650834215885375,-231.6896760703926,0.05932768047024392
2023-08-08T20:30:00-04:00,1.09626,1.09653,1.09622,1.09627,1.095172619456,1.0959564444444445,1.0957711111111035,1.0956222222222147,1.0956355000000046,1.095292,1.096703700000001,1.0980879500000045,1.095909268437644,1.0957146742089754,1100,-287476,-289800.8,0.008544594001664465,-231.67964195439816,0.06846063969621992
2023-08-08T20:45:00-04:00,1.09627,1.09627,1.09575,1.09575,1.0953083575104001,1.0959522222222224,1.0958099999999924,1.0956837777777702,1.0956375000000045,1.0953242,1.0966586000000011,1.0980640500000045,1.0958774147501151,1.0957841393671803,-1461,-288937,-289179.2,0.011687005562574704,-232.37264641497822,0.03195179842980395
2023-08-08T21:00:00-04:00,1.09575,1.09642,1.0955,1.09638,1.09543052175936,1.0960662222222222,1.0959433333333257,1.0957655555555479,1.0956790000000047,1.0953604,1.096622700000001,1.0980446500000047,1.0959779318000922,1.095858511493744,1827,-287110,-288377.6,0.017719053263029107,-231.3222152034794,0.10957102941980933
2023-08-08T21:15:00-04:00,1.09638,1.0968,1.09627,1.0965799999999999,1.0955,1.0961935555555555,1.0960622222222147,1.0958548888888813,1.0957405000000047,1.0954056,1.096592200000001,1.0980264000000046,1.0960983454400737,1.095936409194995,2666,-284444,-287308.6,0.0260189411984161,-230.8358874703942,0.0976714041861694
2023-08-08T21:30:00-04:00,1.0965799999999999,1.09698,1.09631,1.09657,1.0955,1.0962951111111112,1.0961799999999924,1.0959533333333258,1.0957890000000048,1.0954348,1.096565900000001,1.0980084500000045,1.0961926763520589,1.0960111273559958,-2858,-287302,-287053.8,0.030389311723411885,-230.86195032034547,0.09675858732463062
2023-08-08T21:45:00-04:00,1.09657,1.09666,1.09622,1.09636,1.0957071999999999,1.0963311111111111,1.096244444444437,1.0960479999999926,1.0958255000000048,1.0954670000000002,1.0965376000000011,1.0979890500000045,1.0962261410816472,1.0960745018847966,-2174,-289476,-287453.8,0.0348424787962567,-231.27828489087,0.052930332731024925
2023-08-08T22:00:00-04:00,1.09636,1.09651,1.09619,1.09619,1.095885392,1.0963202222222221,1.0962755555555481,1.0961411111111037,1.0958635000000048,1.0955110000000001,1.0965091000000011,1.0979659500000045,1.0962189128653177,1.0961428015078372,-2024,-291500,-287966.4,0.03614960434918551,-231.5921234110641,0.02554954330191877
2023-08-08T22:15:00-04:00,1.09619,1.09644,1.09615,1.09637,1.09603863712,1.0963391111111112,1.0963033333333259,1.0962131111111035,1.0959140000000047,1.0955620000000001,1.096488400000001,1.0979443000000044,1.0962491302922541,1.0961970412062694,1487,-290013,-288547,0.036261104284525676,-231.34795041185768,0.02280772178229423
2023-08-08T22:30:00-04:00,1.09637,1.09657,1.09631,1.09643,1.09615,1.0963644444444445,1.0963222222222149,1.0962651111111037,1.0959545000000048,1.0956144,1.096469500000001,1.0979209500000044,1.0962853042338032,1.0962344329650153,1517,-288496,-289357.4,0.03443884367894289,-231.26493099323082,0.015507270173134429
2023-08-08T22:45:00-04:00,1.09643,1.09697,1.09635,1.09683,1.09615,1.096466,1.096384444444437,1.0963059999999927,1.0960265000000047,1.0956622000000003,1.096458500000001,1.0979001000000044,1.0963942433870426,1.0962747463720122,2043,-286453,-289187.6,0.034380550506189704,-230.51960297411432,0.05108230636612275
2023-08-08T23:00:00-04:00,1.09683,1.09708,1.09675,1.09684,1.0962662,1.0965571111111112,1.096505555555548,1.0963582222222148,1.0960880000000048,1.0956982000000002,1.096444600000001,1.0978829500000042,1.0964833947096342,1.0963261970976095,1932,-284521,-288196.6,0.03327921478458295,-230.50198857625855,0.09947524526580291
2023-08-08T23:15:00-04:00,1.09684,1.09699,1.09667,1.09676,1.09635,1.0966080000000002,1.0965477777777703,1.0964126666666592,1.0961500000000046,1.0957424000000002,1.096427400000001,1.0978685500000043,1.0965387157677073,1.0963901576780875,-1699,-286220,-287140.6,0.03749589461035719,-230.62590819990479,0.034659515861293254
2023-08-08T23:30:00-04:00,1.09676,1.0968499999999999,1.09664,1.09679,1.0964668,1.0966564444444444,1.0965711111111038,1.0964662222222148,1.0962195000000046,1.0957812000000002,1.096407700000001,1.0978539500000042,1.0965889726141658,1.09645812614247,1622,-284598,-286057.6,0.035717093857369854,-230.58154115515484,0.019150449579606002
2023-08-08T23:45:00-04:00,1.09679,1.0968,1.09662,1.09665,1.096564912,1.0966722222222223,1.0965799999999928,1.0965177777777706,1.0962930000000046,1.0958144,1.0963858000000009,1.0978369000000041,1.0966011780913325,1.0965213009139758,-1073,-285671,-285492.6,0.030923885280866897,-230.71850447538938,0.007295475892998893
2023-08-09T00:00:00-04:00,1.09665,1.0968499999999999,1.09662,1.09672,1.09708,1.0967002222222224,1.0966199999999928,1.096564888888882,1.0963535000000046,1.0958460000000003,1.0963637000000008,1.097821450000004,1.096624942473066,1.0965674407311805,1514,-284157,-285033.4,0.025600953498972682,-230.62186470882756,0.03283592980407129
2023-08-09T00:15:00-04:00,1.09672,1.09682,1.09632,1.09638,1.0970708,1.096652222222222,1.0966411111111039,1.096591999999993,1.0963970000000045,1.0958734,1.0963405000000008,1.097802850000004,1.0965759539784528,1.0965859525849442,-1154,-285311,-285191.4,0.02200365279776035,-230.97962238626573,0.017332761656274228
2023-08-09T00:30:00-04:00,1.09638,1.09684,1.09637,1.09672,1.097040768,1.096668,1.096679999999993,1.0966184444444376,1.0964440000000046,1.0959076,1.096324300000001,1.0977862500000042,1.0966047631827622,1.0965991620679554,1088,-284223,-284792,0.021581209017072927,-230.6422211202813,0.031923529465404055
2023-08-09T00:45:00-04:00,1.09672,1.09674,1.09655,1.09667,1.09701193728,1.096666,1.0967066666666594,1.0966455555555485,1.0964820000000048,1.0959312,1.0963093000000008,1.0977694000000042,1.0966178105462099,1.096604929654364,-1527,-285750,-285022.4,0.020451194434301666,-230.71183779545802,0.021889222294174546
2023-08-09T01:00:00-04:00,1.09667,1.0979,1.09666,1.09757,1.09632,1.0968386666666665,1.0967888888888817,1.0966873333333265,1.0965545000000048,1.0959790000000003,1.096301600000001,1.0977571000000044,1.096808248436968,1.096646343723491,1866,-283884,-284665,0.023637253492990954,-229.18047466890235,0.0674671553476804
2023-08-09T01:15:00-04:00,1.09757,1.09782,1.09752,1.09773,1.0963516,1.097026888888889,1.0968877777777704,1.0967408888888819,1.0966280000000048,1.0960372000000003,1.0962924000000007,1.0977451500000042,1.0969925987495743,1.0967198749787925,1191,-282693,-284372.2,0.024851468725104162,-229.00685476311028,0.08114219029211711
2023-08-09T01:30:00-04:00,1.09773,1.09774,1.09736,1.0975,1.096382568,1.0971493333333333,1.0969699999999927,1.0968066666666594,1.0966895000000048,1.0960848,1.0962789000000008,1.0977340000000042,1.0970940789996595,1.096823499983034,-2082,-284775,-284265,0.0254840847139244,-229.4430822507442,0.06747146139537938
2023-08-09T01:45:00-04:00,1.0975,1.09774,1.09743,1.09766,1.0964129166399998,1.0972873333333333,1.097066666666659,1.0968839999999926,1.0967850000000046,1.0961324000000001,1.0962635000000007,1.097724450000004,1.0972072631997276,1.096943999986427,1938,-282837,-283987.8,0.02765349120470298,-229.16054922113116,0.0793223862362119
2023-08-09T02:00:00-04:00,1.09766,1.09792,1.09725,1.09736,1.0964426583071998,1.0973459999999997,1.097145555555548,1.0969717777777706,1.0968340000000045,1.096159,1.0962432000000006,1.097713850000004,1.097237810559782,1.0970679999891417,-2610,-285447,-283927.2,0.025858483414986075,-229.87388486240488,0.06474262526786016
2023-08-09T02:15:00-04:00,1.09736,1.09736,1.09699,1.09713,1.0965017519749118,1.0973428888888888,1.0971911111111037,1.0970522222222148,1.0968615000000046,1.0961826000000001,1.0962233000000008,1.097703300000004,1.0972162484478256,1.097149599991313,-2185,-287632,-284676.8,0.026977734035610604,-230.33184760936112,0.037384200160480476
2023-08-09T02:30:00-04:00,1.09713,1.09797,1.09711,1.09767,1.0965584818959153,1.0974386666666667,1.0973344444444368,1.0971415555555482,1.0969165000000047,1.0962214000000001,1.0962096000000008,1.0976944000000042,1.0973069987582604,1.0972124799930503,2672,-284960,-285130.2,0.0309052785124824,-229.01670719755947,0.11765993542385063
2023-08-09T02:45:00-04:00,1.09767,1.09792,1.09712,1.09726,1.0966431729821604,1.0974237777777778,1.0973944444444368,1.097226444444437,1.0969615000000046,1.0962532000000003,1.0961832000000007,1.097682450000004,1.0972975990066083,1.09725318399444,-2498,-287458,-285666.8,0.035931356653177995,-229.94975629246053,0.04923772704062887
2023-08-09T03:00:00-04:00,1.09726,1.0983,1.09724,1.09782,1.0967227826032309,1.0975088888888889,1.0975222222222145,1.097317555555548,1.0970430000000047,1.0963028000000001,1.0961664000000007,1.097675200000004,1.0974020792052865,1.0972921471955517,4594,-282864,-285672.2,0.0396187879961571,-227.6051524610983,0.10486290315226862
2023-08-09T03:15:00-04:00,1.09782,1.09787,1.09722,1.09732,1.0968489599949725,1.0974684444444445,1.0974944444444368,1.097387333333326,1.0970905000000046,1.0963304,1.0961394000000007,1.097665350000004,1.0973856633642292,1.0973217177564412,-3601,-286465,-285875.8,0.040636890587998915,-229.2452209604878,-0.022777590495354414
2023-08-09T03:30:00-04:00,1.09732,1.0982399999999999,1.09706,1.09808,1.0969650431953746,1.0975855555555554,1.0975333333333255,1.0974557777777705,1.0971730000000046,1.096376,1.0961121000000007,1.097662650000004,1.0975245306913832,1.0973833742051526,2979,-283486,-285046.6,0.03786042381309774,-227.1819759635866,0.03188397875614681
2023-08-09T03:45:00-04:00,1.09808,1.09847,1.09789,1.09842,1.09706,1.0977628888888886,1.0976355555555477,1.0975159999999926,1.0972525000000046,1.0964242000000002,1.0960986000000006,1.097663250000004,1.0977036245531067,1.0974626993641219,2606,-280880,-284230.6,0.03550925532147195,-226.3750766484183,0.08382687927107353
2023-08-09T04:00:00-04:00,1.09842,1.09887,1.09832,1.09844,1.09706,1.0979237777777777,1.0977222222222143,1.0975815555555481,1.0973325000000047,1.0964732000000001,1.0960885000000007,1.0976643000000041,1.0978508996424854,1.0975733594912973,3393,-277487,-282236.4,0.03708639620157985,-226.31329700128836,0.07106025545250833
2023-08-09T04:15:00-04:00,1.09844,1.09845,1.09772,1.09783,1.0972772,1.0979453333333333,1.0977744444444366,1.0976319999999926,1.0973860000000046,1.0965156,1.0960847000000007,1.0976658000000041,1.0978467197139883,1.0976622875930375,-2692,-280179,-281699.4,0.03433794123394792,-227.80825348502893,0.04283006488300945
2023-08-09T04:30:00-04:00,1.09783,1.09786,1.09734,1.09775,1.09887,1.0979404444444445,1.0978433333333255,1.0977017777777704,1.0974340000000047,1.0965596,1.0960814000000005,1.097667900000004,1.0978273757711907,1.09775063007443,-2372,-282551,-280916.6,0.03359445478903357,-227.98110356199913,0.05651107890587852
2023-08-09T04:45:00-04:00,1.09775,1.09864,1.09772,1.09837,1.0988394,1.0980457777777777,1.0979211111111036,1.097779333333326,1.0975200000000045,1.0966200000000002,1.0960862000000007,1.0976697000000042,1.0979359006169527,1.0978329040595438,2051,-280500,-280319.4,0.03803523661410986,-226.82271595097646,0.06377144314777164
2023-08-09T05:00:00-04:00,1.09837,1.09865,1.09805,1.09837,1.0988094119999998,1.0981355555555556,1.0980444444444368,1.0978611111111038,1.0976025000000047,1.0966754,1.0960938000000007,1.097670250000004,1.0980227204935622,1.097896723247635,0,-280500,-280243.4,0.03694774168022228,-226.82271595097646,0.10116107394784887
2023-08-09T05:15:00-04:00,1.09837,1.09872,1.09817,1.09819,1.0987800237599998,1.0981646666666667,1.098085555555548,1.0979337777777707,1.0976930000000045,1.0967266,1.0960958000000007,1.097667150000004,1.0980561763948498,1.0979377785981077,-2578,-283078,-281361.6,0.039040808252195205,-227.2451965358433,0.03370315716601824
2023-08-09T05:30:00-04:00,1.09819,1.09849,1.09795,1.09828,1.0987512232847998,1.0982035555555556,1.0981922222222145,1.0980173333333263,1.0977710000000047,1.0967836000000002,1.0960962000000007,1.097663300000004,1.0981009411158797,1.097988622878486,2242,-280836,-281493,0.034985905864132985,-227.06145783853242,0.08748587467647084
2023-08-09T05:45:00-04:00,1.09828,1.09831,1.09777,1.09785,1.0987229988191038,1.0981351111111113,1.0981666666666592,1.0980819999999931,1.0978300000000047,1.0968334000000002,1.0960894000000008,1.0976562500000042,1.0980507528927037,1.0980332983027887,-2119,-282955,-281573.8,0.034910448713209745,-227.89109144744805,-0.02094565059011661
2023-08-09T06:00:00-04:00,1.09785,1.09801,1.09762,1.09768,1.0986953388427219,1.098037777777778,1.0980844444444369,1.0981146666666597,1.0978355000000046,1.0968746000000003,1.0960894000000008,1.097652400000004,1.097976602314163,1.0980414386422308,-2082,-285037,-282481.2,0.02688437895293906,-228.2134852170887,-0.06736949436462947
2023-08-09T06:15:00-04:00,1.09768,1.09794,1.09749,1.09771,1.0986682320658674,1.097962888888889,1.0980033333333254,1.0981064444444373,1.0978345000000047,1.096921,1.0960910000000006,1.097650100000004,1.0979232818513305,1.0980215509137845,1958,-283079,-282997,0.019809650384036915,-228.15997235359484,-0.0664578857288627
2023-08-09T06:30:00-04:00,1.09771,1.09809,1.0976299999999999,1.09795,1.09864166742455,1.0979522222222222,1.0980166666666589,1.0980926666666595,1.0978570000000047,1.0969678000000003,1.0960963000000006,1.0976503000000042,1.0979286254810643,1.0979960407310276,1841,-281238,-282629,0.01439189681585759,-227.7574616722673,0.010930654108550318
2023-08-09T06:45:00-04:00,1.09795,1.09811,1.09745,1.0976299999999999,1.0986156340760591,1.097874888888889,1.0980033333333254,1.0980548888888815,1.0978555000000048,1.09701,1.0961019000000005,1.097651100000004,1.0978689003848514,1.097949632584822,-2127,-283365,-283134.8,0.01200619221127699,-228.37738061210993,-0.010931450694613529
2023-08-09T07:00:00-04:00,1.0976299999999999,1.09791,1.09742,1.09743,1.098590121394538,1.097760222222222,1.097898888888881,1.0980013333333258,1.0978590000000046,1.0970506,1.0961115000000006,1.097651250000004,1.097781120307881,1.0978957060678574,-1759,-285124,-283568.6,0.010089119106570725,-228.69788934456074,-0.08558136147201424
2023-08-09T07:15:00-04:00,1.09743,1.09765,1.09728,1.09738,1.0985651189666472,1.0976564444444443,1.097788888888881,1.0979422222222148,1.0978715000000048,1.0970946000000001,1.0961211000000006,1.0976511500000041,1.0977008962463048,1.0978405648542857,-1756,-286880,-283937.2,0.000984620830203211,-228.7778944473917,-0.09013356155030147
2023-08-09T07:30:00-04:00,1.09738,1.09809,1.09731,1.09772,1.0985137142079813,1.0976426666666668,1.0977366666666586,1.0978888888888814,1.097874000000005,1.0971388,1.0961402000000007,1.0976544000000041,1.097704716997044,1.0977968518834285,2158,-284722,-284265.8,-0.007495071599750095,-228.10928375647333,-0.04279769438803581
2023-08-09T07:45:00-04:00,1.09772,1.09792,1.09693,1.09698,1.098464365639662,1.0974913333333336,1.097592222222214,1.0978039999999925,1.0978600000000047,1.0971681999999998,1.0961564000000008,1.097656200000004,1.0975597735976352,1.0977230815067425,-2729,-287451,-285508.4,-0.01552411116952951,-229.94896965087253,-0.11836690097241659
2023-08-09T08:00:00-04:00,1.09698,1.0974,1.09653,1.09668,1.0983723037012822,1.097308888888889,1.0974622222222141,1.0976957777777703,1.0978030000000047,1.0971862,1.0961702000000006,1.0976556000000042,1.0973838188781082,1.097626065205394,-3547,-290998,-287035,-0.02758320942043423,-230.91899645172566,-0.10657193605682866
2023-08-09T08:15:00-04:00,1.09668,1.09698,1.0962,1.09692,1.0982249194051796,1.0972004444444445,1.0973777777777698,1.0975915555555482,1.0977830000000048,1.0972064,1.0961916000000007,1.097654700000004,1.0972910551024866,1.0975280521643151,3737,-287261,-287462.4,-0.03215202546452378,-230.10118268654418,-0.06923693608338441
2023-08-09T08:30:00-04:00,1.09692,1.09798,1.0968,1.09759,1.0980224274646617,1.0972428888888888,1.0973644444444364,1.0975066666666593,1.0977585000000047,1.0972357999999998,1.0962224000000007,1.0976573500000042,1.0973508440819892,1.097458041731452,3547,-283714,-286829.2,-0.034142691377258255,-227.9346709992738,-0.010931849031155585
2023-08-09T08:45:00-04:00,1.09759,1.09817,1.09745,1.09816,1.0962,1.097402,1.0973877777777696,1.0974368888888815,1.097745500000005,1.0972738,1.0962627000000007,1.097661650000004,1.0975126752655915,1.0974196333851614,3520,-280194,-285923.6,-0.030390403468505932,-226.1066660065171,0.019126554032519102
2023-08-09T09:00:00-04:00,1.09816,1.09873,1.09815,1.0984,1.0962394,1.0976044444444446,1.0974733333333253,1.0974131111111036,1.0977435000000049,1.0973163999999997,1.0963042000000007,1.0976654500000043,1.0976901402124732,1.0974457067081291,3006,-277188,-283871,-0.026204479963726653,-225.44971255711076,0.07015114382808046
2023-08-09T09:15:00-04:00,1.0984,1.09852,1.09801,1.09836,1.096339024,1.0977817777777776,1.0975766666666589,1.0974359999999925,1.0977700000000048,1.0973685999999998,1.0963464000000007,1.0976669000000043,1.0978241121699785,1.0975337653665032,-2787,-279975,-281666.4,-0.019207720566385502,-225.55120563795572,0.08474344605123767
2023-08-09T09:30:00-04:00,1.09836,1.09879,1.09791,1.09794,1.09643466304,1.0978544444444445,1.097638888888881,1.0974882222222149,1.0977795000000048,1.0973997999999998,1.0963801000000009,1.0976670000000042,1.0978472897359828,1.0976450122932022,-5479,-285454,-281305,-0.01503903555807411,-227.64631106786985,0.051030636607182
2023-08-09T09:45:00-04:00,1.09794,1.09816,1.09714,1.09801,1.0965759832575999,1.0979286666666668,1.0976711111111033,1.0975495555555483,1.0977615000000047,1.0974283999999999,1.0964170000000009,1.0976651000000042,1.0978798317887861,1.0977508098345616,4331,-281123,-280786.8,-0.010427872436098263,-227.3701848678953,0.0264183944903893
2023-08-09T10:00:00-04:00,1.09801,1.09953,1.09775,1.0988499999999999,1.0967088242621439,1.0981644444444445,1.097878888888881,1.0976477777777707,1.0977855000000047,1.0974739999999998,1.0964544000000007,1.0976678000000042,1.098073865431029,1.0978630478676492,5432,-275691,-279886.2,-0.00221652739960508,-223.21459429950363,0.1704680121788744
2023-08-09T10:15:00-04:00,1.0988499999999999,1.09917,1.09788,1.09821,1.0969345183211723,1.0982306666666668,1.098048888888881,1.0977628888888815,1.0977865000000047,1.097511,1.0964890000000007,1.0976658000000041,1.0981010923448231,1.0979452382941193,-3813,-279504,-280349.4,0.009681650669711868,-225.43538876644627,0.13951198161722736
2023-08-09T10:30:00-04:00,1.09821,1.09857,1.09767,1.09842,1.0971421568554784,1.0983048888888887,1.098215555555548,1.0978906666666595,1.0977935000000048,1.0975555999999997,1.0965333000000006,1.0976659000000042,1.0981648738758585,1.0980133906352951,4334,-275170,-279388.4,0.024533543852505883,-224.60664016645157,0.1367465266382286
2023-08-09T10:45:00-04:00,1.09842,1.09876,1.09812,1.09828,1.0973331843070402,1.0983177777777777,1.0982922222222145,1.098021333333326,1.0978150000000046,1.0975937999999998,1.0965779000000007,1.097659600000004,1.0981878991006868,1.098081512508236,-4704,-279874,-278272.4,0.03692176896596062,-225.20619225035404,0.06286500423654164
2023-08-09T11:00:00-04:00,1.09828,1.09878,1.09783,1.09822,1.097508929562477,1.0983033333333332,1.0982988888888814,1.098146888888882,1.0978420000000046,1.0976295999999996,1.0966220000000007,1.097651200000004,1.0981943192805494,1.0981444100065887,-3857,-283731,-278794,0.04105485605455238,-225.41690354437725,0.005463684708963082
2023-08-09T11:15:00-04:00,1.09822,1.09828,1.09764,1.09783,1.09953,1.0982095555555555,1.098235555555548,1.0982182222222154,1.0978480000000048,1.0976495999999998,1.0966559000000007,1.097639150000004,1.0981214554244396,1.0981539280052708,-3261,-286992,-281054.2,0.0373980629523826,-226.57495020169512,-0.05189366351055712
2023-08-09T11:30:00-04:00,1.09783,1.09855,1.09778,1.09796,1.0994921999999998,1.0981544444444444,1.0981911111111036,1.0982466666666597,1.0978485000000047,1.0976719999999998,1.0966851000000006,1.0976282000000042,1.0980891643395516,1.0981515424042165,2863,-284129,-281979.2,0.0323054688546588,-226.2359268556398,-0.036417932189806254
2023-08-09T11:45:00-04:00,1.09796,1.09806,1.09739,1.09741,1.0994551559999999,1.0979982222222222,1.0981322222222145,1.0982299999999932,1.0978375000000047,1.0976849999999998,1.0967137000000007,1.0976188500000041,1.0979533314716412,1.098109233923373,-2390,-286519,-284249,0.02599506037491777,-227.43314715510436,-0.048272218882627414
2023-08-09T12:00:00-04:00,1.09741,1.09816,1.09733,1.09792,1.09937254976,1.097955777777778,1.0981222222222147,1.098195999999993,1.0978620000000046,1.0977076,1.0967444000000006,1.0976101500000042,1.0979466651773129,1.0980609871386982,2461,-284058,-285085.8,0.024554678076351512,-226.28944516587515,-0.008196646660770255
2023-08-09T12:15:00-04:00,1.09792,1.09801,1.09767,1.09775,1.0992499967744,1.0978813333333333,1.0979999999999925,1.0981362222222153,1.0978805000000045,1.0977295999999999,1.0967720000000007,1.097598000000004,1.0979073321418502,1.0980035897109583,-2088,-286146,-285568.8,0.02079810054163566,-226.61274741011883,-0.10010465486644028
2023-08-09T12:30:00-04:00,1.09775,1.09811,1.09772,1.09786,1.0991347969679361,1.0978533333333333,1.0979611111111034,1.0980813333333264,1.0978875000000046,1.0977523999999999,1.0967992000000006,1.0975850000000043,1.0978978657134801,1.0979588717687663,1854,-284292,-285028.8,0.009698349242342084,-226.42696740556397,-0.03187004307007316
2023-08-09T12:45:00-04:00,1.09786,1.09816,1.09766,1.09784,1.0990265091498599,1.0978291111111111,1.0978966666666592,1.0980224444444375,1.0979305000000044,1.0977815999999998,1.0968275000000007,1.097573350000004,1.0978862925707842,1.097918297415013,-1926,-286218,-285446.6,0.0058077021670865595,-226.4620538464583,-0.0528031172047145
2023-08-09T13:00:00-04:00,1.09784,1.099,1.09772,1.09899,1.09733,1.0980477777777777,1.097975555555548,1.0979911111111043,1.0980460000000043,1.0978269999999997,1.0968673000000007,1.097568350000004,1.0981070340566272,1.09794903793201,2303,-283915,-284925.8,0.0022812434948485246,-224.04963491473788,0.06464653822340281
2023-08-09T13:15:00-04:00,1.09899,1.09916,1.09772,1.09777,1.0973633999999999,1.0980066666666666,1.097925555555548,1.097951777777771,1.0980885000000042,1.0978489999999999,1.0968901000000009,1.097557250000004,1.0980396272453017,1.0979676303456078,-2174,-286089,-285332,-0.007090602284591049,-226.46301447233168,-0.040975396550787774
2023-08-09T13:30:00-04:00,1.09777,1.0981,1.09748,1.09806,1.0974352639999998,1.0980335555555556,1.0979511111111036,1.0979419999999933,1.0981120000000044,1.0978587999999998,1.0969189000000008,1.0975465000000042,1.0980437017962414,1.097994904276486,2346,-283743,-284851.4,-0.013490992778064334,-225.84326716642946,0.020950420374734928
2023-08-09T13:45:00-04:00,1.09806,1.09815,1.09787,1.09796,1.09748,1.0980353333333335,1.0979511111111036,1.0979399999999935,1.0981020000000044,1.0978633999999998,1.0969503000000007,1.0975368500000042,1.098026961436993,1.0980207234211885,-1467,-285210,-285035,-0.013911414471381365,-225.97686642330066,0
2023-08-09T14:00:00-04:00,1.09796,1.09798,1.09766,1.09788,1.09748,1.0980211111111111,1.098003333333326,1.0979613333333265,1.0980760000000043,1.0978709999999998,1.0969779000000008,1.0975276500000042,1.0979975691495945,1.0980429787369506,-1796,-287006,-285192.6,-0.013425892197098447,-226.1077272925492,0.0428281134671609
2023-08-09T14:15:00-04:00,1.09788,1.09789,1.09752,1.09766,1.09916,1.0979524444444444,1.0979744444444368,1.0979611111111045,1.0980410000000043,1.0978709999999998,1.0970017000000007,1.0975169500000042,1.0979300553196756,1.0980075829895604,-2058,-289064,-286222.4,-0.007940438471536497,-226.5201220897946,-0.023681142524038815
2023-08-09T14:30:00-04:00,1.09766,1.09785,1.09756,1.0976299999999999,1.0991271999999999,1.0978835555555557,1.0979611111111036,1.0979682222222154,1.0980255000000043,1.0978763999999999,1.0970177000000008,1.097507250000004,1.0978700442557405,1.0979736663916482,-1714,-290778,-287160.2,-0.007415936456870509,-226.5669671966586,-0.010931450694613529
2023-08-09T14:45:00-04:00,1.0976299999999999,1.09779,1.09747,1.09752,1.099095056,1.0977953333333335,1.097923333333326,1.0979626666666598,1.0980010000000042,1.0978842,1.0970334000000006,1.0974945500000042,1.0978000354045925,1.0979249331133183,-1376,-292154,-288842.4,-0.007689295225735839,-226.70486430224042,-0.030969340353051114
2023-08-09T15:00:00-04:00,1.09752,1.09787,1.0974599999999999,1.09758,1.09903005376,1.0977266666666667,1.0978944444444372,1.0979513333333264,1.0979375000000042,1.0978823999999998,1.0970519000000005,1.0974835500000042,1.097756028323674,1.0978707464906545,1580,-290574,-289915.2,-0.00837467906434107,-226.61848774418232,-0.023682868177505555
2023-08-09T15:15:00-04:00,1.09758,1.09804,1.09752,1.09795,1.0989358505344,1.097737777777778,1.0977788888888815,1.0979064444444375,1.0979245000000042,1.0978962,1.0970747000000007,1.0974754000000042,1.0977948226589391,1.0978301971925233,1207,-289367,-290387.4,-0.003469707286570165,-226.2116016857629,-0.09463234424334434
2023-08-09T15:30:00-04:00,1.09795,1.09821,1.09792,1.09819,1.098847299502336,1.09782,1.097825555555548,1.0978766666666597,1.0979130000000041,1.0979036,1.0971032000000007,1.0974639500000043,1.0978738581271512,1.0978189577540183,1387,-287980,-290170.6,-0.010669359161600191,-225.90841848069888,0.03825938038023329
2023-08-09T15:45:00-04:00,1.09819,1.09819,1.09731,1.09732,1.0987640615321959,1.097718888888889,1.0977433333333257,1.0978331111111044,1.0978650000000043,1.0979036,1.0971170000000008,1.0974476000000042,1.097763086501721,1.0977975662032144,-2060,-290040,-290023,-0.009997579761355622,-227.54037652074646,-0.06739158151648934
2023-08-09T16:00:00-04:00,1.09732,1.09749,1.09723,1.09724,1.0986477366096201,1.0976182222222222,1.0976633333333257,1.0977811111111042,1.0978160000000043,1.0978868,1.0971314000000008,1.097430300000004,1.0976584692013767,1.097769252962571,-918,-290958,-289783.8,-0.012956233349040527,-227.60730321487404,-0.06557615942293471
2023-08-09T16:15:00-04:00,1.09724,1.09741,1.09718,1.09732,1.098505962948658,1.0975495555555557,1.0976011111111037,1.0977224444444376,1.0977905000000043,1.0978648,1.0971445000000009,1.0974142500000041,1.0975907753611014,1.0977362023700565,603,-290355,-289740,-0.014882682300680801,-227.56333835759574,-0.051007396072420844
2023-08-09T16:30:00-04:00,1.09732,1.09733,1.09712,1.09724,1.098346847394819,1.0974773333333334,1.097554444444437,1.0976775555555487,1.0977545000000042,1.0978408,1.0971570000000008,1.097397350000004,1.0975206202888812,1.097681361896045,-415,-290770,-290020.6,-0.018153780085247487,-227.59359388925472,-0.03826321447443534
2023-08-09T16:45:00-04:00,1.09724,1.09741,1.09722,1.09738,1.0981750887595443,1.0974424444444446,1.097526666666659,1.097617777777771,1.097753000000004,1.0978318000000002,1.0971737000000008,1.097380900000004,1.097492496231105,1.0976050895168359,628,-290142,-290453,-0.01818894027383008,-227.51346556728322,-0.022776345398710082
2023-08-09T17:00:00-04:00,1.09738,1.09785,1.09718,1.09745,1.098027376333208,1.0974271111111111,1.0975188888888812,1.097572888888882,1.0977295000000042,1.0978258,1.0971927000000008,1.097364900000004,1.097483996984884,1.0975492716134685,493,-289649,-290374.8,-0.020002160285113157,-227.48201793747404,-0.006378015890372339
2023-08-09T17:15:00-04:00,1.09745,1.09761,1.09716,1.0976,1.0979003436465589,1.0974433333333333,1.0975211111111036,1.0975444444444373,1.097722000000004,1.0978104,1.0972152000000008,1.097351200000004,1.0975071975879072,1.0975190172907747,174,-289475,-290078.2,-0.017885502418411442,-227.4582355328087,0.0018221906375762112
2023-08-09T17:30:00-04:00,1.0976,1.0976,1.09737,1.09742,1.09785,1.097423111111111,1.0974622222222146,1.0975166666666596,1.0977000000000041,1.0977914000000002,1.097233400000001,1.0973363500000042,1.0974897580703258,1.0974988138326196,-74,-289549,-289917,-0.017911786727594404,-227.4703711013218,-0.04827177922491183
2023-08-09T17:45:00-04:00,1.09742,1.09771,1.0974,1.09761,1.0977478,1.0974526666666666,1.0973977777777701,1.0974853333333263,1.0976885000000043,1.0977798,1.097253200000001,1.097322150000004,1.0975138064562606,1.0974974510660953,1219,-288330,-289429,-0.019924855573806882,-227.25932154873493,-0.052814176053326375
2023-08-09T18:00:00-04:00,1.09761,1.09783,1.09758,1.09781,1.09712,1.0975351111111114,1.0974522222222147,1.0974704444444374,1.0976295000000043,1.0977704000000001,1.097277000000001,1.0973108500000042,1.0975730451650085,1.097513560852876,185,-288145,-289029.6,-0.023256540332327144,-227.22561194331954,0.04465424853277798
2023-08-09T18:15:00-04:00,1.09781,1.09787,1.09774,1.09785,1.0971342000000002,1.0976146666666668,1.0975199999999923,1.0974706666666596,1.0976335000000041,1.0977704000000001,1.0973019000000008,1.0973001000000042,1.0976284361320068,1.0975424486823007,280,-287865,-288672.8,-0.013483473634062914,-227.21540981362494,0.055594035944734006
2023-08-09T18:30:00-04:00,1.09785,1.09789,1.09767,1.09767,1.0971636320000002,1.0976446666666666,1.0975588888888812,1.0974782222222152,1.097614000000004,1.0977702000000003,1.0973224000000008,1.0972873500000042,1.0976367489056054,1.0975683589458405,-206,-288071,-288392,-0.009132186336238492,-227.24918491951374,0.03189589180912135
2023-08-09T18:45:00-04:00,1.09767,1.09776,1.09765,1.09768,1.0972072140800002,1.0976688888888888,1.0976077777777702,1.0975073333333263,1.0976000000000041,1.0977696000000001,1.0973453000000009,1.0972746000000042,1.0976453991244843,1.097599487156672,394,-287677,-288017.6,-0.00420391185033554,-227.2455954982851,0.040100616091283216
2023-08-09T19:00:00-04:00,1.09768,1.09768,1.09755,1.09762,1.0972481812352002,1.0976713333333332,1.097634444444437,1.0975546666666598,1.097587000000004,1.097763,1.0973654000000008,1.0972613500000041,1.0976403192995874,1.0976247897253375,-296,-287973,-287946.2,0.0007332008079103239,-227.26177507703298,0.021870272831655213
2023-08-09T19:15:00-04:00,1.09762,1.09766,1.09752,1.09762,1.0972866903610883,1.0976684444444444,1.0976533333333258,1.097594888888882,1.0975850000000043,1.0977628,1.0973864000000009,1.097247450000004,1.09763625543967,1.0976374317802697,0,-287973,-287911.8,0.004047834734062616,-227.26177507703298,0.015490455146020637
2023-08-09T19:30:00-04:00,1.09762,1.09777,1.09761,1.09768,1.097322888939423,1.0976737777777776,1.0976622222222148,1.0976233333333265,1.0975875000000042,1.0977678000000002,1.0974092000000006,1.0972348000000043,1.0976450043517358,1.0976407454242156,400,-287573,-287853.4,0.00605656204228733,-227.23990958624384,0.007288629737616619
2023-08-09T19:45:00-04:00,1.09768,1.09774,1.09762,1.09772,1.0973569156030578,1.0976853333333334,1.097695555555548,1.09765066666666,1.0975975000000042,1.0977746000000002,1.0974346000000008,1.097222200000004,1.0976600034813886,1.0976453963393724,617,-286956,-287630.4,0.006759374510829232,-227.21742580226305,0.027336844599147724
2023-08-09T20:00:00-04:00,1.09772,1.09777,1.09725,1.09727,1.09789,1.0976002222222223,1.0976577777777703,1.0976606666666597,1.097582000000004,1.0977656000000002,1.0974522000000009,1.097207550000004,1.0975820027851109,1.0976327170714975,-1472,-288428,-287780.6,0.006477442620870208,-227.82085837158866,-0.030976394165505686
2023-08-09T20:15:00-04:00,1.09727,1.09729,1.09688,1.09699,1.0978772,1.0974666666666666,1.0975666666666593,1.0976471111111041,1.0975340000000042,1.0977658000000003,1.0974670000000009,1.097191650000004,1.0974636022280886,1.0975973736571978,-1158,-289586,-288103.2,0.0033884877325024154,-228.11635537779503,-0.07469416383527595
2023-08-09T20:30:00-04:00,1.09699,1.09706,1.09672,1.09694,1.097837312,1.0973413333333333,1.0974655555555481,1.0976095555555487,1.0974715000000042,1.0977710000000003,1.097478600000001,1.097174900000004,1.0973588817824709,1.097541898925758,-1286,-290872,-288683,-0.0001561983403684275,-228.17497031503225,-0.08288928359976011
2023-08-09T20:45:00-04:00,1.09694,1.0974,1.09694,1.09708,1.09777027328,1.0972642222222222,1.0973999999999926,1.0975571111111042,1.0974595000000043,1.0977742000000001,1.097490300000001,1.097159400000004,1.0973031054259768,1.097473519140606,1879,-288993,-288967,-0.0023561051106567063,-227.93515774552066,-0.05375021636738441
2023-08-09T21:00:00-04:00,1.09708,1.09718,1.09683,1.09687,1.0977072568832,1.097158222222222,1.0973099999999925,1.0974799999999931,1.097441000000004,1.0977598000000004,1.0974978000000009,1.097141850000004,1.0972164843407815,1.0973848153124846,-1381,-290374,-289650.6,-0.007693289004388383,-228.199504921661,-0.0737919976678064
2023-08-09T21:15:00-04:00,1.09687,1.09725,1.09677,1.09722,1.097648021470208,1.0971402222222222,1.097265555555548,1.0974015555555485,1.097436000000004,1.0977410000000003,1.097507400000001,1.0971263500000041,1.097217187472625,1.0973118522499876,1520,-288854,-289735.8,-0.011798122366924697,-227.71448846574543,-0.036442484648599324
2023-08-09T21:30:00-04:00,1.09722,1.09759,1.09718,1.09727,1.0975923401819956,1.0971411111111111,1.097226666666659,1.0973335555555486,1.097437500000004,1.0977184000000004,1.097517400000001,1.097110550000004,1.0972277499781,1.0972646817999898,2055,-286799,-289178.4,-0.014770465490651105,-227.6208427064631,-0.031887174067534524
2023-08-09T21:45:00-04:00,1.09727,1.09748,1.09708,1.09729,1.09759,1.0971537777777778,1.0971833333333256,1.097277111111104,1.097433000000004,1.0976970000000004,1.097532800000001,1.097095700000004,1.0972401999824801,1.0972409454399918,1808,-284991,-288002.2,-0.01799441465833108,-227.58788819207717,-0.035529480358564465
2023-08-09T22:00:00-04:00,1.09729,1.09785,1.09715,1.09785,1.09672,1.097287111111111,1.09719777777777,1.0972366666666595,1.097453000000004,1.0976952000000002,1.0975475000000012,1.097085100000004,1.0973621599859842,1.0972527563519932,1502,-283489,-286901.4,-0.0184843605384531,-226.8213451633429,0.01184272856465797
2023-08-09T22:15:00-04:00,1.09785,1.09796,1.0977,1.09787,1.0967426,1.0974215555555558,1.0972644444444368,1.0972275555555482,1.0974665000000041,1.0976924000000003,1.097560400000001,1.0970763000000041,1.0974637279887873,1.0973022050815946,1499,-281990,-285224.6,-0.01893961581836137,-226.79403724331752,0.054681163250606866
2023-08-09T22:30:00-04:00,1.09787,1.09806,1.09758,1.09759,1.096791296,1.0974866666666665,1.0973311111111035,1.0972406666666594,1.0974750000000042,1.0976672000000003,1.0975706000000012,1.097068250000004,1.0974889823910299,1.0973565640652754,-1290,-283280,-284109.8,-0.015980443373480115,-227.12303794467542,0.05469512028369958
2023-08-09T22:45:00-04:00,1.09759,1.09798,1.09758,1.09789,1.09686741824,1.0975984444444444,1.097436666666659,1.0972826666666593,1.0974890000000042,1.0976608000000003,1.097585900000001,1.097061750000004,1.0975691859128238,1.09742485125222,1358,-281922,-283134.4,-0.00981889923296286,-226.7518610935744,0.08660455448793976
2023-08-09T23:00:00-04:00,1.09789,1.09819,1.09784,1.09815,1.0969389731456,1.097741111111111,1.097555555555548,1.0973571111111038,1.097506000000004,1.0976554000000003,1.097605500000001,1.097057300000004,1.0976853487302591,1.0975138810017757,1090,-280832,-282302.6,-0.0011367615223031985,-226.49372958677506,0.09753162941625992
2023-08-09T23:15:00-04:00,1.09815,1.09817,1.09781,1.09783,1.097039055293952,1.097796,1.0976622222222145,1.0974499999999927,1.097505000000004,1.0976464000000004,1.097620100000001,1.0970542500000038,1.0977142789842074,1.0975843048014204,-970,-281802,-281965.2,0.005610043409825239,-226.77638678296856,0.08752176648099336
2023-08-09T23:30:00-04:00,1.09783,1.09808,1.09778,1.09797,1.097131130870436,1.0978575555555556,1.097745555555548,1.0975462222222148,1.097520000000004,1.0976414000000003,1.0976355000000009,1.097052500000004,1.097765423187366,1.0976446438411362,940,-280862,-281739.6,0.015111894401870421,-226.65651394291152,0.06835456881936224
2023-08-09T23:45:00-04:00,1.09797,1.098,1.09786,1.09791,1.097215840400801,1.0978904444444444,1.0978166666666591,1.097643333333326,1.0975315000000039,1.0976430000000004,1.097646300000001,1.097052400000004,1.0977943385498927,1.0977057150729086,-917,-281779,-281439.4,0.020357240943335842,-226.70662460167264,0.058326574133984704
2023-08-10T00:00:00-04:00,1.09791,1.0986,1.09791,1.09847,1.0972937731687369,1.0980211111111111,1.09794777777777,1.0977455555555484,1.0975740000000038,1.0976532000000003,1.097662600000001,1.0970536000000042,1.097929470839914,1.0977777720583266,1246,-280533,-281161.6,0.027862259264204,-226.07108981284648,0.10753766096473664
2023-08-10T00:15:00-04:00,1.09847,1.09881,1.09847,1.09862,1.0974243958518632,1.0981555555555553,1.0980333333333254,1.0978411111111037,1.0976240000000037,1.0976774000000002,1.097681200000001,1.0970543000000041,1.0980675766719312,1.097854217646661,982,-279551,-280905.4,0.035639758613037684,-225.9369942071405,0.07013708612287083
2023-08-10T00:30:00-04:00,1.09862,1.09862,1.09831,1.09834,1.0975906683496397,1.098216888888889,1.0980855555555478,1.0979257777777705,1.0976570000000039,1.0976858000000005,1.097696700000001,1.097052200000004,1.098122061337545,1.0979357741173286,-957,-280508,-280646.6,0.03697916169606556,-226.18090019829287,0.04281016878138509
2023-08-10T00:45:00-04:00,1.09834,1.09835,1.09791,1.09792,1.0977369881476828,1.0981837777777779,1.0981222222222147,1.0980011111111039,1.097667000000004,1.0976892000000005,1.0977094000000012,1.097047600000004,1.098081649070036,1.0979990192938627,-1428,-281936,-280861.4,0.036393120316639695,-226.72696061674264,0.030065871591390358
2023-08-10T01:00:00-04:00,1.09792,1.09808,1.09785,1.09799,1.09881,1.0981573333333332,1.0981333333333254,1.0980644444444372,1.097703000000004,1.0976918000000004,1.0977221000000013,1.0970429000000042,1.0980633192560287,1.0980528154350897,1817,-280119,-280529.4,0.03886543639811038,-226.61111428914134,0.009108380621008388
2023-08-10T01:15:00-04:00,1.09799,1.09845,1.09795,1.09838,1.0987908,1.0982066666666668,1.0981588888888811,1.0981066666666592,1.097772500000004,1.0977026000000003,1.0977421000000012,1.097041300000004,1.098126655404823,1.0980922523480716,1490,-278629,-280148.6,0.03851219220203969,-226.08187449642935,0.02094431543959864
2023-08-10T01:30:00-04:00,1.09838,1.09854,1.09817,1.09834,1.0987719839999999,1.0982428888888889,1.098215555555548,1.0981431111111037,1.097842500000004,1.0976896000000003,1.097758300000001,1.097041300000004,1.0981693243238584,1.098112601878457,-1591,-280220,-280282.4,0.03438480180506913,-226.13981437151784,0.046455279961379305
2023-08-10T01:45:00-04:00,1.09834,1.09862,1.09831,1.09851,1.0987535443199998,1.0983017777777777,1.098275555555548,1.0981811111111037,1.097914000000004,1.0977044000000005,1.097776700000001,1.0970430000000042,1.0982374594590867,1.0981356815027652,1602,-278618,-279904.4,0.0337665514659367,-225.891858365181,0.04918167163039127
2023-08-10T02:00:00-04:00,1.09851,1.09925,1.09828,1.09923,1.09785,1.0984926666666668,1.0984222222222144,1.0982411111111037,1.098032000000004,1.0977278000000004,1.097793300000001,1.0970474500000043,1.0984359675672692,1.098206545202212,2634,-275984,-278714,0.03591454584671848,-224.16544713542473,0.12022843402464573
2023-08-10T02:15:00-04:00,1.09923,1.09955,1.09899,1.0992899999999999,1.097878,1.0986662222222223,1.0985133333333257,1.0983171111111036,1.098135500000004,1.0977544000000001,1.097808900000001,1.0970506500000041,1.0986067740538155,1.0983152361617692,1696,-274288,-277547.8,0.03798363655076966,-224.07287324279088,0.07464928491445563
2023-08-10T02:30:00-04:00,1.0992899999999999,1.09951,1.09914,1.0994,1.09794488,1.0988435555555554,1.0985999999999925,1.098405333333326,1.098242000000004,1.0977848000000003,1.0978279000000009,1.097053400000004,1.0987654192430523,1.0984429889294152,1720,-272568,-276335.6,0.036995747570626215,-223.90076215290551,0.0709981613296684
2023-08-10T02:45:00-04:00,1.0994,1.0999,1.0992899999999999,1.09942,1.0980090848,1.0990075555555554,1.0987199999999921,1.0985062222222148,1.0983485000000042,1.0978200000000002,1.097845500000001,1.097054500000004,1.0988963353944419,1.098588391143532,2119,-270449,-274381.4,0.03495451404057938,-223.86221385383305,0.09833020740389768
2023-08-10T03:00:00-04:00,1.09942,1.10126,1.0993,1.10117,1.098122539712,1.0994975555555555,1.0990811111111034,1.0986673333333257,1.098514500000004,1.0978908000000005,1.097883600000001,1.0970634000000041,1.0993510683155534,1.0988111129148252,5349,-265100,-271677.8,0.04389170518325702,-215.34795178838075,0.2960142815505661
2023-08-10T03:15:00-04:00,1.10117,1.10186,1.10103,1.10106,1.09837353653504,1.0998933333333332,1.0994222222222148,1.098867333333326,1.098674000000004,1.0979616000000005,1.097922900000001,1.097073100000004,1.0996928546524427,1.09906249033186,-4327,-269427,-270366.4,0.05855314058371545,-215.78019204192947,0.27960181786718513
2023-08-10T03:30:00-04:00,1.10106,1.10133,1.10081,1.10106,1.0987221828815361,1.1002208888888887,1.0997199999999925,1.0991086666666594,1.098847500000004,1.0980312000000003,1.097956800000001,1.0970832000000041,1.0999662837219542,1.099334392265488,0,-269427,-269394.2,0.07266017004047745,-215.78019204192947,0.2439957027622513
2023-08-10T03:45:00-04:00,1.10106,1.10107,1.10057,1.10082,1.0990359645933825,1.100440888888889,1.099995555555548,1.0993877777777705,1.098994000000004,1.0980886000000003,1.097992400000001,1.0970878000000042,1.1001370269775632,1.09960871381239,-2949,-272376,-269355.8,0.0808570325471407,-216.4229907994904,0.22579529107560642
2023-08-10T04:00:00-04:00,1.10082,1.10174,1.10081,1.10124,1.0993183681340442,1.1006897777777778,1.1002988888888814,1.0997035555555483,1.099148500000004,1.0981496000000002,1.098026600000001,1.0970965000000041,1.1003576215820505,1.0999009710499117,3394,-268982,-269062.4,0.09271647129800271,-215.12806519857446,0.24851844771553275
2023-08-10T04:15:00-04:00,1.10124,1.10265,1.1012,1.10227,1.0995725313206397,1.101084,1.100636666666659,1.1000146666666595,1.099370500000004,1.0982486000000002,1.098076100000001,1.0971077500000042,1.1007400972656405,1.100178776839929,3064,-265918,-269226,0.1090566959670181,-212.26227754102456,0.27655722642214586
2023-08-10T04:30:00-04:00,1.10227,1.10243,1.10196,1.1021,1.0999418275621629,1.1013766666666667,1.1009488888888812,1.1003199999999929,1.099577000000004,1.0983458000000001,1.098116300000001,1.0971142000000043,1.1010120778125123,1.100442621471943,-3036,-268954,-269131.4,0.11664604402629117,-212.73051127686063,0.2556195362461408
2023-08-10T04:45:00-04:00,1.1021,1.10211,1.10164,1.10184,1.1002668082547034,1.1015548888888889,1.1012199999999925,1.1006199999999928,1.099773500000004,1.0984362,1.098150500000001,1.0971245500000042,1.1011776622500098,1.100684897177554,-2356,-271310,-269508,0.12305691068196731,-213.2863229091992,0.22193923958522813
2023-08-10T05:00:00-04:00,1.10184,1.10242,1.10176,1.1024,1.1005527912641389,1.101790888888889,1.1015511111111038,1.100931111111104,1.099970000000004,1.0985394000000002,1.098190100000001,1.097139300000004,1.1014221298000078,1.1009419177420428,2152,-269158,-268864.4,0.13086921001828525,-212.19258879172276,0.2710520092412347
2023-08-10T05:15:00-04:00,1.1024,1.10247,1.10199,1.10202,1.1008044563124422,1.1018846666666666,1.1016455555555482,1.1012004444444374,1.1001400000000037,1.0986322000000002,1.098232000000001,1.0971583500000042,1.1015417038400062,1.101178734193634,-1760,-270918,-269251.6,0.13911698934545014,-212.79926513424823,0.07719062451756017
2023-08-10T05:30:00-04:00,1.10202,1.10212,1.10178,1.10181,1.1010259215549492,1.1019175555555556,1.1017288888888814,1.1014188888888818,1.100313500000004,1.0987194000000002,1.098272600000001,1.097177000000004,1.101595363072005,1.101349787354907,-1760,-272678,-270603.6,0.13110803428428114,-213.13464924705931,0.06811617895482794
2023-08-10T05:45:00-04:00,1.10181,1.10222,1.1016,1.1020699999999999,1.1012208109683552,1.1019857777777777,1.1018411111111037,1.1015973333333264,1.1005210000000039,1.0988088000000003,1.098309600000001,1.097197900000004,1.101690290457604,1.1014854298839254,1935,-270743,-270961.4,0.12412401756269686,-212.67803694548294,0.09172978765916076
2023-08-10T06:00:00-04:00,1.1020699999999999,1.10228,1.1018999999999999,1.10211,1.1013923136521526,1.1020395555555556,1.101984444444437,1.1017502222222153,1.1007270000000038,1.0989026000000002,1.098347000000001,1.097220400000004,1.1017742323660833,1.1016047439071401,2198,-268545,-270408.4,0.115513100469953,-212.59825979884064,0.11718537090532634
2023-08-10T06:15:00-04:00,1.10211,1.10229,1.10198,1.1022399999999999,1.1015432360138944,1.1020906666666666,1.102095555555548,1.101859111111104,1.100920000000004,1.0989952000000003,1.098387500000001,1.0972416500000042,1.1018673858928667,1.101693795125712,1387,-267158,-270008.4,0.11000667047940348,-212.43465543992914,0.09080672696232336
2023-08-10T06:30:00-04:00,1.1022399999999999,1.10275,1.1022,1.10256,1.101676047692227,1.1021835555555557,1.1021277777777705,1.1019555555555485,1.1011310000000039,1.0990902000000002,1.098430300000001,1.0972632500000041,1.1020059087142933,1.1017866361005695,1703,-265455,-268915.8,0.10389707001808325,-211.94024405946737,0.026309343445789272
2023-08-10T06:45:00-04:00,1.10256,1.10278,1.1025099999999999,1.10278,1.1018264010153151,1.102314,1.1022033333333259,1.1020504444444374,1.1013445000000037,1.0991888000000003,1.0984796000000012,1.0972845000000042,1.1021607269714346,1.1018997088804554,1513,-263942,-267168.6,0.08930872547088947,-211.6383466570583,0.06170039016423318
2023-08-10T07:00:00-04:00,1.10278,1.10296,1.10253,1.10272,1.1019789768528647,1.1024173333333331,1.1023011111111038,1.1021424444444374,1.101519000000004,1.0992898000000002,1.0985300000000011,1.097309700000004,1.1022725815771477,1.102016167104364,-1857,-265799,-266179.8,0.07671984093139028,-211.73938222172242,0.07986640528570318
2023-08-10T07:15:00-04:00,1.10272,1.10287,1.10246,1.10253,1.102155561019349,1.102463111111111,1.1023155555555482,1.1022086666666595,1.101681000000004,1.0993868000000002,1.0985782000000013,1.0973346000000042,1.1023240652617181,1.1021261336834909,-1636,-267435,-265957.8,0.06870730919735568,-212.0212670156863,0.011792452830185365
2023-08-10T07:30:00-04:00,1.10253,1.10271,1.10214,1.10225,1.10296,1.10245,1.1023411111111037,1.1022577777777707,1.1018235000000038,1.0994794,1.098621200000001,1.0973587500000042,1.1023092522093745,1.1022145069467926,-1603,-269038,-266333.8,0.054543010485662353,-212.42836704924557,0.020870764595919536
2023-08-10T07:45:00-04:00,1.10225,1.1024,1.10142,1.10165,1.1029436,1.1023117777777778,1.102323333333326,1.1022968888888818,1.1019350000000037,1.09956,1.0986614000000012,1.097381650000004,1.1021774017674997,1.102248805557434,-2814,-271852,-267613.2,0.0414553991424214,-213.96014296215083,-0.01452155997857507
2023-08-10T08:00:00-04:00,1.10165,1.10232,1.10162,1.10226,1.102882656,1.1022991111111111,1.102344444444437,1.102325111111104,1.1019895000000037,1.0996516000000003,1.0987097000000012,1.0974106000000041,1.1021939214139997,1.1022554444459467,2976,-268876,-268600,0.033261368586468956,-212.3122874726578,0.01724028419248637
2023-08-10T08:15:00-04:00,1.10226,1.10304,1.1021,1.10297,1.10142,1.102424222222222,1.1024399999999925,1.1023528888888818,1.1020850000000038,1.0997566,1.0987656000000012,1.0974433500000043,1.1023491371311998,1.1022707555567572,3373,-265503,-268540.8,0.033647672101561214,-210.13963310798889,0.07803213835280352
2023-08-10T08:30:00-04:00,1.10297,1.10649,1.10103,1.1018,1.10649,1.1022962222222221,1.1023911111111035,1.102367999999993,1.1021220000000038,1.0998472000000001,1.0988064000000013,1.097473300000004,1.1022393097049599,1.1022538044454055,-25019,-290522,-273158.2,0.0276362693631301,-236.6790947433941,-0.03991871098853208
2023-08-10T08:45:00-04:00,1.1018,1.10446,1.10108,1.10413,1.10649,1.102644,1.102565555555548,1.1024128888888818,1.1022875000000039,1.09999,1.0988779000000013,1.097517150000004,1.1026174477639679,1.1023154435563243,11854,-278668,-275084.2,0.031516548672454604,-211.6111876822197,0.14239587868234577
2023-08-10T09:00:00-04:00,1.10413,1.10458,1.10181,1.10228,1.10649,1.102586888888889,1.1025099999999926,1.102450222222215,1.102339500000004,1.1000968000000002,1.0989339000000014,1.0975520500000042,1.1025499582111742,1.102389954845059,-10672,-289340,-278581.8,0.02266715569337846,-229.4924154361992,-0.045339959012692194
2023-08-10T09:15:00-04:00,1.10228,1.10327,1.10075,1.10159,1.1063808,1.102402888888889,1.102384444444437,1.102458222222215,1.102305500000004,1.100187,1.0989806000000013,1.0975861000000042,1.1023579665689394,1.1024227638760469,-8677,-298017,-284410,0.010359256241917332,-234.92400269170483,-0.10247388276261003
2023-08-10T09:30:00-04:00,1.10159,1.10298,1.10117,1.10279,1.106155568,1.102484,1.102413333333326,1.1024528888888816,1.1023400000000039,1.1003054,1.0990326000000012,1.0976275000000042,1.1024443732551514,1.1024418111008372,9399,-288618,-289033,0.008747715874418357,-224.6853476567111,0.0235821247494333
2023-08-10T09:45:00-04:00,1.10279,1.10401,1.1025,1.10395,1.10593934528,1.1027913333333332,1.102602222222215,1.102495111111104,1.102445500000004,1.10044,1.0990905000000013,1.0976766000000042,1.1027454986041212,1.1025430488806696,8463,-280155,-286959.6,0.01363670723432108,-215.78330828384733,0.15422998412338715
2023-08-10T10:00:00-04:00,1.10395,1.10437,1.10231,1.10275,1.1057317714688,1.102820888888889,1.102724444444437,1.1025268888888817,1.102463000000004,1.1005496000000001,1.0991340000000012,1.097719100000004,1.1027463988832968,1.1025688391045354,-8348,-288503,-288926.6,0.014240879487929453,-224.85763230214593,0.0998502246629945
2023-08-10T10:15:00-04:00,1.10275,1.10338,1.10228,1.10282,1.105532500610048,1.10284,1.102786666666659,1.102582222222215,1.1025030000000038,1.1006602,1.0991786000000012,1.097762500000004,1.1027611191066375,1.102611071283628,6618,-281885,-287435.6,0.023038966693472582,-224.43753708564165,0.05080471032241884
2023-08-10T10:30:00-04:00,1.10282,1.10326,1.10241,1.1026799999999999,1.1053412005856462,1.1028186666666666,1.1027544444444368,1.102656222222215,1.1025465000000039,1.1007568,1.0992260000000014,1.097803050000004,1.10274489528531,1.102688457026902,-6273,-288158,-285463.8,0.023997159731656715,-225.23387737689515,-0.02629264621885668
2023-08-10T10:45:00-04:00,1.1026799999999999,1.1026799999999999,1.10122,1.10187,1.1051575525622204,1.1026417777777777,1.1027622222222146,1.1027259999999928,1.1025365000000038,1.1008368,1.0992646000000013,1.097840800000004,1.102569916228248,1.1027135656215212,-8583,-296741,-287088.4,0.013760754638996746,-231.5387255649459,0.00635324015247908
2023-08-10T11:00:00-04:00,1.10187,1.10188,1.10091,1.10115,1.1049812504597316,1.1023193333333332,1.1024311111111036,1.1026917777777705,1.1024885000000038,1.100908,1.0992876000000014,1.097871000000004,1.1022859329825985,1.1026216524972168,-6254,-302995,-291656.4,0.011839211329939764,-235.62530565152503,-0.26989575502884466
2023-08-10T11:15:00-04:00,1.10115,1.10195,1.10084,1.10184,1.1048120004413424,1.102201111111111,1.1023822222222148,1.102623333333326,1.1024685000000036,1.1009870000000002,1.0993239000000015,1.0979064500000042,1.1021967463860787,1.102511721997773,5258,-297737,-293503.2,-0.007766198549253782,-232.33055016862147,-0.039917262401567295
2023-08-10T11:30:00-04:00,1.10184,1.1022,1.10172,1.1018999999999999,1.1046495204236888,1.1021046666666665,1.1024166666666593,1.102549333333326,1.1024355000000037,1.101062,1.0993587000000014,1.097946000000004,1.1021373971088628,1.102386977598218,3628,-294109,-295948,-0.00974460580324808,-232.132989724274,0.028141141440990787
2023-08-10T11:45:00-04:00,1.1018999999999999,1.1022,1.10121,1.10151,1.1044935396067412,1.1019233333333331,1.1022744444444372,1.102453333333326,1.102372000000004,1.1011356,1.0993910000000013,1.0979844500000042,1.1020119176870902,1.1022403820785744,-3852,-297961,-297908.6,-0.005935148780240148,-233.49634393064446,-0.1160692425575085
2023-08-10T12:00:00-04:00,1.10151,1.10167,1.10121,1.10122,1.1043437980224715,1.1017124444444446,1.101971111111104,1.102295111111104,1.1022970000000039,1.1012006,1.0994210000000013,1.0980215000000042,1.1018535341496722,1.102097105662859,-3354,-301315,-298823.4,-0.01343922283167968,-234.37936814286192,-0.2472938085963947
2023-08-10T12:15:00-04:00,1.10122,1.10147,1.1010199999999999,1.10112,1.1042000461015726,1.1015422222222222,1.1017899999999927,1.1021668888888816,1.1022265000000036,1.1012648,1.0994539000000014,1.0980549000000042,1.101706827319738,1.101981284530287,-2347,-303662,-298956.8,-0.03220279378872061,-234.59249540172024,-0.147812287463142
2023-08-10T12:30:00-04:00,1.10112,1.10192,1.101,1.10176,1.1040620442575098,1.1015362222222222,1.101672222222215,1.1020248888888817,1.1022020000000037,1.1013306,1.0994919000000014,1.0980885000000042,1.1017174618557903,1.1018854276242294,2770,-300892,-299587.8,-0.03785919903339966,-232.98249830785224,-0.09611722674596389
2023-08-10T12:45:00-04:00,1.10176,1.10192,1.10111,1.10133,1.1039295624872094,1.101467777777778,1.101522222222215,1.1018459999999928,1.1021860000000037,1.1013848000000002,1.0995311000000014,1.0981224000000043,1.1016399694846322,1.1017859420993834,-2322,-303214,-301408.8,-0.04740472932576248,-233.88873923146568,-0.12242899118510923
2023-08-10T13:00:00-04:00,1.10133,1.10141,1.10072,1.10094,1.103802379987721,1.1013513333333333,1.1014188888888816,1.1016748888888819,1.1021200000000035,1.1014368000000003,1.0995613000000015,1.0981528500000044,1.1014999755877057,1.1016835536795064,-3379,-306593,-303135.2,-0.06012618029361733,-235.08530156972907,-0.08440197119441271
2023-08-10T13:15:00-04:00,1.10094,1.1010199999999999,1.09941,1.09945,1.1036174371884577,1.1009575555555553,1.101229999999993,1.1015266666666597,1.1019440000000036,1.1014674000000002,1.0995783000000015,1.0981751500000043,1.1010899804701646,1.1015308429436046,-3886,-310479,-304968,-0.06995119232019863,-240.344570921374,-0.15438405303546607
2023-08-10T13:30:00-04:00,1.09945,1.09945,1.0977999999999999,1.09827,1.103280842213381,1.1003655555555556,1.100833333333326,1.1013353333333262,1.1017675000000036,1.1014730000000004,1.0995824000000014,1.0981908000000042,1.1005259843761317,1.1012946743548837,-5859,-316338,-307503.2,-0.0757915300715363,-246.6328241388916,-0.3240034850794899
2023-08-10T13:45:00-04:00,1.09827,1.09915,1.09762,1.098,1.102732757992043,1.0997988888888888,1.1003999999999927,1.1010808888888817,1.1014610000000036,1.1014654000000004,1.0995840000000014,1.0982057500000044,1.1000207875009054,1.1009553394839064,-5443,-321781,-311681,-0.094236243345408,-247.97093771751977,-0.35393411380341167
2023-08-10T14:00:00-04:00,1.098,1.09879,1.09783,1.0987,1.1021192270329978,1.099458888888889,1.1000877777777704,1.1007939999999927,1.1012820000000036,1.1014726000000001,1.0995811000000013,1.0982242000000044,1.0997566300007242,1.1005786715871249,4656,-317125,-314463.2,-0.0998360423243713,-245.00263170659113,-0.2551043567466459
2023-08-10T14:15:00-04:00,1.0987,1.09928,1.09853,1.09904,1.101579319789038,1.0992493333333333,1.0998455555555484,1.100479333333326,1.1011545000000038,1.1014832,1.0995938000000012,1.0982419500000042,1.0996133040005793,1.1002013372696997,3745,-313380,-315820.6,-0.10826960632511715,-243.8437166251312,-0.1979622600388724
2023-08-10T14:30:00-04:00,1.09904,1.09908,1.09825,1.09835,1.1011042014143535,1.0989502222222223,1.0995377777777706,1.1001408888888817,1.1009325000000039,1.1014656000000003,1.0995967000000013,1.0982578000000043,1.0993606432004634,1.0998554698157594,-3281,-316661,-317057,-0.1203385256279034,-245.9035961563587,-0.25156204591689924
2023-08-10T14:45:00-04:00,1.09835,1.0992,1.0982,1.09908,1.100686097244631,1.0988586666666667,1.0992399999999927,1.099822222222215,1.1006890000000038,1.1014614000000003,1.0996079000000014,1.0982791000000043,1.0993045145603708,1.0996111758526073,3077,-313584,-316506.2,-0.12284078064732683,-243.85851945039033,-0.24324716816729738
2023-08-10T15:00:00-04:00,1.09908,1.09913,1.09855,1.09883,1.1003181655752754,1.0987766666666667,1.098962222222215,1.0995346666666594,1.1004930000000037,1.1014500000000003,1.0996174000000014,1.0982976500000041,1.0992096116482966,1.0994489406820853,-3022,-316606,-315471.2,-0.12733741451068678,-244.54591254279512,-0.22699826573324497
2023-08-10T15:15:00-04:00,1.09883,1.09894,1.09818,1.09828,1.0999943857062424,1.0986402222222222,1.0986666666666594,1.099250444444437,1.1002660000000037,1.1014272000000003,1.0996236000000013,1.0983126500000042,1.0990236893186371,1.099302352545668,-2744,-319350,-315916.2,-0.13573571910130572,-245.9193734057131,-0.24161171362654701
2023-08-10T15:30:00-04:00,1.09828,1.0984099999999999,1.09797,1.09798,1.0997094594214933,1.0985028888888888,1.0985033333333258,1.0989819999999928,1.1000310000000035,1.1013634,1.099627100000001,1.0983224000000043,1.0988149514549097,1.099142682036534,-2337,-321687,-317577.6,-0.1417200140237294,-246.55773520780355,-0.13370321524399312
2023-08-10T15:45:00-04:00,1.09798,1.09819,1.09786,1.09792,1.0994587242909142,1.0983862222222223,1.0984644444444371,1.0987673333333259,1.0998335000000037,1.1013006,1.0996311000000012,1.0983322500000041,1.0986359611639278,1.098997745629227,-1815,-323502,-318945.8,-0.13505182578614291,-246.65691734226857,-0.03186830196582557
2023-08-10T16:00:00-04:00,1.09792,1.098,1.09781,1.09793,1.0992380773760044,1.0982793333333336,1.0984566666666593,1.0986106666666593,1.0996725000000036,1.1012380000000002,1.099634600000001,1.098343250000004,1.0984947689311422,1.0988357965033813,997,-322505,-320730,-0.12110623262552257,-246.64783653492373,-0.006375227686704416
2023-08-10T16:15:00-04:00,1.09793,1.0982,1.09792,1.09801,1.0990439080908838,1.09819,1.0983799999999926,1.098494222222215,1.0994810000000037,1.1011818,1.0996352000000011,1.0983549500000043,1.0983978151449136,1.0986734372027045,676,-321829,-321774.6,-0.10743365729121392,-246.59858020710692,-0.06280149267316641
2023-08-10T16:30:00-04:00,1.09801,1.09806,1.09785,1.09794,1.0988730391199777,1.098102,1.0982577777777704,1.098412444444437,1.0992830000000038,1.1011158,1.0996327000000012,1.0983679500000043,1.0983062521159308,1.098529949762163,-464,-322293,-322363.2,-0.09747240505249626,-246.62816099416716,-0.10008734895910075
2023-08-10T16:45:00-04:00,1.09794,1.09814,1.09777,1.09808,1.0987226744255805,1.0980664444444446,1.0982277777777705,1.0983573333333259,1.0991115000000036,1.101032,1.0996403000000012,1.0983786500000041,1.0982610016927445,1.0984191598097302,805,-321488,-322323.4,-0.08967351044473906,-246.52551421929783,-0.024582328037510127
2023-08-10T17:00:00-04:00,1.09808,1.09826,1.09781,1.09808,1.0985903534945107,1.098036888888889,1.0981166666666595,1.0982877777777704,1.0989545000000036,1.1009516000000001,1.0996487000000013,1.0983900500000043,1.0982248013541955,1.0983369278477837,0,-321488,-321920.6,-0.07728232419725983,-246.52551421929783,-0.09098518761146704
2023-08-10T17:15:00-04:00,1.09808,1.09816,1.0979,1.09795,1.0984739110751693,1.0980035555555556,1.0980188888888816,1.0982002222222147,1.0987960000000037,1.1008738,1.0996550000000012,1.0983997500000042,1.0981698410833565,1.0982719422782263,-238,-321726,-321764.8,-0.07340629474115297,-246.55369067274384,-0.08008518151124304
2023-08-10T17:30:00-04:00,1.09795,1.09823,1.09795,1.0982,1.098371441746149,1.098039777777778,1.0980099999999926,1.098126222222215,1.0986180000000039,1.1007898,1.0996646000000012,1.0984108000000041,1.0981758728666853,1.0982275538225807,1346,-320380,-321475,-0.06649441018740923,-246.24721041407986,-0.007284116982905813
2023-08-10T17:45:00-04:00,1.0982,1.0984,1.09815,1.09838,1.09762,1.0981137777777779,1.0980544444444371,1.0980855555555482,1.098470500000004,1.100717,1.099674600000001,1.098424150000004,1.0982166982933481,1.0982096430580641,160,-320220,-321060.4,-0.05094331607885791,-246.22098568270127,0.036430536075334335
2023-08-10T18:00:00-04:00,1.09838,1.0984,1.09816,1.09821,1.0976356,1.098144888888889,1.0980866666666593,1.0980573333333261,1.0983340000000037,1.1006449999999999,1.099682200000001,1.0984374500000043,1.0982153586346786,1.098200514446451,-519,-320739,-320910.6,-0.03533090973379487,-246.3013130739502,0.026413582046041738
2023-08-10T18:15:00-04:00,1.09821,1.09844,1.09812,1.09844,1.097650888,1.0982155555555553,1.098143333333326,1.0980626666666593,1.0982835000000037,1.1005724000000001,1.099690600000001,1.0984529000000043,1.098260286907743,1.0982076115571604,599,-320140,-320641,-0.01976144065123874,-246.17586347869965,0.04645104879181828
2023-08-10T18:30:00-04:00,1.09844,1.09844,1.09823,1.09832,1.09768245248,1.0982508888888889,1.0981777777777704,1.0980944444444372,1.0982860000000039,1.1004966,1.0996996000000012,1.0984665000000042,1.0982722295261944,1.0982280892457281,-370,-320510,-320397.8,-0.011312006291786547,-246.21628443933477,0.028232894053791174
2023-08-10T18:45:00-04:00,1.09832,1.09833,1.09822,1.09828,1.0977127543808,1.0982713333333332,1.0982155555555482,1.098135555555548,1.0983000000000038,1.1004174,1.0997063000000011,1.0984797500000043,1.0982737836209555,1.098247671396582,-354,-320864,-320494.6,-0.008896982309818054,-246.22917685684516,0.030967083811502177
2023-08-10T19:00:00-04:00,1.09828,1.09842,1.09811,1.0984099999999999,1.097741844205568,1.098310222222222,1.0982522222222149,1.0981751111111038,1.0982855000000038,1.1003344,1.099712300000001,1.0984946500000041,1.0983010268967643,1.0982645371172655,586,-320278,-320506.2,-0.0063951343213941,-246.15981385287535,0.030052455194516017
2023-08-10T19:15:00-04:00,1.0984099999999999,1.09846,1.09831,1.09842,1.0977697704373452,1.0983437777777778,1.0982899999999927,1.0982157777777704,1.0982545000000037,1.1002472,1.099718000000001,1.0985099500000042,1.0983248215174115,1.098286429693812,479,-319799,-320318.2,-0.0020854894589043796,-246.15545300401195,0.03096313565496202
2023-08-10T19:30:00-04:00,1.09842,1.09846,1.09831,1.09844,1.0978111842111045,1.098373777777778,1.098344444444437,1.0982559999999926,1.0982590000000039,1.1001616,1.0997257000000011,1.0985240500000042,1.0983478572139291,1.0983039437550493,659,-319140,-320118.2,0.0037938685017501078,-246.14345395082637,0.044628626075877906
2023-08-10T19:45:00-04:00,1.09844,1.09846,1.09811,1.09816,1.0978501131584382,1.098336888888889,1.0983399999999928,1.098288444444437,1.0982130000000039,1.1000742000000001,1.099730500000001,1.0985379000000042,1.0983102857711433,1.098311555004039,-706,-319846,-319985.4,0.006529843466126866,-246.32341826385215,-0.0036423238025896925
2023-08-10T20:00:00-04:00,1.09816,1.09825,1.09797,1.09809,1.097886706368932,1.0982868888888888,1.0983077777777703,1.0983068888888814,1.0981760000000036,1.099991,1.0997352000000011,1.0985503000000043,1.0982662286169147,1.0983100440032307,-981,-320827,-319978,0.009821202089388685,-246.3859501353463,-0.026402520075010604
2023-08-10T20:15:00-04:00,1.09809,1.09859,1.09809,1.09848,1.097921103986796,1.0983213333333333,1.0983377777777705,1.0983239999999925,1.0981860000000039,1.0999276,1.099743800000001,1.098565100000004,1.0983089828935317,1.0983116352025841,1196,-319631,-319848.6,0.012249588067194837,-245.9611762097119,0.0245854617969234
2023-08-10T20:30:00-04:00,1.09848,1.09877,1.09837,1.09875,1.09797,1.0984037777777778,1.0983722222222148,1.098340444444437,1.0982245000000037,1.0998574,1.099754500000001,1.0985818500000042,1.0983971863148254,1.0983261081620672,975,-318656,-319620,0.015128474964135911,-245.72152687608727,0.028221841884837624
2023-08-10T20:45:00-04:00,1.09875,1.09891,1.09863,1.0988,1.09805,1.0984893333333334,1.0984255555555482,1.098356666666659,1.0982685000000036,1.099774,1.099765300000001,1.098599950000004,1.0984777490518602,1.0983520865296534,877,-317779,-319347.8,0.014850439811763205,-245.6816178886014,0.043703110204679506
2023-08-10T21:00:00-04:00,1.0988,1.09905,1.09877,1.09897,1.0981532,1.0985982222222221,1.0985022222222147,1.0983891111111037,1.0983205000000038,1.0997174,1.0997823000000009,1.098617250000004,1.0985761992414882,1.0984052692237225,1212,-316567,-318692,0.016215508443203356,-245.49410423734548,0.06282550897768142
2023-08-10T21:15:00-04:00,1.09897,1.09914,1.0988,1.09891,1.0982787520000001,1.0986797777777777,1.0985577777777704,1.0984391111111038,1.0983655000000039,1.099613,1.099801500000001,1.0986342500000041,1.0986429593931906,1.0984806153789775,-1443,-318010,-318128.6,0.017701900515864424,-245.57288709766007,0.04552034304132037
2023-08-10T21:30:00-04:00,1.09891,1.09914,1.09872,1.09905,1.0984165516800002,1.0987782222222222,1.0986277777777707,1.0984971111111037,1.0984210000000039,1.0995484,1.0998226000000009,1.098650600000004,1.0987243675145524,1.0985636923031816,2494,-315516,-317305.6,0.019019038981721893,-245.2551540712975,0.057355110067199296
2023-08-10T21:45:00-04:00,1.09905,1.09979,1.09905,1.09944,1.0985323034112002,1.0989406666666668,1.0987388888888816,1.098570444444437,1.0984890000000038,1.0995054,1.0998462000000009,1.0986682500000042,1.0988674940116419,1.0986577538425448,1943,-313573,-316289,0.021800895271872282,-244.5656767954686,0.09103819962855411
2023-08-10T22:00:00-04:00,1.09944,1.09944,1.09905,1.09925,1.09872,1.099042888888889,1.0988599999999928,1.098657333333326,1.0985475000000038,1.0994346,1.099870000000001,1.098683900000004,1.0989439952093134,1.0987510030740355,-1531,-315104,-315754,0.024101576876281307,-244.83025694536295,0.0992569388795836
2023-08-10T22:15:00-04:00,1.09925,1.09933,1.09867,1.09873,1.09979,1.099016888888889,1.098931111111104,1.098743111111104,1.098586500000004,1.0993302,1.099885100000001,1.0986962500000041,1.0989011961674506,1.098816002459228,-1419,-316523,-315745.2,0.02647197533760149,-245.501514621051,0.058283018696097214
2023-08-10T22:30:00-04:00,1.09873,1.09895,1.09855,1.09892,1.0997676,1.0990146666666665,1.098979999999993,1.0988275555555487,1.0986225000000038,1.0992536,1.0999016000000008,1.098709500000004,1.0989049569339604,1.098868401967382,1281,-315242,-315191.6,0.02982143979500815,-245.279995230482,0.040055349209816835
2023-08-10T22:45:00-04:00,1.09892,1.09904,1.09881,1.09886,1.0997188960000002,1.0989906666666664,1.098992222222215,1.0989004444444377,1.0986465000000039,1.0991743999999999,1.0999173000000009,1.098725050000004,1.0988959655471684,1.0989027215739051,-1231,-316473,-315383,0.03041873218325712,-245.34720667444512,0.010011376564282548
2023-08-10T23:00:00-04:00,1.09886,1.09915,1.09874,1.09894,1.0996721401600003,1.0989802222222222,1.0990077777777705,1.0989542222222153,1.0986830000000039,1.0990996,1.0999282000000008,1.098737850000004,1.0989047724377348,1.0989101772591237,1252,-315221,-315712.6,0.02972017439448918,-245.2560576654721,0.01274117218784392
2023-08-10T23:15:00-04:00,1.09894,1.09906,1.09883,1.09904,1.0996272545536003,1.0989866666666666,1.0990155555555485,1.0989853333333264,1.098713000000004,1.099043,1.0999399000000007,1.098750150000004,1.098931817950188,1.0989077418072986,977,-314244,-315540.6,0.028306180031244254,-245.1671538126685,0.006369600626042066
2023-08-10T23:30:00-04:00,1.09904,1.09915,1.09859,1.09867,1.0995841643714563,1.0989175555555555,1.0989888888888817,1.0989968888888817,1.0987305000000038,1.0989934,1.0999507000000008,1.098760650000004,1.0988794543601503,1.0989033934458385,-1307,-315551,-315346.2,0.024578586248340608,-245.60716509524235,-0.021839823097434544
2023-08-10T23:45:00-04:00,1.09867,1.09878,1.09857,1.09872,1.0995427977965981,1.0988637777777777,1.0989522222222152,1.0989913333333263,1.0987525000000038,1.0989309999999999,1.0999590000000008,1.0987724500000042,1.0988475634881203,1.0988919147566705,969,-314582,-315214.2,0.021115287650591178,-245.5630663212703,-0.030025931486298483
2023-08-11T00:00:00-04:00,1.09872,1.0988,1.09848,1.0985,1.099503085884734,1.0987733333333332,1.0988477777777708,1.0989624444444375,1.098757000000004,1.098863,1.0999625000000008,1.0987840000000042,1.0987780507904963,1.098868331805336,-936,-315518,-315023.2,0.015155881951720197,-245.75048440777087,-0.08549807174561057
2023-08-11T00:15:00-04:00,1.0985,1.0986799999999999,1.09847,1.0985,1.0994417007316502,1.0987037777777777,1.098764444444437,1.0989137777777707,1.0987610000000039,1.0988027999999999,1.099969200000001,1.098794650000004,1.098722440632397,1.0988318654442684,0,-315518,-315082.6,0.006210550221252785,-245.75048440777087,-0.06822833750284543
2023-08-11T00:30:00-04:00,1.0985,1.09887,1.09844,1.0988499999999999,1.0993639646731181,1.098720888888889,1.0987777777777705,1.098866222222215,1.098781500000004,1.0987554,1.099978000000001,1.098806750000004,1.0987479525059176,1.0987950923554144,1104,-314414,-315116.6,0.0007064206707908218,-245.39873201814882,0.01092170050875993
2023-08-11T00:45:00-04:00,1.0988499999999999,1.09905,1.09839,1.09853,1.0992715682058063,1.0986713333333333,1.0987344444444374,1.0988153333333261,1.098800000000004,1.0987036,1.0999842000000009,1.0988152500000041,1.098704362004734,1.0987600738843313,-1165,-315579,-315122.2,-0.0015038467269415864,-245.73799579391425,-0.03548938958248921
2023-08-11T01:00:00-04:00,1.09853,1.09881,1.0984,1.09876,1.0991657800211094,1.0986764444444446,1.098723333333326,1.0987695555555486,1.098833500000004,1.0986436,1.099987100000001,1.0988248500000042,1.0987154896037872,1.0987336591074646,1487,-314092,-315024.2,-0.005560187841307412,-245.42666155634228,-0.00910034035272819
2023-08-11T01:15:00-04:00,1.09876,1.09904,1.09869,1.09888,1.0990726864185763,1.0987077777777778,1.0987166666666595,1.0987433333333263,1.0988535000000041,1.0985945999999998,1.099989700000001,1.0988354500000042,1.0987483916830298,1.0987277272859712,1242,-312850,-314490.6,-0.008801523690351209,-245.29101773967608,-0.005459806722837369
2023-08-11T01:30:00-04:00,1.09888,1.09906,1.09874,1.0988499999999999,1.09839,1.0987344444444445,1.0986955555555484,1.0987295555555485,1.0988585000000042,1.0985528,1.0999948000000008,1.0988457500000042,1.098768713346424,1.0987369818287767,-1666,-314516,-314290.2,-0.011223821195137759,-245.3365004129437,-0.017287814820218964
2023-08-11T01:45:00-04:00,1.0988499999999999,1.09937,1.09877,1.09932,1.0984034,1.0988593333333334,1.0987677777777707,1.0987275555555485,1.0988845000000043,1.0985502,1.100008800000001,1.0988591000000043,1.0988789706771391,1.098763185463021,1805,-312711,-313949.6,-0.011145542497724658,-244.5644660133438,0.05916244186152707
2023-08-11T02:00:00-04:00,1.09932,1.09971,1.09904,1.0996,1.098442064,1.0990257777777777,1.0988655555555484,1.0987537777777707,1.098916000000004,1.0985767999999998,1.100024900000001,1.098873500000004,1.0990231765417113,1.0988269483704165,3988,-308723,-312578.4,-0.006148902232188232,-243.5487108192244,0.08009319935925367
2023-08-11T02:15:00-04:00,1.0996,1.10021,1.09954,1.0997,1.0985181401600002,1.0991926666666667,1.0989988888888818,1.0988088888888818,1.098955500000004,1.0986108,1.100038100000001,1.0988901000000042,1.099158541233369,1.0989155586963328,2628,-306095,-310979,-0.00039431458997831153,-243.3097148206795,0.10923987255346998
2023-08-11T02:30:00-04:00,1.0997,1.0997999999999999,1.09915,1.0994,1.0986534889472002,1.0992728888888887,1.0990988888888817,1.0988853333333264,1.098973000000004,1.0986247999999998,1.1000487000000012,1.098903500000004,1.0992068329866953,1.099007246957066,-2534,-308629,-310134.8,0.005671943292967058,-244.00099426052665,0.08192990441510249
2023-08-11T02:45:00-04:00,1.0994,1.0995,1.09896,1.09909,1.0987780098314242,1.099271111111111,1.0991255555555486,1.0989713333333264,1.0989555000000042,1.0986258,1.100054500000001,1.0989156000000042,1.0991834663893563,1.0990901975656526,-2617,-311246,-309480.8,0.0108672338602734,-244.7389149445362,0.021841015607227374
2023-08-11T03:00:00-04:00,1.09909,1.09957,1.09874,1.09926,1.10021,1.0992979999999999,1.0992066666666596,1.0990591111111043,1.098956000000004,1.098644,1.100054800000001,1.098924050000004,1.099198773111485,1.0991541580525217,4057,-307189,-308376.4,0.01537803579742597,-244.1114049135105,0.06645244098931276
2023-08-11T03:15:00-04:00,1.09926,1.0996299999999999,1.09912,1.09959,1.1001805999999998,1.0993746666666666,1.099298888888882,1.099145777777771,1.098999000000004,1.0986542,1.1000578000000012,1.098933350000004,1.099277018489188,1.0992049264420172,3167,-304022,-307436.2,0.023549843124086714,-243.16066532505963,0.07553969929739966
2023-08-11T03:30:00-04:00,1.09959,1.09991,1.09936,1.09973,1.1001517879999998,1.0994608888888888,1.0993933333333263,1.0992246666666599,1.0990395000000042,1.0986722,1.1000611000000011,1.098944500000004,1.0993676147913505,1.0992467411536133,2721,-301301,-306477.4,0.028041946801142564,-242.81422710717834,0.07735148514851643
2023-08-11T03:45:00-04:00,1.09973,1.09975,1.09916,1.09924,1.10012355224,1.0994302222222223,1.0994366666666597,1.0992922222222155,1.099058500000004,1.0986914,1.100059300000001,1.098952400000004,1.0993420918330803,1.0992737929228902,-2618,-303919,-305535.4,0.029930637005504922,-243.98071342654788,0.03549165036175206
2023-08-11T04:00:00-04:00,1.09924,1.09968,1.09901,1.09958,1.1000958811952,1.099458888888889,1.0994655555555488,1.0993602222222154,1.099090500000004,1.0987234,1.100043400000001,1.0989635000000042,1.0993896734664643,1.0993150343383118,2700,-301219,-303530,0.033452119190485734,-243.1455909783109,0.023650984244799233
2023-08-11T04:15:00-04:00,1.09958,1.09995,1.09939,1.09961,1.100068763571296,1.0994877777777778,1.09946666666666,1.0994122222222156,1.099119000000004,1.0987572,1.100028900000001,1.0989759000000041,1.0994337387731714,1.099362027470649,2235,-298984,-301889,0.033186866319585916,-243.08461315041302,0.0009094216078633606
2023-08-11T04:30:00-04:00,1.09961,1.10031,1.09901,1.10022,1.09874,1.0996384444444445,1.0995244444444376,1.0994573333333266,1.0991965000000041,1.098803,1.100020500000001,1.0989886500000041,1.099590991018537,1.0994248219765188,2867,-296117,-300308,0.03371370642847239,-241.49416744693633,0.04728562335183013
2023-08-11T04:45:00-04:00,1.10022,1.10027,1.09979,1.09994,1.0987714,1.0997215555555555,1.0995844444444376,1.0994955555555488,1.099257500000004,1.0988415999999999,1.100011700000001,1.0990020500000042,1.0996607928148296,1.0994834575812145,-2715,-298832,-299814.2,0.03039351720513391,-242.18512016548368,0.0491177005639426
2023-08-11T05:00:00-04:00,1.09994,1.10005,1.09952,1.09967,1.0988021719999999,1.0997386666666669,1.099648888888882,1.0995379999999932,1.099316000000004,1.0988762,1.099996000000001,1.099011300000004,1.0996626342518636,1.0995475660649714,-2497,-301329,-299296.2,0.02873316751032571,-242.79805359821637,0.05277092867736263
2023-08-11T05:15:00-04:00,1.09967,1.09968,1.09851,1.09862,1.10031,1.0995328888888887,1.0995777777777709,1.0995604444444378,1.099322000000004,1.098887,1.0999595000000009,1.099017800000004,1.099454107401491,1.0995604528519767,-2322,-303651,-299782.6,0.023937684048848763,-245.01517327957532,-0.058220985026288044
2023-08-11T05:30:00-04:00,1.09862,1.09904,1.09802,1.09819,1.100274,1.0992553333333333,1.0994222222222154,1.0995515555555488,1.099289000000004,1.0988892,1.0999204000000011,1.0990183500000041,1.0992012859211928,1.0995139622815808,-2622,-306273,-301240.4,0.01554714110670179,-246.04142439461037,-0.1273201829772977
2023-08-11T05:45:00-04:00,1.09819,1.09828,1.09761,1.09773,1.10018384,1.098916888888889,1.099199999999993,1.0994866666666598,1.0992490000000041,1.0988847999999998,1.099879300000001,1.099014900000004,1.0989070287369542,1.0993771698252643,-3031,-309304,-303877.8,0.003478673737496079,-247.31102255157748,-0.18186282087421474
2023-08-11T06:00:00-04:00,1.09773,1.09871,1.09765,1.09865,1.1000294095999998,1.0988068888888889,1.0991344444444375,1.0993966666666601,1.099243500000004,1.0988938,1.099841800000001,1.099015950000004,1.0988556229895634,1.099216135860211,2148,-307156,-305542.6,-0.006866337746425105,-245.51079845275575,-0.05367344710891984
2023-08-11T06:15:00-04:00,1.09865,1.09924,1.09857,1.09916,1.0998842450239998,1.098812,1.099087777777771,1.099284444444438,1.099257500000004,1.0989094,1.0998132000000012,1.099022600000004,1.0989164983916506,1.0990669086881684,1914,-305242,-306325.2,-0.009326794324644483,-244.62230803269475,-0.03819640226269003
2023-08-11T06:30:00-04:00,1.09916,1.09948,1.09914,1.09936,1.0997477903225599,1.0988664444444443,1.099059999999993,1.0991808888888823,1.099283000000004,1.0989323999999998,1.099788700000001,1.099030650000004,1.0990051987133205,1.0989771269505344,1793,-303449,-306284.8,-0.0134072588065894,-244.29605889699116,-0.02273533343640777
2023-08-11T06:45:00-04:00,1.09936,1.09959,1.09905,1.09931,1.0996195229032062,1.0989164444444444,1.098958888888882,1.0990882222222156,1.099282500000004,1.0989498,1.0997611000000012,1.099035350000004,1.0990661589706563,1.0989501015604273,-2002,-305451,-306120.4,-0.018128678529525856,-244.38711187326805,-0.08271073058115344
2023-08-11T07:00:00-04:00,1.09931,1.09958,1.09907,1.09915,1.09761,1.0989546666666665,1.0988711111111042,1.0990224444444379,1.099260000000004,1.0989664,1.099731500000001,1.099039250000004,1.099082927176525,1.0989852812483414,-2133,-307584,-305776.4,-0.027126074299712505,-244.69756115509017,-0.07182209938722535
2023-08-11T07:15:00-04:00,1.09915,1.0995,1.09895,1.09938,1.0976493999999999,1.0990564444444444,1.098838888888882,1.0989633333333269,1.0992440000000039,1.0989883999999999,1.0997029000000011,1.099045200000004,1.09914234174122,1.0990426249986727,1898,-305686,-305482.4,-0.031267625401613416,-244.3003997121571,-0.026371547827975798
2023-08-11T07:30:00-04:00,1.09938,1.10026,1.09917,1.10008,1.0976880119999999,1.0993046666666666,1.0990011111111042,1.0989459999999933,1.099278000000004,1.0990217999999998,1.099678100000001,1.0990542000000039,1.099329873392976,1.0991252999989376,2558,-303128,-305059.6,-0.02918350302505392,-242.67166351539183,0.13289399428373933
2023-08-11T07:45:00-04:00,1.10008,1.10017,1.09955,1.09973,1.0977908915199999,1.0994504444444444,1.0991722222222151,1.0989684444444376,1.099310000000004,1.099048,1.099647600000001,1.099063600000004,1.0994098987143808,1.0992062399991496,-3004,-306132,-305596.2,-0.020515228528368346,-243.6274121882152,0.1402307433140073
2023-08-11T08:00:00-04:00,1.09973,1.10044,1.09966,1.0999,1.0978896558592,1.099596,1.0994133333333262,1.0990593333333267,1.099342000000004,1.0990772,1.099619400000001,1.099074700000004,1.0995079189715047,1.0992945919993193,3068,-303064,-305118.8,-0.008468299106112338,-243.15315032393943,0.1976806682881952
2023-08-11T08:15:00-04:00,1.0999,1.10049,1.09952,1.1002,1.0980426765076479,1.0997533333333334,1.0995855555555485,1.0992022222222155,1.0993725000000043,1.099118,1.099596100000001,1.0990871500000041,1.0996463351772037,1.0994072735994551,3511,-299553,-303512.6,0.00992764771952824,-242.19551781189298,0.14108223729123584
2023-08-11T08:30:00-04:00,1.1002,1.1002,1.09736,1.09818,1.10049,1.0994722222222222,1.0994766666666598,1.099329777777771,1.0992950000000041,1.0991198,1.0995554000000007,1.099088300000004,1.099353068141763,1.0994494188795638,-12482,-312035,-304782.4,0.01176056273997177,-265.1128419347812,-0.08915899414097865
2023-08-11T08:45:00-04:00,1.09818,1.09827,1.09657,1.09682,1.10049,1.098940888888889,1.0991944444444377,1.0993684444444378,1.0991740000000043,1.0990866,1.099507100000001,1.099084250000004,1.0988464545134102,1.0993527351036507,-8193,-320228,-308202.4,0.0030802262474645082,-275.2591567465609,-0.23104351622762215
2023-08-11T09:00:00-04:00,1.09682,1.09811,1.09655,1.09714,1.1003332,1.09853,1.0989533333333266,1.09932466666666,1.0990520000000044,1.0990544,1.0994559000000008,1.0990828000000041,1.0985051636107281,1.09917178808292,6633,-313595,-309695,-0.008019715241336612,-273.32396227527056,-0.19739654874421275
2023-08-11T09:15:00-04:00,1.09714,1.09724,1.09605,1.09646,1.100106208,1.0980313333333334,1.0986544444444375,1.0991728888888823,1.098894500000004,1.0990076,1.099390800000001,1.0990782000000041,1.0980961308885826,1.0988894304663357,-5658,-319253,-312932.8,-0.02043548911250251,-276.83075265753723,-0.24473456762044135
2023-08-11T09:30:00-04:00,1.09646,1.0971899999999999,1.09607,1.09639,1.09978171136,1.0975784444444445,1.0983222222222153,1.0989202222222156,1.0987030000000042,1.0989559999999998,1.099336700000001,1.0990715500000041,1.0977549047108661,1.098511144373068,-7417,-326670,-318356.2,-0.03160228618155853,-277.30426742323783,-0.27197147483127293
2023-08-11T09:45:00-04:00,1.09639,1.09644,1.09545,1.09627,1.0994831744512,1.097168,1.097898888888882,1.09860466666666,1.098519500000004,1.0989032,1.099258100000001,1.0990680000000042,1.097457923768693,1.0981321154984542,-5689,-332359,-322421,-0.042795226595946013,-277.9269290673603,-0.34633844811285264
2023-08-11T10:00:00-04:00,1.09627,1.09778,1.09576,1.09635,1.09907985700608,1.0968582222222218,1.0975233333333265,1.0982704444444376,1.098353500000004,1.0988492,1.0991988000000008,1.099066350000004,1.0972363390149544,1.0978100923987628,13727,-318632,-322101.8,-0.06119633723680672,-276.9252050395222,-0.30734816727743725
2023-08-11T10:15:00-04:00,1.09635,1.0981,1.09616,1.0976299999999999,1.098716871305472,1.0968795555555555,1.0972711111111042,1.097933999999993,1.098304000000004,1.098813,1.0991592000000008,1.0990699000000042,1.0973150712119635,1.0975720739190098,7442,-311190,-321620.8,-0.071477192419323,-268.2365928262695,-0.20638239839987418
2023-08-11T10:30:00-04:00,1.0976299999999999,1.0981,1.0965799999999999,1.09796,1.0983901841749248,1.0970173333333333,1.0970222222222152,1.0976075555555487,1.0982925000000041,1.0987872,1.0991109000000008,1.099071750000004,1.0974440569695707,1.0974416591352074,7280,-303910,-318552.2,-0.08628150141927651,-266.04787713883275,-0.20359934557353387
2023-08-11T10:45:00-04:00,1.09796,1.09838,1.09697,1.09722,1.09545,1.0970568888888887,1.0969155555555485,1.0973262222222153,1.0982670000000039,1.098757,1.0990436000000008,1.0990670500000042,1.0973992455756565,1.0973705273081655,-6945,-310855,-315389.2,-0.10921356090036108,-270.72864875164174,-0.08741736327376659
2023-08-11T11:00:00-04:00,1.09722,1.09756,1.09615,1.09621,1.0955086,1.0969157777777778,1.0968477777777708,1.097115999999993,1.098145000000004,1.0987028,1.0989782000000006,1.099056100000004,1.0971613964605251,1.097311221846532,-4546,-315401,-311997.6,-0.12056865215016481,-274.9132789989949,-0.05561532430116149
2023-08-11T11:15:00-04:00,1.09621,1.09637,1.09587,1.09591,1.0955660280000001,1.096728222222222,1.096711111111104,1.0969535555555485,1.0979825000000039,1.0986438,1.0989091000000006,1.099043850000004,1.09691111716842,1.097246177477225,-3368,-318769,-312025,-0.11698782374259134,-275.83500020204895,-0.11210966695226356
2023-08-11T11:30:00-04:00,1.09591,1.09602,1.09518,1.09528,1.09838,1.0964420000000001,1.0965799999999932,1.0968153333333261,1.097778500000004,1.0985706000000002,1.0988351000000005,1.0990305500000042,1.096584893734736,1.0971001419817796,-2582,-321351,-314057.2,-0.11712028620316493,-277.3193009201734,-0.1076190649909672
2023-08-11T11:45:00-04:00,1.09528,1.09566,1.09509,1.09562,1.0983159999999998,1.09625,1.0964944444444376,1.0967097777777706,1.097594000000004,1.0985022,1.0987726000000007,1.0990186000000042,1.0963919149877888,1.0968897135854232,2821,-318530,-316981.2,-0.10856706313183648,-276.4435979035932,-0.07023048367824747
2023-08-11T12:00:00-04:00,1.09562,1.09632,1.09562,1.09628,1.0981869599999998,1.0962071111111111,1.0964955555555485,1.0966257777777706,1.0974505000000039,1.0984544,1.0987239000000004,1.0990057500000041,1.096369531990231,1.0966837708683381,2860,-315670,-317944.2,-0.09643719932499611,-274.72073778785995,0.0009121840422380861
2023-08-11T12:15:00-04:00,1.09628,1.09647,1.09571,1.09602,1.0980630815999999,1.096112,1.0964588888888818,1.0965479999999928,1.0972825000000042,1.0984004,1.0986657000000006,1.098994800000004,1.0962996255921846,1.0965114166946701,-2411,-318081,-318480.2,-0.0851463417489134,-275.2925442606587,-0.03009987686413476
2023-08-11T12:30:00-04:00,1.09602,1.09611,1.09518,1.09534,1.097944158336,1.0958882222222224,1.0962044444444377,1.0964466666666597,1.0970455000000041,1.0983372000000002,1.0986001000000005,1.0989794000000042,1.0961077004737476,1.0963507333557356,-2014,-320095,-318745.4,-0.07683263609739789,-276.5420835026434,-0.20863132385229116
2023-08-11T12:45:00-04:00,1.09534,1.09535,1.09456,1.09465,1.0978299920025598,1.0955773333333334,1.0958366666666597,1.0962979999999931,1.096791500000004,1.0982602000000001,1.0985315000000004,1.0989612500000043,1.095816160378998,1.0961969866845878,-1879,-321974,-318870,-0.08044518995820232,-277.7257433708123,-0.30146817734709336
2023-08-11T13:00:00-04:00,1.09465,1.0950199999999999,1.09453,1.09487,1.0976337924824062,1.095384,1.0955755555555486,1.0961142222222153,1.096540000000004,1.0981806,1.0984680000000004,1.0989445000000042,1.0956269283031983,1.0960439893476697,2125,-319849,-319133.8,-0.08753533327228818,-277.2986662228653,-0.21417764896739708
2023-08-11T13:15:00-04:00,1.09487,1.09556,1.09479,1.09536,1.0973854890838137,1.095340888888889,1.0954811111111042,1.0959113333333264,1.096298000000004,1.0981172000000001,1.0984104000000003,1.098932150000004,1.0955735426425586,1.0958847914781351,1718,-318131,-319626,-0.08479920229833744,-276.52978955257583,-0.07753988743032973
2023-08-11T13:30:00-04:00,1.09536,1.09537,1.09435,1.0945,1.0971570499571086,1.0951446666666667,1.0953244444444374,1.0956844444444376,1.096114000000004,1.0980320000000001,1.0983378000000004,1.098914850000004,1.0953588341140468,1.0956966331825075,-1999,-320130,-320035.8,-0.07565878353405546,-278.0992644284155,-0.12866020019891336
2023-08-11T13:45:00-04:00,1.0945,1.09456,1.09428,1.09451,1.0968763449613976,1.0949817777777777,1.0952388888888818,1.0954913333333263,1.0959985000000039,1.0979446,1.0982696000000005,1.0989003500000043,1.0951890672912374,1.0955129065460054,1617,-318513,-319719.4,-0.0724992494607011,-278.0844905590687,-0.07030165802351339
2023-08-11T14:00:00-04:00,1.09451,1.09475,1.09435,1.09446,1.09656478356603,1.0948259999999999,1.095109999999993,1.095345999999993,1.095864500000004,1.0978568000000002,1.0982048000000004,1.0988830500000042,1.09504325383299,1.0953583252368038,-1652,-320165,-319357.6,-0.06973451004411488,-278.1599581198951,-0.10587612493383197
2023-08-11T14:15:00-04:00,1.09446,1.0949,1.09446,1.0948,1.0962906095381064,1.094764,1.0949455555555485,1.095219999999993,1.095781500000004,1.0977664,1.0981583000000004,1.0988683000000043,1.094994603066392,1.0952318601894426,1768,-318397,-319067.2,-0.06705605618587739,-277.61071922582863,-0.13500200678658061
2023-08-11T14:30:00-04:00,1.0948,1.09505,1.09477,1.09493,1.0960493363935337,1.094760888888889,1.0948244444444375,1.0950886666666597,1.0957085000000037,1.0976730000000001,1.0981249000000004,1.0988536500000043,1.0949816824531136,1.0951134881515536,1142,-317255,-318892,-0.07273182399708321,-277.4751145491754,-0.09945073995000414
2023-08-11T14:45:00-04:00,1.09493,1.09515,1.09492,1.09507,1.0958370160263098,1.09481,1.0947944444444377,1.0949826666666598,1.095648500000004,1.0975804,1.0980956000000004,1.0988398000000044,1.094999345962491,1.0950415905212423,1595,-315660,-317998,-0.07566960056021982,-277.2711745712772,-0.024649880402431434
2023-08-11T15:00:00-04:00,1.09507,1.09511,1.09449,1.09465,1.0956501741031526,1.094781111111111,1.0947944444444377,1.094893777777771,1.095563500000004,1.0974854000000003,1.0980551000000005,1.0988181000000043,1.0949294767699926,1.0949896724169934,-1541,-317201,-317735.6,-0.07493169654203143,-277.86220528164284,0
2023-08-11T15:15:00-04:00,1.09465,1.0947,1.09432,1.0947,1.0954857532107742,1.0947622222222222,1.0947755555555487,1.0948268888888821,1.0954170000000039,1.0973976,1.0980117000000005,1.0988027500000042,1.094883581415994,1.0949577379335942,1326,-315875,-316877.6,-0.06730861598073991,-277.8016379770248,-0.015526957538338203
2023-08-11T15:30:00-04:00,1.0947,1.09487,1.09462,1.09469,1.0953410628254814,1.0947451111111113,1.0947011111111042,1.0947779999999934,1.095253500000004,1.0973062000000002,1.0979751000000002,1.0987859000000042,1.0948448651327953,1.0949277903468748,-1295,-317170,-316632.2,-0.056179555475673604,-277.81346770206375,-0.061167104878756616
2023-08-11T15:45:00-04:00,1.09469,1.0948499999999999,1.09463,1.09467,1.0952137352864235,1.094738888888889,1.0947199999999933,1.0947571111111045,1.095126000000004,1.0972078,1.0979310000000004,1.0987694500000043,1.0948098921062364,1.0948934322774995,-1204,-318374,-316856,-0.048183153374494546,-277.83546479713164,0.015532206486980674
2023-08-11T16:00:00-04:00,1.09467,1.09471,1.09449,1.09459,1.0951016870520527,1.0947128888888888,1.094728888888882,1.0947439999999935,1.0950450000000038,1.097105,1.0978886000000003,1.0987530000000043,1.094765913684989,1.0948467458219988,-900,-319274,-317578.8,-0.035930601714438445,-277.9012380438636,0.00730920685967766
2023-08-11T16:15:00-04:00,1.09459,1.09482,1.09445,1.09472,1.0950030846058063,1.0947111111111112,1.0947577777777708,1.09473666666666,1.094985500000004,1.0970146,1.0978530000000004,1.0987383000000044,1.094756730947991,1.0948121966575985,578,-318696,-317877.8,-0.027535678533264895,-277.83259133596385,0.023756007528820327
2023-08-11T16:30:00-04:00,1.09472,1.09488,1.09468,1.09487,1.0949163144531096,1.0947335555555555,1.0947655555555487,1.09473466666666,1.0949650000000037,1.0969204000000001,1.0978219000000005,1.0987245000000043,1.0947793847583929,1.0947913573260784,318,-318378,-318378.4,-0.01926975835150382,-277.78901855022866,0.0063938618925844445
2023-08-11T16:45:00-04:00,1.09487,1.09493,1.0944099999999999,1.09445,1.09428,1.0946704444444444,1.0947122222222154,1.0947368888888822,1.0949065000000038,1.0968172,1.0977872000000004,1.0987091500000044,1.0947135078067143,1.0947650858608622,-679,-319057,-318755.8,-0.018857298178600445,-278.04948782968654,-0.04383841889436183
2023-08-13T17:00:00-04:00,1.0951,1.09517,1.09483,1.09515,1.094293,1.0947580000000001,1.0947211111111044,1.0947371111111042,1.0948500000000037,1.0967158000000001,1.0977594000000004,1.0986970000000043,1.0948008062453713,1.094763268688689,136,-318921,-318865.2,-0.01480432543742447,-277.9625034996577,0.0073054690567799325
2023-08-13T17:15:00-04:00,1.09515,1.09515,1.0948,1.09505,1.09432808,1.0948237777777778,1.0947655555555487,1.0947444444444376,1.0948015000000038,1.096618,1.0977298000000004,1.0986825000000042,1.0948506449962971,1.094780214950951,-157,-319078,-318826,-0.009638114043521013,-277.9768394353743,0.03654136025215165
2023-08-13T17:30:00-04:00,1.09505,1.09505,1.09489,1.095,1.0943617568,1.0948706666666668,1.0947988888888822,1.0947526666666598,1.0947845000000036,1.0965246,1.0977004000000006,1.0986665500000043,1.0948805159970376,1.0948049719607602,-328,-319406,-318968,-0.0020051298264549444,-277.99181592046637,0.02740476842970375
2023-08-13T17:45:00-04:00,1.095,1.09503,1.09462,1.0947,1.094394086528,1.0948508888888888,1.0947999999999931,1.094759555555549,1.0947870000000037,1.0964462,1.0976666000000004,1.0986534500000043,1.09484441279763,1.0948179775686075,-834,-320240,-319340.4,0.0007785861834429913,-278.2203090711513,0.0009135006257539132
2023-08-13T18:00:00-04:00,1.0947,1.09503,1.0944,1.0945799999999999,1.09517,1.0948068888888889,1.0947899999999933,1.0947751111111044,1.0947725000000037,1.096374,1.0976316000000006,1.0986401500000043,1.094791530238104,1.0948335820548853,-559,-320799,-319688.8,0.00007829382129438258,-278.2815861333602,-0.008221655841499769
2023-08-13T18:15:00-04:00,1.0945799999999999,1.0946,1.09436,1.09438,1.0951545999999999,1.0947248888888887,1.0947666666666598,1.0947842222222155,1.0947235000000037,1.096307,1.0975959000000004,1.0986254500000043,1.0947092241904832,1.0948152656439079,-483,-321282,-320161,-0.0004393246924698355,-278.36983916191906,-0.01918526571593414
2023-08-13T18:30:00-04:00,1.09438,1.09442,1.09415,1.09416,1.095122816,1.0946035555555556,1.0947044444444378,1.0947719999999932,1.0947065000000038,1.0962172,1.0975555000000006,1.0986100500000042,1.0945993793523865,1.0947650125151256,-720,-322002,-320745.8,0.0008525953919627832,-278.5145786491172,-0.051154633148192595
2023-08-13T18:45:00-04:00,1.09416,1.09427,1.09401,1.09423,1.09506444704,1.0945086666666666,1.0946333333333265,1.094738888888882,1.0946925000000038,1.0961185999999998,1.0975140000000005,1.0985943000000042,1.0945255034819092,1.0946940100120999,382,-321620,-321188.6,-0.0024490655268411226,-278.49013981019056,-0.05845442837962259
2023-08-13T19:00:00-04:00,1.09423,1.09437,1.09408,1.09426,1.0949800912768,1.094434,1.0946122222222154,1.0947013333333266,1.0946825000000036,1.0960165999999998,1.0974745000000006,1.0985783500000041,1.0944724027855275,1.0946196080096793,536,-321084,-321357.4,-0.00693401936892169,-278.47544454502696,-0.0173603179679211
2023-08-13T19:15:00-04:00,1.09426,1.09451,1.09426,1.09438,1.094902483974656,1.0943875555555556,1.09452666666666,1.09464866666666,1.0946615000000037,1.0959179999999997,1.0974339000000006,1.098562250000004,1.094453922228422,1.094552086407743,382,-320702,-321338,-0.007225499531499922,-278.43355322121,-0.07031000319592379
2023-08-13T19:30:00-04:00,1.09438,1.09444,1.09427,1.0944,1.0948310852566834,1.0943622222222222,1.0944544444444377,1.0945862222222156,1.0946350000000036,1.095823,1.0973947000000006,1.0985471500000044,1.0944431377827375,1.0944988691261939,401,-320301,-321141.8,-0.012337069980475424,-278.42622487091114,-0.05935802018173046
2023-08-13T19:45:00-04:00,1.0944,1.09447,1.09431,1.09433,1.0947653984361487,1.0943373333333333,1.094379999999993,1.0945213333333268,1.0945980000000037,1.0957219999999999,1.0973552000000004,1.098530750000004,1.09442051022619,1.0944630953009546,-774,-321075,-320956.4,-0.016304846689408528,-278.47573144985853,-0.061187214611867435
2023-08-13T20:00:00-04:00,1.09433,1.09467,1.09407,1.09429,1.094704966561257,1.0943193333333334,1.0943344444444376,1.0944615555555488,1.0945800000000037,1.0956061999999998,1.0973140000000006,1.098513150000004,1.094394408180952,1.094436876240763,-1661,-322736,-321179.6,-0.019398553482871134,-278.5364443975069,-0.03745318352060121
2023-08-13T20:15:00-04:00,1.09429,1.09431,1.09396,1.094,1.09467,1.0942524444444444,1.0942699999999934,1.0943931111111045,1.0945450000000037,1.0954916,1.0972698000000005,1.098493900000004,1.0943155265447617,1.09440550099261,-1501,-324237,-321810.2,-0.022966552972074606,-278.93422743491,-0.05298836083244742
2023-08-13T20:30:00-04:00,1.094,1.09411,1.0936,1.09373,1.09467,1.0941444444444444,1.0941977777777712,1.0943273333333265,1.0944970000000036,1.0953682,1.0972227000000006,1.098474200000004,1.0941984212358093,1.0943544007940875,-1739,-325976,-322865,-0.02651337002141802,-279.3634139065736,-0.059394360277035166
2023-08-13T20:45:00-04:00,1.09373,1.09386,1.09361,1.09371,1.0945416000000001,1.0940468888888888,1.094147777777771,1.0942659999999933,1.0944490000000038,1.0952384,1.0971782000000008,1.0984543500000041,1.0941007369886475,1.0942859206352695,-1814,-327790,-324362.8,-0.028372342947954664,-279.39658479884156,-0.04112744022812582
2023-08-13T21:00:00-04:00,1.09371,1.09408,1.09357,1.09394,1.094428608,1.0940053333333333,1.0941155555555486,1.0942131111111044,1.094416500000004,1.0951536,1.0971367000000007,1.098435950000004,1.094068589590918,1.0942155365082153,2358,-325432,-325234.2,-0.02720716079573046,-278.900712949814,-0.026502654834918024
2023-08-13T21:15:00-04:00,1.09394,1.09399,1.09345,1.09362,1.09430840288,1.0939062222222222,1.0940444444444375,1.0941551111111043,1.0943615000000038,1.0950895999999999,1.0970881000000008,1.0984159500000041,1.0939788716727343,1.0941324292065717,-2188,-327620,-326211,-0.028561545038424778,-279.5407480522874,-0.05848701405515818
2023-08-13T21:30:00-04:00,1.09362,1.0937,1.09312,1.09369,1.0941710584192001,1.0938353333333333,1.093967777777771,1.0940946666666598,1.0943025000000035,1.0950206,1.0970375000000008,1.098396000000004,1.0939210973381874,1.094053543365257,2698,-324922,-326348,-0.02928951495396597,-279.3680555265472,-0.0630493978325497
2023-08-13T21:45:00-04:00,1.09369,1.0937,1.09338,1.0936,1.09399,1.0937617777777777,1.093878888888882,1.094030888888882,1.0942600000000036,1.0949634000000001,1.0969855000000006,1.098375400000004,1.09385687787055,1.093985234692205,-2252,-327174,-326587.6,-0.030892550582588406,-279.5533731211127,-0.0730994152046906
2023-08-13T22:00:00-04:00,1.0936,1.09381,1.0933599999999999,1.09344,1.0938334,1.0936739999999998,1.093779999999993,1.0939573333333263,1.0941745000000034,1.0949043999999999,1.0969302000000007,1.0983562500000041,1.0937735022964399,1.0939197877537634,-2255,-329429,-326915.4,-0.03527188728294554,-279.8832926529341,-0.08132830133506871
2023-08-13T22:15:00-04:00,1.09344,1.09347,1.09312,1.09322,1.09381,1.093562,1.0936611111111043,1.0938664444444375,1.0940830000000035,1.0948433999999998,1.0968733000000008,1.0983374000000041,1.093662801837152,1.09383863020301,-2030,-331459,-328120.8,-0.03702009556613022,-280.2917284152985,-0.09778029589961568
2023-08-13T22:30:00-04:00,1.09322,1.09349,1.09312,1.09337,1.09381,1.0935037777777779,1.093591111111104,1.0937757777777708,1.0940015000000036,1.0947837999999999,1.0968165000000007,1.098319550000004,1.0936042414697216,1.0937637041624075,1812,-329647,-328526.2,-0.03811964554542554,-280.0431050823923,-0.05758683729434464
2023-08-13T22:45:00-04:00,1.09337,1.09345,1.09301,1.09304,1.0936858,1.0933935555555554,1.0935144444444376,1.0936851111111043,1.0939185000000036,1.0946919999999998,1.0967525000000007,1.098299350000004,1.0934913931757773,1.0936777633299255,-1653,-331300,-329801.8,-0.03836666148648694,-280.54201213124117,-0.06308686787416268
2023-08-13T23:00:00-04:00,1.09304,1.09318,1.09293,1.09309,1.0935506400000001,1.0933086666666667,1.0934455555555485,1.0935984444444373,1.0938440000000036,1.0945946,1.096690900000001,1.098280450000004,1.0934111145406218,1.0935886106639399,1852,-329448,-330256.6,-0.037211391874760275,-280.45729428011055,-0.05668778743908943
2023-08-13T23:15:00-04:00,1.09309,1.0933599999999999,1.0930199999999999,1.09322,1.09345,1.0932635555555557,1.0933655555555486,1.0935155555555487,1.0937860000000037,1.0945146,1.0966358000000007,1.0982604500000042,1.0933728916324974,1.0935084885311512,1798,-327650,-329900.8,-0.03577259132503054,-280.2434601036014,-0.0658171380514317
2023-08-13T23:30:00-04:00,1.09322,1.09329,1.09297,1.09306,1.0933599999999999,1.0932024444444441,1.0933033333333262,1.0934439999999932,1.0937310000000036,1.0944516,1.096577200000001,1.098239400000004,1.0933103133059978,1.0934379908249203,-1348,-328998,-329408.6,-0.03807341965898074,-280.440748846947,-0.051206086209114314
2023-08-13T23:45:00-04:00,1.09306,1.09327,1.09292,1.0932,1.0933599999999999,1.093181777777778,1.0932488888888818,1.0933755555555487,1.0936795000000035,1.0943973999999996,1.0965206000000007,1.0982189500000041,1.0932882506447983,1.0933747926599358,1358,-327640,-329007.2,-0.03773540544967606,-280.26681511961266,-0.04480245773483359
2023-08-14T00:00:00-04:00,1.0932,1.0935,1.09317,1.0935,1.09292,1.0932319999999998,1.0932377777777706,1.0933202222222154,1.0936415000000035,1.0943617999999997,1.096466200000001,1.098197200000004,1.0933306005158385,1.093342634127948,1079,-326561,-328059.4,-0.036295412261408914,-279.9707119362977,-0.009144111192391093
2023-08-14T00:15:00-04:00,1.0935,1.09354,1.09327,1.09339,1.09292,1.0932624444444445,1.0932322222222153,1.0932775555555487,1.0935920000000035,1.0943171999999999,1.0964097000000008,1.0981748000000042,1.0933424804126708,1.0933289073023578,-783,-327344,-327638.6,-0.034428826336861194,-280.0494773683963,-0.004572724612222296
2023-08-14T00:30:00-04:00,1.09339,1.09355,1.09334,1.09348,1.0929448,1.0933119999999998,1.0932611111111041,1.0932566666666599,1.0935460000000035,1.0942611999999996,1.0963578000000007,1.098154250000004,1.0933699843301365,1.0933283258418858,761,-326583,-327425.2,-0.03014545410186531,-279.9868373223012,0.023782953110986528
2023-08-14T00:45:00-04:00,1.09348,1.09357,1.09335,1.09355,1.092981112,1.0933697777777778,1.0932811111111043,1.0932522222222154,1.0935070000000036,1.0942117999999998,1.0963061000000007,1.0981325500000043,1.0934059874641093,1.093347460673508,1077,-325506,-326726.8,-0.023427494733986837,-279.91789230273065,0.016462862525958185
2023-08-14T01:00:00-04:00,1.09355,1.09368,1.09333,1.09354,1.09302822304,1.0934215555555555,1.0933366666666597,1.093269777777771,1.0934695000000034,1.0941757999999997,1.0962565000000009,1.098109500000004,1.0934327899712875,1.0933763685388058,-1428,-326934,-326585.6,-0.01843345665827455,-279.9309506905502,0.04574398009221482
2023-08-14T01:15:00-04:00,1.09354,1.09377,1.09324,1.09369,1.093093400736,1.093492222222222,1.0934033333333266,1.093302888888882,1.0934540000000035,1.0941565999999998,1.096208400000001,1.0980888000000042,1.09348423197703,1.0934070948310441,1690,-325244,-326322.2,-0.009876723853852867,-279.6991347533187,0.05489026521147902
2023-08-14T01:30:00-04:00,1.09369,1.0939,1.09359,1.09386,1.09317459264768,1.0935835555555555,1.0934744444444375,1.0933513333333265,1.0934605000000037,1.0941363999999998,1.096158500000001,1.098068250000004,1.093559385581624,1.093450475864835,1747,-323497,-325552.8,-0.002225324805712439,-279.42758614265205,0.05854265381167321
2023-08-14T01:45:00-04:00,1.09386,1.09405,1.0935,1.09373,1.09324,1.0936346666666668,1.0935488888888818,1.093408888888882,1.0934615000000036,1.0941037999999998,1.0961105000000009,1.0980473500000043,1.0935935084652992,1.0934951806918674,-2024,-325521,-325340.4,0.0024387121163708153,-279.6681288080753,0.0612958117578331
2023-08-14T02:00:00-04:00,1.09373,1.09374,1.09259,1.09291,1.09405,1.093506888888889,1.0935166666666598,1.093455999999993,1.0934100000000035,1.0940719999999997,1.096052000000001,1.0980195500000043,1.0934568067722394,1.0935053445534932,-3598,-329119,-326063,0.004550969552733932,-282.3656501341797,-0.02652762532015198
2023-08-14T02:15:00-04:00,1.09291,1.09376,1.09279,1.09366,1.09405,1.0935355555555555,1.0935344444444375,1.0934955555555486,1.0934120000000038,1.0940549999999998,1.095999800000001,1.0979947500000042,1.0934974454177915,1.0935182756427944,1971,-327148,-326105.8,0.009977414721881296,-281.0130684943374,0.014631915866498401
2023-08-14T02:30:00-04:00,1.09366,1.09371,1.09305,1.0931,1.0940208,1.0934486666666665,1.0935022222222155,1.0935153333333265,1.0933825000000037,1.0940277999999999,1.095942300000001,1.0979685500000043,1.0934179563342332,1.093505020514235,-2041,-329189,-326894.8,0.008583993791536898,-282.05814648932693,-0.026523015575423543
2023-08-14T02:45:00-04:00,1.0931,1.09347,1.09285,1.0932,1.093992184,1.0933882222222222,1.0934711111111044,1.09351466666666,1.0933625000000038,1.0939957999999996,1.095881100000001,1.0979449500000042,1.0933743650673866,1.0934680164113875,2317,-326872,-327569.8,0.00898050377079713,-281.84618052098006,-0.025606321103271937
2023-08-14T03:00:00-04:00,1.0932,1.09434,1.09295,1.09416,1.09259,1.0935259999999998,1.093538888888882,1.09351266666666,1.093398500000004,1.0939803999999997,1.0958267000000008,1.0979258000000043,1.0935314920539092,1.0934556131291093,4474,-322398,-326945.2,0.012760540402581984,-277.91731114666584,0.055781628640665666
2023-08-14T03:15:00-04:00,1.09416,1.09487,1.09416,1.09447,1.092625,1.0937122222222222,1.0936422222222155,1.093537777777771,1.093461000000004,1.0939683999999996,1.095774400000001,1.097906250000004,1.0937191936431274,1.093508090503287,3241,-319157,-324952.8,0.016688121994256747,-276.9990633584081,0.08504490004938982
2023-08-14T03:30:00-04:00,1.09447,1.09494,1.09423,1.09461,1.0927148,1.0939057777777779,1.0937444444444375,1.0935797777777712,1.0935230000000042,1.0939675999999998,1.095726500000001,1.0978876000000042,1.093897354914502,1.093588072402629,3271,-315886,-322700.4,0.020419067725438497,-276.5806507934222,0.08411890023681591
2023-08-14T03:45:00-04:00,1.09461,1.0956299999999999,1.09444,1.0952,1.092848312,1.0941968888888889,1.0938933333333265,1.0936579999999934,1.0936310000000042,1.0939775999999997,1.0956876000000009,1.0978710500000042,1.0941578839316015,1.0937360579221027,4035,-311851,-319232.8,0.026256593540364827,-274.40576658808925,0.12250196551660146
2023-08-14T04:00:00-04:00,1.0952,1.09569,1.09505,1.0952,1.0930708470400001,1.094458222222222,1.0940566666666598,1.0937751111111045,1.0937365000000043,1.0939877999999996,1.095647000000001,1.0978509000000043,1.0943663071452812,1.0939344463376817,0,-311851,-316228.6,0.029101586480836966,-274.40576658808925,0.134402457644927
2023-08-14T04:15:00-04:00,1.0952,1.09567,1.09515,1.09542,1.093332762336,1.094730888888889,1.0943355555555487,1.0939344444444377,1.0938465000000042,1.0940027999999997,1.095605300000001,1.0978315500000042,1.094577045716225,1.0941435570701448,2842,-309009,-313550.8,0.03440552194942055,-273.8348754266573,0.22966209477450222
2023-08-14T04:30:00-04:00,1.09542,1.09602,1.09528,1.09591,1.0935684861024,1.095045777777778,1.0945855555555488,1.0941231111111045,1.093989000000004,1.0940291999999998,1.095567100000001,1.0978141000000041,1.09484363657298,1.0943684456561154,2619,-306390,-310997.4,0.05011570184645213,-272.6633521753019,0.20573121445420542
2023-08-14T04:45:00-04:00,1.09591,1.09594,1.09454,1.09462,1.093862667770112,1.0950526666666667,1.0947544444444377,1.0943251111111043,1.094060000000004,1.0940271999999998,1.095520900000001,1.0977901000000043,1.0947989092583839,1.0945487565248917,-2761,-309151,-309650.4,0.05209711679112527,-275.91333620683736,0.13905406641661017
2023-08-14T05:00:00-04:00,1.09462,1.09515,1.09417,1.0951,1.0941215476376986,1.0951217777777777,1.0949655555555486,1.0945395555555488,1.094140000000004,1.0940317999999998,1.095476100000001,1.0977597500000043,1.094859127406707,1.0946890052199127,2667,-306484,-308577,0.0621031236537738,-274.7438344619395,0.17380168313209046
2023-08-14T05:15:00-04:00,1.0951,1.09517,1.09469,1.09489,1.09417,1.0951066666666665,1.0950466666666598,1.094737555555549,1.0942150000000042,1.0940405999999998,1.095428900000001,1.0977289000000041,1.0948653019253656,1.0947888041759297,-2536,-309020,-308010.8,0.07149543753118229,-275.230146214291,0.0667178474811634
2023-08-14T05:30:00-04:00,1.09489,1.09491,1.09451,1.09471,1.09417,1.0950393333333333,1.0950733333333265,1.0948851111111044,1.094276500000004,1.0940317999999998,1.095373800000001,1.0976971500000041,1.0948342415402925,1.0948402433407431,-2397,-311417,-308492.4,0.07077328396683015,-275.62421319818856,0.021928421975935197
2023-08-14T05:45:00-04:00,1.09471,1.09518,1.09465,1.09496,1.094392,1.0950166666666667,1.0951122222222152,1.0949904444444376,1.094347000000004,1.0940299999999998,1.095324000000001,1.097667850000004,1.094859393232234,1.094843394672594,2201,-309216,-309057.6,0.06880619168721473,-275.121568662193,0.03197485862543284
2023-08-14T06:00:00-04:00,1.09496,1.09532,1.09465,1.09504,1.09451,1.0950022222222224,1.0950944444444375,1.0950584444444376,1.094422000000004,1.0940307999999999,1.0952777000000011,1.097636850000004,1.094895514585787,1.0948627157380746,2449,-306767,-308580.8,0.0662475556939267,-274.9426397515477,-0.014609203798387324
2023-08-14T06:15:00-04:00,1.09504,1.09527,1.09471,1.09481,1.09465,1.0949453333333334,1.0950511111111043,1.095075555555549,1.094478000000004,1.0940329999999998,1.095239600000001,1.097599550000004,1.0948784116686296,1.0948665725904592,-2358,-309125,-309109,0.05715466698602764,-275.43790933074104,-0.0356099342585729
2023-08-14T06:30:00-04:00,1.09481,1.09515,1.0947,1.09492,1.09602,1.0949191111111112,1.0949955555555486,1.0950653333333267,1.094531000000004,1.0940398,1.095206900000001,1.097563650000004,1.0948867293349036,1.0948708580723667,2167,-306958,-308696.6,0.0492419232458709,-275.2201820538623,-0.04564459294153539
2023-08-14T06:45:00-04:00,1.09492,1.09512,1.0945,1.0945,1.0959936,1.09482,1.094838888888882,1.0950184444444377,1.094569500000004,1.0940421999999999,1.0951746000000009,1.0975269500000042,1.094809383467923,1.0948658864578928,-1861,-308819,-308177,0.038050704107979796,-275.93404242722266,-0.12866020019891336
2023-08-14T07:00:00-04:00,1.0945,1.0945799999999999,1.09392,1.09402,1.0959338559999998,1.0946562222222223,1.0947722222222156,1.0949504444444378,1.094625000000004,1.0940393999999998,1.095128300000001,1.097485050000004,1.0946515067743383,1.094824309166314,-2144,-310963,-308526.4,0.019521078806351354,-276.8743073883922,-0.054813542599252155
2023-08-14T07:15:00-04:00,1.09402,1.09409,1.09368,1.09393,1.0958130246399997,1.0944877777777777,1.0946422222222154,1.0948599999999933,1.0946385000000038,1.0940333999999998,1.095076000000001,1.0974446000000042,1.0945072054194707,1.0947466473330505,-1941,-312904,-309753.8,0.008779092708443983,-277.03398454237464,-0.10683955803122029
2023-08-14T07:30:00-04:00,1.09393,1.09409,1.09367,1.09388,1.0956423826687998,1.0943353333333334,1.0945299999999933,1.094755777777771,1.094677500000004,1.0940257999999998,1.095021200000001,1.097404950000004,1.0943817643355764,1.0946473178664398,-2386,-315290,-310986.8,-0.0033236683028551707,-277.14304088053177,-0.09224670971512713
2023-08-14T07:45:00-04:00,1.09388,1.09414,1.09371,1.09391,1.0954451444019198,1.0942113333333332,1.0944411111111043,1.0946448888888822,1.094713000000004,1.0940163999999999,1.094967200000001,1.0973641500000042,1.094287411468461,1.0945274542931513,2506,-312784,-312152,-0.01579991873804004,-277.0743130493255,-0.07307871491081053
2023-08-14T08:00:00-04:00,1.09391,1.09411,1.09278,1.09314,1.0952676299617279,1.093951111111111,1.094238888888882,1.094524888888882,1.094662000000004,1.0939912,1.094907100000001,1.097319300000004,1.094057929174769,1.0943771634345205,-4377,-317161,-313820.4,-0.029881587304077955,-280.15527034928596,-0.16621611748373757
2023-08-14T08:15:00-04:00,1.09314,1.09333,1.09194,1.09218,1.0949691143663205,1.0935393333333332,1.0939211111111042,1.09435466666666,1.094547500000004,1.0939481999999998,1.0948351000000012,1.0972690000000043,1.093682343339815,1.0941833307476159,-5315,-322476,-316123,-0.046668714341264905,-284.8229249955347,-0.2611776738749347
2023-08-14T08:30:00-04:00,1.09218,1.09234,1.09023,1.09037,1.0945450383550357,1.092829111111111,1.0934277777777708,1.0941117777777711,1.094335500000004,1.0938697999999998,1.094738000000001,1.0972080500000043,1.093019874671852,1.0938858645980922,-6196,-328672,-319276.6,-0.07151025267451558,-295.0911591693881,-0.4055498214302024
2023-08-14T08:45:00-04:00,1.09037,1.09107,1.0902,1.09056,1.09385463221823,1.0922555555555555,1.0929433333333263,1.0937944444444376,1.0941035000000041,1.0938009999999998,1.094646300000001,1.0971469500000042,1.0925278997374817,1.0935150916784733,5274,-323398,-320898.2,-0.09273947688277273,-294.17215002570333,-0.39820260840973953
2023-08-14T09:00:00-04:00,1.09056,1.0907499999999999,1.08981,1.09016,1.0931967984189488,1.091698888888889,1.092461111111104,1.0933984444444378,1.093851500000004,1.0937295999999999,1.0945489000000013,1.0970841500000041,1.0920543197899852,1.0930684733427778,-5621,-329019,-324145.2,-0.11433369768603321,-296.2338431008205,-0.3965280950205583
2023-08-14T09:15:00-04:00,1.09016,1.09027,1.0885,1.08869,1.092519438735159,1.0909446666666667,1.091868888888882,1.0929244444444375,1.093515000000004,1.0936291999999996,1.0944338000000011,1.0970149500000042,1.091381455831988,1.0925331786742216,-4974,-333993,-327511.6,-0.13914651924669896,-302.9409136225791,-0.4871940183908939
2023-08-14T09:30:00-04:00,1.08869,1.08881,1.08807,1.08817,1.0917155509881273,1.090204888888889,1.091228888888882,1.092385999999993,1.093128000000004,1.0935137999999998,1.094333700000001,1.0969445500000041,1.0907391646655904,1.0919445429393766,-6158,-340151,-331046.6,-0.16112136392338577,-305.88221004304694,-0.5265419176729761
2023-08-14T09:45:00-04:00,1.08817,1.08848,1.08746,1.08815,1.0909864407905019,1.0895891111111111,1.0905922222222153,1.091818888888882,1.092804500000004,1.0934043999999998,1.094247000000001,1.096877050000004,1.0902213317324723,1.0913848343515007,-6125,-346276,-334567.4,-0.1802515042015916,-305.99478436507457,-0.5238234541265965
2023-08-14T10:00:00-04:00,1.08815,1.08955,1.08802,1.08948,1.0902811526324014,1.0893666666666668,1.090099999999993,1.0912502222222151,1.092523500000004,1.0933202,1.0941704000000012,1.096813150000004,1.0900730653859778,1.0908938674811999,6639,-339637,-337815.2,-0.19816025489862021,-297.88021376359467,-0.4049693302008332
2023-08-14T10:15:00-04:00,1.08948,1.09088,1.08941,1.08956,1.08746,1.0892586666666668,1.0897022222222152,1.0906984444444374,1.092257000000004,1.0932393999999999,1.0941014000000013,1.0967461000000043,1.0899704523087823,1.0904770939849593,6985,-332652,-338541.8,-0.21387940643472084,-297.36730852439746,-0.3274969354336971
2023-08-14T10:30:00-04:00,1.08956,1.09087,1.08952,1.09027,1.0875284,1.0893722222222224,1.0894899999999932,1.0902226666666597,1.0920350000000039,1.093176,1.0940402000000011,1.0966884500000043,1.090030361847026,1.0902068751879668,6005,-326647,-337072.6,-0.22005710820058463,-293.4542151656105,-0.17487959860095006
2023-08-14T10:45:00-04:00,1.09027,1.09092,1.0899699999999999,1.09032,1.087595432,1.0895382222222223,1.0894844444444376,1.0898737777777707,1.0918030000000039,1.0931179999999998,1.0939807000000012,1.0966194000000042,1.0900882894776207,1.0900767001503728,5590,-321057,-333253.8,-0.21798855872938055,-293.1978566489134,-0.00458559938370512
2023-08-14T11:00:00-04:00,1.09032,1.09103,1.09021,1.0907,1.0877284147200001,1.0897813333333333,1.089499999999993,1.0896553333333263,1.0915860000000037,1.0930645999999997,1.0939242000000013,1.0965615000000042,1.0902106315820965,1.0900745601202977,4230,-316827,-327364,-0.19642548707251464,-291.72361055602306,0.01283744131455665
2023-08-14T11:15:00-04:00,1.0907,1.09224,1.0907,1.09198,1.0879265098368,1.0902773333333335,1.0897022222222152,1.0895757777777706,1.0914445000000037,1.0930433999999998,1.0938677000000012,1.0965134500000042,1.0905645052656772,1.0901728480962376,4227,-312600,-321956.6,-0.17009470547924896,-286.76297976845564,0.16694797094003933
2023-08-14T11:30:00-04:00,1.09198,1.09234,1.09173,1.09227,1.088271589049856,1.0907908888888889,1.0900999999999932,1.0896553333333263,1.0913120000000038,1.0930269999999997,1.0938108000000013,1.0964608500000042,1.0909056042125418,1.0903598784769895,3301,-309299,-317286,-0.1397006085204708,-285.8863245183591,0.3288355730281475
2023-08-14T11:45:00-04:00,1.09227,1.09256,1.09201,1.09206,1.0886784301448704,1.0911828888888888,1.0905322222222154,1.0898637777777707,1.0911900000000037,1.0930037999999995,1.0937592000000014,1.0964014000000042,1.0911364833700334,1.0905811027815908,-2705,-312004,-314357.4,-0.09635967763727973,-286.4063882388679,0.35748090831395357
2023-08-14T12:00:00-04:00,1.09206,1.0931,1.09199,1.09268,1.089144218527486,1.0916124444444446,1.0910355555555489,1.0901739999999929,1.0911230000000036,1.0929961999999995,1.0937239000000012,1.0963510500000042,1.0914451866960269,1.0908524822252719,3183,-308821,-311910.2,-0.0470971108998729,-284.59928972779693,0.4163028994164541
2023-08-14T12:15:00-04:00,1.09268,1.09296,1.09221,1.09287,1.089698027933638,1.0919793333333334,1.0914122222222153,1.0905564444444376,1.0910700000000038,1.0929895999999997,1.0936935000000012,1.0963013000000041,1.0917301493568214,1.091156385780217,2362,-306459,-309836.6,0.001173886651661806,-284.1885747883821,0.311157616477586
2023-08-14T12:30:00-04:00,1.09287,1.0932,1.09263,1.09308,1.0901743040229286,1.092312888888889,1.0918033333333266,1.0909766666666596,1.091030000000004,1.0929811999999997,1.0936715000000012,1.0962533000000043,1.0920001194854572,1.0914435086241732,2574,-303885,-308093.6,0.03787561402243496,-283.6939688425696,0.3230661918572605
2023-08-14T12:45:00-04:00,1.09308,1.0936,1.09283,1.09284,1.09065841537926,1.0925202222222221,1.092088888888882,1.0913744444444375,1.090976500000004,1.0929701999999997,1.093643700000001,1.0962081500000043,1.0921680955883657,1.091696006899338,-2242,-306127,-307459.2,0.07247711386877347,-284.18622924437005,0.23572142680253158
2023-08-14T13:00:00-04:00,1.09284,1.09313,1.09245,1.0926,1.0911879006109932,1.0926224444444446,1.0923422222222152,1.0917364444444375,1.0909495000000038,1.0929525999999996,1.0936069000000013,1.0961654000000045,1.0922544764706925,1.0919196055194698,-1904,-308031,-306664.6,0.09955425357682655,-284.60436913676057,0.20911292097733325
2023-08-14T13:15:00-04:00,1.0926,1.09266,1.0921,1.09226,1.0916220785010144,1.092606,1.0925155555555486,1.0920324444444376,1.090953500000004,1.0929267999999999,1.0935693000000013,1.0961175000000045,1.092255581176554,1.0920816844155754,-1782,-309813,-306863,0.1211806426976085,-285.15889961452007,0.14302741358760482
2023-08-14T13:30:00-04:00,1.09226,1.09256,1.0917999999999999,1.09201,1.0936,1.092504888888889,1.092518888888882,1.092253777777771,1.0910355000000038,1.0928961999999998,1.0935360000000012,1.0960680500000044,1.092206464941243,1.0921769475324596,-1613,-311426,-307856.4,0.13393083172009837,-285.5280882692361,0.002747303064156348
2023-08-14T13:45:00-04:00,1.09201,1.09201,1.09151,1.09173,1.093564,1.0923471111111112,1.092458888888882,1.092384888888882,1.0910940000000038,1.0928569999999997,1.0935068000000012,1.0960191500000045,1.0921111719529946,1.0921991580259671,-1648,-313074,-309694.2,0.1256959101695473,-285.95064850220075,-0.04943832568870196
2023-08-14T14:00:00-04:00,1.09173,1.09198,1.09161,1.09175,1.09348184,1.0922053333333335,1.0924244444444373,1.092451999999993,1.0911735000000038,1.0928148,1.0934756000000012,1.0959718000000045,1.0920389375623956,1.0921733264207731,1756,-311318,-310732.4,0.1157302444006218,-285.91847937613494,-0.028386718678463863
2023-08-14T14:15:00-04:00,1.09175,1.09179,1.09144,1.09162,1.0934029664,1.0920444444444446,1.0923066666666594,1.0924448888888818,1.0913200000000036,1.0927725999999998,1.0934382000000011,1.0959243000000043,1.0919551500499165,1.0921134611366177,-1757,-313075,-311741.2,0.10531924596436101,-286.1276939399086,-0.09700918841747454
2023-08-14T14:30:00-04:00,1.09162,1.09165,1.091,1.0911,1.093285188416,1.091803111111111,1.0921099999999928,1.0923637777777706,1.0914665000000037,1.0927364,1.0934042000000013,1.0958710000000045,1.0917841200399332,1.0920191689092937,-1875,-314950,-312768.6,0.08031417039405438,-287.02086189212656,-0.16195887891515454
2023-08-14T14:45:00-04:00,1.0911,1.0911,1.09036,1.09046,1.0931023733427199,1.0914731111111111,1.0918188888888816,1.0922237777777706,1.0915820000000038,1.0926723999999999,1.0933637000000014,1.0958166500000044,1.0915192960319466,1.0918817351274344,-2036,-316986,-313880.6,0.048233426222737755,-288.21510623270024,-0.23968968419512449
2023-08-14T15:00:00-04:00,1.09046,1.09063,1.0903,1.09057,1.092828136008448,1.0912233333333332,1.0915666666666592,1.092045333333326,1.091636500000004,1.0926218,1.0933248000000013,1.0957648000000044,1.0913294368255573,1.0917253881019469,1814,-315172,-314300.2,0.014675722803571488,-288.0321192363867,-0.20771567658577597
2023-08-14T15:15:00-04:00,1.09057,1.09088,1.09057,1.0908,1.0925247596874341,1.09107,1.0913666666666595,1.0918337777777705,1.0916985000000037,1.0925738,1.0932848000000015,1.0957215500000046,1.0912235494604459,1.091562310481557,1702,-313470,-314730.6,-0.009771618943284002,-287.6731693294573,-0.1647446457990137
2023-08-14T15:30:00-04:00,1.0908,1.0913,1.09064,1.09123,1.092257788524942,1.0910426666666668,1.091252222222215,1.0916228888888817,1.0917465000000037,1.0925152,1.0932478000000012,1.0956863500000045,1.0912248395683566,1.091416248385245,1690,-311780,-314471.6,-0.0296049761831673,-287.00696104196203,-0.09429989196712196
2023-08-14T15:45:00-04:00,1.09123,1.09132,1.09028,1.09029,1.092022853901949,1.0908502222222223,1.091061111111104,1.0914131111111038,1.0917450000000037,1.0924315999999998,1.0932000000000013,1.0956478000000045,1.0910378716546854,1.0912669987081955,-2834,-314614,-314404.4,-0.04773781887348075,-289.4482062423321,-0.1575077151308087
2023-08-14T16:00:00-04:00,1.09029,1.0907,1.09027,1.0907,1.0917788543556761,1.090778,1.0909466666666594,1.0912386666666594,1.0917450000000037,1.0923534,1.0931605000000013,1.0956078000000047,1.0909702973237483,1.0911571989665558,737,-313877,-313782.6,-0.06139424922333539,-289.1710597950566,-0.09434567154883408
2023-08-14T16:15:00-04:00,1.0907,1.0907499999999999,1.09037,1.09047,1.0915374376587679,1.090682666666667,1.0908044444444374,1.091086222222215,1.0916695000000038,1.0922588,1.0931182000000015,1.0955649500000046,1.0908702378589987,1.0910653591732442,-427,-314304,-313609,-0.07193340827191134,-289.2611028866491,-0.11724295855277746
2023-08-14T16:30:00-04:00,1.09047,1.0905799999999999,1.09045,1.09047,1.091334647633365,1.0906157777777776,1.0906766666666594,1.090948222222215,1.0915795000000037,1.0921642,1.0930760000000013,1.0955255500000047,1.090790190287199,1.090978687338595,0,-314304,-313775.8,-0.07707689717153395,-289.2611028866491,-0.1053480148769704
2023-08-14T16:45:00-04:00,1.09047,1.09074,1.09043,1.09056,1.0911643040120267,1.0905924444444446,1.0906166666666595,1.090821111111104,1.0915045000000037,1.092067,1.0930349000000015,1.0954829500000047,1.0907441522297592,1.0908825498708754,2778,-311526,-313725,-0.07933374487098833,-289.0318256025424,-0.04949133901567088
2023-08-14T17:00:00-04:00,1.09056,1.09067,1.09024,1.09036,1.0910212153701024,1.0905411111111112,1.0906055555555485,1.0907299999999929,1.0913885000000036,1.091956,1.0929926000000014,1.0954406000000048,1.0906673217838074,1.0908084398966997,-63,-311589,-313120,-0.0787026432724612,-289.04337929972553,-0.00917044183188645
2023-08-14T17:15:00-04:00,1.09036,1.09072,1.0901399999999999,1.09056,1.090880596603484,1.0905319999999998,1.0906044444444372,1.0906615555555483,1.0912730000000037,1.0918748,1.0929510000000013,1.0954020000000044,1.090645857427046,1.0907435519173592,693,-310896,-312523.8,-0.06854338863234317,-288.91626531902193,-0.0009169516858216815
2023-08-14T17:30:00-04:00,1.09056,1.09072,1.09053,1.09056,1.090732477282787,1.0905231111111109,1.0905777777777705,1.090616222222215,1.0911470000000036,1.0917839999999999,1.0929079000000013,1.0953649000000045,1.0906286859416368,1.0906952415338869,0,-310896,-311842.2,-0.05856165250311654,-288.91626531902193,-0.02200220022002365
2023-08-14T17:45:00-04:00,1.09056,1.09062,1.0904,1.09048,1.0901399999999999,1.0905035555555556,1.0904944444444373,1.0905797777777706,1.0910290000000036,1.0916957999999999,1.0928682000000014,1.0953277000000046,1.0905989487533094,1.090656993227109,-448,-311344,-311250.2,-0.050154014546705136,-288.94912916878724,-0.06872978198913414
2023-08-14T18:00:00-04:00,1.09048,1.09062,1.09042,1.0905799999999999,1.0901496,1.0905206666666665,1.0905266666666593,1.0905617777777705,1.0909280000000037,1.0916132,1.0928225000000014,1.0952909500000048,1.0905951590026475,1.0906271945816866,329,-311015,-311148,-0.04625256861698743,-288.9189589685085,0.02659842794118092
2023-08-14T18:15:00-04:00,1.0905799999999999,1.09074,1.09057,1.0907,1.0901590079999999,1.0905553333333333,1.0905266666666593,1.0905459999999927,1.0908500000000037,1.091528,1.0927790000000013,1.0952544000000046,1.090616127202118,1.0906169556653487,385,-310630,-310956.2,-0.03420450944269206,-288.87659618906997,0
2023-08-14T18:30:00-04:00,1.0907,1.09079,1.09065,1.09078,1.0901822476799998,1.090606,1.0905611111111038,1.090537333333326,1.0907885000000035,1.0914428,1.0927368000000015,1.0952186000000046,1.0906489017616945,1.0906175645322782,546,-310084,-310793.8,-0.027012656835129115,-288.8365485132654,0.028428108980534307
2023-08-14T18:45:00-04:00,1.09078,1.09084,1.0907499999999999,1.0907499999999999,1.0902187128191998,1.0906437777777778,1.0905922222222149,1.0905402222222147,1.0907395000000035,1.0913616,1.0926973000000013,1.0951819500000048,1.0906691214093556,1.0906256516258221,-229,-310313,-310677.2,-0.018946570670486648,-288.8428467585578,0.025677001659819704
2023-08-14T19:00:00-04:00,1.0907499999999999,1.0907499999999999,1.09039,1.09048,1.0902684157936637,1.0906213333333332,1.0905833333333261,1.0905579999999924,1.0906760000000033,1.0912728,1.0926563000000014,1.0951439500000046,1.0906312971274845,1.0906321213006571,-479,-310792,-310566.8,-0.013398663276820988,-288.9614165499857,-0.007335680751181045
2023-08-14T19:15:00-04:00,1.09048,1.09055,1.0904,1.09048,1.0903141425301706,1.0906006666666666,1.0905966666666593,1.0905719999999923,1.0906190000000033,1.0911924,1.0926173000000012,1.0951066000000047,1.0906010377019877,1.0906332970405253,0,-310792,-310522.2,-0.008588019559657148,-288.9614165499857,0.011005539454849588
2023-08-14T19:30:00-04:00,1.09048,1.09069,1.09048,1.09069,1.090356211127757,1.0906193333333332,1.0906111111111036,1.090588888888881,1.0905985000000034,1.0911258,1.0925826000000014,1.0950690500000047,1.0906188301615902,1.0906338376324196,501,-310291,-310454.4,-0.0015019820484539087,-288.8649361010091,0.011920481220653928
2023-08-14T19:45:00-04:00,1.09069,1.0908,1.09063,1.09077,1.0903949142375364,1.0906511111111112,1.0906344444444371,1.090603555555548,1.0906140000000033,1.0910625999999999,1.0925480000000014,1.0950310000000045,1.090649064129272,1.090633870105935,1062,-309229,-310283.4,0.001864405743832493,-288.7870404569672,0.019256161971834974
2023-08-14T20:00:00-04:00,1.09077,1.09096,1.09053,1.09069,1.0904305210985334,1.0906622222222222,1.0906577777777704,1.090616666666659,1.0906200000000033,1.0909988,1.0925123000000014,1.0949934000000048,1.0906572513034176,1.0906314960847474,-1547,-310776,-310376,0.0020521355966512914,-288.9005015899284,0.019257574646031426
2023-08-14T20:15:00-04:00,1.09069,1.09087,1.09055,1.0907,1.0904834689886802,1.0906706666666666,1.0906711111111038,1.0906342222222145,1.0906150000000032,1.0909345999999998,1.0924755000000013,1.0949547000000046,1.0906658010427341,1.0906383968677973,1079,-309697,-310157,0.0035017093758202226,-288.890608769787,0.011003319334676962
2023-08-14T20:30:00-04:00,1.0907,1.09072,1.0901399999999999,1.09029,1.09096,1.0905944444444444,1.0906255555555484,1.0906399999999923,1.0905680000000033,1.0908775999999998,1.0924344000000012,1.0949145500000048,1.0905906408341872,1.0906363174942375,-960,-310657,-310130,0.003069521831610741,-289.2514779363773,-0.03759053818648771
2023-08-14T20:45:00-04:00,1.09029,1.09074,1.09023,1.09073,1.0909436,1.090615333333333,1.0906199999999928,1.0906417777777702,1.0905900000000033,1.0908485999999997,1.0923984000000013,1.0948768000000046,1.0906185126673498,1.0906362539953893,1225,-309432,-309958.2,0.005527879770191501,-288.7571140515393,-0.004583875758641111
2023-08-14T21:00:00-04:00,1.09073,1.09079,1.09042,1.09066,1.090927528,1.0906233333333333,1.0906099999999928,1.0906368888888813,1.0905880000000034,1.0908543999999998,1.0923621000000012,1.0948380500000048,1.0906268101338799,1.090631803196311,-1563,-310995,-310311.4,0.0028119250074331577,-288.85742301892816,-0.008251203300474306
2023-08-14T21:15:00-04:00,1.09066,1.09135,1.09034,1.09109,1.0901399999999999,1.0907193333333334,1.0906777777777703,1.0906408888888814,1.0906190000000033,1.0908649999999998,1.0923330000000013,1.0948014000000048,1.0907194481071039,1.090644242557048,3006,-307989,-309754,0.004226548224566108,-287.672287412965,0.05593866920988918
2023-08-14T21:30:00-04:00,1.09109,1.0911,1.09002,1.09072,1.09135,1.090727777777778,1.0907044444444371,1.0906475555555482,1.0906315000000033,1.0908761999999996,1.0923029000000013,1.0947628000000047,1.090719558485683,1.090654994045638,-4221,-312210,-310256.6,0.005335522265770003,-289.10367254159775,0.022008656738318724
2023-08-14T21:45:00-04:00,1.09072,1.09155,1.09065,1.0910199999999999,1.09002,1.0907908888888889,1.0907411111111038,1.090670666666659,1.0906545000000034,1.0909227999999997,1.0922760000000014,1.0947271000000047,1.0907796467885464,1.0906927952365097,3166,-309044,-309934,0.007885206070001642,-288.23287160276845,0.030256076428677395
2023-08-14T22:00:00-04:00,1.0910199999999999,1.09108,1.09074,1.0909,1.09002,1.0908226666666665,1.0907555555555482,1.0906977777777702,1.0906815000000034,1.0909773999999997,1.0922456000000014,1.0946911500000047,1.0908037174308371,1.090729836189207,-3006,-312050,-310457.6,0.008326060219440911,-288.5634979890856,0.011918186235408332
2023-08-14T22:15:00-04:00,1.0909,1.0913,1.09085,1.09128,1.0900506,1.0909275555555555,1.0908211111111037,1.0907399999999925,1.0907175000000033,1.0910399999999998,1.0922222000000013,1.0946551500000046,1.0908989739446697,1.0907842689513652,2180,-309870,-310232.6,0.008984973091180787,-287.80412499431054,0.0540941972512896
2023-08-14T22:30:00-04:00,1.09128,1.09174,1.09128,1.09144,1.0900805880000002,1.0910513333333334,1.090903333333326,1.0907851111111035,1.0907615000000033,1.0910791999999998,1.0921997000000014,1.0946186000000047,1.0910071791557359,1.0908418151610917,1721,-308149,-310264.6,0.012018795248088226,-287.5517974523416,0.0678463372146294
2023-08-14T22:45:00-04:00,1.09144,1.09147,1.09094,1.09096,1.0901469644800001,1.0910626666666667,1.0909777777777705,1.0908397777777703,1.0907855000000033,1.0911072,1.0921733000000016,1.0945794000000049,1.0909977433245888,1.0908974521288726,-1591,-309740,-309770.6,0.012655967666641595,-288.2514969319282,0.06145154041584793
2023-08-14T23:00:00-04:00,1.09096,1.0914,1.09093,1.09138,1.0902106859008,1.091143111111111,1.0910499999999927,1.0909015555555481,1.0908255000000033,1.0911293999999998,1.0921527000000013,1.0945414500000048,1.091074194659671,1.0909563617030975,1500,-308240,-309609.8,0.018719095267254807,-287.67402388067046,0.05959311653663505
2023-08-14T23:15:00-04:00,1.09138,1.09174,1.09132,1.09172,1.0902718584647682,1.091277111111111,1.0911677777777704,1.0909839999999924,1.0908765000000034,1.0911574,1.0921377000000012,1.0945055000000048,1.0912033557277367,1.0910362893624774,1521,-306719,-308543.6,0.022817127294670173,-287.20018342180185,0.09718885812261024
2023-08-14T23:30:00-04:00,1.09172,1.09175,1.09134,1.09135,1.0903305841261774,1.0913135555555553,1.0911966666666593,1.0910591111111034,1.0909050000000033,1.0911704,1.0921175000000014,1.0944670000000045,1.0912326845821894,1.0911030314899814,-1404,-308123,-308194.2,0.02630421041995474,-287.6760197168225,0.023829381627560424
2023-08-14T23:45:00-04:00,1.09135,1.09146,1.09122,1.09145,1.0904157490786068,1.0913642222222224,1.0912777777777702,1.0911339999999923,1.0909400000000034,1.0911597999999998,1.0921016000000014,1.0944270500000046,1.0912761476657515,1.0911568251919843,1069,-307054,-307975.2,0.0266788304442978,-287.5780676391206,0.06692826756638913
2023-08-15T00:00:00-04:00,1.09145,1.09147,1.09117,1.09126,1.0904958041338904,1.0913606666666666,1.0913044444444369,1.0911993333333254,1.0909790000000035,1.0911396,1.0920833000000014,1.0943871000000047,1.0912729181326013,1.091211860153587,-1332,-308386,-307704.4,0.029401930855066503,-287.8099426677524,0.02199776356070631
2023-08-15T00:15:00-04:00,1.09126,1.0914,1.0912,1.09135,1.090571055885857,1.0913697777777778,1.091354444444437,1.0912602222222145,1.0910225000000033,1.0911254,1.0920646000000014,1.0943502000000047,1.091288334506081,1.091254688122869,934,-307452,-307546.8,0.028628257342931163,-287.732912445807,0.04125034375287024
2023-08-15T00:30:00-04:00,1.09135,1.09139,1.0910199999999999,1.09113,1.0906417925327057,1.091324888888889,1.0913377777777702,1.0912942222222144,1.0910445000000035,1.0910944,1.0920453000000014,1.0943112500000047,1.091256667604865,1.0912653504982948,-971,-308423,-307887.6,0.027898556101578872,-287.9286516678715,-0.013745326588968413
2023-08-15T00:45:00-04:00,1.09113,1.09126,1.09098,1.091,1.0907082849807432,1.0912573333333333,1.0912888888888814,1.0913126666666586,1.0910560000000034,1.091057,1.0920233000000015,1.0942719500000049,1.0912053340838919,1.0912598803986353,-1074,-309497,-308162.4,0.023978816239320168,-288.0566107561561,-0.040313713992523266
2023-08-15T01:00:00-04:00,1.091,1.09101,1.0907,1.0909,1.09175,1.0911795555555555,1.0912822222222145,1.0913135555555475,1.0910665000000033,1.0910134,1.0919973000000014,1.0942317500000047,1.0911442672671134,1.0912335043189074,-1376,-310873,-308926.2,0.018461925225529443,-288.18273357925415,-0.005499743345305876
2023-08-15T01:15:00-04:00,1.0909,1.09141,1.09088,1.091,1.091729,1.0911231111111113,1.0912399999999924,1.0913006666666587,1.0910815000000036,1.0909765999999999,1.0919734000000014,1.0941915500000048,1.0911154138136907,1.0912020034551255,1576,-309297,-309108.4,0.017475306963808283,-288.0382657086886,-0.03481830343235601
2023-08-15T01:30:00-04:00,1.091,1.09107,1.09061,1.09078,1.09170842,1.091031111111111,1.0911355555555482,1.091256888888881,1.0911060000000035,1.0909402,1.0919464000000014,1.0941521000000047,1.0910483310509527,1.0911540027640998,-1619,-310916,-309801.2,0.011626886914372104,-288.3647368360945,-0.08610266368665416
2023-08-15T01:45:00-04:00,1.09078,1.09138,1.09076,1.09117,1.0916644832,1.091038,1.091115555555548,1.0912124444444367,1.0911280000000034,1.0909184,1.0919226000000013,1.0941143500000046,1.091072664840762,1.0911172022112792,1768,-309148,-309946.2,0.002745131755657723,-287.7326020334764,-0.016493333944203874
2023-08-15T02:00:00-04:00,1.09117,1.09188,1.09101,1.09156,1.09061,1.0911268888888888,1.0911277777777704,1.0911802222222142,1.0911730000000035,1.0909094000000001,1.0919028000000013,1.0940796500000045,1.0911701318726097,1.0911101617690229,6672,-302476,-308542,0.0010473891210318873,-285.34793236697095,0.010078336158326491
2023-08-15T02:15:00-04:00,1.09156,1.09236,1.09112,1.092,1.0906354,1.0913013333333335,1.0912099999999925,1.09116577777777,1.0912185000000034,1.0909148,1.0918859000000014,1.0940471500000046,1.0913361054980877,1.0911485294152174,3479,-298997,-306166.8,0.0002400126379759355,-283.94557244172637,0.06781152062754843
2023-08-15T02:30:00-04:00,1.092,1.09231,1.09173,1.09179,1.0907043840000001,1.0914173333333335,1.0912588888888815,1.0911695555555476,1.0912720000000036,1.0909155999999998,1.0918652000000013,1.0940118500000047,1.0914268843984702,1.0912108235321734,-3421,-302418,-304791,0.002042226970211222,-284.60345705711114,0.040317038530260314
2023-08-15T02:45:00-04:00,1.09179,1.09263,1.09179,1.09234,1.0907706086400002,1.0916335555555556,1.091393333333326,1.0912211111111032,1.0913380000000035,1.09093,1.0918513000000014,1.0939809000000047,1.0916095075187762,1.091323058825738,2941,-299477,-302503.2,0.0040448944009976884,-283.1218992483749,0.11089421058903663
2023-08-15T03:00:00-04:00,1.09234,1.09306,1.09216,1.09261,1.0908821721216002,1.091876888888889,1.0915722222222148,1.0913124444444366,1.0914235000000034,1.0909601999999998,1.0918483000000014,1.0939501500000046,1.0918096060150209,1.0914704470605898,4604,-294873,-299648.2,0.010667832493022208,-281.98390192153533,0.1475710357470313
2023-08-15T03:15:00-04:00,1.09261,1.09279,1.09172,1.09195,1.0910563983518722,1.0919524444444446,1.0916888888888814,1.091424666666659,1.0914570000000035,1.0909899999999997,1.0918312000000014,1.0939155000000045,1.0918376848120166,1.0916039576484713,-4573,-299446,-299042.2,0.014790304889931546,-284.7462599449842,0.09625080209001699
2023-08-15T03:30:00-04:00,1.09195,1.0926,1.09154,1.09238,1.0912166864837225,1.0920906666666668,1.0918422222222146,1.0915511111111031,1.0915040000000036,1.0910262,1.0918240000000015,1.0938831500000046,1.0919461478496133,1.0917259661187764,5414,-294032,-298049.2,0.02354992164592231,-282.6142758797801,0.12648945921172658
2023-08-15T03:45:00-04:00,1.09238,1.09285,1.09222,1.09235,1.0913641515650248,1.0921922222222222,1.0920166666666593,1.0917026666666587,1.0915735000000035,1.0910571999999998,1.0918155000000014,1.0938483000000045,1.0920269182796907,1.0918459728950203,-4055,-298087,-297183,0.03194687474254854,-282.72563822621623,0.14393369882101334
2023-08-15T04:00:00-04:00,1.09235,1.0926,1.09183,1.09231,1.0914998194398227,1.0922508888888889,1.092143333333326,1.0918526666666586,1.0916200000000036,1.0910787999999998,1.0917970000000015,1.0938118500000045,1.0920835346237525,1.0919407783160158,-4516,-302603,-297808.2,0.04007192531097248,-282.8910064689957,0.1044750130593692
2023-08-15T04:15:00-04:00,1.09231,1.09247,1.09184,1.09204,1.091624633884637,1.0922302222222224,1.0921966666666592,1.0919775555555475,1.0916360000000034,1.0911137999999998,1.0917727000000013,1.0937735500000045,1.092074827699002,1.0919938226528116,-3918,-306521,-300137.8,0.04516140852320737,-283.8594678032323,0.0439737623217976
2023-08-15T04:30:00-04:00,1.09204,1.09308,1.09177,1.09305,1.091739463173866,1.092400888888889,1.0923133333333257,1.0921024444444363,1.0917210000000035,1.0911608,1.0917571000000015,1.0937418000000045,1.0922698621592015,1.0920802581222488,4133,-302388,-300726.2,0.053005853238766776,-280.03696130163826,0.09615384615384573
2023-08-15T04:45:00-04:00,1.09305,1.09344,1.0927499999999999,1.09277,1.09177,1.0924922222222222,1.0924222222222146,1.0922184444444363,1.0917870000000034,1.0912068,1.0917328000000015,1.0937102000000045,1.0923698897273613,1.0921650064977986,-3136,-305524,-303024.6,0.05386181211064875,-280.84029143292247,0.0897608514457891
2023-08-15T05:00:00-04:00,1.09277,1.09301,1.0923,1.0923,1.09177,1.0924677777777776,1.0924177777777702,1.0922986666666585,1.0918390000000033,1.0912434,1.0917038000000014,1.0936754000000046,1.092355911781889,1.0922308051982381,-3149,-308673,-305141.8,0.05482370058693067,-282.1946752465337,-0.003661863522350184
2023-08-15T05:15:00-04:00,1.0923,1.09295,1.09213,1.09279,1.0919704,1.0925422222222223,1.0924377777777703,1.0923575555555474,1.0919110000000036,1.0912879999999998,1.0916775000000014,1.0936414000000045,1.0924427294255112,1.09230264415859,3036,-305637,-305748.6,0.052268751660220956,-280.8327417117908,0.01647431379905428
2023-08-15T05:30:00-04:00,1.09279,1.09379,1.09271,1.09359,1.09213,1.0927726666666666,1.0926199999999924,1.092442222222214,1.0920340000000035,1.0913525999999998,1.0916543000000016,1.0936107000000046,1.092672183540409,1.0924221153268714,3022,-302615,-304967.4,0.05146998863174953,-278.62042278500667,0.15019002701589687
2023-08-15T05:45:00-04:00,1.09359,1.09448,1.09358,1.09402,1.09213,1.0930526666666667,1.092802222222215,1.0925399999999919,1.0921850000000035,1.0914218,1.0916483000000015,1.0935846000000047,1.0929417468323273,1.0925564922614965,3568,-299047,-304299.2,0.057816321992687436,-277.21748384079564,0.1501309068273024
2023-08-15T06:00:00-04:00,1.09402,1.09428,1.09372,1.09406,1.092506,1.0933042222222222,1.092992222222215,1.092653999999992,1.0923430000000036,1.0914917999999998,1.0916379000000016,1.0935570000000048,1.0931653974658617,1.0927155938091966,3654,-295393,-302273,0.05984891288450873,-277.0838848206679,0.1565432324804413
2023-08-15T06:15:00-04:00,1.09406,1.09416,1.09346,1.09353,1.09282184,1.0934117777777779,1.0931277777777706,1.0927959999999919,1.0924695000000035,1.0915527999999999,1.0916243000000017,1.0935266000000048,1.0932383179726894,1.0928920750473567,-3435,-298828,-300304,0.05917946469113395,-278.7479160438188,0.11168990488048255
2023-08-15T06:30:00-04:00,1.09353,1.09374,1.09327,1.09367,1.0930871456,1.0935202222222222,1.0933088888888818,1.0929702222222142,1.0926140000000035,1.0916146,1.0916139000000016,1.0934938500000047,1.0933246543781516,1.0930684600378848,3022,-295806,-298337.8,0.05998328034734009,-278.3610222228902,0.14926193179737193
2023-08-15T06:45:00-04:00,1.09367,1.09374,1.09332,1.09349,1.09327,1.0935564444444443,1.0933577777777705,1.0931177777777699,1.0927300000000035,1.0916704,1.0915992000000017,1.0934616000000046,1.0933577235025214,1.0932055680303072,-2577,-298383,-297491.4,0.061436160129118816,-278.785153816515,0.04025433420246063
2023-08-15T07:00:00-04:00,1.09349,1.09349,1.09278,1.09335,1.09448,1.093554888888889,1.0934222222222152,1.0932417777777699,1.0928195000000036,1.0917218,1.0915823000000016,1.0934300000000046,1.0933561788020172,1.0932884544242452,-2903,-301286,-297939.2,0.054675907870023875,-279.1568261683427,0.053076127638938195
2023-08-15T07:15:00-04:00,1.09335,1.09354,1.09313,1.09347,1.0944459999999998,1.0935644444444443,1.0935522222222152,1.0933537777777698,1.0928930000000037,1.0917762,1.0915689000000015,1.0934042500000045,1.0933789430416136,1.0933311635393959,2196,-299090,-298678.6,0.05275413444812994,-278.9158054521953,0.10711343037626049
2023-08-15T07:30:00-04:00,1.09347,1.09361,1.09324,1.09337,1.0944126799999998,1.093528,1.0936166666666596,1.0934515555555475,1.0929720000000036,1.091834,1.0915534000000016,1.0933801500000044,1.0933771544332909,1.093358930831516,-2069,-301159,-299144.8,0.05657213142850127,-279.10501960530416,0.05307515625143211
2023-08-15T07:45:00-04:00,1.09337,1.09347,1.09266,1.0929,1.0943800263999999,1.0933846666666667,1.0935399999999929,1.0934977777777697,1.0930000000000037,1.0918824,1.0915374000000018,1.0933560000000044,1.0932817235466328,1.0933503446652122,-2742,-303901,-300763.8,0.05273972065616832,-280.2837056859538,-0.06309494417469796
2023-08-15T08:00:00-04:00,1.0929,1.093,1.09234,1.09249,1.094311225344,1.0931746666666666,1.0933699999999928,1.093500222222214,1.0929940000000038,1.0919184,1.0915221000000017,1.0933252000000047,1.0931233788373063,1.0933034757321693,-3563,-307464,-302580,0.042021584586516975,-281.6203604576622,-0.1398511910202767
2023-08-15T08:15:00-04:00,1.09249,1.09286,1.0921399999999999,1.09228,1.09419295182336,1.0929566666666668,1.093172222222215,1.0934502222222142,1.0930105000000037,1.0919486,1.0915056000000016,1.0932908000000046,1.092954703069845,1.0932231805857346,-3634,-311098,-304542.4,0.02753989167058,-282.31889316734384,-0.16269674423707245
2023-08-15T08:30:00-04:00,1.09228,1.09257,1.08964,1.09222,1.094028715677491,1.092766222222222,1.0930266666666595,1.0933451111111032,1.0930025000000037,1.0919792,1.0914890000000017,1.0932551000000046,1.092807762455876,1.0931089444685873,-17054,-328152,-310354.8,0.009528402875256445,-283.25568593110324,-0.11979552458550954
2023-08-15T08:45:00-04:00,1.09222,1.09325,1.0919,1.0922,1.093589844109742,1.0926008888888887,1.0928633333333262,1.0931944444444366,1.0929950000000037,1.0920092,1.0914719000000017,1.0932195500000046,1.0926862099647008,1.0929707555748691,-10379,-338531,-317829.2,-0.001856027186631541,-283.4457392170704,-0.13440983111906338
2023-08-15T09:00:00-04:00,1.0922,1.09493,1.09168,1.09469,1.08964,1.0929662222222223,1.0929966666666595,1.0930857777777698,1.0931140000000037,1.0920972,1.0914874000000017,1.0931972500000047,1.0930869679717605,1.0929318044598948,10287,-328244,-322697.8,-0.002718410566000107,-259.9934136356762,0.10974037256855278
2023-08-15T09:15:00-04:00,1.09469,1.09524,1.09399,1.0941,1.0897458,1.093186888888889,1.093079999999993,1.0930277777777697,1.0932170000000037,1.0921646,1.0915066000000015,1.0931708500000046,1.0932895743774085,1.092965043567915,-8704,-336948,-328594.6,-0.0049354471390518715,-264.68456820911604,0.06859651529702551
2023-08-15T09:30:00-04:00,1.0941,1.0942399999999999,1.0930199999999999,1.0939,1.089965568,1.0933508888888888,1.0931277777777708,1.093018888888881,1.0932595000000036,1.0922294,1.0915419000000015,1.0931399500000045,1.0934116595019268,1.0930564348543315,-9713,-346661,-335707.2,-0.008005840168679435,-266.4600914702437,0.0393243527486033
2023-08-15T09:45:00-04:00,1.0939,1.09446,1.09343,1.09401,1.09017654528,1.0935273333333333,1.0931988888888817,1.0930533333333254,1.0933215000000036,1.0922878,1.0915764000000017,1.0931113500000047,1.0935313276015415,1.0932011478834647,8047,-338614,-337799.6,-0.007247639290327275,-265.6509041587905,0.05853462231449317
2023-08-15T10:00:00-04:00,1.09401,1.09433,1.0924,1.09252,1.0903790834688,1.0933915555555556,1.0931566666666594,1.093111999999992,1.0933325000000036,1.0923238,1.0916000000000015,1.0930744500000045,1.0933290620812333,1.0933297183067712,-9738,-348352,-339763.8,-0.013933564034694753,-278.91368969091536,-0.03476987830543023
2023-08-15T10:15:00-04:00,1.09252,1.09355,1.09246,1.09332,1.0905735201300482,1.0934242222222221,1.0932488888888818,1.0931624444444366,1.0933590000000035,1.0923698,1.0916463000000016,1.0930400500000046,1.0933272496649866,1.0933777746454163,6561,-341791,-342473.2,-0.014533991115604768,-274.1093840489126,0.07597323545296601
2023-08-15T10:30:00-04:00,1.09332,1.09404,1.0931899999999999,1.09347,1.0907601793248463,1.0934684444444445,1.0933811111111043,1.0932226666666587,1.0933530000000036,1.0924212,1.0916993000000015,1.0930165000000045,1.0933557997319894,1.0933910197163326,6555,-335236,-342130.8,-0.008531988423446569,-273.2100590571452,0.10894642399384998
2023-08-15T10:45:00-04:00,1.09347,1.09474,1.09339,1.09409,1.0909393721518523,1.0936102222222222,1.093588888888882,1.093314888888881,1.0933565000000036,1.0924774000000002,1.0917587000000015,1.0930028500000046,1.0935026397855916,1.0934092157730653,6733,-328503,-338499.2,0.005844654993579814,-269.3924326019151,0.17121092820128164
2023-08-15T11:00:00-04:00,1.09409,1.09445,1.09354,1.09357,1.0911113972657782,1.0936064444444444,1.0937411111111042,1.0934233333333256,1.0933320000000035,1.0925200000000002,1.0917996000000016,1.0929850000000045,1.0935161118284733,1.0934061726184519,-5500,-334003,-337577,0.02015182463975062,-272.006477150353,0.12543490203258298
2023-08-15T11:15:00-04:00,1.09357,1.09362,1.09233,1.0927,1.091276541375147,1.0933982222222223,1.0935199999999932,1.0934959999999925,1.0932905000000035,1.0925548000000003,1.0918310000000016,1.0929662000000047,1.0933528894627786,1.093410938094761,-4578,-338581,-335622.8,0.030649835753355087,-275.64854853124285,-0.18178662452383199
2023-08-15T11:30:00-04:00,1.0927,1.09304,1.09248,1.09294,1.091435079720141,1.0932822222222223,1.093391111111104,1.0935244444444367,1.0932540000000033,1.092586,1.0918577000000014,1.0929489500000045,1.093270311570223,1.093399550475808,3332,-335249,-334314.4,0.017213480699321455,-274.91670996622037,-0.10602321542821039
2023-08-15T11:45:00-04:00,1.09294,1.09312,1.09259,1.09269,1.0915872765313355,1.093142,1.0932566666666599,1.0934995555555478,1.0932140000000032,1.0926054,1.0918814000000017,1.0929310500000045,1.0931542492561783,1.0933592403806458,-3188,-338437,-334954.6,0.008585328627535159,-275.6459357242677,-0.1106134015906532
2023-08-15T12:00:00-04:00,1.09269,1.09287,1.09205,1.09225,1.0917333854700821,1.0929406666666668,1.0930611111111042,1.0933939999999924,1.0931590000000033,1.0926234000000001,1.0918969000000016,1.0929105500000045,1.0929733994049426,1.0932533923045162,-3149,-341586,-337571.2,-0.0011064389955519208,-276.9139623374883,-0.16087604318059104
2023-08-15T12:15:00-04:00,1.09225,1.09265,1.09204,1.09205,1.091873650051279,1.0927384444444446,1.0930088888888823,1.0932475555555479,1.0930880000000034,1.0926354000000003,1.0918976000000016,1.0928826500000044,1.092788719523954,1.0931079138436122,-2604,-344190,-339608.6,-0.013373858593210216,-277.3907762537162,-0.04301980741771047
2023-08-15T12:30:00-04:00,1.09205,1.09216,1.0916,1.0917999999999999,1.09524,1.0924966666666667,1.0928399999999934,1.093111555555548,1.0930095000000033,1.0926462000000001,1.0918929000000017,1.0928518500000044,1.0925909756191632,1.0929555310748893,-2608,-346798,-341252,-0.01268648523342523,-277.98781851368614,-0.13902608568398894
2023-08-15T12:45:00-04:00,1.0917999999999999,1.09201,1.09149,1.09177,1.0951672,1.0922826666666665,1.0926511111111046,1.092963555555548,1.0929530000000034,1.0926546000000001,1.0918900000000018,1.0928246000000046,1.0924267804953305,1.0927868248599109,-1985,-348783,-343958.8,-0.019898082777881496,-278.04236147027154,-0.15546837133163552
2023-08-15T13:00:00-04:00,1.09177,1.09196,1.09157,1.09165,1.0950201119999998,1.0920824444444444,1.0923799999999935,1.0927882222222147,1.0929110000000033,1.0926650000000002,1.0918797000000018,1.0928018000000046,1.0922714243962643,1.092610259887928,-2243,-351026,-346476.6,-0.031105791498189102,-278.28889691271803,-0.223016388048515
2023-08-15T13:15:00-04:00,1.09165,1.09208,1.09157,1.09207,1.0948789075199998,1.0920204444444443,1.0922133333333268,1.092618666666659,1.0929005000000034,1.0926864000000003,1.0918717000000018,1.0927826000000045,1.0922311395170115,1.0924618079103416,1985,-349041,-347967.6,-0.04775974508360184,-277.5251905965909,-0.13716543065371534
2023-08-15T13:30:00-04:00,1.09207,1.09211,1.0916299999999999,1.09182,1.0947433512191997,1.0919417777777776,1.0921155555555488,1.0924399999999923,1.0928805000000033,1.0927048000000001,1.0918591000000017,1.0927653000000044,1.0921489116136092,1.0923338463282726,-1847,-350888,-349307.2,-0.06176952073260575,-277.9480114780364,-0.08053445593483956
2023-08-15T13:45:00-04:00,1.09182,1.09208,1.09168,1.09175,1.0946132171704317,1.0918686666666666,1.0919833333333266,1.092268666666659,1.0928580000000032,1.0927198000000002,1.0918482000000018,1.0927459500000043,1.0920691292908873,1.0922294770626173,-2052,-352940,-350535.6,-0.0684158512479089,-278.07957162531346,-0.10888063388658338
2023-08-15T14:00:00-04:00,1.09175,1.09181,1.09138,1.09141,1.0944882884836145,1.0917540000000001,1.0918411111111044,1.0921066666666592,1.0926940000000032,1.0927324000000003,1.091836300000002,1.0927216000000042,1.0919373034327098,1.0921315816500932,-1453,-354393,-351657.6,-0.07897659854162908,-278.5320744876904,-0.1171420988569446
2023-08-15T14:15:00-04:00,1.09141,1.09158,1.09132,1.09147,1.0943017911745976,1.0916797777777778,1.0917544444444376,1.0919815555555479,1.0925625000000032,1.0927384000000002,1.091828400000002,1.0926988500000043,1.0918438427461679,1.0920460653200739,1381,-353012,-352054.8,-0.07611999816932848,-278.4561543476881,-0.07141222247653953
2023-08-15T14:30:00-04:00,1.09147,1.09193,1.09135,1.09143,1.0940632478806298,1.0916148888888888,1.091685555555549,1.0918759999999925,1.092439000000003,1.0927358000000003,1.091822600000002,1.0926793000000043,1.0917610741969344,1.0919520522560586,-1533,-354545,-353155.6,-0.07199681990049143,-278.5123354612323,-0.05677395723639622
2023-08-15T14:45:00-04:00,1.09143,1.09145,1.09034,1.09042,1.0938437880501795,1.0913617777777778,1.0915322222222155,1.0917593333333255,1.092259500000003,1.0927042000000002,1.0918095000000019,1.0926581500000045,1.0914928593575475,1.091820841804846,-2380,-356925,-354363,-0.07175925925901265,-280.714767133442,-0.12639677596628843
2023-08-15T15:00:00-04:00,1.09042,1.09064,1.09027,1.09027,1.0934934092451616,1.0911093333333333,1.0913655555555488,1.09163577777777,1.092147000000003,1.0926738000000003,1.091794700000002,1.0926351500000044,1.091248287486038,1.0916566734438764,-1844,-358769,-355528.8,-0.06947320873418587,-280.9684308593456,-0.13739157514859676
2023-08-15T15:15:00-04:00,1.09027,1.09044,1.09002,1.09011,1.0931066001357421,1.0908582222222223,1.0911944444444375,1.0915064444444367,1.091986500000003,1.0926292000000004,1.091779600000002,1.0926089000000045,1.0910206299888305,1.0914733387551006,-1334,-360103,-356670.8,-0.07417242800213474,-281.16419888011126,-0.14107085604361258
2023-08-15T15:30:00-04:00,1.09011,1.09021,1.0899,1.09012,1.0926744761167382,1.0906433333333334,1.0909777777777707,1.0913511111111034,1.091819000000003,1.0925794000000004,1.091769800000002,1.0925870000000044,1.0908405039910645,1.0912726710040799,2142,-357961,-357660.6,-0.07423947387333996,-281.1445494869306,-0.17855998241872023
2023-08-15T15:45:00-04:00,1.09012,1.09061,1.08993,1.09059,1.0922305599380602,1.0905657777777775,1.0908411111111043,1.0911822222222143,1.091644000000003,1.0925522000000003,1.0917711000000019,1.0925674000000045,1.0907904031928515,1.0910785368032632,2200,-355761,-357903.8,-0.07524326153845279,-280.19603005787695,-0.1126559322965383
2023-08-15T16:00:00-04:00,1.09059,1.09059,1.09036,1.09043,1.0918576703479705,1.0904835555555554,1.0906944444444375,1.0910146666666587,1.091487000000003,1.0925132000000004,1.0917697000000022,1.0925472500000044,1.0907183225542811,1.09092362944261,-1087,-356848,-357888.4,-0.0720227576206968,-280.3555033704875,-0.12090680100755556
2023-08-15T16:15:00-04:00,1.09043,1.09049,1.09023,1.09047,1.0915444430922954,1.0904386666666668,1.0905899999999933,1.0908595555555478,1.091375500000003,1.0924756000000004,1.091766400000002,1.0925256000000045,1.0906686580434248,1.0908077035540873,545,-356303,-357395.2,-0.07023495857997512,-280.33551125728445,-0.08612711996407774
2023-08-15T16:30:00-04:00,1.09047,1.09048,1.0903,1.09033,1.091281332197528,1.0903866666666666,1.0904633333333265,1.0907133333333257,1.091245000000003,1.0924360000000002,1.091757400000002,1.0925026000000044,1.0906009264347398,1.090723762843269,-411,-356714,-356717.4,-0.06979715365822307,-280.38827749569543,-0.10444629719551787
2023-08-15T16:45:00-04:00,1.09033,1.09048,1.0901399999999999,1.0901399999999999,1.0910603190459236,1.090322,1.0903199999999933,1.09058177777777,1.091117500000003,1.0923980000000002,1.091755900000002,1.0924779500000044,1.0905087411477918,1.0906574102746145,-1204,-357918,-356708.8,-0.06977513458387764,-280.5980855354634,-0.11819356257387222
2023-08-15T17:00:00-04:00,1.0901399999999999,1.0906,1.0901399999999999,1.09048,1.090874667998576,1.0903539999999998,1.0903266666666598,1.090478888888881,1.0910290000000031,1.0923466000000004,1.091753700000002,1.0924571000000045,1.0905029929182335,1.090599928219691,96,-357822,-357121,-0.06884352565765987,-280.5681444269819,0.0055024669393397944
2023-08-15T17:15:00-04:00,1.09048,1.09054,1.09021,1.0904,1.0907187211188039,1.0903686666666665,1.090341111111104,1.0904082222222145,1.0909465000000031,1.0922992000000002,1.091753000000002,1.0924356000000044,1.0904823943345867,1.090552742575752,-459,-358281,-357407.6,-0.06095767182349424,-280.6018176717915,0.011923651939424497
2023-08-15T17:30:00-04:00,1.0904,1.09066,1.09024,1.0903,1.0899,1.0903604444444446,1.0903622222222156,1.0903626666666588,1.090871500000003,1.0922592000000002,1.091751300000002,1.0924136500000046,1.0904459154676693,1.090508194060601,-545,-358826,-357912.2,-0.05304848744346617,-280.6517993298986,0.01742943372688394
2023-08-15T17:45:00-04:00,1.0903,1.0905,1.09029,1.09043,1.0899152,1.0903740000000002,1.0903966666666598,1.0903493333333254,1.090804500000003,1.0922120000000004,1.091750000000002,1.0923924500000044,1.0904427323741355,1.09047655524848,717,-358109,-358191.2,-0.04413768898512182,-280.5663090978524,0.028437236267569853
2023-08-15T18:00:00-04:00,1.09043,1.0906,1.09038,1.09042,1.089930096,1.0903786666666666,1.0903777777777708,1.0903608888888807,1.090743000000003,1.0921486000000005,1.091750600000002,1.0923716000000043,1.0904381858993084,1.0904624441987836,-399,-358508,-358309.2,-0.035496459303249676,-280.56996820481027,-0.015587892791975306
2023-08-15T18:15:00-04:00,1.09042,1.09051,1.09034,1.09035,1.08994469408,1.090373111111111,1.0903688888888818,1.0903693333333253,1.090657000000003,1.0920752000000005,1.091748500000002,1.0923497500000046,1.0904205487194467,1.090445955359026,-444,-358952,-358535.2,-0.032023282039082515,-280.59847098355607,-0.007336555303878287
2023-08-15T18:30:00-04:00,1.09035,1.09047,1.09021,1.09023,1.0899590001983999,1.0903453333333333,1.0903422222222152,1.0903695555555475,1.090577500000003,1.0919986000000004,1.091745200000002,1.0923265500000046,1.0903824389755574,1.0904259642872203,-388,-359340,-358747,-0.025825893743803424,-280.64117286827195,-0.02200885856557429
2023-08-15T18:45:00-04:00,1.09023,1.09035,1.09022,1.09031,1.0899730201944318,1.090338888888889,1.090339999999993,1.090365111111103,1.090505500000003,1.0919342000000005,1.091743500000002,1.0923058500000045,1.0903679511804458,1.0904103714297757,366,-358974,-358776.6,-0.02070137534655814,-280.61431614996485,-0.001834307044668222
2023-08-15T19:00:00-04:00,1.09031,1.09035,1.09018,1.09034,1.089986759790543,1.090338888888889,1.0903622222222151,1.090358222222214,1.090452000000003,1.0918676000000005,1.0917411000000021,1.0922818000000045,1.0903623609443567,1.09039429714382,483,-358491,-358853,-0.01445386444347488,-280.60102635165055,0.018346267451905263
2023-08-15T19:15:00-04:00,1.09034,1.09043,1.09026,1.09026,1.0900002245947322,1.0903184444444445,1.0903377777777705,1.090350222222214,1.090391500000003,1.0918030000000005,1.091736700000002,1.0922578500000044,1.0903418887554854,1.0903750377150554,-365,-358856,-358922.6,-0.008332132423009822,-280.627806988883,-0.020174602010113618
2023-08-15T19:30:00-04:00,1.09026,1.09042,1.09015,1.09038,1.0900134201028375,1.090326888888889,1.0903355555555483,1.0903435555555472,1.090339000000003,1.0917436000000003,1.091732700000002,1.0922347500000043,1.0903495110043884,1.0903608301720435,588,-358268,-358785.8,-0.004489433890002106,-280.56308848137104,-0.0018341892883465723
2023-08-15T19:45:00-04:00,1.09038,1.09049,1.09035,1.09039,1.0900263517007809,1.0903377777777779,1.0903455555555484,1.0903442222222137,1.090337500000003,1.0916820000000005,1.091729100000002,1.0922132000000042,1.0903576088035107,1.0903558641376343,725,-357543,-358426.4,-0.00003930616728604666,-280.55643942324446,0.008254608823252635
2023-08-15T20:00:00-04:00,1.09039,1.09044,1.09008,1.09042,1.0900390246667653,1.0903526666666667,1.0903444444444372,1.0903451111111027,1.090345000000003,1.0916230000000005,1.0917285000000019,1.0921924000000045,1.0903700870428086,1.090356291310107,1577,-355966,-357824.8,0.001061266523586159,-280.5130512777186,-0.0009170694129898766
2023-08-15T20:15:00-04:00,1.09042,1.09052,1.09027,1.09028,1.09005144417343,1.0903397777777777,1.0903288888888816,1.090338444444436,1.090353500000003,1.0915706000000005,1.091726500000002,1.0921719000000043,1.0903520696342468,1.0903542330480849,-1181,-357147,-357556,-0.00035812270307020335,-280.6646809250105,-0.012839089525139763
2023-08-15T20:30:00-04:00,1.09028,1.09038,1.08988,1.09022,1.09066,1.090318,1.090314444444437,1.090333777777769,1.090358500000003,1.0915252000000004,1.091721800000002,1.0921522000000043,1.0903256557073975,1.0903509864384673,-1737,-358884,-357561.6,-0.002672805384146584,-280.76027104864835,-0.011922777089921904
2023-08-15T20:45:00-04:00,1.09022,1.0904099999999999,1.09011,1.0903,1.0906444,1.0903151111111111,1.090322222222215,1.0903311111111027,1.0903440000000029,1.0914856000000004,1.091717100000002,1.0921325500000043,1.090320524565918,1.0903451891507732,1402,-357482,-357404.4,-0.00391746337015775,-280.6573927305106,0.006420663529715243
2023-08-15T21:00:00-04:00,1.0903,1.0904099999999999,1.09008,1.09019,1.090629112,1.0902886666666667,1.0903088888888817,1.0903237777777692,1.090332000000003,1.0914450000000004,1.0917121000000019,1.0921122000000043,1.0902944196527344,1.090332551320618,-2009,-359491,-357794,-0.0025374425633555853,-280.86008006427204,-0.011006044152571101
2023-08-15T21:15:00-04:00,1.09019,1.09079,1.0899,1.09079,1.08988,1.0903848888888887,1.0903588888888818,1.0903266666666582,1.0903480000000028,1.0914168000000004,1.091713000000002,1.0920942500000042,1.0903935357221874,1.0903372410564938,2267,-357224,-358045.6,0.00029260925812778953,-279.6124076401993,0.041271529981458936
2023-08-15T21:30:00-04:00,1.09079,1.09105,1.0905799999999999,1.09092,1.0898982,1.090497111111111,1.090432222222215,1.0903473333333247,1.0903775000000029,1.0913414000000006,1.0917193000000018,1.0920768500000042,1.09049882857775,1.0903665928451942,3244,-353980,-357412.2,0.003646625801405037,-279.2257887676392,0.06053601893125336
2023-08-15T21:45:00-04:00,1.09092,1.0912,1.09055,1.09059,1.0899,1.0905286666666667,1.0904555555555482,1.0903755555555468,1.090400000000003,1.0912712000000007,1.091717900000002,1.0920581500000042,1.0905170628621998,1.0904048742761547,-2663,-356643,-356964,0.005537567680431679,-280.0313382121446,0.019259340780282425
2023-08-15T22:00:00-04:00,1.09059,1.09098,1.09046,1.09095,1.0899780000000001,1.0906275555555556,1.0905177777777706,1.090414666666658,1.090423500000003,1.0912122000000006,1.0917208000000018,1.0920414500000042,1.0906036502897598,1.0904614994209232,3250,-353393,-356146.2,0.007227405623670377,-278.95852441410824,0.051357771072746077
2023-08-15T22:15:00-04:00,1.09095,1.09109,1.09067,1.0907,1.0900513200000002,1.0906639999999999,1.0905488888888817,1.090462666666658,1.0904385000000032,1.0911460000000006,1.0917169000000018,1.0920249500000043,1.0906229202318078,1.0905271995367378,-2023,-355416,-355331.2,0.009109500475599898,-279.42211119627075,0.025678179050279526
2023-08-15T22:30:00-04:00,1.0907,1.09078,1.09052,1.0905799999999999,1.0901202408000001,1.090670222222222,1.090582222222215,1.0905073333333246,1.0904525000000032,1.0911072000000006,1.0917155000000018,1.0920092000000041,1.0906143361854463,1.0905713596293896,-1801,-357217,-355329.8,0.009790670914523398,-279.6202591746335,0.02751586748357917
2023-08-15T22:45:00-04:00,1.0905799999999999,1.09069,1.09043,1.09044,1.090185026352,1.0906417777777777,1.0906066666666594,1.0905422222222134,1.0904530000000032,1.0910496000000005,1.0917097000000018,1.0919928500000042,1.090579468948357,1.090587487703511,-1623,-358840,-356301.8,0.010646525315910234,-279.8286070262351,0.020179413329429748
2023-08-15T23:00:00-04:00,1.09044,1.09087,1.09039,1.09082,1.09024592477088,1.0906844444444443,1.090664444444437,1.0905839999999913,1.0904730000000031,1.0909966000000006,1.0917089000000018,1.0919772500000042,1.0906275751586856,1.0906095901628083,2080,-356760,-356325.2,0.01444549054431162,-279.10376200954494,0.047693295423264594
2023-08-15T23:15:00-04:00,1.09082,1.09105,1.0907499999999999,1.09082,1.0903031692846272,1.0907155555555557,1.0907344444444371,1.0906273333333245,1.090496500000003,1.0909312000000004,1.0917043000000017,1.091963250000004,1.0906660601269484,1.090622072130246,0,-356760,-356998.6,0.01746703533781324,-279.10376200954494,0.0577880919839577
2023-08-15T23:30:00-04:00,1.09082,1.09085,1.0905799999999999,1.0907,1.0903569791275496,1.0907086666666665,1.0907244444444373,1.0906624444444355,1.090520000000003,1.0908738000000004,1.0916969000000016,1.0919483000000043,1.0906728481015588,1.0906320577041961,-1318,-358078,-357531,0.02061515338248936,-279.24875385054514,-0.008250900723321948
2023-08-15T23:45:00-04:00,1.0907,1.09076,1.09063,1.09065,1.0904075603798966,1.0906937777777777,1.090694444444437,1.09068488888888,1.0905370000000032,1.0908328000000005,1.0916938000000016,1.0919335500000042,1.0906682784812471,1.0906428461633564,-1034,-359112,-357910,0.017497014329275265,-279.296154602356,-0.024749752502474288
2023-08-16T00:00:00-04:00,1.09065,1.09098,1.09059,1.0909,1.0904551067571029,1.090734888888889,1.0907288888888818,1.0907093333333246,1.0905650000000031,1.0907920000000004,1.0916890000000017,1.0919208500000042,1.0907146227849978,1.0906698769306844,989,-358123,-357766.6,0.014736935870360136,-279.0694549278499,0.028424980973604425
2023-08-16T00:15:00-04:00,1.0909,1.09094,1.09074,1.09077,1.0904998003516768,1.090743111111111,1.0907088888888816,1.0907182222222134,1.0905905000000031,1.0907536000000004,1.0916795000000017,1.0919086000000042,1.0907256982279983,1.090689501544547,-993,-359116,-358237.8,0.01450960546389388,-279.18778841396227,-0.016499381273208578
2023-08-16T00:30:00-04:00,1.09077,1.0909,1.09074,1.09083,1.0905418123305761,1.0907673333333334,1.0907233333333262,1.0907159999999911,1.0906130000000032,1.0907252000000005,1.0916743000000015,1.0918959000000041,1.0907465585823986,1.090705601235637,1167,-357949,-358475.6,0.010920138464644904,-279.1235952293313,0.011918951132297009
2023-08-16T00:45:00-04:00,1.09083,1.09134,1.09074,1.09133,1.0905813035907415,1.0908886666666666,1.0908066666666594,1.0907324444444355,1.090660000000003,1.0907108000000003,1.0916731000000015,1.0918873500000041,1.0908632468659187,1.0907436809885092,1151,-356798,-358219.6,0.012548251169614293,-278.59601531312074,0.06877074584166484
2023-08-16T01:00:00-04:00,1.09133,1.09179,1.09128,1.09139,1.0906419993034822,1.0910053333333334,1.090912222222215,1.0907759999999913,1.0907085000000032,1.0907026000000004,1.0916744000000014,1.0918788500000043,1.090968597492735,1.0908037447908066,1811,-354987,-357394.6,0.015608225251174801,-278.49644872922744,0.0871207952753023
2023-08-16T01:15:00-04:00,1.09139,1.09165,1.09128,1.09158,1.09074,1.0911388888888887,1.0909966666666595,1.090829555555547,1.0907735000000032,1.0906988000000004,1.0916767000000014,1.0918706500000044,1.091090877994188,1.0908789958326446,1829,-353158,-356401.6,0.02099472839813882,-278.17803826184195,0.06967235657579564
2023-08-16T01:30:00-04:00,1.09158,1.09175,1.0914,1.09155,1.090845,1.0912495555555555,1.0910777777777707,1.0909033333333247,1.0908400000000031,1.0906968000000006,1.0916809000000014,1.0918631000000043,1.0911827023953504,1.090970396666115,-1697,-354855,-355549.4,0.022141684077885904,-278.22467707896936,0.06692213197412218
2023-08-16T01:45:00-04:00,1.09155,1.09168,1.09116,1.09159,1.0909395000000002,1.0913519999999999,1.0911766666666596,1.0909939999999914,1.0909045000000033,1.0906872000000005,1.0916868000000013,1.0918550500000044,1.0912641619162804,1.0910739173328914,2452,-352403,-354440.2,0.023218567520714863,-278.1348232014557,0.08159897313652309
2023-08-16T02:00:00-04:00,1.09159,1.09194,1.09105,1.09145,1.0910245500000002,1.0914066666666666,1.0912655555555486,1.0910857777777692,1.0909675000000032,1.0906798000000004,1.0916923000000014,1.0918448000000043,1.0913013295330243,1.0911615338663125,-5230,-357633,-354607.2,0.02507252437219958,-278.8055878658445,0.07335075413745326
2023-08-16T02:15:00-04:00,1.09145,1.09271,1.09139,1.0927,1.09105,1.0916935555555556,1.0914655555555486,1.0911964444444358,1.0910630000000032,1.0906988000000006,1.0917093000000013,1.0918413500000044,1.0915810636264194,1.0912840270930495,3695,-353938,-354397.4,0.03290408322282779,-274.5738319448221,0.16500137501146062
2023-08-16T02:30:00-04:00,1.0927,1.09271,1.0921,1.09245,1.09105,1.0918904444444444,1.0916522222222154,1.0913275555555468,1.0911395000000033,1.0907196000000006,1.0917260000000015,1.0918362000000044,1.0917548509011354,1.0914168216744389,-3443,-357381,-355242,0.039862597545555496,-275.361559591935,0.1540196375037729
2023-08-16T02:45:00-04:00,1.09245,1.0925799999999999,1.09182,1.09192,1.0912824,1.091944,1.0917733333333264,1.091466666666658,1.0912060000000035,1.0907286000000007,1.0917335000000015,1.0918280500000044,1.0917878807209083,1.0915378573395507,-2569,-359950,-356261,0.04603593063170767,-276.6079049624323,0.0999239111502283
2023-08-16T03:00:00-04:00,1.09192,1.09244,1.09165,1.0919699999999999,1.0914822640000001,1.0919833333333335,1.0918444444444375,1.0916002222222134,1.0912570000000035,1.0907394000000006,1.0917376000000014,1.0918202000000041,1.0918243045767266,1.09164988587164,4342,-355608,-356902,0.05045799697965416,-276.40908087275585,0.058644039841292184
2023-08-16T03:15:00-04:00,1.0919699999999999,1.0925799999999999,1.09188,1.0919,1.09165,1.0919944444444445,1.091901111111104,1.0917273333333246,1.0913170000000032,1.0907690000000008,1.0917366000000015,1.0918112500000041,1.0918394436613814,1.0917575086973113,-3335,-358943,-357164,0.0515337059238688,-276.6228687973319,0.04672940012278016
2023-08-16T03:30:00-04:00,1.0919,1.09244,1.09175,1.09234,1.09271,1.0920822222222222,1.0919855555555484,1.0918313333333245,1.0914050000000033,1.0908104000000007,1.0917421000000014,1.0918036500000041,1.091939554929105,1.0918292069578484,3079,-355864,-357549.2,0.05307897313483895,-275.382132466166,0.06962384800015518
2023-08-16T03:45:00-04:00,1.09234,1.09267,1.09208,1.09234,1.0926908,1.0921531111111114,1.0920733333333261,1.0919155555555466,1.0915000000000035,1.0908550000000006,1.0917421000000014,1.0917967000000042,1.092019643943284,1.091882165566278,0,-355864,-357245.8,0.05235937879053558,-275.382132466166,0.0723741468553954
2023-08-16T04:00:00-04:00,1.09234,1.09289,1.09224,1.09268,1.09175,1.0922744444444443,1.0921944444444374,1.091999777777769,1.0915930000000034,1.0909062000000007,1.0917428000000013,1.0917955500000043,1.0921517151546274,1.091954932453022,3529,-352335,-355722.8,0.052934473630733274,-274.2837015746853,0.09985434091554846
2023-08-16T04:15:00-04:00,1.09268,1.09307,1.09247,1.0929,1.0917728,1.0924155555555557,1.0923555555555486,1.0921019999999912,1.0916970000000035,1.0909524000000008,1.0917523000000013,1.0917917500000043,1.0923013721237018,1.092050345962417,2722,-349613,-354523.8,0.055856637103565025,-273.7356545709883,0.13285079481423348
2023-08-16T04:30:00-04:00,1.0929,1.09345,1.09268,1.09283,1.091824688,1.0925104444444445,1.092369999999993,1.0921957777777689,1.0918035000000035,1.0910004000000006,1.0917568000000015,1.0917904000000043,1.0924070976989615,1.0921638767699329,-3572,-353185,-353372.2,0.059724941629621,-273.96444037023804,0.011897135535825339
2023-08-16T04:45:00-04:00,1.09283,1.09293,1.09268,1.09281,1.09192220672,1.0925984444444445,1.092409999999993,1.0922806666666578,1.0919115000000035,1.0910472000000007,1.0917614000000015,1.0917884500000041,1.0924876781591693,1.092273501415946,-2271,-355456,-353290.6,0.0515245402307393,-274.00600218680586,0.03295345324730084
2023-08-16T05:00:00-04:00,1.09281,1.09315,1.09266,1.09314,1.0920138743168,1.0927444444444443,1.0925455555555486,1.0923751111111024,1.0920235000000034,1.0911034000000006,1.0917697000000015,1.0917833500000043,1.0926181425273354,1.092393201132756,2453,-353003,-352718.4,0.04697931261872121,-273.2652604293184,0.11172979705472919
2023-08-16T05:15:00-04:00,1.09314,1.09326,1.09272,1.09278,1.092100041857792,1.0927913333333334,1.0926355555555487,1.0924633333333247,1.0921240000000034,1.0911562000000006,1.0917771000000014,1.091774900000004,1.0926505140218683,1.0924929609062042,-2323,-355326,-353316.6,0.046652785802523834,-274.0302859521241,0.0741778620291949
2023-08-16T05:30:00-04:00,1.09278,1.09308,1.0924099999999999,1.09248,1.0921810393463245,1.0927602222222224,1.092699999999993,1.0925322222222136,1.0922065000000034,1.0911962000000006,1.0917714000000016,1.091764250000004,1.0926164112174945,1.0925559687249629,-2442,-357768,-354947.6,0.04386316784532394,-274.70068621567253,0.05311841743747622
2023-08-16T05:45:00-04:00,1.09248,1.09265,1.09208,1.09264,1.09345,1.0927482222222222,1.0927333333333265,1.0926048888888802,1.0922720000000035,1.0912410000000008,1.0917701000000015,1.091751450000004,1.0926211289739955,1.0925987749799695,2389,-355379,-355386.4,0.04274359467380146,-274.3508033802885,0.02746397641759589
2023-08-16T06:00:00-04:00,1.09264,1.09268,1.09222,1.09222,1.0934226,1.0926455555555554,1.0927199999999928,1.0926668888888802,1.0923135000000035,1.0912794000000008,1.0917693000000015,1.091736550000004,1.0925409031791964,1.092609419983975,-2135,-357514,-355798,0.03776322432219186,-275.17147624600835,-0.010985590567050552
2023-08-16T06:15:00-04:00,1.09222,1.09247,1.09195,1.09216,1.093395748,1.0925335555555555,1.0926622222222153,1.0926902222222137,1.0923425000000033,1.0913140000000008,1.0917630000000016,1.0917202500000043,1.092464722543357,1.0925787359871795,-2754,-360268,-357251,0.03275725496494348,-275.3227644480188,-0.047589413185935125
2023-08-16T06:30:00-04:00,1.09216,1.09227,1.09174,1.09177,1.09333791808,1.0923551111111112,1.0925366666666596,1.0926704444444357,1.0923535000000033,1.0913410000000008,1.0917448000000016,1.0916995500000042,1.0923257780346856,1.0925137887897427,-2636,-362904,-358766.6,0.0235977578426943,-276.2640551014032,-0.10339463811877349
2023-08-16T06:45:00-04:00,1.09177,1.09213,1.09157,1.09182,1.0932420429952001,1.0922117777777778,1.092424444444437,1.0926153333333246,1.0923650000000031,1.091370400000001,1.0917228000000017,1.0916855500000042,1.0922246224277485,1.0924354310317936,2496,-360408,-359294.6,0.01253330043458134,-276.1497453108793,-0.09242059606708779
2023-08-16T07:00:00-04:00,1.09182,1.09195,1.09153,1.09159,1.0931082795555842,1.092044888888889,1.0922888888888818,1.0925264444444356,1.0923720000000032,1.091397600000001,1.0916981000000014,1.0916680000000043,1.0920976979421988,1.0923307448254342,-2000,-362408,-360700.4,0.001181399797693789,-276.5710601796305,-0.11163880271959432
2023-08-16T07:15:00-04:00,1.09159,1.09179,1.09149,1.0917,1.0929504516000257,1.091927111111111,1.0921288888888818,1.0924082222222133,1.0923220000000033,1.091425400000001,1.0916798000000016,1.0916520500000042,1.092018158353759,1.0922261958603467,2158,-360250,-361247.6,-0.010070124686234319,-276.3535975792039,-0.13173061090071791
2023-08-16T07:30:00-04:00,1.0917,1.09188,1.09069,1.09087,1.0927751974080226,1.0916753333333333,1.0919166666666595,1.0922591111111024,1.0922430000000032,1.091436000000001,1.0916518000000017,1.0916328500000043,1.0917885266830072,1.0920909566882768,-2373,-362623,-361718.6,-0.022875393844974463,-278.1577470708222,-0.17478357949450743
2023-08-16T07:45:00-04:00,1.09087,1.09155,1.09065,1.09133,1.0924832697708995,1.091558,1.0917888888888816,1.0921095555555467,1.092213500000003,1.0914574000000008,1.0916302000000015,1.0916147000000043,1.0916968213464058,1.0919651653506208,2171,-360452,-361228.2,-0.03126936077851638,-277.2422759331066,-0.10526508494434539
2023-08-16T08:00:00-04:00,1.09133,1.09181,1.09104,1.09109,1.0921899466075555,1.0914182222222222,1.0916166666666594,1.091947999999991,1.0921695000000031,1.091471600000001,1.0916076000000015,1.0915949500000044,1.0915754570771246,1.091835332280496,-3284,-363736,-361893.8,-0.040378699091476615,-277.9644772837522,-0.14185825157418383
2023-08-16T08:15:00-04:00,1.09109,1.09134,1.0905799999999999,1.09082,1.0919435551503467,1.0912588888888888,1.0914611111111039,1.0917824444444357,1.0921155000000033,1.091480200000001,1.0915811000000015,1.0915750000000042,1.0914243656616995,1.0917006658243962,-3731,-367467,-362905.6,-0.052031441239740434,-278.8877466749115,-0.12817930453572246
2023-08-16T08:30:00-04:00,1.09082,1.0916,1.0905,1.0907,1.09181,1.0911066666666664,1.0912988888888817,1.0916164444444356,1.0920335000000032,1.091485800000001,1.0915544000000015,1.0915539000000043,1.0912794925293596,1.0915529326595164,-5042,-372509,-365357.4,-0.06072033283005297,-279.442411972577,-0.13368004687957963
2023-08-16T08:45:00-04:00,1.0907,1.09104,1.09022,1.09023,1.0916,1.090892888888889,1.0911277777777706,1.0914586666666577,1.0919280000000033,1.0914848000000008,1.0915277000000017,1.0915325500000044,1.0910695940234878,1.0914091461276125,-4699,-377208,-368274.4,-0.06919920282214455,-281.46728590674763,-0.14105535048589674
2023-08-16T09:00:00-04:00,1.09023,1.09105,1.08981,1.09039,1.0916,1.0907453333333332,1.0909688888888818,1.0912946666666576,1.0918135000000033,1.091488200000001,1.0915067000000016,1.091514400000004,1.0909336752187901,1.0912565169020894,4493,-372715,-370727,-0.07333959906558196,-280.8079021069992,-0.13097397006833017
2023-08-16T09:15:00-04:00,1.09039,1.09086,1.08956,1.09083,1.0912419999999998,1.0907175555555555,1.0908844444444372,1.091148222222213,1.0917100000000033,1.091498800000001,1.0914922000000018,1.0914989000000042,1.0909129401750322,1.091124013521671,6422,-366293,-371238.4,-0.07434433486986342,-278.21646234691343,-0.06962321017965481
2023-08-16T09:30:00-04:00,1.09083,1.09232,1.0907499999999999,1.09175,1.08956,1.0908906666666667,1.0908899999999928,1.091033999999991,1.0916560000000033,1.091530000000001,1.0914875000000017,1.0914882500000043,1.0910803521400256,1.0910552108173364,9331,-356962,-369137.4,-0.06786632614981096,-270.34674845932295,0.004580012824045573
2023-08-16T09:45:00-04:00,1.09175,1.09223,1.09085,1.09088,1.08956,1.0908886666666666,1.0908911111111042,1.0909524444444354,1.0915595000000033,1.0915318000000012,1.0914743000000016,1.0914731000000042,1.0910402817120206,1.0910073686538684,-7173,-364135,-367462.6,-0.06687750828802139,-276.0628098286836,0.0009166995150719621
2023-08-16T10:00:00-04:00,1.09088,1.09233,1.09065,1.09192,1.0896152000000001,1.0910944444444446,1.0909566666666595,1.0909182222222131,1.0914985000000033,1.091551800000001,1.0914466000000016,1.0914670000000042,1.0912162253696165,1.0910366949230943,6542,-357593,-363539.6,-0.05337844646707364,-269.8259368454045,0.054062474228701723
2023-08-16T10:15:00-04:00,1.09192,1.09234,1.09151,1.09153,1.089723792,1.091209111111111,1.0910055555555485,1.0909255555555464,1.0914360000000034,1.091570600000001,1.0914209000000015,1.0914637500000042,1.0912789802956933,1.0911057559384747,-5990,-363583,-361713.2,-0.04452588181377204,-271.9653792954015,0.04032664583123262
2023-08-16T10:30:00-04:00,1.09153,1.09161,1.09031,1.09057,1.08988076448,1.091122,1.0909777777777707,1.0909442222222132,1.0913405000000034,1.091563000000001,1.0913876000000016,1.0914647500000043,1.0911371842365547,1.0911506047507793,-5302,-368885,-362231.6,-0.03965218817834248,-276.6284852109505,-0.022918538347285664
2023-08-16T10:45:00-04:00,1.09057,1.09078,1.08961,1.09066,1.09234,1.0910584444444444,1.0909733333333262,1.09096088888888,1.0912415000000033,1.0915622000000011,1.0913541000000015,1.0914652500000042,1.0910417473892438,1.091142883800623,5844,-363041,-363447.4,-0.03317992780153206,-276.14620530227927,-0.0036673695791730083
2023-08-16T11:00:00-04:00,1.09066,1.09125,1.09051,1.09089,1.0922854000000002,1.0910417777777779,1.0910466666666594,1.090991999999991,1.0911750000000033,1.091568400000001,1.0913378000000016,1.0914689000000042,1.091011397911395,1.0911371070404978,4779,-358262,-362272.8,-0.023804619710576312,-275.13840268734907,0.060537684708720445
2023-08-16T11:15:00-04:00,1.09089,1.09107,1.0904099999999999,1.09068,1.0922318920000003,1.0909684444444445,1.0910788888888818,1.0910164444444355,1.0911010000000032,1.091573200000001,1.0913114000000015,1.091478850000004,1.090945118329116,1.0910828856323977,-3608,-361870,-363128.2,-0.012961406430158915,-275.8329548420112,0.026595988591249325
2023-08-16T11:30:00-04:00,1.09068,1.0907,1.09005,1.09013,1.0921794541600003,1.0907786666666666,1.0910011111111038,1.0910155555555465,1.0910190000000033,1.091559400000001,1.0912780000000017,1.0914886500000043,1.0907820946632927,1.0909835085059176,-2473,-364343,-363280.2,-0.006485641897161943,-277.0800208925486,-0.06417131908729343
2023-08-16T11:45:00-04:00,1.09013,1.09048,1.08965,1.0903,1.0921280650768004,1.0906384444444444,1.090839999999993,1.090987999999991,1.0909430000000033,1.091549000000001,1.0912401000000016,1.0914994000000042,1.0906856757306342,1.0908932068047335,3554,-360789,-361661,-0.004927832783368525,-276.52579341509175,-0.13281428898556916
2023-08-16T12:00:00-04:00,1.0903,1.09047,1.08939,1.0895,1.0920777037752645,1.0903704444444444,1.0906866666666597,1.0909306666666576,1.0908385000000034,1.091525000000001,1.0911994000000016,1.0914995000000043,1.0904485405845075,1.0907745654437861,-3014,-363803,-361813.4,-0.015426682660564753,-278.7372948367192,-0.12650337342330584
2023-08-16T12:15:00-04:00,1.0895,1.08952,1.08881,1.08889,1.0919701956242538,1.090011111111111,1.0903499999999928,1.0907913333333243,1.0906980000000033,1.091489800000001,1.0911613000000016,1.0914961500000044,1.090136832467606,1.0905996523550285,-2631,-366434,-363447.8,-0.0218854204591557,-280.21036505241443,-0.27749285661954065
2023-08-16T12:30:00-04:00,1.08889,1.08926,1.08872,1.08904,1.0917805838867987,1.089749111111111,1.0900733333333263,1.0905902222222132,1.0906065000000034,1.091452600000001,1.0911223000000014,1.0914900000000043,1.0899174659740847,1.0903941218840223,2593,-363841,-363842,-0.036680784176494736,-279.85316643731073,-0.22812016160800724
2023-08-16T12:45:00-04:00,1.08904,1.08914,1.0886,1.08867,1.0915357371758547,1.0894684444444442,1.089862222222215,1.0903624444444353,1.0904735000000032,1.091410600000001,1.0910821000000015,1.0914817500000042,1.0896679727792677,1.0901712975072173,-2068,-365909,-364155.2,-0.053303814713612695,-280.5557668927577,-0.1742208203049793
2023-08-16T13:00:00-04:00,1.08867,1.08905,1.08838,1.08894,1.0912421634582692,1.0892840000000001,1.0896711111111042,1.0901286666666576,1.0903660000000035,1.0913728000000011,1.0910490000000015,1.0914729500000044,1.0895223782234142,1.0899386380057732,2070,-363839,-364765.2,-0.0578206085048766,-280.04238818295585,-0.15770267544422129
2023-08-16T13:15:00-04:00,1.08894,1.08909,1.0885,1.08853,1.090898703843277,1.0890557777777778,1.089408888888882,1.0898731111111022,1.0902515000000033,1.091316800000001,1.0910138000000016,1.0914557000000042,1.0893239025787314,1.089713710404618,-2189,-366028,-365210.2,-0.06618229941206433,-280.86657500683964,-0.21633711923291238
2023-08-16T13:30:00-04:00,1.08853,1.08901,1.08846,1.08883,1.0905964593820836,1.08894,1.0892033333333264,1.0896437777777688,1.0901580000000033,1.091265600000001,1.0909841000000013,1.0914385000000044,1.0892251220629852,1.0895313683236938,2206,-363822,-364687.8,-0.07639166134475898,-280.258599112744,-0.16961895331354102
2023-08-16T13:45:00-04:00,1.08883,1.0892,1.08877,1.08902,1.0903304842562336,1.0889033333333331,1.089079999999993,1.0894451111111023,1.0900975000000033,1.091214400000001,1.0909566000000015,1.0914233000000044,1.0891840976503881,1.0893846946589547,2444,-361378,-364195.2,-0.0842864244469008,-279.832122986994,-0.10182271839137941
2023-08-16T14:00:00-04:00,1.08902,1.08916,1.08774,1.08832,1.0900964261454855,1.0887513333333334,1.0888599999999928,1.089244666666658,1.0899940000000032,1.0911498000000008,1.0909233000000014,1.0914015000000044,1.0890112781203105,1.089253355727163,-6827,-368205,-364654.4,-0.09255460944736082,-284.2203803192753,-0.18160139411172088
2023-08-16T14:15:00-04:00,1.08832,1.09003,1.08824,1.08951,1.08774,1.0888813333333334,1.088861111111104,1.0890826666666578,1.0899280000000033,1.091108200000001,1.0908977000000015,1.0913847000000045,1.0891110224962484,1.08917108458173,6159,-362046,-364295.8,-0.09596149132828229,-277.4859547826683,0.0009178522257976607
2023-08-16T14:30:00-04:00,1.08951,1.08996,1.08901,1.08924,1.08774,1.0889571111111112,1.0888999999999929,1.0889808888888801,1.0898025000000033,1.091064000000001,1.0908719000000013,1.0913655000000047,1.0891368179969987,1.0891336676653836,-4397,-366443,-364378.8,-0.09140677566188686,-278.57560976518334,0.03214282434406345
2023-08-16T14:45:00-04:00,1.08924,1.08937,1.0879,1.08808,1.0877858,1.088793111111111,1.0887933333333264,1.08889888888888,1.0896625000000033,1.090971600000001,1.0908352000000014,1.0913417000000047,1.088925454397599,1.0890737341323062,-3760,-370203,-365655,-0.08281721874481232,-282.57986961608873,-0.08815103210167413
2023-08-16T15:00:00-04:00,1.08808,1.08809,1.08735,1.08749,1.09003,1.0885324444444444,1.0886622222222153,1.0888153333333246,1.0894410000000034,1.090872400000001,1.0907960000000012,1.0913161500000046,1.0886383635180792,1.0889645873058444,-3562,-373765,-368132.4,-0.08223947302379064,-284.51132686187907,-0.10838913536700366
2023-08-16T15:15:00-04:00,1.08749,1.08756,1.08714,1.08725,1.0899764,1.08825,1.0884744444444374,1.0887382222222135,1.0892270000000033,1.0907790000000008,1.0907538000000014,1.0912911000000047,1.0883606908144634,1.088834469844675,-3963,-377728,-370037,-0.07487737185603212,-285.3859280076368,-0.15519679688504134
2023-08-16T15:30:00-04:00,1.08725,1.08785,1.08725,1.08744,1.089862944,1.0880431111111113,1.0883533333333264,1.0886366666666578,1.0890705000000034,1.0906884000000008,1.0907139000000015,1.0912682500000046,1.0881765526515708,1.0886475758757395,3053,-374675,-372562.8,-0.07078092932899578,-284.85240765813137,-0.1001350445095712
2023-08-16T15:45:00-04:00,1.08744,1.08767,1.08733,1.08745,1.08975402624,1.0878624444444445,1.0881999999999932,1.0884966666666578,1.0889100000000034,1.0905994000000008,1.0906842000000012,1.0912468500000048,1.0880312421212566,1.0884264607005911,2801,-371874,-373649,-0.06706499580629521,-284.82664991517527,-0.1267415482674005
2023-08-16T16:00:00-04:00,1.08745,1.08771,1.08741,1.08756,1.0896494651904,1.0877344444444446,1.088037777777771,1.0883455555555468,1.0887435000000034,1.090503800000001,1.0906571000000012,1.0912259000000046,1.0879369936970054,1.0882287685604726,1177,-370697,-373747.8,-0.06518042697875615,-284.70759156766496,-0.13406549007364574
2023-08-16T16:15:00-04:00,1.08756,1.08774,1.08751,1.08773,1.0895490865827842,1.087672888888889,1.0879722222222155,1.0882075555555468,1.0885960000000034,1.0904116000000008,1.0906333000000012,1.0912064500000047,1.0878955949576044,1.0880802148483775,750,-369947,-372984.2,-0.06321678199304483,-284.59035665648764,-0.054211996471613906
2023-08-16T16:30:00-04:00,1.08773,1.08793,1.08764,1.08788,1.0894527231194728,1.0876544444444445,1.0877911111111045,1.0880708888888804,1.0884835000000035,1.090315600000001,1.0906109000000013,1.0911903500000046,1.0878924759660835,1.0879865718787014,441,-369506,-371339.8,-0.05501797915966355,-284.5295419322455,-0.14960853961872955
2023-08-16T16:45:00-04:00,1.08788,1.0879699999999999,1.08781,1.08792,1.0893602141946939,1.0876802222222222,1.0876444444444378,1.0879291111111027,1.0883645000000033,1.090216000000001,1.0905842000000012,1.0911776500000046,1.0878979807728668,1.0879308575029607,725,-368781,-370161,-0.05996257698184002,-284.5028845803316,-0.12118541368293377
2023-08-16T17:00:00-04:00,1.08792,1.08792,1.08733,1.08775,1.0892714056269062,1.0877013333333332,1.0876077777777708,1.0878106666666583,1.0882770000000033,1.0901144000000007,1.0905574000000013,1.0911635500000045,1.0878683846182935,1.087898286002368,-185,-368966,-369579.4,-0.06250262524124674,-284.5317929559475,-0.030328652304972194
2023-08-16T17:15:00-04:00,1.08775,1.08782,1.08737,1.08772,1.08918614940183,1.0877237777777777,1.0876333333333266,1.0877297777777692,1.0882185000000033,1.0900126000000008,1.0905299000000013,1.0911481500000046,1.0878387076946348,1.0878786288018938,-207,-369173,-369274.6,-0.05802673229090489,-284.5375019883538,0.021149619766614173
2023-08-16T17:30:00-04:00,1.08772,1.08815,1.08767,1.08796,1.0891043034257568,1.087789111111111,1.0877122222222155,1.0876777777777693,1.0881645000000033,1.089909000000001,1.0905062000000012,1.0911318000000045,1.0878629661557078,1.0878721030415144,481,-368692,-369023.6,-0.04964045241748633,-284.4313717342443,0.06530236836054158
2023-08-16T17:45:00-04:00,1.08796,1.08815,1.08796,1.08813,1.0890257312887266,1.0878726666666665,1.087788888888882,1.0876773333333247,1.0881375000000033,1.089816000000001,1.0904861000000012,1.0911210000000044,1.0879163729245662,1.087876882433211,374,-368318,-368786,-0.037573157379009584,-284.3729320857278,0.0634517766497535
2023-08-16T18:00:00-04:00,1.08813,1.08833,1.08795,1.0883099999999999,1.0889503020371776,1.0879768888888888,1.0878844444444375,1.0877253333333248,1.0881060000000033,1.089732600000001,1.0904644000000012,1.0911090500000045,1.087995098339653,1.0878963059465683,428,-367890,-368607.8,-0.028003077318679608,-284.3021317218008,0.0790840958204847
2023-08-16T18:15:00-04:00,1.0883099999999999,1.0883099999999999,1.08806,1.08817,1.0888778899556906,1.0880340000000002,1.0879522222222153,1.0877942222222137,1.0880880000000035,1.089643200000001,1.090442100000001,1.0910975500000046,1.0880300786717223,1.087928644757254,-348,-368238,-368462.2,-0.01801727680454225,-284.34689837836,0.05608885946522485
2023-08-16T18:30:00-04:00,1.08817,1.08818,1.08796,1.08806,1.088808374357463,1.0880555555555558,1.087988888888882,1.0878653333333248,1.0880495000000034,1.089560000000001,1.090419700000001,1.0910855000000046,1.0880360629373778,1.0879681158058028,-275,-368513,-368330.2,-0.01136551622701333,-284.3746973435952,0.030338411186594232
2023-08-16T18:45:00-04:00,1.08806,1.08809,1.0879,1.08791,1.0887416393831646,1.0880397777777777,1.0879922222222154,1.0879213333333249,1.0879940000000035,1.089475000000001,1.0903945000000013,1.0910722500000045,1.0880108503499022,1.0879976926446417,-243,-368756,-368343,-0.005685175216054587,-284.4081973344045,0.0027576570945301404
2023-08-16T19:00:00-04:00,1.08791,1.08792,1.08769,1.08777,1.088677573807838,1.0879953333333332,1.0879755555555488,1.0879586666666583,1.0879665000000034,1.089395000000001,1.0903680000000013,1.0910593000000046,1.0879626802799218,1.088006954115713,-689,-369445,-368568.4,-0.0012255089689364813,-284.49686275709576,-0.013787778513134652
2023-08-16T19:15:00-04:00,1.08777,1.0879699999999999,1.08777,1.08783,1.0886160708555246,1.0879662222222222,1.0879844444444375,1.0879786666666582,1.0878825000000036,1.089315200000001,1.0903428000000013,1.0910456500000045,1.0879361442239375,1.0879951632925697,559,-368886,-368767.6,0.0000919151441968742,-284.4660290330547,0.0073546311192902785
2023-08-16T19:30:00-04:00,1.08783,1.08788,1.08734,1.0875,1.0885570280213035,1.0878693333333334,1.087959999999993,1.087980222222214,1.0877955000000035,1.089233400000001,1.0903155000000013,1.0910303500000047,1.08784891537915,1.0879589306340554,-727,-369613,-369042.6,0.006592208849846137,-284.68656900713165,-0.020225793402723954
2023-08-16T19:45:00-04:00,1.0875,1.0877,1.08741,1.08744,1.0885003469004513,1.0877653333333335,1.0879022222222152,1.0879628888888804,1.0877635000000034,1.089148200000001,1.0902868000000014,1.0910151500000047,1.08776713230332,1.0879051445072438,-1028,-370641,-369468.2,0.011898429959097517,-284.7432862485109,-0.04779587484834699
2023-08-16T20:00:00-04:00,1.08744,1.08747,1.0868,1.08693,1.0884459330244332,1.0875708888888889,1.087768888888882,1.0879182222222137,1.0877355000000037,1.089069400000001,1.0902527000000013,1.0909969000000046,1.087599705842656,1.0878229156057946,-2463,-373104,-370337.8,0.007464254756803041,-285.8984120485551,-0.11028094069643239
2023-08-16T20:15:00-04:00,1.08693,1.08708,1.08663,1.08696,1.0883471770429671,1.087409111111111,1.0876188888888818,1.0878468888888801,1.0877210000000035,1.0889820000000008,1.0902197000000013,1.0909782000000046,1.0874717646741248,1.087724732484635,2045,-371059,-370660.6,-0.0009719079206516166,-285.84196867133676,-0.124045538495462
2023-08-16T20:30:00-04:00,1.08696,1.08716,1.08678,1.0871,1.0882098028795297,1.0873053333333331,1.0874999999999928,1.0877499999999913,1.0877040000000036,1.088902200000001,1.0901869000000013,1.0909598000000045,1.0873974117392997,1.0876169859877076,1775,-369284,-370740.2,-0.011439694030605576,-285.61334940291835,-0.0983302241377842
2023-08-16T20:45:00-04:00,1.0871,1.08711,1.08685,1.08694,1.0880834186491672,1.0871933333333332,1.0873755555555487,1.0876331111111024,1.0876785000000038,1.088824600000001,1.0901524000000011,1.0909407500000043,1.0873059293914398,1.0875083887901655,-1621,-370905,-370998.6,-0.020559502158547675,-285.85192911039684,-0.1029354998805222
2023-08-16T21:00:00-04:00,1.08694,1.08708,1.08651,1.08667,1.087967145157234,1.0870522222222223,1.0872377777777706,1.0875002222222137,1.0876340000000035,1.088744000000001,1.0901149000000012,1.0909217000000044,1.087178743513152,1.087390711032132,-2343,-373248,-371520,-0.029925254725572923,-286.4339391569495,-0.11398001672931657
2023-08-16T21:15:00-04:00,1.08667,1.08689,1.08628,1.08629,1.0878214306415106,1.0868626666666665,1.0870733333333262,1.0873611111111026,1.0875620000000035,1.088665200000001,1.090075000000001,1.0909007500000045,1.0870009948105215,1.087270968825705,-2971,-376219,-372143,-0.03926184061688612,-287.4728746203378,-0.1360581740625248
2023-08-16T21:30:00-04:00,1.08629,1.08672,1.08616,1.08655,1.0876364589645293,1.0867580000000001,1.086931111111104,1.087223555555547,1.0874955000000035,1.088588400000001,1.0900383000000011,1.0908800500000044,1.0869107958484172,1.0871587750605636,4150,-372069,-372345,-0.045315242849410686,-286.47958553547124,-0.1176654440491777
2023-08-16T21:45:00-04:00,1.08655,1.08663,1.08627,1.08659,1.0874297547094953,1.0866897777777778,1.0868299999999929,1.0870895555555469,1.0874290000000038,1.088503600000001,1.090001200000001,1.0908591500000044,1.0868466366787337,1.0870486200484504,2458,-369611,-372410.4,-0.051071749173196034,-286.3890972928684,-0.08367816091953714
2023-08-16T22:00:00-04:00,1.08659,1.08693,1.08655,1.0867,1.087251989050166,1.086663777777778,1.0867477777777705,1.0869639999999914,1.0873765000000035,1.088402600000001,1.089966300000001,1.0908392000000044,1.086817309342987,1.0869508960387597,2071,-367540,-371737.4,-0.05308890453691508,-286.1794413969002,-0.06804973147943454
2023-08-16T22:15:00-04:00,1.0867,1.087,1.08656,1.08682,1.0870991105831427,1.0866782222222222,1.0867355555555482,1.086863555555547,1.0873315000000034,1.088321400000001,1.0899266000000012,1.0908198000000044,1.0868178474743895,1.0868787168310072,1572,-365968,-370281.4,-0.05472019129045774,-286.00585162971527,-0.010120246934030205
2023-08-16T22:30:00-04:00,1.08682,1.08687,1.08667,1.08671,1.087,1.086673111111111,1.0867077777777707,1.0867904444444358,1.0872690000000036,1.0882172000000008,1.089884500000001,1.0908019000000044,1.0867962779795115,1.0868377734648051,-1547,-367515,-368540.6,-0.052322612460273615,-286.1624276956689,-0.022999926400222772
2023-08-16T22:45:00-04:00,1.08671,1.08677,1.08641,1.0866,1.087,1.0866515555555554,1.086652222222215,1.0867346666666582,1.0871925000000036,1.0881186000000007,1.089844600000001,1.0907812500000045,1.0867570223836092,1.0868070187718435,-1563,-369078,-367942.4,-0.049680316818504044,-286.32063917803316,-0.04599392880139315
2023-08-16T23:00:00-04:00,1.0866,1.08683,1.08656,1.08657,1.0868824,1.0866351111111112,1.086611111111104,1.0866908888888802,1.0871055000000036,1.0880386000000009,1.0898008000000012,1.0907608000000044,1.0867196179068874,1.0867816150174743,-1872,-370950,-368210.2,-0.04772579742262714,-286.3723233304351,-0.03404051741586302
2023-08-16T23:15:00-04:00,1.08657,1.08674,1.08647,1.08667,1.08683,1.0866468888888887,1.086611111111104,1.086663555555547,1.0870305000000033,1.087958800000001,1.0897605000000012,1.0907387000000042,1.08670969432551,1.086760092013979,1416,-369534,-368609,-0.043029018633214386,-286.242004989233,0
2023-08-16T23:30:00-04:00,1.08667,1.0868,1.08647,1.08651,1.08616,1.0866266666666666,1.0866355555555485,1.0866435555555471,1.0869530000000034,1.0878712000000008,1.0897198000000012,1.0907176500000042,1.086669755460408,1.0867304736111827,-1546,-371080,-369631.4,-0.0372320292701531,-286.4696361928182,0.020252418783207892
2023-08-16T23:45:00-04:00,1.08651,1.08655,1.08627,1.08642,1.0861728,1.0865835555555556,1.086621111111104,1.0866262222222136,1.0868785000000034,1.0877860000000006,1.089679600000001,1.090694650000004,1.0866198043683264,1.0866951788889456,-1540,-372620,-370652.4,-0.02885371961480196,-286.59720059627534,-0.011964474713539505
2023-08-17T00:00:00-04:00,1.08642,1.08647,1.08629,1.08634,1.086185344,1.0865273333333332,1.0865933333333262,1.0866144444444361,1.0868070000000034,1.0877102000000007,1.0896348000000011,1.090671850000004,1.0865638434946612,1.086656543111156,-1243,-373863,-371609.4,-0.02390913739116024,-286.6887305754729,-0.02300775821605771
2023-08-17T00:15:00-04:00,1.08634,1.0866,1.08634,1.08657,1.08619763712,1.0865226666666667,1.0865788888888817,1.0866079999999916,1.0867440000000035,1.0876356000000007,1.0895923000000012,1.0906483000000042,1.086565074795729,1.0866256344889242,1088,-372775,-371974.4,-0.01883650101122128,-286.45837912012746,-0.011962823226278042
2023-08-17T00:30:00-04:00,1.08657,1.08663,1.08652,1.08659,1.0862096843776,1.0865248888888888,1.0865533333333264,1.0865964444444358,1.0866985000000036,1.0875774000000007,1.0895512000000014,1.0906240500000042,1.086570059836583,1.0865977075911388,1009,-371766,-372420.8,-0.014416249259743648,-286.4398069158517,-0.021162658029844177
2023-08-17T00:45:00-04:00,1.08659,1.08691,1.08659,1.08684,1.0862214906900478,1.0865822222222223,1.0865677777777707,1.0865828888888802,1.0866685000000036,1.0875364000000007,1.0895131000000013,1.0906034500000041,1.0866240478692664,1.0865885660729107,1184,-370582,-372321.2,-0.011340526475327063,-286.16739505857333,0.011962713143337548
2023-08-17T01:00:00-04:00,1.08684,1.0869199999999999,1.08659,1.08684,1.086249031062446,1.0866366666666667,1.0865944444444375,1.086577555555547,1.0866640000000036,1.0874924000000008,1.0894725000000012,1.0905807500000042,1.086667238295413,1.0865980528583277,0,-370582,-371913.6,-0.0075152682641043385,-286.16739505857333,0.02208724461623578
2023-08-17T01:15:00-04:00,1.08684,1.08688,1.08666,1.08669,1.0862892891986993,1.0866557777777777,1.086607777777771,1.086580444444436,1.0866505000000035,1.0874528000000008,1.0894317000000013,1.0905556000000043,1.0866717906363303,1.0866196422866614,-1151,-371733,-371487.6,-0.005635414945499987,-286.3262500878326,0.011043927220510227
2023-08-17T01:30:00-04:00,1.08669,1.0867,1.08627,1.08641,1.0869199999999999,1.0866162222222222,1.0865788888888819,1.086580444444436,1.0866160000000036,1.0874022000000008,1.0893875000000013,1.0905309000000043,1.0866194325090643,1.0866305138293284,-1865,-373598,-371652.2,-0.004697753053910574,-286.8067919166887,-0.02392630697451176
2023-08-17T01:45:00-04:00,1.08641,1.08739,1.08639,1.08735,1.08627,1.0867704444444444,1.0866722222222154,1.0866042222222139,1.0866365000000038,1.0873786000000008,1.0893477000000014,1.0905104000000043,1.0867655460072514,1.0866696110634622,2189,-371409,-371580.8,0.00046451153792076124,-284.91279241373877,0.07731175967086835
2023-08-17T02:00:00-04:00,1.08735,1.08744,1.087,1.08735,1.08627,1.086906,1.0867755555555487,1.0866457777777694,1.0866705000000036,1.0873490000000008,1.0893073000000013,1.0904908500000043,1.0868824368058012,1.0867212888507694,0,-371409,-371746.2,0.006397874153229022,-284.91279241373877,0.08560225327222414
2023-08-17T02:15:00-04:00,1.08735,1.08788,1.08709,1.08774,1.0863168,1.0870988888888888,1.0869311111111044,1.0867131111111028,1.0867430000000036,1.0873234000000007,1.0892689000000013,1.0904728000000043,1.087053949444641,1.0867986310806148,3267,-368142,-371258.2,0.01385556819030131,-283.7410169964402,0.12887309682050238
2023-08-17T02:30:00-04:00,1.08774,1.08867,1.08772,1.08865,1.086410592,1.0874426666666666,1.0871622222222155,1.0868239999999916,1.0868480000000038,1.0873300000000008,1.0892399000000013,1.0904604000000042,1.0873731595557128,1.0869389048644913,3294,-364848,-369881.2,0.0247683200351746,-280.9852665413683,0.1914280718223271
2023-08-17T02:45:00-04:00,1.08865,1.08867,1.08822,1.08835,1.08659134464,1.0876802222222222,1.087357777777771,1.0869797777777694,1.0869360000000037,1.0873068000000008,1.0892075000000012,1.0904471500000041,1.0875685276445701,1.0871287238915925,-2665,-367513,-368664.2,0.03325694152702058,-281.7196623526942,0.16197461784113454
2023-08-17T03:00:00-04:00,1.08835,1.0884,1.08761,1.08799,1.0867576370688,1.0878066666666668,1.0874855555555487,1.0871424444444362,1.0870005000000036,1.0872818000000009,1.0891729000000012,1.0904326000000042,1.087652822115656,1.0873061791132737,-4072,-371585,-368699.4,0.040001384343437765,-283.0665820017038,0.10581134297596559
2023-08-17T03:15:00-04:00,1.08799,1.08855,1.08776,1.08815,1.086910626103296,1.0879395555555555,1.087631111111104,1.087313555555547,1.0870670000000036,1.0872832000000008,1.089127400000001,1.0904183500000044,1.087752257692525,1.0874801432906183,3981,-367604,-367938.4,0.04569794499450653,-282.4811354442908,0.1205329211291379
2023-08-17T03:30:00-04:00,1.08815,1.08825,1.08749,1.0879,1.0870513760150322,1.0879933333333334,1.0877655555555485,1.0874804444444361,1.0871265000000034,1.0872914000000007,1.0890819000000012,1.0904039500000042,1.0877818061540199,1.0876257146324941,-3822,-371426,-368595.2,0.05071566114360757,-283.3592312950462,0.11134730235855261
2023-08-17T03:45:00-04:00,1.0879,1.0882,1.08761,1.08804,1.0871808659338296,1.0880482222222223,1.0879466666666597,1.087637333333325,1.0871985000000035,1.0873072000000008,1.0890431000000012,1.090388300000004,1.0878334449232159,1.0877177717059947,3168,-368258,-369277.2,0.057304745348282816,-282.95154676521867,0.15003543781811637
2023-08-17T04:00:00-04:00,1.08804,1.08838,1.08772,1.08801,1.0872999966591232,1.0880608888888887,1.088019999999993,1.0877697777777695,1.0872705000000036,1.0873186000000006,1.0890035000000013,1.0903705500000043,1.0878687559385727,1.0877778173647952,-3300,-371558,-370086.2,0.06584185865641483,-283.0425360670825,0.06069802731410152
2023-08-17T04:15:00-04:00,1.08801,1.08812,1.08752,1.08759,1.0874095969263935,1.087974888888889,1.0880466666666597,1.0878819999999916,1.0873165000000036,1.0873214000000007,1.0889604000000013,1.0903485000000042,1.087813004750858,1.0878098538918357,-3126,-374684,-370706,0.0635790303510798,-284.24925291711105,0.02207200993240612
2023-08-17T04:30:00-04:00,1.08759,1.08805,1.08737,1.08792,1.08867,1.0879495555555556,1.0880666666666599,1.0879691111111027,1.0873870000000037,1.0873286000000006,1.0889162000000012,1.0903291500000043,1.0878344038006864,1.087826283113468,2470,-372214,-371628,0.0633434424168167,-283.4997976996119,0.016548072149600915
2023-08-17T04:45:00-04:00,1.08792,1.08804,1.08697,1.0873,1.088644,1.0877962222222224,1.0879166666666598,1.0879993333333249,1.0874310000000036,1.0873200000000007,1.088865800000001,1.0903039500000042,1.0877275230405492,1.0878154264907738,-2793,-375007,-372344.2,0.05583524267997282,-285.0915140022814,-0.12400679740963234
2023-08-17T05:00:00-04:00,1.0873,1.08743,1.0869199999999999,1.08713,1.0885770399999999,1.0876388888888888,1.0877811111111042,1.0879662222222137,1.0874705000000036,1.0873050000000009,1.0888103000000011,1.0902765500000042,1.0876080184324393,1.0877703411926185,-3077,-378084,-374309.4,0.03874626408180896,-285.5726047775964,-0.11209629255294702
2023-08-17T05:15:00-04:00,1.08713,1.08737,1.08673,1.08678,1.0884776176,1.0874386666666669,1.0876466666666598,1.087891555555547,1.0874810000000035,1.0872822000000009,1.0887491000000011,1.0902507000000043,1.0874424147459514,1.0876850729540943,-2376,-380460,-376089.8,0.022381141512947594,-286.3375546915898,-0.1112142574839781
2023-08-17T05:30:00-04:00,1.08678,1.08696,1.08637,1.08687,1.0883378081919999,1.0872833333333334,1.0875044444444373,1.0877831111111027,1.0874950000000037,1.0872646000000008,1.0886895000000012,1.0902231500000044,1.087327931796761,1.0875880583632749,2897,-377563,-376665.6,0.010767854429762485,-286.0976441301148,-0.11763084133620805
2023-08-17T05:45:00-04:00,1.08687,1.0874,1.08668,1.08737,1.0881410273727998,1.0872564444444444,1.0874455555555487,1.0876588888888805,1.0875215000000036,1.0872576000000007,1.0886351000000012,1.0901982500000043,1.0873363454374088,1.0874884466906194,2884,-374679,-377158.6,0.0001795310913564326,-284.7708985211645,-0.04871771302510722
2023-08-17T06:00:00-04:00,1.08737,1.08782,1.08731,1.08761,1.08796392463552,1.087289333333333,1.087397777777771,1.0875551111111028,1.0875600000000036,1.0872506000000006,1.0885798000000013,1.0901747500000043,1.087391076349927,1.087421157352495,3892,-370787,-376314.6,-0.005858646363411909,-283.91187169496914,-0.039520605860072285
2023-08-17T06:15:00-04:00,1.08761,1.08877,1.08755,1.08812,1.08637,1.0874337777777778,1.087409999999993,1.0874808888888805,1.0876315000000036,1.0872504000000007,1.0885332000000012,1.0901551500000044,1.0875368610799416,1.0874069258819954,3922,-366865,-374070.8,-0.010727114467229227,-282.0727749599262,0.01011020119300875
2023-08-17T06:30:00-04:00,1.08812,1.08869,1.08795,1.0886,1.086418,1.0876717777777776,1.0875222222222152,1.0874559999999915,1.0877410000000038,1.087256200000001,1.0884944000000012,1.0901329000000042,1.0877494888639534,1.0874683407055958,2941,-363924,-370763.6,-0.0136638876274759,-280.7754180507617,0.09286587776643361
2023-08-17T06:45:00-04:00,1.0886,1.0887,1.08832,1.08836,1.0864650400000002,1.0878393333333334,1.0875711111111042,1.087469333333325,1.0877915000000038,1.0872600000000008,1.0884516000000013,1.0901108500000043,1.0878715910911627,1.0875770725644762,-3079,-367003,-368651.6,-0.015120486727025597,-281.45423487971635,0.040444150305169124
2023-08-17T07:00:00-04:00,1.08836,1.08882,1.08811,1.08864,1.0865111392000002,1.0880531111111111,1.087719999999993,1.0875242222222137,1.087856000000004,1.087271600000001,1.0884158000000013,1.0900925500000043,1.0880252728729303,1.0877148580515805,3167,-363836,-366483,-0.014147844095028277,-280.63946770708947,0.12324105582636981
2023-08-17T07:15:00-04:00,1.08864,1.0887499999999999,1.08826,1.08834,1.0866034936320002,1.0881771111111112,1.0878544444444376,1.0876155555555471,1.087886000000004,1.087280200000001,1.0883776000000014,1.0900703000000043,1.0880882182983442,1.0878542864412641,-2356,-366192,-365564,-0.008920809648565372,-281.2887181480065,0.11130223616312267
2023-08-17T07:30:00-04:00,1.08834,1.08917,1.08827,1.08909,1.0866921538867202,1.0884242222222222,1.0881111111111041,1.087755777777769,1.0879080000000036,1.087306600000001,1.0883508000000013,1.0900478000000042,1.0882885746386755,1.0880046291530108,3023,-363169,-364824.8,0.003186440470547605,-279.2054996684878,0.21255451885384458
2023-08-17T07:45:00-04:00,1.08909,1.08957,1.08901,1.08944,1.086840824653517,1.08869,1.0883966666666598,1.087930666666658,1.0879625000000037,1.087338800000001,1.0883270000000014,1.0900249000000042,1.0885188597109403,1.0881585033224082,3140,-360029,-364045.8,0.024177594145850592,-278.19640032867176,0.23645882212223737
2023-08-17T08:00:00-04:00,1.08944,1.09006,1.0892,1.08985,1.0870591586812357,1.0889806666666666,1.0886722222222154,1.0881508888888802,1.0880555000000038,1.0873858000000007,1.0883096000000014,1.0900038500000042,1.0887850877687522,1.088341202657926,4122,-355907,-361826.6,0.04499958422897308,-276.645126279619,0.22807324093915024
2023-08-17T08:15:00-04:00,1.08985,1.09004,1.0895,1.08989,1.087359242813112,1.0892242222222221,1.0889255555555488,1.0883919999999914,1.0881425000000038,1.087434800000001,1.0882915000000015,1.0899856500000042,1.0890060702150017,1.0885373621263403,3939,-351968,-359453,0.059839831955112645,-276.5005559259004,0.20963396805840878
2023-08-17T08:30:00-04:00,1.08989,1.09183,1.08865,1.09082,1.087629318531801,1.089603111111111,1.0892255555555488,1.0886662222222137,1.088288500000004,1.0875126000000008,1.0882910000000015,1.0899714000000043,1.0893688561720014,1.0887934897010716,12028,-339940,-354202.6,0.07764617236557751,-266.23709814575886,0.24813439694150688
2023-08-17T08:45:00-04:00,1.09082,1.09099,1.08994,1.09062,1.0881334003079848,1.0898819999999998,1.0894499999999931,1.0889339999999916,1.088417500000004,1.087585800000001,1.0882839000000015,1.0899570500000042,1.089619084937601,1.0890595917608568,-6436,-346376,-350844,0.08870604675570755,-267.4171278481844,0.1855594341355788
2023-08-17T09:00:00-04:00,1.09062,1.09144,1.09032,1.09143,1.0885769922710267,1.0902779999999999,1.089791111111104,1.0892128888888803,1.088588500000004,1.087672400000001,1.0882873000000017,1.0899474500000041,1.0899812679500809,1.089352073408685,7025,-339351,-346708.4,0.0998609785398897,-262.199682725227,0.28207578374801595
2023-08-17T09:15:00-04:00,1.09143,1.09179,1.09092,1.0910199999999999,1.0889673531985036,1.0905237777777779,1.0900555555555487,1.0894895555555473,1.088760000000004,1.087754000000001,1.0882893000000016,1.0899352000000042,1.0901890143600648,1.0896328587269477,-6242,-345593,-344645.6,0.11111504763885635,-264.54451473460927,0.2186213991769388
2023-08-17T09:30:00-04:00,1.0910199999999999,1.09152,1.0902,1.09094,1.0893108708146833,1.0907006666666668,1.0903444444444377,1.089773333333325,1.088911000000004,1.087839400000001,1.0882917000000016,1.0899230500000041,1.090339211488052,1.0898994869815577,-6921,-352514,-344754.8,0.1175712210284146,-265.0520031399538,0.23889593325614564
2023-08-17T09:45:00-04:00,1.09094,1.09094,1.08975,1.08991,1.0896131663169213,1.0906137777777778,1.0904355555555485,1.090015333333325,1.089041500000004,1.087911800000001,1.0882885000000015,1.0899081000000042,1.0902533691904415,1.0900763895852454,-6453,-358967,-348560.2,0.12327636759135484,-271.1445380181328,0.07529221643758027
2023-08-17T10:00:00-04:00,1.08991,1.08996,1.08899,1.08932,1.09183,1.0903906666666665,1.090422222222215,1.0902097777777695,1.089151000000004,1.087967200000001,1.0882778000000015,1.0898922500000041,1.0900666953523532,1.0901659116681959,-6635,-365602,-352405.4,0.11654492865180982,-274.7362566004002,-0.011014833308846561
2023-08-17T10:15:00-04:00,1.08932,1.08968,1.08871,1.08887,1.0917732,1.0900802222222221,1.0903133333333264,1.0903142222222137,1.089255500000004,1.088012800000001,1.0882582000000016,1.089875200000004,1.0898273562818825,1.0901351293345563,-5465,-371067,-358748.6,0.10369497230034057,-276.9938576726291,-0.08992063127953213
2023-08-17T10:30:00-04:00,1.08887,1.08928,1.08843,1.08913,1.091650672,1.0898435555555557,1.0902288888888818,1.0903488888888806,1.089368500000004,1.088061400000001,1.0882320000000016,1.089859750000004,1.089687885025506,1.0900349034676446,5151,-365916,-362813.2,0.08680069807811806,-275.76390368363167,-0.06973180779712576
2023-08-17T10:45:00-04:00,1.08913,1.08962,1.08873,1.08894,1.09145743168,1.0895857777777778,1.0900199999999929,1.0902839999999916,1.089447000000004,1.088103800000001,1.0882126000000016,1.089843450000004,1.0895383080204049,1.0898747227741152,-5332,-371248,-366560,0.06902336959091507,-276.694077308451,-0.17234740837167287
2023-08-17T11:00:00-04:00,1.08894,1.08903,1.0883099999999999,1.0885,1.0912757857792001,1.089281777777778,1.0897844444444376,1.0901537777777692,1.0894915000000043,1.088139600000001,1.0881784000000017,1.089812500000004,1.089330646416324,1.0896901782192916,-4353,-375601,-369886.8,0.042784507357754395,-278.4529620954916,-0.19438484531733324
2023-08-17T11:15:00-04:00,1.0885,1.08852,1.08715,1.08738,1.0910385229168642,1.0888008888888887,1.0893344444444375,1.0899362222222138,1.0894545000000042,1.088155200000001,1.0881369000000018,1.089778900000004,1.088940517133059,1.0894649425754328,-4253,-379854,-372737.2,0.014048915930160263,-282.82903926590967,-0.3710728127319102
2023-08-17T11:30:00-04:00,1.08738,1.08767,1.08698,1.08717,1.0906496706251778,1.0883680000000002,1.0889066666666598,1.0896548888888804,1.0893830000000042,1.0881672000000011,1.0881029000000018,1.089745250000004,1.0885864137064472,1.089216754060346,-2871,-382725,-375068.8,-0.0209037666119185,-283.3835004478333,-0.35288079045296233
2023-08-17T11:45:00-04:00,1.08717,1.0875,1.08666,1.08735,1.0902093101501564,1.0880566666666667,1.088507777777771,1.089310666666658,1.0893325000000043,1.0881808000000008,1.0880698000000018,1.0897119500000039,1.0883391309651578,1.0889470032482762,3998,-378727,-377631,-0.04913221895827342,-282.7215616526124,-0.3290740095697272
2023-08-17T12:00:00-04:00,1.08735,1.0875,1.08684,1.08713,1.0897124067291346,1.0877811111111109,1.088198888888882,1.088946444444436,1.0892570000000041,1.088193200000001,1.0880322000000016,1.0896850000000038,1.0880973047721263,1.0886588025986206,-3119,-381846,-379750.6,-0.0787364397136581,-283.3526188099218,-0.25506693213201137
2023-08-17T12:15:00-04:00,1.08713,1.08897,1.08699,1.0887499999999999,1.0892850697870557,1.0878913333333333,1.0881355555555485,1.088616666666658,1.0892775000000041,1.088239800000001,1.0880129000000016,1.0896621500000037,1.088227843817701,1.088438242078896,3460,-378386,-380307.6,-0.08986665582431735,-278.1966577013149,-0.05232622186319735
2023-08-17T12:30:00-04:00,1.0887499999999999,1.08877,1.08757,1.08779,1.08897,1.0878222222222222,1.0880155555555486,1.0883528888888803,1.0892125000000041,1.088268800000001,1.0879895000000017,1.0896337500000037,1.0881402750541609,1.0882781936631165,-2692,-381078,-380552.4,-0.10151119163154484,-280.5703155658381,-0.0991853940323427
2023-08-17T12:45:00-04:00,1.08779,1.0879,1.08747,1.08778,1.08897,1.087775111111111,1.0878655555555485,1.088144666666658,1.089129500000004,1.088293000000001,1.0879643000000017,1.0896022000000039,1.0880682200433287,1.0881745549304926,-2576,-383654,-380738.2,-0.10579734286782774,-280.59399660721573,-0.12395214529027411
2023-08-17T13:00:00-04:00,1.08778,1.08784,1.08707,1.08715,1.08877,1.087632,1.0876666666666595,1.0879764444444358,1.088994500000004,1.088304200000001,1.0879408000000017,1.0895701000000038,1.087884576034663,1.088083643944394,-2866,-386520,-382296.8,-0.11397593501254377,-282.2538726850989,-0.16438003930427372
2023-08-17T13:15:00-04:00,1.08715,1.08729,1.0869199999999999,1.08698,1.0884746,1.0874946666666667,1.0874977777777708,1.0878362222222135,1.088849000000004,1.088307000000001,1.0879217000000017,1.0895415000000037,1.0877036608277304,1.0880049151555145,-2324,-388844,-383696.4,-0.11943917116743435,-282.61728159831233,-0.13964170877353843
2023-08-17T13:30:00-04:00,1.08698,1.087,1.08571,1.08582,1.088220556,1.087159111111111,1.0873244444444374,1.0876739999999914,1.088599000000004,1.0882866000000009,1.0878895000000015,1.0895059000000038,1.0873269286621843,1.0878247321244114,-2534,-391378,-386294.8,-0.12627499693797484,-285.32150798702247,-0.14346410638415327
2023-08-17T13:45:00-04:00,1.08582,1.08624,1.08582,1.08611,1.08781886704,1.0869162222222224,1.0872066666666595,1.0875122222222136,1.088373500000004,1.0882750000000008,1.0878639000000014,1.089473000000004,1.0870835429297474,1.0876133856995287,1906,-389472,-387973.6,-0.11736326175957039,-284.812454921137,-0.09750085083290203
2023-08-17T14:00:00-04:00,1.08611,1.08622,1.08583,1.08613,1.0874814483136,1.0867008888888887,1.087071111111104,1.0873533333333245,1.0881085000000041,1.0882694000000008,1.0878358000000015,1.0894424000000038,1.086892834343798,1.0873783085596225,1966,-387506,-388744,-0.10729600588062685,-284.77625232655606,-0.11219938382305594
2023-08-17T14:15:00-04:00,1.08613,1.0863,1.08576,1.08616,1.0871980165834239,1.0865186666666669,1.0869633333333262,1.087212666666658,1.0878655000000041,1.088245600000001,1.0878121000000016,1.089412950000004,1.0867462674750383,1.0871506468476977,1874,-385632,-388566.4,-0.09519295283262844,-284.7244905669141,-0.08922575956876505
2023-08-17T14:30:00-04:00,1.08616,1.08627,1.08577,1.08594,1.086959933930076,1.086314,1.086651111111104,1.0870433333333245,1.087615500000004,1.088217400000001,1.0877832000000014,1.0893836500000038,1.0865850139800306,1.0869269174781577,-1750,-387382,-388274,-0.0839153798165333,-285.07895031501766,-0.258094144661307
2023-08-17T14:45:00-04:00,1.08594,1.08605,1.08563,1.08569,1.086759944501264,1.0861217777777776,1.0864177777777708,1.0868619999999911,1.0874045000000039,1.088176400000001,1.0877499000000015,1.089353250000004,1.0864060111840246,1.086742733982526,-1992,-389374,-387873.2,-0.08908398283538874,-285.5375391873308,-0.19305196775112757
2023-08-17T15:00:00-04:00,1.08569,1.0867,1.08568,1.0862,1.08563,1.0860782222222223,1.0862422222222152,1.0866691111111022,1.0872485000000038,1.0881274000000007,1.0877287000000015,1.089326000000004,1.0863648089472198,1.0865989871860202,3686,-385688,-387116.4,-0.08747370730572683,-283.8060504566618,-0.14524995863133308
2023-08-17T15:15:00-04:00,1.0862,1.08672,1.08619,1.08667,1.08563,1.0861637777777777,1.0861888888888818,1.0864926666666577,1.0871385000000038,1.0880938000000007,1.0877003000000014,1.0892990000000038,1.086425847157776,1.086505589748816,3287,-382401,-386095.4,-0.08608667620872129,-282.3837617437177,-0.04415214091891974
2023-08-17T15:30:00-04:00,1.08667,1.08684,1.08649,1.08672,1.0856736,1.0862699999999998,1.086159999999993,1.086331999999991,1.0870180000000038,1.0880684000000007,1.0876751000000013,1.089273500000004,1.0864846777262207,1.0864532717990525,2408,-379993,-384967.6,-0.08063255026697683,-282.2729645375744,-0.02391948333917358
2023-08-17T15:45:00-04:00,1.08672,1.08739,1.08663,1.08718,1.085743584,1.086474,1.0863111111111041,1.086263999999991,1.0869300000000037,1.0880490000000007,1.0876661000000016,1.089250650000004,1.0866237421809766,1.0864610174392415,3110,-376883,-382867.8,-0.07025724191019667,-280.9565260805658,0.12525096240629457
2023-08-17T16:00:00-04:00,1.08718,1.08734,1.08697,1.0873,1.08587529728,1.0866717777777777,1.0864433333333263,1.0862691111111022,1.086870000000004,1.0880370000000008,1.0876642000000016,1.089230100000004,1.0867589937447812,1.0865316139513932,1095,-375788,-380150.6,-0.04946135749276943,-280.8356629300297,0.10956532947860019
2023-08-17T16:15:00-04:00,1.0873,1.08735,1.08717,1.08727,1.0859964734976002,1.0868371111111113,1.0865699999999932,1.0863346666666578,1.086864500000004,1.0880216000000007,1.0876644000000015,1.089209100000004,1.086861194995825,1.0866308911611142,-778,-376566,-378326.2,-0.03340245444924822,-280.8571289467684,0.10495981144061198
2023-08-17T16:30:00-04:00,1.08727,1.08727,1.087,1.08717,1.0861079556177922,1.0869571111111112,1.0866822222222152,1.0864333333333245,1.086864500000004,1.0880048000000009,1.0876617000000015,1.089187800000004,1.08692295599666,1.086730312928891,-442,-377008,-377247.6,-0.02291401417576727,-280.89778122265204,0.09298814171024115
2023-08-17T16:45:00-04:00,1.08717,1.08728,1.0871,1.0872,1.0862105191683689,1.0870606666666667,1.086822222222215,1.086565777777769,1.086857000000004,1.0879970000000008,1.0876592000000016,1.0891717000000039,1.086978364797328,1.0868290503431124,635,-376373,-376523.6,-0.013476752382826562,-280.88025866408253,0.11602850986242692
2023-08-17T17:00:00-04:00,1.0872,1.0872,1.08632,1.08683,1.0863048776348994,1.0870622222222222,1.0869488888888816,1.0866933333333244,1.0868420000000039,1.0879752000000007,1.0876519000000016,1.0891545000000038,1.0869486918378624,1.0868940402744895,-278,-376651,-376477.2,-0.0030099934408700435,-280.9748686714409,0.10500234873674058
2023-08-17T17:15:00-04:00,1.08683,1.08729,1.08674,1.08702,1.08632,1.0870764444444445,1.0870399999999927,1.0868126666666578,1.0867555000000038,1.0879696000000008,1.0876448000000016,1.0891390500000038,1.0869629534702898,1.0869348322195913,271,-376380,-376595.6,0.00970913771840207,-280.92749235683783,0.07549254280979957
2023-08-17T17:30:00-04:00,1.08702,1.0874,1.08671,1.08698,1.08632,1.0870644444444446,1.0870744444444371,1.0869135555555465,1.0867150000000037,1.0879666000000008,1.0876358000000017,1.089123350000004,1.0869663627762318,1.0869558657756726,-560,-376940,-376670.4,0.024642791260841367,-280.94809915340096,0.028527519854236565
2023-08-17T17:45:00-04:00,1.08698,1.08712,1.08656,1.08683,1.086428,1.0870155555555556,1.0870866666666594,1.0869944444444353,1.086667500000004,1.0879676000000007,1.0876249000000016,1.0891045500000038,1.0869390902209854,1.086959092620538,-443,-377383,-376745.4,0.030322775428122895,-281.00923183293514,0.01012220259128888
2023-08-17T18:00:00-04:00,1.08683,1.0874,1.08682,1.08713,1.0865251999999999,1.0870242222222222,1.0870811111111038,1.087046222222213,1.0866665000000038,1.0879728000000006,1.0876187000000017,1.0890880500000037,1.0869772721767883,1.08695887409643,656,-376727,-376816.2,0.03694488459516198,-280.82815475556333,-0.004599054434417991
2023-08-17T18:15:00-04:00,1.08713,1.08741,1.08712,1.08727,1.08656,1.087062,1.0870777777777707,1.087071999999991,1.0866810000000036,1.0879708000000008,1.0876142000000015,1.089072050000004,1.0870358177414305,1.0869762992771437,610,-376117,-376709.4,0.03724704871937493,-280.74959929301514,-0.002759128115513151
2023-08-17T18:30:00-04:00,1.08727,1.08742,1.08723,1.08735,1.086662,1.0871164444444443,1.0870866666666597,1.0870813333333242,1.0867575000000036,1.0879656000000006,1.0876081000000015,1.089057150000004,1.0870986541931444,1.0870034394217147,401,-375716,-376576.6,0.036085232135434804,-280.7200942022833,0.007357877987995623
2023-08-17T18:45:00-04:00,1.08735,1.08745,1.08733,1.0873599999999999,1.0867681200000001,1.0871711111111109,1.0871077777777707,1.0870879999999912,1.0868200000000034,1.0879504000000009,1.0876004000000017,1.0890432500000038,1.0871509233545156,1.0870403515373712,253,-375463,-376281.2,0.030163202908229422,-280.71776744456963,0.01747656760211489
2023-08-17T19:00:00-04:00,1.0873599999999999,1.08749,1.08727,1.08733,1.0868772208000002,1.0872155555555556,1.087122222222215,1.0870951111111022,1.0868800000000036,1.087925000000001,1.0875906000000015,1.089027500000004,1.0871867386836125,1.0870898812298968,-494,-375957,-375996,0.026288428753996916,-280.7313967853583,0.011957321559967208
2023-08-17T19:15:00-04:00,1.08733,1.08745,1.08729,1.08732,1.086987521056,1.087255111111111,1.0871766666666596,1.0871142222222132,1.0869380000000037,1.0879042000000008,1.0875821000000017,1.089012100000004,1.08721339094689,1.087137104983917,-526,-376483,-375947.2,0.02217751475167815,-280.7362343231802,0.045085247922867555
2023-08-17T19:30:00-04:00,1.08732,1.0875,1.08728,1.08749,1.08707796726592,1.0873177777777778,1.087228888888882,1.0871444444444356,1.0870155000000037,1.0878812000000009,1.0875764000000017,1.088998050000004,1.087268712757512,1.0871836839871334,384,-376099,-375943.6,0.022421554131986522,-280.6761967997281,0.04323747493146128
2023-08-17T19:45:00-04:00,1.08749,1.08756,1.08737,1.08744,1.087162373812736,1.08736,1.087279999999993,1.0871831111111023,1.0871030000000037,1.0878632000000008,1.0875717000000016,1.0889831000000039,1.0873029702060095,1.0872245471897064,-682,-376781,-376156.6,0.019712849492639968,-280.7075534099039,0.04231908590773564
2023-08-17T20:00:00-04:00,1.08744,1.08755,1.08716,1.0873,1.08756,1.087364,1.087332222222215,1.0872279999999912,1.0871580000000036,1.0878274000000008,1.0875670000000017,1.0889675000000039,1.0873023761648075,1.0872548377517646,-2034,-378815,-376827,0.015602715100468149,-280.9694161333645,0.04324503372192252
2023-08-17T20:15:00-04:00,1.0873,1.08764,1.08728,1.08754,1.08716,1.0874055555555555,1.0873777777777704,1.0872791111111024,1.0872015000000037,1.0877894000000008,1.0875641000000016,1.088953450000004,1.087349900931846,1.0872874702014113,1217,-377598,-377155.2,0.016263189477589497,-280.7007874200379,0.03771398084865853
2023-08-17T20:30:00-04:00,1.08754,1.08789,1.08751,1.08775,1.08716,1.0874799999999998,1.087431111111104,1.0873299999999912,1.0872530000000038,1.0877474000000007,1.0875666000000017,1.0889410500000039,1.0874299207454767,1.0873307761611286,1015,-376583,-377175.2,0.017234749108741183,-280.5047946289681,0.044147267927932894
2023-08-17T20:45:00-04:00,1.08775,1.08921,1.08775,1.08896,1.0871891999999999,1.087785777777778,1.0876099999999929,1.0874062222222136,1.0873420000000038,1.087728800000001,1.0875818000000017,1.088934300000004,1.0877359365963815,1.0874242209289027,2714,-373869,-376729.2,0.022965732709598213,-277.485773714236,0.14806639996320314
2023-08-17T21:00:00-04:00,1.08896,1.08903,1.08844,1.08855,1.0873104479999998,1.0879737777777778,1.087742222222215,1.0874986666666582,1.0874045000000039,1.0876834000000009,1.0875980000000016,1.088925350000004,1.087898749277105,1.0875433767431217,-2189,-376058,-376584.6,0.028000397628667906,-278.30994540098305,0.1094393761035926
2023-08-17T21:15:00-04:00,1.08855,1.0889,1.08838,1.08862,1.0874244211199997,1.0881493333333332,1.0878855555555482,1.0876093333333248,1.0874720000000038,1.0876434000000008,1.0876146000000015,1.0889171500000039,1.088042999421684,1.087691501394497,2614,-373444,-375510.4,0.03380521975386953,-278.14185022850586,0.11863923555866328
2023-08-17T21:30:00-04:00,1.08862,1.08904,1.08852,1.089,1.0875315558527998,1.088372222222222,1.088072222222215,1.087748222222214,1.087563500000004,1.0875948000000009,1.0876336000000015,1.088910250000004,1.0882343995373471,1.0878684011155972,2560,-370884,-374167.6,0.041583400617799686,-277.2482418068343,0.15450833241363202
2023-08-17T21:45:00-04:00,1.089,1.08924,1.08872,1.08909,1.087632262501632,1.0885757777777778,1.0882499999999926,1.0879119999999916,1.087658000000004,1.087556200000001,1.0876551000000017,1.088903750000004,1.0884055196298776,1.0880635208924774,2297,-368587,-372568.4,0.049447556868878265,-277.05840709609066,0.14712778968080845
2023-08-17T22:00:00-04:00,1.08909,1.08938,1.08901,1.08931,1.0877608815015014,1.0887877777777777,1.0884577777777704,1.088081555555547,1.0877820000000038,1.087523600000001,1.0876815000000015,1.088898200000004,1.088586415703902,1.0882336167139814,2152,-366435,-371081.6,0.05693780050959759,-276.6236955479172,0.1719635106304751
2023-08-17T22:15:00-04:00,1.08931,1.08938,1.08913,1.08925,1.0879227933513513,1.0889462222222221,1.0886744444444372,1.0882679999999914,1.0878935000000038,1.0875104000000009,1.0877111000000017,1.0888930500000042,1.0887191325631216,1.088397693371185,-1696,-368131,-369496.2,0.06297688454643699,-276.71711248157237,0.1793433275085182
2023-08-17T22:30:00-04:00,1.08925,1.08928,1.08867,1.08904,1.0880685140162163,1.0890193333333333,1.0888411111111038,1.0884591111111024,1.087996500000004,1.087504800000001,1.0877360000000016,1.0888871500000041,1.0887833060504972,1.0885457546969475,-1747,-369878,-368783,0.07012326831095805,-277.0539222130391,0.1379259613439558
2023-08-17T22:45:00-04:00,1.08904,1.08915,1.08868,1.08883,1.0881996626145947,1.089017111111111,1.0889611111111042,1.0886368888888804,1.0880965000000038,1.087504000000001,1.0877584000000016,1.0888798000000042,1.0887926448403977,1.0886574037575576,-1598,-371476,-368901.4,0.07387709442467746,-277.36206516462954,0.0992875201103167
2023-08-17T23:00:00-04:00,1.08883,1.08883,1.08824,1.08834,1.08938,1.088892888888889,1.0888922222222153,1.0887653333333247,1.0881570000000038,1.087488200000001,1.0877748000000016,1.0888705500000042,1.0887021158723182,1.0887167230060457,-1858,-373334,-369850.8,0.07268623084134539,-278.198210384728,-0.05693505730236583
2023-08-17T23:15:00-04:00,1.08834,1.08865,1.08828,1.08863,1.0893572,1.0888404444444446,1.088901111111104,1.0888539999999916,1.0882250000000038,1.087482000000001,1.0877929000000015,1.0888597500000041,1.0886876926978546,1.0887369784048364,1942,-371392,-370842.2,0.06308482887786776,-277.68074341668506,0.007349226034640578
2023-08-17T23:30:00-04:00,1.08863,1.08889,1.08857,1.0887499999999999,1.089334856,1.0888102222222222,1.0889155555555485,1.0889022222222138,1.0882950000000038,1.0874870000000008,1.0878133000000016,1.0888489000000043,1.0887001541582837,1.0887331827238687,1623,-369769,-371169.8,0.058442453480631006,-277.5018396569138,0.01194172438499784
2023-08-17T23:45:00-04:00,1.0887499999999999,1.08877,1.0884,1.08859,1.0893129588800001,1.088745111111111,1.088869999999993,1.0889079999999915,1.0883565000000037,1.087511200000001,1.0878332000000015,1.0888389000000043,1.088678123326627,1.0887121461790945,-1707,-371476,-371489.4,0.052737995903944304,-277.75269614371047,-0.03764921946740326
2023-08-18T00:00:00-04:00,1.08859,1.0888,1.08857,1.08864,1.0892914997024001,1.0886991111111108,1.088819999999993,1.0888797777777695,1.0884220000000036,1.087540600000001,1.0878539000000016,1.0888273500000043,1.0886704986613016,1.0886877169432754,1472,-370004,-371195,0.0438270073599207,-277.6850857486121,-0.04131889926450885
2023-08-18T00:15:00-04:00,1.08864,1.0887,1.0883,1.08834,1.0892704697083522,1.088603111111111,1.0887122222222152,1.0888437777777695,1.0884730000000036,1.087560400000001,1.0878706000000016,1.088815550000004,1.0886043989290413,1.08866817355462,-1098,-371102,-370748.6,0.03251551618410643,-277.98766511369143,-0.08904719501334932
2023-08-18T00:30:00-04:00,1.08834,1.08852,1.08817,1.08824,1.0892498603141851,1.088508666666667,1.0885999999999931,1.0887835555555472,1.0885105000000037,1.087582600000001,1.0878879000000017,1.0888038500000043,1.088531519143233,1.0886369388436956,-1289,-372391,-370948.4,0.018658920189097077,-278.10610236675575,-0.09272435161808174
2023-08-18T00:45:00-04:00,1.08824,1.08834,1.08802,1.08823,1.0892066659016177,1.0884346666666667,1.0885099999999932,1.0887024444444362,1.0885500000000037,1.087572200000001,1.0879060000000016,1.0887928000000044,1.0884712153145863,1.0885911510749562,-1336,-373727,-371740,0.006050281646820216,-278.1183790704241,-0.0743774333357799
2023-08-18T01:00:00-04:00,1.08823,1.08833,1.08793,1.08809,1.0891354659475208,1.0883506666666667,1.0884277777777707,1.0886139999999918,1.0885895000000037,1.087578200000001,1.0879235000000016,1.0887791500000044,1.088394972251669,1.0885345208599646,-1559,-375286,-372502,-0.00552077969828455,-278.31894328938523,-0.06796285921585214
2023-08-18T01:15:00-04:00,1.08809,1.08815,1.08757,1.08779,1.089039028671719,1.0882231111111111,1.0883666666666596,1.0885233333333253,1.0886020000000038,1.087578400000001,1.0879357000000016,1.0887640000000045,1.0882739778013353,1.0884552166879713,-1742,-377028,-373906.8,-0.01721816411298014,-278.7992344417715,-0.05053567818880592
2023-08-18T01:30:00-04:00,1.08779,1.0883,1.08766,1.08822,1.0888921258045472,1.0881937777777777,1.088321111111104,1.088445111111103,1.0886255000000038,1.087599800000001,1.0879520000000016,1.0887516000000046,1.0882631822410682,1.0883869733503766,2074,-374954,-374677.2,-0.021294595949181535,-277.97938869948683,-0.037662015560844496
2023-08-18T01:45:00-04:00,1.08822,1.08849,1.0881399999999999,1.08829,1.0887599132240924,1.0881875555555556,1.088269999999993,1.088379111111103,1.0885920000000038,1.087626000000001,1.0879665000000016,1.0887398000000044,1.0882685457928545,1.0883343786803008,2366,-372588,-374716.6,-0.026779465285267586,-277.8271952091999,-0.0422502870263977
2023-08-18T02:00:00-04:00,1.08829,1.0885,1.08779,1.08839,1.088640921901683,1.0882115555555556,1.0882477777777706,1.0883266666666584,1.0885840000000038,1.0876774000000011,1.0879820000000016,1.0887272500000045,1.0882928366342837,1.0882987029442401,4069,-368519,-373675,-0.027593773115731874,-277.45330589660864,-0.018372389972347532
2023-08-18T02:15:00-04:00,1.08839,1.08872,1.08812,1.08822,1.08757,1.0882059999999998,1.088201111111104,1.0882813333333252,1.0885640000000039,1.0877196000000011,1.0879973000000016,1.0887145000000045,1.0882782693074269,1.0882753623553918,-2578,-371097,-372837.2,-0.029549560583958537,-277.8559740578376,-0.03858024691358823
2023-08-18T02:30:00-04:00,1.08822,1.08855,1.08779,1.08784,1.087593,1.0881337777777778,1.0881455555555484,1.0882371111111029,1.0885060000000037,1.087753800000001,1.0880116000000015,1.0886995500000045,1.0881906154459415,1.0882586898843132,-3142,-374239,-372279.4,-0.03348772831121336,-278.9531419099265,-0.04594152562619833
2023-08-18T02:45:00-04:00,1.08784,1.08799,1.08708,1.0871899999999999,1.08872,1.0879426666666665,1.0880288888888818,1.0881786666666584,1.0884110000000038,1.0877744000000011,1.0880100000000015,1.0886788500000044,1.0879904923567532,1.0882041519074501,-3226,-377465,-372781.6,-0.03613723574619031,-280.8807231718769,-0.09648606924945025
2023-08-18T03:00:00-04:00,1.0871899999999999,1.08729,1.08643,1.08729,1.0886871999999999,1.0877948888888886,1.0879244444444374,1.0881095555555471,1.0883100000000039,1.0878014000000011,1.0880094000000016,1.0886583500000042,1.0878503938854025,1.0881205215259597,5310,-372155,-372695,-0.036993267706288226,-280.3923080834369,-0.08637879859955531
2023-08-18T03:15:00-04:00,1.08729,1.0877,1.08728,1.08756,1.0885969119999999,1.087722,1.0878655555555485,1.0880331111111028,1.088225500000004,1.087838800000001,1.0880076000000016,1.0886382500000042,1.087792315108322,1.0880204172207673,3408,-368747,-372740.6,-0.0354952532972087,-279.54602052446,-0.048709206039934144
2023-08-18T03:30:00-04:00,1.08756,1.08758,1.08671,1.08712,1.0885102355199998,1.087572888888889,1.0877911111111043,1.0879511111111029,1.088129500000004,1.087857200000001,1.0879923000000016,1.0886161000000043,1.0876578520866576,1.0878963337766134,-4066,-372813,-373083.8,-0.03509158865224853,-281.19102401852007,-0.06159277066345052
2023-08-18T03:45:00-04:00,1.08712,1.08782,1.08709,1.08731,1.0884270260991997,1.0874766666666666,1.087689999999993,1.0878599999999916,1.088053500000004,1.087870000000001,1.0879819000000017,1.0885947000000042,1.087588281669326,1.0877758670212905,3031,-369782,-372192.4,-0.031934494242583794,-280.66128489128505,-0.08362279686092577
2023-08-18T04:00:00-04:00,1.08731,1.08769,1.08707,1.08727,1.0883471450552318,1.0873926666666665,1.0875766666666595,1.0877695555555473,1.0880000000000039,1.0878810000000012,1.0879747000000015,1.0885738000000043,1.087524625335461,1.0876826936170318,-3014,-372796,-371258.6,-0.03384053283494702,-280.77216403338815,-0.09372501814773827
2023-08-18T04:15:00-04:00,1.08727,1.08756,1.08704,1.08715,1.0882704592530226,1.0873073333333334,1.0874388888888817,1.0876724444444363,1.087926000000004,1.087880400000001,1.0879647000000015,1.0885460500000042,1.0874497002683687,1.0876025548936252,-3017,-375813,-371990.2,-0.03911209932064218,-281.1051448017343,-0.11392974944642159
2023-08-18T04:30:00-04:00,1.08715,1.08766,1.0869,1.08697,1.0881968408829017,1.0872135555555555,1.0872999999999928,1.087559333333325,1.087837000000004,1.0878738000000012,1.0879554000000013,1.0885186500000044,1.087353760214695,1.0875148439148998,-2988,-378801,-374001,-0.04490164141774026,-281.59986954073094,-0.11486647920457016
2023-08-18T04:45:00-04:00,1.08697,1.08697,1.08637,1.08674,1.0881261672475857,1.0871015555555557,1.0871777777777707,1.0874366666666584,1.087744500000004,1.0878632000000013,1.0879424000000015,1.0884927500000043,1.087231008171756,1.0874294751319193,-2894,-381695,-375777.4,-0.04971221547649759,-282.212232347432,-0.10111781144284812
2023-08-18T05:00:00-04:00,1.08674,1.08691,1.08628,1.0864,1.0880207972127305,1.086946,1.0870899999999928,1.0873166666666583,1.087632500000004,1.0878478000000011,1.0879263000000015,1.0884649000000044,1.087064806537405,1.0873247801055352,-2815,-384510,-378723,-0.05336826422643077,-283.09293978435346,-0.07266439168865116
2023-08-18T05:15:00-04:00,1.0864,1.08681,1.08624,1.0868,1.0878815334357121,1.0868879999999999,1.0870355555555482,1.0872084444444359,1.0875555000000041,1.0878398000000011,1.0879184000000015,1.0884394000000044,1.087011845229924,1.0872222240844278,2477,-382033,-380570.4,-0.04890222838085479,-282.18093683884547,-0.04506617369791881
2023-08-18T05:30:00-04:00,1.0868,1.08732,1.08657,1.08695,1.087717380092141,1.086870888888889,1.0869677777777704,1.0871142222222137,1.087491000000004,1.087842200000001,1.0879087000000016,1.0884124500000043,1.0869994761839392,1.0871321792675421,2537,-379496,-381307,-0.04594523352654549,-281.8307804163204,-0.05608885946522485
2023-08-18T05:45:00-04:00,1.08695,1.08701,1.08662,1.08684,1.0875696420829268,1.0868453333333332,1.0869366666666593,1.087041555555547,1.087421500000004,1.087838600000001,1.0879041000000016,1.0883849500000045,1.0869675809471513,1.0870549434140333,-2191,-381687,-381884.2,-0.046438489691307316,-282.0525109467037,-0.02575612627861303
2023-08-18T06:00:00-04:00,1.08684,1.0875,1.08679,1.08734,1.08624,1.086926,1.0869399999999927,1.0869939999999914,1.0873840000000041,1.087845800000001,1.0879062000000015,1.0883582500000044,1.087042064757721,1.0870171547312262,2277,-379410,-381427.2,-0.04051976351109294,-281.00497865124174,0.0027591027397866744
2023-08-18T06:15:00-04:00,1.08734,1.08765,1.08718,1.08757,1.0862652000000002,1.0870520000000001,1.0869733333333262,1.0869706666666583,1.0873730000000041,1.087860600000001,1.0879141000000014,1.0883316000000043,1.087147651806177,1.0870337237849808,1888,-377522,-380029.6,-0.03585246493878538,-280.6056187454166,0.027592042454952954
2023-08-18T06:30:00-04:00,1.08757,1.0876,1.08661,1.08662,1.086320592,1.0869813333333331,1.0869144444444372,1.086946444444436,1.0872930000000038,1.087850400000001,1.0879116000000015,1.0883005500000045,1.0870421214449415,1.0870397790279842,-2109,-379631,-379549.2,-0.036708288663012734,-282.44784499292257,-0.048751322264649906
2023-08-18T06:45:00-04:00,1.08662,1.0867,1.08621,1.0863099999999999,1.08765,1.0868604444444443,1.0868411111111038,1.0869211111111028,1.087194000000004,1.087831200000001,1.0879010000000013,1.0882680500000044,1.0868956971559531,1.0870190232223869,-1946,-381577,-379965.4,-0.03607191081680294,-283.0030160738893,-0.060719247081345844
2023-08-18T07:00:00-04:00,1.0863099999999999,1.08655,1.08621,1.08628,1.0876212,1.0867482222222222,1.0867899999999926,1.0868917777777696,1.0870885000000041,1.0878098000000012,1.0878877000000013,1.0882337500000043,1.0867725577247624,1.0869800185779093,-2657,-384234,-380474.8,-0.03361781082544765,-283.07639291843634,-0.04232843182363095
2023-08-18T07:15:00-04:00,1.08628,1.08645,1.08602,1.08615,1.087592976,1.086620222222222,1.086762222222215,1.086856222222214,1.086985000000004,1.087785600000001,1.0878680000000014,1.0882006000000044,1.08664804617981,1.086901214862327,-2062,-386296,-381852,-0.029236128389894166,-283.3231617073305,-0.023011782032408272
2023-08-18T07:30:00-04:00,1.08615,1.0866,1.08605,1.0866,1.08753005696,1.0865877777777777,1.0867399999999927,1.0868095555555473,1.086923000000004,1.0877710000000012,1.0878480000000013,1.0881712000000043,1.086638436943848,1.0867993718898614,2186,-384110,-383169.6,-0.02030114385570284,-282.41748569572974,-0.018402649981595322
2023-08-18T07:45:00-04:00,1.0866,1.08706,1.08619,1.08629,1.0874696546815998,1.0864977777777776,1.0866666666666596,1.0867599999999917,1.086878000000004,1.0877504000000011,1.0878273000000014,1.0881394500000043,1.0865687495550784,1.0867046975118888,-2866,-386976,-384638.6,-0.018203923372368255,-283.23513708538565,-0.06072036432219558
2023-08-18T08:00:00-04:00,1.08629,1.08672,1.08598,1.08653,1.0874116684943358,1.0864704444444444,1.0866322222222151,1.0867182222222138,1.086840000000004,1.0877312000000012,1.0878062000000015,1.0881110000000043,1.0865609996440628,1.0866377580095108,3667,-383309,-384985,-0.019177106294003435,-282.42496668889845,-0.028523057671785403
2023-08-18T08:15:00-04:00,1.08653,1.08667,1.08522,1.08526,1.0873257683846755,1.0861959999999997,1.086401111111104,1.0866404444444362,1.0867250000000042,1.087687600000001,1.0877754000000013,1.0880765000000043,1.0863007997152503,1.0865434064076083,-4995,-388304,-385799,-0.024822474395112388,-288.2634156962894,-0.1912925120017733
2023-08-18T08:30:00-04:00,1.08526,1.08539,1.0844799999999999,1.08512,1.0871573069139016,1.0859397777777777,1.086128888888882,1.0865137777777696,1.0866250000000042,1.0876440000000012,1.0877357000000014,1.0880432500000043,1.0860646397722002,1.0864267251260862,-5728,-394032,-387346.2,-0.03456236343963081,-289.00233540216533,-0.22527285600005897
2023-08-18T08:45:00-04:00,1.08512,1.08576,1.0849199999999999,1.08554,1.0868895762225115,1.085822,1.086008888888882,1.0863675555555472,1.0865365000000042,1.0876040000000011,1.0876967000000013,1.0880118500000042,1.0859597118177602,1.0862909801008689,4779,-389253,-388374.8,-0.046322997066943566,-287.15260449682825,-0.09939077138281735
2023-08-18T09:00:00-04:00,1.08554,1.08686,1.0853,1.08669,1.0844799999999999,1.0859582222222224,1.0860511111111042,1.0862444444444361,1.0865075000000042,1.0875828000000012,1.0876651000000013,1.0879873500000041,1.0861057694542082,1.0861983840806948,5476,-383777,-387735,-0.04296278895658104,-281.35143641458353,0.03498080658376034
2023-08-18T09:15:00-04:00,1.08669,1.08678,1.08598,1.08604,1.0845276,1.085956,1.0860244444444376,1.0861228888888808,1.0864520000000042,1.0875244000000013,1.0876266000000014,1.0879590500000043,1.0860926155633666,1.0861047072645555,-5098,-388875,-388848.2,-0.04005927369966663,-284.4007881156208,-0.022093751150717864
2023-08-18T09:30:00-04:00,1.08604,1.08649,1.08571,1.08641,1.084574248,1.086033111111111,1.0860533333333264,1.0860533333333253,1.086424000000004,1.0874816000000012,1.0875825000000015,1.0879367500000043,1.0861560924506932,1.0860757658116442,7394,-381481,-387483.6,-0.03562059919893287,-281.88174645969514,0.02393776181928362
2023-08-18T09:45:00-04:00,1.08641,1.08762,1.08606,1.08707,1.08461996304,1.0862364444444443,1.0861055555555488,1.0860486666666587,1.0864405000000041,1.0874506000000013,1.0875470000000014,1.0879154500000043,1.0863388739605546,1.086130612649315,7873,-373608,-383398.8,-0.027590831691266044,-277.0988560223841,0.04325418737345577
2023-08-18T10:00:00-04:00,1.08707,1.08735,1.08672,1.08714,1.0847399645184,1.0864433333333332,1.0861999999999932,1.086086888888881,1.086477500000004,1.087413400000001,1.0875041000000014,1.0878957000000042,1.0864990991684438,1.086238490119452,5513,-368095,-379167.2,-0.02437330025677639,-276.74385588439844,0.07824798166235696
2023-08-18T10:15:00-04:00,1.08714,1.08815,1.08674,1.08771,1.084855165937664,1.0867453333333332,1.0863311111111045,1.0861428888888809,1.086523000000004,1.0873858000000012,1.0874710000000014,1.0878801500000044,1.086741279334755,1.0863655920955613,4507,-363588,-375129.4,-0.01704411484963317,-274.3807839709376,0.1086026156663837
2023-08-18T10:30:00-04:00,1.08771,1.0881,1.0871,1.08715,1.085052855981404,1.086909111111111,1.0865411111111043,1.0862462222222145,1.086533000000004,1.0873426000000013,1.0874331000000013,1.0878624000000041,1.086823023467804,1.0865116736764486,-4369,-367957,-370945.8,-0.01287163730093365,-276.6301335218285,0.1741518161546698
2023-08-18T10:45:00-04:00,1.08715,1.08777,1.08684,1.0872,1.08523868462252,1.087040888888889,1.0867722222222156,1.0863899999999922,1.086551000000004,1.087301600000001,1.0874060000000014,1.0878472500000043,1.0868984187742432,1.0866601389411585,5124,-362833,-367216.2,0.003887305821229656,-276.39447146967433,0.19168386906515958
2023-08-18T11:00:00-04:00,1.0872,1.08765,1.08688,1.08754,1.0854133635451688,1.0871944444444446,1.0869944444444377,1.08656777777777,1.086561000000004,1.0872716000000013,1.0873882000000017,1.0878330000000043,1.0870267350193945,1.0867977111529263,3647,-359186,-364331.8,0.023090852359031543,-275.25394534752564,0.1842401017005363
2023-08-18T11:15:00-04:00,1.08754,1.0879699999999999,1.08728,1.08737,1.0855775617324588,1.0872695555555556,1.0870699999999933,1.0867417777777701,1.086551000000004,1.0872424000000012,1.0873732000000016,1.0878157000000044,1.0870953880155156,1.0869169689223408,-3286,-362472,-363207.2,0.03980088164980873,-275.7676000176987,0.06257534347422117
2023-08-18T11:30:00-04:00,1.08737,1.08755,1.08687,1.08691,1.0857319080285113,1.0872375555555556,1.0871666666666602,1.0869088888888812,1.0865655000000038,1.0872138000000013,1.0873510000000015,1.0877915000000042,1.0870583104124125,1.0869803751378722,-3063,-365535,-363596.6,0.04471921861473284,-277.06336870728893,0.08010754668337709
2023-08-18T11:45:00-04:00,1.08691,1.08765,1.08687,1.08743,1.0858769935468007,1.0872902222222223,1.0872799999999936,1.087056666666659,1.086621500000004,1.0871898000000013,1.0873359000000016,1.0877742500000043,1.08713264832993,1.0870423001102973,2422,-363113,-362627.8,0.05396003460340522,-275.9046343134572,0.09388720648740335
2023-08-18T12:00:00-04:00,1.08743,1.08749,1.08707,1.08715,1.0860133739339926,1.0872642222222222,1.0872888888888823,1.0871599999999926,1.086665000000004,1.0871578000000013,1.0873224000000015,1.0877504000000042,1.0871361186639439,1.0870898400882374,-2780,-365893,-363239.8,0.057086940250669016,-276.62045050392425,0.007359231696218276
2023-08-18T12:15:00-04:00,1.08715,1.08755,1.08707,1.08735,1.086141571497953,1.0872764444444445,1.0873122222222156,1.087223555555548,1.0867250000000042,1.0871330000000012,1.0873221000000013,1.0877295000000042,1.0871788949311552,1.0871202720705895,1928,-363965,-364195.6,0.054972141459842395,-276.2657616385423,0.019316739334404354
2023-08-18T12:30:00-04:00,1.08735,1.08755,1.08712,1.08721,1.0862620772080758,1.087256,1.08725666666666,1.0872608888888815,1.086755500000004,1.0871044000000014,1.0873225000000013,1.0877127000000042,1.0871851159449242,1.0871382176564712,-2143,-366108,-364922.8,0.050969011524817684,-276.54168015603904,-0.045968134888889955
2023-08-18T12:45:00-04:00,1.08721,1.0874,1.08679,1.0873,1.0863753525755913,1.0872646666666665,1.0872733333333267,1.0872822222222147,1.0868060000000042,1.0870836000000013,1.0873220000000012,1.0876959000000042,1.0872080927559393,1.0871681741251766,2693,-363415,-364498.8,0.044127679767635285,-276.31875174294515,0.013797544037149653
2023-08-18T13:00:00-04:00,1.0873,1.08807,1.0873,1.08777,1.0864818314210558,1.087364,1.08733666666666,1.087293555555548,1.086868000000004,1.0870742000000013,1.0873284000000012,1.0876803000000042,1.0873204742047515,1.0872057393001409,2503,-360912,-364058.6,0.043344933751683884,-275.2367964408207,0.05242825607063645
2023-08-18T13:15:00-04:00,1.08777,1.08778,1.08684,1.08722,1.0865819215357924,1.0873406666666665,1.0873011111111046,1.0872959999999927,1.086966000000004,1.0870540000000013,1.0873131000000014,1.087663000000004,1.0873003793638012,1.0872385914401124,-2301,-363213,-363522.6,0.04050457883587733,-276.400231725853,-0.02942420508669805
2023-08-18T13:30:00-04:00,1.08722,1.08763,1.08711,1.08763,1.086676006243645,1.0874064444444447,1.0873299999999935,1.0872995555555482,1.087091500000004,1.0870448000000013,1.0873115000000013,1.087650500000004,1.087366303491041,1.0872760731520894,1871,-361342,-362998,0.03094587757041038,-275.69466155606216,0.023910904292021026
2023-08-18T13:45:00-04:00,1.08763,1.08812,1.08756,1.08793,1.0867644458690262,1.0875264444444446,1.0874433333333269,1.0873368888888817,1.087211000000004,1.0870476000000013,1.087313000000001,1.0876386500000041,1.087479042792833,1.0873348585216713,1510,-359832,-361742.8,0.023784744123706146,-275.27815962066137,0.09384401652390914
2023-08-18T14:00:00-04:00,1.08793,1.08798,1.08744,1.08756,1.0868475791168846,1.0875497777777778,1.0874577777777712,1.0873737777777706,1.087254500000004,1.0870344000000014,1.0873171000000013,1.0876289500000043,1.0874952342342663,1.0873922868173367,-1717,-361549,-361369.6,0.020913831510554964,-275.8621034405762,0.011954792492407376
2023-08-18T14:15:00-04:00,1.08756,1.08774,1.08737,1.08752,1.0869257243698716,1.0875622222222223,1.0874988888888826,1.087406222222215,1.087328500000004,1.0870190000000013,1.087322500000001,1.0876221000000041,1.087500187387413,1.0874282294538689,-1238,-362787,-361744.6,0.018105683056197194,-275.90763656058806,0.03403394195832971
2023-08-18T14:30:00-04:00,1.08752,1.08803,1.08752,1.08782,1.0869991809076793,1.0876264444444446,1.0875511111111047,1.0874562222222148,1.087399000000004,1.0870076000000013,1.087342500000001,1.0876160000000044,1.0875641499099304,1.0874809835630947,1402,-361385,-361379,0.016470770622986092,-275.52088505256984,0.04322435278428936
2023-08-18T14:45:00-04:00,1.08782,1.08795,1.08767,1.08781,1.0870682300532186,1.087678222222222,1.0876177777777716,1.0875137777777706,1.087436000000004,1.0869994000000012,1.0873595000000011,1.0876117000000043,1.0876133199279443,1.0875303868504753,-1544,-362929,-361696.4,0.014569235397847102,-275.53507857723395,0.05518713036119369
2023-08-18T15:00:00-04:00,1.08781,1.08782,1.08732,1.08733,1.0871331362500256,1.0876206666666668,1.0876211111111047,1.0875493333333262,1.087445500000004,1.0869892000000014,1.087371500000001,1.0876036500000044,1.0875566559423555,1.0875459094803799,-1869,-364798,-362689.6,0.014534037191468051,-276.35978142056143,0.002759128115513151
2023-08-18T15:15:00-04:00,1.08733,1.08767,1.08721,1.08765,1.087194148075024,1.0876264444444446,1.0876077777777715,1.0875793333333263,1.0874425000000039,1.0869984000000015,1.087386400000001,1.0875992500000045,1.0875753247538844,1.0875619275843034,1551,-363247,-363029.2,0.015518974837104989,-275.9033238593793,-0.011031743842898588
2023-08-18T15:30:00-04:00,1.08765,1.08769,1.08735,1.08752,1.08721,1.0876088888888888,1.0876411111111048,1.0876077777777706,1.087461000000004,1.0870030000000015,1.0874022000000012,1.0875927000000045,1.0875642598031074,1.0875747420674422,-1845,-365092,-363490.2,0.014052145766004772,-276.12384516678515,0.027593311381318125
2023-08-18T15:45:00-04:00,1.08752,1.08789,1.08721,1.08727,1.08815,1.0875346666666665,1.0876011111111046,1.0876177777777707,1.0874645000000038,1.0869972000000012,1.087418000000001,1.0875839500000044,1.087505407842486,1.0875629936539533,-2244,-367336,-364680.4,0.013986387575618747,-276.6396977488068,-0.033099491555045185
2023-08-18T16:00:00-04:00,1.08727,1.08737,1.08713,1.08724,1.0881311999999999,1.0874624444444443,1.0875244444444379,1.0875991111111039,1.087449500000004,1.0869996000000013,1.087428400000001,1.0875785500000044,1.0874523262739888,1.0875307949231623,-1202,-368538,-365802.2,0.010224845894111713,-276.67286338383764,-0.06342319818371397
2023-08-18T16:15:00-04:00,1.08724,1.08728,1.08701,1.08702,1.0880911519999998,1.0873615555555556,1.0874644444444381,1.0875677777777706,1.0874320000000037,1.0869938000000015,1.0874319000000012,1.0875661000000043,1.087365861019191,1.0874926359385293,-475,-369013,-366645.2,0.004133821977035429,-276.768978317063,-0.0496524329692141
2023-08-18T16:30:00-04:00,1.08702,1.08708,1.08689,1.08691,1.0880262828799998,1.0872506666666666,1.0873966666666601,1.0875255555555485,1.0874320000000037,1.0869866000000015,1.087433800000001,1.0875544500000043,1.0872746888153528,1.087432508750823,-409,-369422,-367880.2,0.00017078633997754376,-276.81036669998144,-0.056090922465793676
2023-08-18T16:45:00-04:00,1.08691,1.08734,1.08676,1.08682,1.0879353802496,1.0871353333333333,1.087285555555549,1.0874544444444374,1.087401500000004,1.0869800000000014,1.087430200000001,1.0875481500000044,1.0871837510522822,1.087356407000658,-1135,-370557,-368973.2,-0.005872445748575418,-276.9043487224122,-0.0919269732124903
2023-08-20T17:00:00-04:00,1.08659,1.08698,1.08659,1.08687,1.0878178422246398,1.0870522222222223,1.0871811111111045,1.0873704444444374,1.087387500000004,1.0869780000000013,1.0874259000000008,1.0875450500000043,1.0871210008418257,1.087279525600526,42,-370515,-369609,-0.012156830115033187,-276.9024164797225,-0.08641214918045807
2023-08-20T17:15:00-04:00,1.08687,1.0872,1.08679,1.0872,1.087670501157683,1.087056,1.08716666666666,1.0872988888888817,1.087380000000004,1.0869872000000016,1.0874252000000009,1.0875448000000043,1.0871368006734605,1.0872164204804204,518,-369997,-369900.8,-0.01798558788145616,-276.7451391604479,-0.011955891955520725
2023-08-20T17:30:00-04:00,1.0872,1.08726,1.08701,1.08706,1.087540841018761,1.0870346666666668,1.0871011111111044,1.087226222222215,1.0873725000000038,1.0870004000000015,1.087424100000001,1.0875429000000043,1.0871214405387684,1.0871675363843358,-562,-370559,-370210,-0.01919888450250621,-276.8175085497047,-0.05424539144026943
2023-08-20T17:45:00-04:00,1.08706,1.08732,1.087,1.08722,1.0874267400965096,1.0870584444444444,1.087067777777771,1.0871604444444372,1.0873685000000042,1.0870088000000013,1.0874243000000008,1.0875417500000042,1.0871411524310146,1.0871408291074682,677,-369882,-370302,-0.023197182179290104,-276.7178636359004,-0.02758569957333814
2023-08-20T18:00:00-04:00,1.08722,1.08777,1.08711,1.08776,1.08659,1.0871968888888888,1.0871222222222154,1.0871277777777704,1.087368000000004,1.0870250000000015,1.0874336000000009,1.0875427500000043,1.0872649219448116,1.087157063285974,393,-369489,-370088.4,-0.02300402931772032,-276.52266855118893,0.04506700267643745
2023-08-20T18:15:00-04:00,1.08776,1.08785,1.0876,1.08775,1.0866136,1.0873224444444445,1.087178888888882,1.0871273333333258,1.0873945000000043,1.0870432000000014,1.087440900000001,1.0875428500000044,1.0873619375558492,1.0872052506287786,-380,-369869,-369959.2,-0.018502209973722122,-276.52616196885464,0.04690776645450963
2023-08-20T18:30:00-04:00,1.08775,1.0877999999999999,1.08764,1.08768,1.086663056,1.0874226666666664,1.0872522222222154,1.0871444444444367,1.0873970000000042,1.0870500000000014,1.0874479000000008,1.0875418500000043,1.0874255500446794,1.0872630005030224,-295,-370164,-369992.6,-0.016469919515616094,-276.5451461104313,0.06071645415906633
2023-08-20T18:45:00-04:00,1.08768,1.0877,1.08732,1.08741,1.0867105337599998,1.0874542222222223,1.087307777777771,1.0871857777777703,1.087371000000004,1.0870468000000015,1.0874537000000009,1.0875393000000042,1.0874224400357435,1.0873232004024176,-645,-370809,-370042.6,-0.011920115084434862,-276.7052575402636,0.04600196888426318
2023-08-20T19:00:00-04:00,1.08741,1.08743,1.0872,1.08726,1.0867561124096,1.0874446666666666,1.0873566666666599,1.087243555555548,1.0873560000000038,1.0870596000000015,1.087455000000001,1.0875368500000042,1.0873899520285948,1.0873729603219338,-545,-371354,-370337,-0.005767543052656241,-276.7804361757369,0.04048508492666642
2023-08-20T19:15:00-04:00,1.08726,1.08732,1.08718,1.08727,1.0867998679132158,1.0874273333333333,1.0874011111111044,1.0872993333333256,1.0873435000000038,1.0870788000000013,1.087455000000001,1.0875346000000041,1.087365961622876,1.0873931682575466,849,-370505,-370540.2,-0.00035910746875009164,-276.7726275559035,0.036802929513185194
2023-08-20T19:30:00-04:00,1.08727,1.0873599999999999,1.08716,1.08722,1.0868418731966871,1.087391111111111,1.0874033333333264,1.0873442222222145,1.0873135000000038,1.0870976000000017,1.0874537000000009,1.0875309000000042,1.0873367692983007,1.0873881346060368,-726,-371231,-370812.6,0.004173584320930942,-276.8060139272739,0.0018395879323152156
2023-08-20T19:45:00-04:00,1.08722,1.08752,1.08717,1.08748,1.0868821982688197,1.0874064444444445,1.0874499999999931,1.0873837777777702,1.0872970000000037,1.0871242000000014,1.0874549000000011,1.0875276500000042,1.0873654154386405,1.087376107684829,424,-370807,-370941.2,0.008237805879733929,-276.704617705718,0.038636321822170534
2023-08-20T20:00:00-04:00,1.08748,1.08821,1.08743,1.08803,1.0869209103380668,1.0875224444444445,1.087539999999993,1.0874302222222145,1.0873320000000037,1.0871528000000015,1.087461900000001,1.0875262500000042,1.0874983323509124,1.0873912861478625,1368,-369439,-370667.2,0.016195168864952453,-276.0127429126183,0.07450194072956506
2023-08-20T20:15:00-04:00,1.08803,1.08842,1.08781,1.08835,1.0869982557177829,1.0876844444444445,1.0876055555555486,1.0874799999999922,1.0873670000000037,1.0871940000000015,1.087472200000001,1.087527150000004,1.08766866588073,1.0874470289182896,1032,-368407,-370077.8,0.02211956300425148,-275.70922187000014,0.05423990586157502
2023-08-20T20:30:00-04:00,1.08835,1.08841,1.08803,1.08809,1.0871119952603603,1.0877813333333333,1.0876433333333264,1.0875284444444366,1.0873955000000035,1.0872252000000016,1.087478200000001,1.087527300000004,1.087752932704584,1.0875244231346313,-1010,-369417,-369860.2,0.023227064259646445,-275.95050454560993,0.031257182256953064
2023-08-20T20:45:00-04:00,1.08809,1.08821,1.08795,1.0879699999999999,1.0872166356395314,1.0878466666666666,1.0876755555555486,1.0875828888888812,1.0874305000000037,1.0872794000000015,1.087483500000001,1.087527600000004,1.0877963461636673,1.0876163385077047,-1397,-370814,-369776.8,0.023279155434606704,-276.104572683356,0.026662253603992117
2023-08-20T21:00:00-04:00,1.0879699999999999,1.0879699999999999,1.08737,1.08754,1.087312904788369,1.0878195555555554,1.0876899999999932,1.087630888888881,1.0874455000000036,1.0873278000000015,1.087485900000001,1.0875264500000041,1.0877450769309338,1.0876922708061634,-2226,-373040,-370223.4,0.0208091118689798,-276.98435797155315,0.011955012368836362
2023-08-20T21:15:00-04:00,1.08754,1.08769,1.08696,1.08733,1.08842,1.0877475555555556,1.0876977777777708,1.0876624444444367,1.0874610000000036,1.0873636000000015,1.087483800000001,1.0875239500000042,1.087662061544747,1.0877250166449302,-3093,-376133,-371562.2,0.019679246671360704,-277.58160496936483,0.006438202453876212
2023-08-20T21:30:00-04:00,1.08733,1.08758,1.08703,1.08712,1.0883908,1.0876320000000002,1.0876811111111042,1.0876775555555478,1.0874715000000035,1.0873722000000015,1.0874775000000012,1.0875220500000042,1.0875536492357976,1.0877020133159436,-2180,-378313,-373543.4,0.017953840239137084,-278.0026363029982,-0.013796021227466265
2023-08-20T21:45:00-04:00,1.08712,1.08737,1.08702,1.08733,1.088362184,1.0875617777777777,1.0876933333333263,1.0876875555555476,1.0874970000000037,1.0873980000000014,1.087461200000001,1.0875215000000042,1.087508919388638,1.0876532106527546,2207,-376106,-374881.2,0.016666112005674312,-277.5763080227719,0.010117547506469017
2023-08-20T22:00:00-04:00,1.08733,1.08764,1.08701,1.08752,1.08833414032,1.0875271111111111,1.0876977777777708,1.087691999999992,1.0875295000000036,1.0874202000000013,1.087450900000001,1.0875244500000043,1.0875111355109104,1.087596168522203,1875,-374231,-375564.6,0.016359087219293366,-277.2486705989905,0.0036782285651267154
2023-08-20T22:15:00-04:00,1.08752,1.0881,1.08748,1.088,1.0883066575136,1.0875875555555556,1.0876944444444376,1.087692888888881,1.0875695000000036,1.0874388000000015,1.0874447000000012,1.0875296500000042,1.0876089084087284,1.0875689348177622,1693,-372538,-375464.2,0.016191892757249554,-276.50142916894777,-0.00275727691331806
2023-08-20T22:30:00-04:00,1.088,1.08838,1.08791,1.08811,1.08696,1.0876706666666665,1.087667777777771,1.087686888888881,1.0876220000000036,1.0874582000000013,1.0874358000000008,1.0875347000000042,1.0877091267269827,1.0875783478542094,1584,-370954,-374428.4,0.012942489984769606,-276.3412821101245,-0.022051729682548628
2023-08-20T22:45:00-04:00,1.08811,1.08821,1.08796,1.08813,1.0869883999999999,1.0877631111111112,1.0876722222222155,1.0876851111111034,1.0876675000000036,1.0874666000000013,1.087426200000001,1.0875406500000042,1.0877933013815861,1.087626278283367,1330,-369624,-372690.6,0.006234520417291722,-276.3168360522809,0.0036761664935841707
2023-08-20T23:00:00-04:00,1.08813,1.08829,1.08804,1.08812,1.0870162319999999,1.0878526666666666,1.087688888888882,1.0876842222222145,1.0876855000000039,1.0874860000000013,1.0874143000000012,1.0875479000000041,1.0878586411052689,1.0876962226266933,-1238,-370862,-371641.8,0.0025698871398092565,-276.3282133693295,0.013787144866135512
2023-08-20T23:15:00-04:00,1.08812,1.08827,1.08791,1.08823,1.0870435073599998,1.0879608888888888,1.0877655555555485,1.08769777777777,1.0877095000000039,1.0875066000000013,1.0874041000000012,1.0875576000000042,1.087932912884215,1.0877805781013543,1029,-369833,-370762.2,0.0029025555625778274,-276.2241899160338,0.06344594221822457
2023-08-20T23:30:00-04:00,1.08823,1.08823,1.08802,1.08819,1.0870702372127998,1.088045777777778,1.0878611111111043,1.0877311111111034,1.087735000000004,1.0875196000000014,1.0873956000000011,1.0875658000000044,1.087984330307372,1.0878556624810831,-782,-370615,-370377.6,0.006951990116917568,-276.25293383965294,0.07909282370578233
2023-08-20T23:45:00-04:00,1.08819,1.0882,1.08799,1.08804,1.087096432468544,1.0880815555555554,1.0879633333333265,1.0877902222222144,1.0877665000000039,1.0875330000000014,1.0873877000000012,1.0875730500000043,1.0879954642458975,1.087912929984866,-850,-371465,-370479.8,0.011903125457236308,-276.37010087849734,0.08462727205826494
2023-08-21T00:00:00-04:00,1.08804,1.08813,1.08782,1.08808,1.087122103819173,1.088104888888889,1.0880466666666597,1.0878651111111035,1.087807500000004,1.0875564000000013,1.0873851000000012,1.0875799500000043,1.088012371396718,1.0879567439878923,1103,-370362,-370627.4,0.017795066498679173,-276.3295508987171,0.06897629974341078
2023-08-21T00:15:00-04:00,1.08808,1.0883,1.08807,1.0883,1.0871472617427895,1.0881555555555555,1.0881333333333265,1.0879539999999923,1.087859000000004,1.0875738000000015,1.0873818000000013,1.0875873500000042,1.0880698971173743,1.0879989951903135,659,-369703,-370395.6,0.022158554922828356,-276.1963070195905,0.07172281889068734
2023-08-21T00:30:00-04:00,1.0883,1.0883,1.08802,1.0881,1.0871719165079337,1.088148888888889,1.0881444444444375,1.08802977777777,1.0879030000000038,1.0875928000000012,1.0873753000000013,1.0875943000000041,1.0880759176938994,1.0880275961522503,-950,-370653,-370559.6,0.023856131332463445,-276.3708912335021,0.009191176470587223
2023-08-21T00:45:00-04:00,1.0881,1.0881399999999999,1.08798,1.08811,1.087196078177775,1.0881419999999997,1.0881444444444375,1.0880864444444367,1.087934500000004,1.0876080000000012,1.0873705000000013,1.0876018500000042,1.0880827341551196,1.0880472769218,928,-369725,-370381.6,0.020970692243254853,-276.3623626056188,0
2023-08-21T01:00:00-04:00,1.08811,1.08873,1.08804,1.08826,1.0872197566142194,1.088165111111111,1.088158888888882,1.0881255555555478,1.087946000000004,1.0876290000000013,1.0873667000000014,1.0876103000000041,1.0881181873240957,1.0880718215374394,1482,-368243,-369737.2,0.018934693690287326,-276.1580634079273,0.011947101908775924
2023-08-21T01:15:00-04:00,1.08826,1.08843,1.08808,1.08815,1.0872801663496507,1.0881633333333331,1.0881622222222154,1.0881486666666589,1.087936000000004,1.0876460000000012,1.0873648000000014,1.087617700000004,1.0881245498592766,1.0880942572299512,-1158,-369401,-369545,0.018593193788403455,-276.2751126424852,0.002757048854903365
2023-08-21T01:30:00-04:00,1.08815,1.0883,1.0879699999999999,1.08813,1.0873381596956646,1.0881568888888886,1.0881511111111044,1.0881522222222144,1.087938000000004,1.0876532000000012,1.0873637000000014,1.087625800000004,1.0881256398874213,1.0881054057839605,-1631,-371032,-369810.8,0.01964822284065959,-276.3050901272069,-0.00918923389356928
2023-08-21T01:45:00-04:00,1.08813,1.0883,1.08785,1.08812,1.0873938333078381,1.0881506666666667,1.0881433333333266,1.0881519999999925,1.087945500000004,1.0876712000000013,1.0873626000000014,1.087634300000004,1.088124511909937,1.088115124627168,-2158,-373190,-370318.2,0.01850580910859044,-276.3249223163756,-0.006432700171846322
2023-08-21T02:00:00-04:00,1.08812,1.08824,1.08726,1.08752,1.08873,1.0880260000000002,1.0880855555555486,1.0881402222222145,1.0879445000000039,1.0876690000000013,1.0873569000000014,1.087640200000004,1.0880036095279495,1.088099299701734,-3243,-376433,-371659.8,0.014317335356436506,-278.1131442036672,-0.04779236057496544
2023-08-21T02:15:00-04:00,1.08752,1.08815,1.08743,1.08798,1.0887006,1.0880048888888891,1.0880744444444377,1.0881233333333256,1.087977000000004,1.0876700000000012,1.0873588000000014,1.087647250000004,1.0879988876223596,1.0880754397613868,1888,-374545,-372920.2,0.01183969620376158,-277.31455659148554,-0.00919050069847704
2023-08-21T02:30:00-04:00,1.08798,1.0881,1.08761,1.08787,1.0886717879999999,1.087964,1.0880266666666598,1.0880962222222146,1.0880145000000039,1.0876762000000013,1.0873553000000016,1.087653650000004,1.0879731100978878,1.088045151809109,-1824,-376369,-374313.8,0.0075457130592356605,-277.498971746176,-0.039511164201061516
2023-08-21T02:45:00-04:00,1.08787,1.08799,1.0873599999999999,1.08774,1.0886435522399998,1.0879066666666666,1.0879866666666596,1.0880633333333256,1.0880350000000039,1.0876806000000012,1.0873498000000015,1.087658150000004,1.0879264880783102,1.088005321447287,-2164,-378533,-375814,-0.0003151256363435348,-277.75756882119407,-0.033085194375529633
2023-08-21T03:00:00-04:00,1.08774,1.08855,1.08723,1.08829,1.0886158811951998,1.0879673333333333,1.0880066666666597,1.0880359999999922,1.088073500000004,1.0876900000000012,1.0873488000000016,1.0876654000000041,1.087999190462648,1.087980257157829,4955,-373578,-375891.6,-0.0027703631536124935,-275.2521447308781,0.016542445157205522
2023-08-21T03:15:00-04:00,1.08829,1.08889,1.08823,1.08868,1.08723,1.0881020000000001,1.0880533333333264,1.0880295555555477,1.088107500000004,1.087707400000001,1.0873534000000016,1.087675350000004,1.0881353523701185,1.0880066057262627,4405,-369173,-374439.6,-0.002608297975870735,-273.6735673296335,0.038593718412887265
2023-08-21T03:30:00-04:00,1.08868,1.08887,1.0885,1.08881,1.08723,1.0882533333333333,1.0881266666666596,1.088039999999992,1.088142500000004,1.087737000000001,1.0873631000000017,1.0876873500000042,1.0882702818960948,1.0880608845810098,2925,-366248,-372780.2,-0.0010984221228918412,-273.3242911419568,0.060653402563994395
2023-08-21T03:45:00-04:00,1.08881,1.08885,1.08838,1.08885,1.0872632,1.088398,1.0882066666666599,1.088075999999992,1.088178500000004,1.087761000000001,1.0873797000000016,1.087694850000004,1.088386225516876,1.0881435076648074,3394,-362854,-370077.2,0.0020961241398653823,-273.19960455752044,0.06616856441785944
2023-08-21T04:00:00-04:00,1.08885,1.08897,1.0885,1.08855,1.087295736,1.0884666666666665,1.0882544444444375,1.0881295555555477,1.088200000000004,1.0877816000000011,1.0873923000000016,1.0877008500000043,1.0884189804135007,1.0882420061318456,-3325,-366179,-367606.4,0.00411777988243066,-274.1157087040977,0.0395177002536421
2023-08-21T04:15:00-04:00,1.08855,1.0885799999999999,1.08821,1.0883,1.08736270656,1.0884757777777776,1.0883411111111043,1.0881964444444368,1.0882035000000039,1.0878022000000012,1.0873997000000015,1.0877036500000044,1.0883951843308006,1.088321204905476,-2565,-368744,-366639.6,0.004984181023669137,-274.70479510343597,0.07172281889068734
2023-08-21T04:30:00-04:00,1.0883,1.08881,1.08824,1.0885,1.0874269982976,1.0885075555555557,1.088398888888882,1.0882655555555476,1.0882190000000038,1.0878274000000012,1.0874135000000016,1.0877029000000042,1.0884161474646405,1.0883773639243803,2504,-366240,-366053,0.012808187438276757,-274.24462787013636,0.04779499623155536
2023-08-21T04:45:00-04:00,1.0885,1.08874,1.08826,1.0886,1.0874887183656958,1.088547777777778,1.0884799999999932,1.0883362222222146,1.088247000000004,1.0878590000000012,1.0874264000000016,1.0877041500000042,1.0884529179717124,1.088413891139504,2607,-363633,-365530,0.016711168521871163,-274.0051239656807,0.06710360612941983
2023-08-21T05:00:00-04:00,1.0886,1.08902,1.08855,1.08897,1.087547969631068,1.088645777777778,1.08861666666666,1.0884182222222145,1.088291500000004,1.0879002000000013,1.0874434000000015,1.0877090500000042,1.0885563343773699,1.0884479129116027,2407,-361226,-365204.4,0.022748842539725398,-273.1870181416866,0.11307849302223551
2023-08-21T05:15:00-04:00,1.08897,1.0897999999999999,1.08887,1.08941,1.0876362914532038,1.0888044444444445,1.0887411111111045,1.088515555555548,1.0883470000000037,1.0879520000000011,1.0874660000000014,1.0877153500000043,1.0887270675018959,1.0885095303292815,3137,-358089,-363586.4,0.032272686701461446,-271.91950847659024,0.10291374541712318
2023-08-21T05:30:00-04:00,1.08941,1.08987,1.08931,1.08976,1.0878093881369475,1.0890082222222222,1.0888611111111044,1.0886195555555478,1.0884300000000038,1.0880098000000014,1.0874939000000015,1.0877246500000042,1.0889336540015166,1.0886172242634249,2405,-355684,-360974.4,0.03938888815998823,-271.14684253814636,0.09920270419223003
2023-08-21T05:45:00-04:00,1.08976,1.09047,1.08969,1.09013,1.0880154493232528,1.089262,1.089007777777771,1.0887413333333256,1.0885310000000037,1.0880684000000014,1.0875278000000015,1.0877351000000042,1.0891729232012133,1.0887685794107393,3282,-352402,-358206.8,0.043825706852769236,-270.03252378906404,0.12123327302284033
2023-08-21T06:00:00-04:00,1.09013,1.09043,1.08969,1.09016,1.0883099954044624,1.0894924444444447,1.0891533333333265,1.0888759999999924,1.0886260000000036,1.0881304000000014,1.0875654000000015,1.0877458500000041,1.0893703385609705,1.088952063528591,3021,-349381,-355356.4,0.04725560545205878,-269.9493869154802,0.12031041924965993
2023-08-21T06:15:00-04:00,1.09016,1.09021,1.08933,1.08941,1.088569195955927,1.0895437777777779,1.089248888888882,1.0890024444444368,1.0886890000000036,1.0881742000000012,1.0875915000000014,1.087754950000004,1.0893782708487765,1.0891164508228726,-2414,-351795,-353470.2,0.047366954583727035,-271.61015230771625,0.07900417987231483
2023-08-21T06:30:00-04:00,1.08941,1.08977,1.08918,1.08974,1.0887972924412157,1.089642,1.0894088888888822,1.0891359999999923,1.0887695000000037,1.0882138000000012,1.0876194000000015,1.0877640500000043,1.0894506166790212,1.0892611606582974,2167,-349628,-351778,0.051339426300327444,-270.9537327778791,0.13231645685931137
2023-08-21T06:45:00-04:00,1.08974,1.08998,1.0896,1.08989,1.0889980173482698,1.0897382222222223,1.0895633333333263,1.0892764444444367,1.0888580000000037,1.0882566000000014,1.0876499000000015,1.0877770000000044,1.089538493343217,1.0893821285266376,1718,-347910,-350223.2,0.05824114115400953,-270.71725435183237,0.12769866789159415
2023-08-21T07:00:00-04:00,1.08989,1.0907,1.08982,1.0906,1.0891746552664774,1.0899455555555555,1.0897855555555487,1.0894319999999922,1.0890120000000036,1.0883150000000013,1.0876825000000014,1.0877943500000042,1.0897507946745737,1.0894977028213098,2379,-345531,-348849,0.06667465462317033,-269.16747409877934,0.18372221201543282
2023-08-21T07:15:00-04:00,1.0906,1.09111,1.09056,1.09106,1.0893882035291707,1.0902004444444446,1.090017777777771,1.0896048888888812,1.0891660000000036,1.0883880000000015,1.0877174000000016,1.0878157500000043,1.090012635739659,1.0896261622570473,2356,-343175,-347607.8,0.07377368142631867,-268.173745875783,0.1919244790949177
2023-08-21T07:30:00-04:00,1.09106,1.09117,1.09064,1.0911,1.0896636909645034,1.0904168888888888,1.0902055555555488,1.0897962222222144,1.0893275000000036,1.0884648000000015,1.0877622000000013,1.0878369000000043,1.0902301085917272,1.0897965298056373,2494,-340681,-345385,0.07967852299668751,-268.0823118574888,0.15512984092306564
2023-08-21T07:45:00-04:00,1.0911,1.09137,1.09037,1.09091,1.0899348265908928,1.0905577777777777,1.0903333333333265,1.0899811111111033,1.0894860000000037,1.0885376000000013,1.0878082000000016,1.0878546000000044,1.0903660868733818,1.0899796238445094,-3030,-343711,-344201.6,0.08014875777320388,-268.60994452177226,0.10552782263984586
2023-08-21T08:00:00-04:00,1.09091,1.0913,1.0904,1.09044,1.0902218612727141,1.0905791111111112,1.0903677777777707,1.0901419999999922,1.0895935000000037,1.0886020000000014,1.0878498000000014,1.0878687500000044,1.0903808694987054,1.090148099075607,-3370,-347081,-344035.8,0.0745798980429522,-270.0618516451829,0.02843697540660586
2023-08-21T08:15:00-04:00,1.09044,1.09054,1.08983,1.08995,1.09137,1.0904955555555556,1.0903444444444377,1.0902537777777699,1.0896570000000039,1.0886514000000014,1.0878878000000014,1.0878779000000045,1.0902946955989643,1.0902568792604854,-3055,-350136,-344956.8,0.06566785334413626,-271.4346461134712,-0.019263227416163084
2023-08-21T08:30:00-04:00,1.08995,1.09027,1.08935,1.09012,1.0913392,1.0904506666666667,1.0904233333333264,1.090334888888881,1.0897225000000037,1.0886932000000014,1.0879230000000013,1.0878855000000045,1.0902597564791714,1.0903063034083877,4398,-345738,-345469.4,0.05900383074817452,-270.748688042,0.06517289174874367
2023-08-21T08:45:00-04:00,1.09012,1.09057,1.08973,1.08985,1.0912596319999999,1.090336,1.0904355555555485,1.0903808888888809,1.0897725000000036,1.0887232000000013,1.0879586000000012,1.0878929500000043,1.090177805183337,1.0902958427267098,-3824,-349562,-347245.6,0.05849425151768022,-271.69581312914636,0.010094150898384432
2023-08-21T09:00:00-04:00,1.08985,1.09002,1.08882,1.08903,1.0911832467199998,1.0900548888888888,1.0903399999999932,1.0903822222222141,1.0897965000000036,1.0887420000000014,1.0879836000000014,1.0878949000000044,1.0899482441466697,1.0902122741813671,-4571,-354133,-349330,0.051191899488509565,-275.1350203594993,-0.07890704566516647
2023-08-21T09:15:00-04:00,1.08903,1.08954,1.08862,1.08928,1.0910414519167997,1.089842888888889,1.0901933333333265,1.0903473333333253,1.0898455000000036,1.0887682000000014,1.0880238000000013,1.0878996000000043,1.0898145953173357,1.0900990193450935,3934,-350199,-349953.6,0.04240293185014875,-274.2319231078163,-0.1210342930496963
2023-08-21T09:30:00-04:00,1.08928,1.0897,1.08823,1.0887,1.0908477357634556,1.089544222222222,1.089931111111104,1.0902646666666587,1.0898555000000036,1.0887914000000016,1.0880596000000013,1.0878976500000044,1.0895916762538687,1.0899584154760742,-6640,-356839,-351294.2,0.023219831151808135,-277.7674695237977,-0.2163034113614208
2023-08-21T09:45:00-04:00,1.0887,1.08882,1.08802,1.08872,1.0905859621871101,1.089302,1.0896666666666597,1.0901133333333255,1.0898615000000036,1.0888192000000014,1.0880914000000013,1.0878940500000043,1.089417341003095,1.0897899323808589,5530,-351309,-352408.4,0.0007865128774812121,-277.6658804726362,-0.21812849418018962
2023-08-21T10:00:00-04:00,1.08872,1.08902,1.0882,1.08835,1.090278046724657,1.0890386666666667,1.0893822222222151,1.0899026666666587,1.0898305000000037,1.0888438000000016,1.0881080000000014,1.0878865500000043,1.089203872802476,1.0895951459046866,-4865,-356174,-353730.8,-0.023355318064640498,-279.3192440555592,-0.23466647111128486
2023-08-21T10:15:00-04:00,1.08835,1.08851,1.08779,1.08827,1.090007081117698,1.0888162222222222,1.089141111111104,1.0896628888888809,1.0897735000000037,1.0888626000000017,1.0881303000000013,1.0878784500000043,1.089017098241981,1.0894089167237488,-5580,-361754,-355255,-0.044522846525452804,-279.72940622765384,-0.19900223762884753
2023-08-21T10:30:00-04:00,1.08827,1.0883,1.08752,1.08811,1.0896966897612204,1.0886099999999999,1.0889366666666596,1.0894115555555475,1.0896910000000037,1.0888744000000015,1.0881473000000015,1.0878649000000042,1.0888356785935847,1.0892131333789987,-5110,-366864,-358588,-0.06022659041957593,-280.4806903758899,-0.16881508326070588
2023-08-21T10:45:00-04:00,1.08811,1.08884,1.08786,1.08873,1.0893484193994252,1.0885686666666667,1.0887822222222152,1.0891817777777697,1.0896210000000037,1.0888890000000016,1.0881639000000014,1.0878554500000042,1.0888145428748677,1.0890577067031986,4526,-362338,-359687.8,-0.06692435939148524,-277.90179669786073,-0.12750889810296137
2023-08-21T11:00:00-04:00,1.08873,1.08924,1.08827,1.08836,1.08752,1.0884842222222222,1.0886166666666595,1.0889717777777697,1.0895310000000036,1.0888940000000016,1.0881761000000014,1.0878401000000042,1.088723634299894,1.0889189653625582,-3770,-366108,-362647.6,-0.07534708169885117,-279.18301426328094,-0.13671606184337215
2023-08-21T11:15:00-04:00,1.08836,1.08885,1.08817,1.08862,1.0875544000000001,1.088484888888889,1.088571111111104,1.0888095555555473,1.0894915000000036,1.0889038000000015,1.0881852000000014,1.0878281000000043,1.0887029074399153,1.0888187722900462,3305,-362803,-363973.4,-0.07991087116503999,-278.39347771287504,-0.03764818232739424
2023-08-21T11:30:00-04:00,1.08862,1.08888,1.08844,1.08849,1.0875881120000002,1.0884686666666668,1.0884833333333264,1.088677999999992,1.0894290000000035,1.0889112000000016,1.0881986000000015,1.0878158500000041,1.0886603259519323,1.0887474178320364,-2765,-365568,-364736.2,-0.08084946796766355,-278.7236663921202,-0.07252497062280298
2023-08-21T11:45:00-04:00,1.08849,1.0888,1.0883,1.08877,1.0876211497600001,1.0885259999999999,1.088491111111104,1.0885888888888808,1.0893730000000035,1.0889220000000015,1.0882143000000015,1.0878101500000041,1.0886822607615458,1.0887167342656288,2439,-363129,-363989.2,-0.0812943806863223,-278.09626512982095,0.00642968678240236
2023-08-21T12:00:00-04:00,1.08877,1.08931,1.0887499999999999,1.08931,1.0876535267648002,1.0886897777777778,1.0885566666666595,1.08854377777777,1.0893085000000036,1.0889444000000015,1.0882320000000016,1.087810100000004,1.0888078086092368,1.0887153874125024,2164,-360965,-363714.6,-0.07316155208946906,-277.0229805977343,0.054192078771409594
2023-08-21T12:15:00-04:00,1.08931,1.08977,1.08921,1.08977,1.0877197856942082,1.0889324444444444,1.0887144444444372,1.0885633333333256,1.0892440000000034,1.0889790000000015,1.0882560000000014,1.0878146000000042,1.0890002468873894,1.0887707099300017,2088,-358877,-362268.4,-0.05989699221077167,-276.1412481248847,0.13047273395506748
2023-08-21T12:30:00-04:00,1.08977,1.09029,1.08968,1.09019,1.0878427985525558,1.0892275555555555,1.0889277777777706,1.0886346666666589,1.0891985000000035,1.0890212000000015,1.0882888000000015,1.0878199000000042,1.0892381975099115,1.0888777679440007,2186,-356691,-361046,-0.03920425161515381,-275.2987584252231,0.1764268058478063
2023-08-21T12:45:00-04:00,1.09019,1.09043,1.09,1.09016,1.0880385746683514,1.089474,1.0891555555555485,1.088769111111103,1.0891610000000034,1.0890584000000014,1.0883161000000017,1.0878260000000042,1.089422558007929,1.0890302143552002,-1667,-358358,-359604,-0.017744937184227434,-275.34463116300276,0.18840006984588942
2023-08-21T13:00:00-04:00,1.09016,1.09025,1.08966,1.0897,1.0882777172015163,1.089582888888889,1.0892633333333261,1.0889235555555477,1.0891240000000035,1.0890904000000015,1.0883416000000015,1.0878320000000041,1.0894780464063432,1.0891893714841596,-1838,-360196,-359017.4,0.0021422712974957492,-276.1201870447084,0.08909463319646886
2023-08-21T13:15:00-04:00,1.0897,1.09034,1.08965,1.09018,1.0884929454813648,1.0897662222222222,1.0894655555555484,1.0891053333333254,1.0891355000000034,1.0891318000000014,1.0883699000000016,1.087846000000004,1.0896184371250746,1.089351497187327,2033,-358163,-358457,0.01659186120050529,-275.22467451832495,0.16722408026755237
2023-08-21T13:30:00-04:00,1.09018,1.09032,1.08996,1.09025,1.0886866509332283,1.089923111111111,1.0896466666666593,1.08929177777777,1.0891420000000034,1.0891716000000013,1.0884003000000015,1.087861400000004,1.0897447497000596,1.0895003977498612,2072,-356091,-357899.8,0.032632418366764705,-275.0916322684212,0.14973085190424762
2023-08-21T13:45:00-04:00,1.09025,1.09029,1.08976,1.08992,1.0888609858399054,1.0899777777777777,1.0898055555555484,1.0894673333333256,1.0891455000000034,1.0892070000000014,1.0884265000000015,1.087874250000004,1.0897797997600478,1.0896087181998886,-1788,-357879,-358137.4,0.04544270127463389,-275.6328292415924,0.13137465663442405
2023-08-21T14:00:00-04:00,1.08992,1.0901,1.08984,1.09006,1.0890178872559149,1.0900286666666665,1.0899488888888815,1.089625999999992,1.0891970000000035,1.0892456000000015,1.0884494000000016,1.087888900000004,1.0898358398080383,1.0896913745599104,1594,-356285,-357722.8,0.05893856372856893,-275.42808026919073,0.11848232409048866
2023-08-21T14:15:00-04:00,1.09006,1.0903,1.08985,1.08995,1.0891590985303234,1.090028888888889,1.0900199999999929,1.0897773333333254,1.0892305000000033,1.0892822000000013,1.0884767000000015,1.087894900000004,1.0898586718464307,1.089767499647928,-1367,-357652,-357214,0.06574745266354957,-275.5660268042439,0.05875278846241877
2023-08-21T14:30:00-04:00,1.08995,1.0901,1.08975,1.08975,1.089286188677291,1.0899748888888887,1.0900177777777706,1.0898877777777698,1.0892830000000033,1.0893268000000014,1.0884979000000015,1.0879047000000042,1.0898369374771446,1.089811199718342,-1549,-359201,-357421.6,0.06773085673245462,-275.8502600259513,-0.001835249639823906
2023-08-21T14:45:00-04:00,1.08975,1.08998,1.08973,1.08984,1.089400569809562,1.0899393333333334,1.0899788888888817,1.0899542222222143,1.0893390000000034,1.0893640000000013,1.0885170000000015,1.087915000000004,1.0898375499817157,1.0898297597746731,1984,-357217,-357646.8,0.06338659264307372,-275.6864059309755,-0.03210449554665448
2023-08-21T15:00:00-04:00,1.08984,1.09017,1.08958,1.08959,1.0895035128286057,1.0898615555555555,1.0899155555555482,1.0899762222222145,1.0894010000000034,1.0893984000000012,1.0885373000000014,1.087927200000004,1.0897880399853725,1.089831407819738,-1683,-358900,-357851,0.05407326424631051,-276.07247177550295,-0.052285902986713824
2023-08-21T15:15:00-04:00,1.08959,1.08987,1.08958,1.08978,1.09043,1.0898344444444443,1.0899244444444371,1.0899713333333254,1.0894765000000033,1.0894392000000013,1.0885599000000012,1.087941200000004,1.089786431988298,1.08982152625579,1268,-357632,-358120.4,0.044331185691220444,-275.8513610824901,0.007341470129400754
2023-08-21T15:30:00-04:00,1.08978,1.08985,1.08955,1.08967,1.090413,1.0897835555555555,1.0898677777777703,1.089940888888881,1.0895545000000033,1.0894668000000012,1.0885784000000014,1.087960450000004,1.0897631455906382,1.0898024210046313,-1606,-359238,-358437.6,0.0379340186722731,-276.0134671956506,-0.046781265479096154
2023-08-21T15:45:00-04:00,1.08967,1.08975,1.08944,1.08961,1.09037848,1.089732,1.0897966666666592,1.0898966666666587,1.0895985000000032,1.0894854000000012,1.0885964000000012,1.0879779500000042,1.0897325164725107,1.0897815368037045,-1470,-360708,-358739,0.02614430502593347,-276.09440913220016,-0.05870213253840623
2023-08-21T16:00:00-04:00,1.08961,1.08962,1.0893,1.08935,1.0903221712,1.0896426666666668,1.0897333333333261,1.0898475555555476,1.0896480000000035,1.0894962000000015,1.0886166000000013,1.087994050000004,1.0896560131780086,1.0897452294429633,-689,-361397,-359575,0.0151739497549339,-276.2588165807367,-0.05229741632413016
2023-08-21T16:15:00-04:00,1.08935,1.08947,1.08926,1.08929,1.090240397504,1.089554,1.0896477777777707,1.089793999999992,1.0896815000000035,1.0895050000000013,1.0886330000000013,1.0880097000000042,1.089582810542407,1.0897041835543702,-430,-361827,-360160.4,0.00532727332352282,-276.28250042890306,-0.07063831348732523
2023-08-21T16:30:00-04:00,1.08929,1.08949,1.08928,1.08946,1.0901423577536,1.0895164444444445,1.089593333333326,1.0897277777777696,1.0897300000000034,1.0895232000000012,1.0886524000000013,1.088027300000004,1.0895582484339257,1.0896585468434956,390,-361437,-360921.4,-0.0038500045226757683,-276.22163509460273,-0.04495619065093623
2023-08-21T16:45:00-04:00,1.08946,1.08961,1.08943,1.08956,1.09005412197824,1.0895097777777778,1.0895722222222153,1.0896686666666586,1.0897695000000034,1.0895484000000013,1.0886753000000013,1.0880466500000041,1.0895585987471406,1.089617637474796,364,-361073,-361288.4,-0.012104442548608063,-276.18822404692776,-0.017435191557688686
2023-08-21T17:00:00-04:00,1.08956,1.08956,1.08902,1.08924,1.089974709780416,1.0894433333333333,1.0895055555555484,1.0896104444444366,1.0897660000000033,1.0895632000000013,1.0886953000000013,1.088061850000004,1.0894948789977124,1.0895701099798363,-172,-361245,-361395.8,-0.018837971162006036,-276.2387398514727,-0.05505395287381028
2023-08-21T17:15:00-04:00,1.08924,1.08937,1.08917,1.08923,1.0898601446067662,1.0893882222222222,1.0894655555555484,1.089556888888881,1.0897390000000036,1.0895758000000013,1.0887174000000013,1.088074650000004,1.08944190319817,1.0895272879838684,-319,-361564,-361429.2,-0.02408611923736226,-276.24166849897006,-0.033039950807197016
2023-08-21T17:30:00-04:00,1.08923,1.08948,1.0892,1.08923,1.0897593272539543,1.0893411111111109,1.0894044444444373,1.0895082222222143,1.0896910000000035,1.0895810000000012,1.0887406000000013,1.0880872000000041,1.089399522558536,1.0894906303870941,0,-361564,-361376.6,-0.02503057811955451,-276.24166849897006,-0.05046890198022082
2023-08-21T17:45:00-04:00,1.08923,1.08964,1.08923,1.08963,1.0896706079834797,1.0893862222222221,1.0893999999999928,1.0894695555555476,1.0896645000000036,1.0895854000000014,1.0887687000000013,1.088099450000004,1.0894456180468288,1.0894681043096748,328,-361236,-361336.4,-0.023960547906589254,-276.12121643650386,-0.0036708361246815973
2023-08-21T18:00:00-04:00,1.08963,1.08973,1.08959,1.08971,1.08902,1.0894482222222224,1.0894111111111038,1.0894373333333252,1.0896650000000037,1.0895844000000015,1.0887971000000014,1.088111500000004,1.089498494437463,1.0894560834477391,291,-360945,-361310.8,-0.021627408993297906,-276.09985138598216,0.009177595653489688
2023-08-21T18:15:00-04:00,1.08971,1.08976,1.08963,1.08964,1.0890342000000002,1.089494,1.089443333333326,1.0894248888888807,1.0896380000000039,1.0895746000000015,1.0888215000000012,1.088123350000004,1.0895267955499703,1.089462466758191,-261,-361206,-361303,-0.021089947357862047,-276.11661731453194,0.026621379721843433
2023-08-21T18:30:00-04:00,1.08964,1.08966,1.08949,1.08959,1.0890632320000002,1.0895233333333332,1.0894766666666595,1.089427111111103,1.0896050000000037,1.0895632000000013,1.0888468000000013,1.088135450000004,1.0895394364399762,1.0894819734065522,-220,-361426,-361275.4,-0.016309513664150704,-276.12671239180514,0.02754087524901238
2023-08-21T18:45:00-04:00,1.08959,1.08961,1.08956,1.08959,1.0890911027200003,1.0895460000000001,1.089491111111104,1.0894444444444364,1.0895885000000036,1.0895668000000014,1.0888705000000014,1.0881474000000042,1.0895495491519809,1.089511978725241,0,-361426,-361247.8,-0.010672288628752184,-276.12671239180514,0.011932517026780559
2023-08-21T19:00:00-04:00,1.08959,1.08971,1.08957,1.08969,1.0891178586112003,1.089585777777778,1.0895055555555484,1.0894655555555475,1.0895700000000037,1.0895658000000012,1.0888898000000014,1.0881617000000041,1.0895776393215848,1.0895383829801921,401,-361025,-361205.6,-0.007556336002725604,-276.08990955771156,0.011931421858361492
2023-08-21T19:15:00-04:00,1.08969,1.0899699999999999,1.08967,1.0899,1.0891435442667523,1.0896646666666667,1.0895788888888818,1.089499111111103,1.0895675000000036,1.0895660000000011,1.0889113000000012,1.088176100000004,1.0896421114572679,1.0895671063841532,346,-360679,-361152.4,-0.003736675800446928,-276.02323004335426,0.06059270684147708
2023-08-21T19:30:00-04:00,1.0899,1.09016,1.08989,1.09012,1.0891931316107473,1.0897728888888891,1.0896777777777706,1.089545999999992,1.0895860000000037,1.0895564000000013,1.0889357000000013,1.0881918000000042,1.0897376891658144,1.089609285107322,505,-360174,-360946,0.003596796884423971,-275.921294085927,0.08170909725219261
2023-08-21T19:45:00-04:00,1.09012,1.09016,1.08973,1.08977,1.0892704810818874,1.0897913333333331,1.0897377777777706,1.089598222222214,1.0895825000000037,1.0895306000000011,1.0889593000000013,1.088206500000004,1.0897441513326516,1.089650228085857,-797,-360971,-360855,0.008465357806994098,-276.17718334582503,0.04957630619795497
2023-08-21T20:00:00-04:00,1.08977,1.08991,1.08931,1.08945,1.09016,1.0897337777777778,1.0897177777777705,1.0896435555555475,1.0895755000000038,1.0894976000000012,1.0889812000000014,1.0882181000000042,1.0896853210661213,1.0896773824686852,-1764,-362735,-361116.8,0.012189099300605128,-276.6951642041711,-0.016519368960112055
2023-08-21T20:15:00-04:00,1.08945,1.0897,1.08938,1.0895,1.09016,1.089690222222222,1.0896944444444374,1.089681333333325,1.0895615000000038,1.0894694000000014,1.0890035000000013,1.0882292500000041,1.089648256852897,1.0896915059749477,1241,-361494,-361210.6,0.011389357375718223,-276.6382088597314,-0.01927118224115072
2023-08-21T20:30:00-04:00,1.0895,1.08973,1.08934,1.0897,1.090143,1.0896913333333331,1.0897011111111037,1.0897057777777694,1.089563000000004,1.0894546000000012,1.0890283000000016,1.0882410000000042,1.0896586054823174,1.0896948047799575,1283,-360211,-361117,0.011647253848799341,-276.4026879785933,0.00550640578539233
2023-08-21T20:45:00-04:00,1.0897,1.09005,1.08967,1.09004,1.09012634,1.089759111111111,1.0897511111111038,1.0897204444444362,1.089584500000004,1.0894564000000013,1.0890539000000015,1.088254400000004,1.0897348843858539,1.0896942438239656,1486,-358725,-360827.2,0.013701144603065247,-275.93903743257147,0.041299938508965704
2023-08-21T21:00:00-04:00,1.09004,1.09036,1.08979,1.08991,1.08931,1.089790888888889,1.0897866666666591,1.0897302222222138,1.0896125000000039,1.089452200000001,1.0890727000000016,1.0882673000000043,1.089769907508683,1.0896993950591718,-1214,-359939,-360620.8,0.01532672540410579,-276.0838211102346,0.029368845161930262
2023-08-21T21:15:00-04:00,1.08991,1.0907499999999999,1.08989,1.09072,1.089331,1.0899775555555555,1.0899011111111037,1.0897668888888805,1.0896840000000039,1.0894696000000013,1.0890964000000016,1.0882843000000042,1.0899599260069464,1.0897543160473369,2098,-357841,-359642,0.019708980084599356,-274.52462814934796,0.09452229533168739
2023-08-21T21:30:00-04:00,1.09072,1.09099,1.09045,1.09052,1.0893877600000001,1.0901013333333331,1.0899699999999926,1.0898219999999914,1.0897370000000037,1.0894994000000013,1.0891207000000016,1.0882994500000043,1.090071940805557,1.0898390528378687,-2117,-359958,-359334.8,0.021949642111436164,-274.91281210123293,0.05688595283969564
2023-08-21T21:45:00-04:00,1.09052,1.09068,1.09019,1.09062,1.0894838944,1.0902313333333333,1.090025555555548,1.0898868888888802,1.0897900000000038,1.0895262000000012,1.0891472000000015,1.0883153500000042,1.0901815526444456,1.0899436422702942,1753,-358205,-358933.6,0.023486630754624416,-274.7520631007561,0.04586651010897378
2023-08-21T22:00:00-04:00,1.09062,1.09099,1.09061,1.09089,1.089574260736,1.0904042222222223,1.0901499999999926,1.089966666666658,1.089872500000004,1.0895700000000013,1.0891807000000016,1.0883333000000042,1.0903232421155564,1.090061313816235,1634,-356571,-358502.8,0.024739269855381725,-274.34754090237357,0.10277397983060738
2023-08-21T22:15:00-04:00,1.09089,1.09128,1.09087,1.09109,1.0896592050918399,1.0905922222222222,1.090332222222215,1.0900757777777694,1.089965500000004,1.0896174000000012,1.0892183000000017,1.0883510500000042,1.0904765936924452,1.0902026510529872,1596,-354975,-357510,0.028765487008210095,-274.05493578178397,0.15053467345907234
2023-08-21T22:30:00-04:00,1.09109,1.09121,1.0908,1.09088,1.0897888686844928,1.0907017777777779,1.0904855555555482,1.0901926666666584,1.090048000000004,1.0896680000000012,1.0892559000000017,1.0883667000000044,1.0905572749539563,1.0903221208423892,-1832,-356807,-357303.2,0.034674242547004804,-274.4075373086971,0.12666360715926195
2023-08-21T22:45:00-04:00,1.09088,1.09097,1.0907499999999999,1.09078,1.0899081591897333,1.0907606666666667,1.090605555555548,1.0903197777777693,1.090105500000004,1.0897182000000012,1.0892904000000017,1.0883758000000043,1.090601819963165,1.0904280966739108,-1678,-358485,-357008.6,0.039643120182511676,-274.56135807725093,0.09910984674682867
2023-08-21T23:00:00-04:00,1.09078,1.09142,1.09057,1.0913599999999999,1.0900179064545545,1.0909115555555555,1.090752222222215,1.0904651111111028,1.0901880000000037,1.0897832000000012,1.0893288000000017,1.0883898500000042,1.090753455970532,1.0905424773391281,1742,-356743,-356716.2,0.047310433936258146,-273.63508513495304,0.12109647352390628
2023-08-21T23:15:00-04:00,1.0913599999999999,1.09152,1.0913,1.09144,1.0901581158090992,1.0910491111111111,1.0909222222222148,1.0906195555555471,1.0902780000000036,1.0898374000000013,1.0893632000000018,1.0884039500000042,1.0908907647764257,1.090655981871302,1544,-355199,-356441.8,0.05259180963725588,-273.5219052493057,0.1403785633676204
2023-08-21T23:30:00-04:00,1.09144,1.09159,1.09137,1.09148,1.0903215419120074,1.0911606666666667,1.0910066666666594,1.0907544444444361,1.090372500000004,1.089899800000001,1.0893969000000014,1.0884163500000041,1.0910086118211406,1.090762385497041,1340,-353859,-356218.6,0.058950851289366786,-273.4727958158966,0.06967874431569
2023-08-21T23:45:00-04:00,1.09148,1.09157,1.09134,1.09152,1.0904991260443264,1.0912633333333333,1.0911177777777705,1.0908808888888806,1.0904690000000037,1.0899578000000012,1.0894308000000017,1.0884285000000042,1.0911108894569126,1.0908731083976324,1259,-352600,-355377.2,0.05785413055726025,-273.4266566287378,0.09169937277630048
2023-08-22T00:00:00-04:00,1.09152,1.0916,1.09145,1.09158,1.0906518483981207,1.0913557777777776,1.0912244444444372,1.0910046666666584,1.0905635000000038,1.0900196000000013,1.0894654000000017,1.088439850000004,1.0912047115655301,1.0909936867181054,1098,-351502,-353980.6,0.058879627753899995,-273.36630042821014,0.08802332618144468
2023-08-22T00:15:00-04:00,1.09158,1.09168,1.09137,1.09139,1.0908035526544213,1.091388888888889,1.091279999999993,1.091110222222214,1.0906380000000038,1.0900720000000013,1.0894970000000017,1.0884505500000041,1.091241769252424,1.0910913493744838,-908,-352410,-353114,0.05851285396570498,-273.5243465631704,0.04583413543071868
2023-08-22T00:30:00-04:00,1.09139,1.09142,1.0911,1.0912,1.0909613131766254,1.0913728888888887,1.091292222222215,1.091184222222214,1.0906920000000038,1.0901098000000011,1.0895271000000017,1.0884613500000042,1.0912334154019392,1.0911598794995867,-975,-353385,-352751.2,0.055675961711720616,-273.69408423714594,0.010081661457813243
2023-08-22T00:45:00-04:00,1.0912,1.09121,1.09088,1.09091,1.09168,1.0912964444444444,1.0912955555555481,1.0912419999999918,1.0907490000000037,1.0901326000000013,1.0895558000000016,1.088471750000004,1.0911687323215513,1.0911919035996687,-1041,-354426,-352864.6,0.05057466246111579,-273.97074296148605,0.0027500733352866023
2023-08-22T01:00:00-04:00,1.09091,1.09126,1.09081,1.09125,1.091664,1.0912873333333335,1.0913477777777705,1.0912879999999918,1.0908390000000037,1.0901538000000013,1.0895875000000017,1.088486300000004,1.091184985857241,1.0912067228797346,1821,-352605,-352865.6,0.04750236071177466,-273.4031984344398,0.0430884321311328
2023-08-22T01:15:00-04:00,1.09125,1.09138,1.09114,1.09128,1.09162984,1.091273777777778,1.0913388888888818,1.0913108888888807,1.0909280000000037,1.0901762000000013,1.0896173000000018,1.088499550000004,1.091203988685793,1.0912065783037872,1759,-350846,-352734.4,0.044093650881236984,-273.3548410461237,-0.007330303474550833
2023-08-22T01:30:00-04:00,1.09128,1.09132,1.09081,1.09111,1.0915970464,1.091228,1.091302222222215,1.091315333333325,1.0909985000000035,1.0902044000000013,1.0896474000000016,1.088511350000004,1.0911851909486343,1.0911952626430292,-1867,-352713,-352795,0.03477134328019407,-273.645682993195,-0.030235285494387365
2023-08-22T01:45:00-04:00,1.09111,1.09118,1.09045,1.09054,1.0915655645439999,1.0910755555555556,1.0911977777777706,1.0912964444444362,1.0910235000000035,1.0902116000000013,1.0896717000000016,1.0885211000000041,1.0910561527589075,1.0911598101144229,-1936,-354649,-353047.8,0.022854139868842164,-274.6570567318647,-0.08612159636456379
2023-08-22T02:00:00-04:00,1.09054,1.09153,1.09054,1.09143,1.09045,1.091122,1.0911877777777705,1.0912748888888806,1.0910995000000037,1.0902352000000013,1.0897034000000014,1.0885350500000042,1.091130922207126,1.0911522480915377,3164,-351485,-352459.6,0.01632775981068326,-272.07488643091335,-0.00824538258576531
2023-08-22T02:15:00-04:00,1.09143,1.09207,1.0911899999999999,1.09195,1.09045,1.0912744444444444,1.0912288888888817,1.091251111111103,1.0911610000000036,1.0902758000000012,1.0897414000000014,1.0885531000000042,1.0912947377657007,1.0911741984732295,3485,-348000,-351538.6,0.011364261231658766,-270.414495934042,0.03389582073691177
2023-08-22T02:30:00-04:00,1.09195,1.09201,1.09152,1.09185,1.0905148,1.0913986666666666,1.091279999999993,1.091239333333325,1.0912275000000038,1.0903116000000013,1.0897786000000016,1.0885711500000044,1.0914057902125607,1.091214558778583,-2965,-350965,-351562.4,0.008906802379671813,-270.68602851337255,0.04214808638524312
2023-08-22T02:45:00-04:00,1.09185,1.0919,1.0913599999999999,1.09179,1.090577008,1.0915006666666667,1.0913455555555482,1.0912479999999918,1.0912860000000038,1.0903484000000012,1.0898153000000015,1.0885889500000043,1.0914826321700486,1.091274047022866,-2395,-353360,-351691.8,0.007029918390397308,-270.8176399984665,0.05406891495602002
2023-08-22T03:00:00-04:00,1.09179,1.09223,1.09172,1.09207,1.09063672768,1.0916455555555555,1.0914744444444373,1.091303333333325,1.0913450000000038,1.0903948000000012,1.0898608000000014,1.0886088500000042,1.091600105736039,1.0913828376182921,3606,-349754,-350712.8,0.008674483883757468,-269.8928467689991,0.10633324472230063
2023-08-22T03:15:00-04:00,1.09207,1.09262,1.09206,1.09256,1.0907323240192,1.0918626666666666,1.0916199999999927,1.0913897777777695,1.0914185000000038,1.0904492000000012,1.0899066000000015,1.0886327000000042,1.0917920845888311,1.0915150700946332,2472,-347282,-349872.2,0.016505624478327513,-268.7836870997474,0.12004581901488405
2023-08-22T03:30:00-04:00,1.09256,1.09301,1.09232,1.09293,1.090883338097664,1.0921246666666669,1.091803333333326,1.0915046666666584,1.0915210000000037,1.0905160000000014,1.0899572000000015,1.088656250000004,1.092019667671065,1.0916600560757062,2662,-344620,-349196.2,0.023868628742971007,-267.88218969914703,0.1511985924785508
2023-08-22T03:45:00-04:00,1.09293,1.09304,1.09239,1.09256,1.0910960042878974,1.0922759999999998,1.091964444444437,1.091641555555547,1.0916100000000037,1.0905716000000012,1.0900054000000015,1.0886776000000042,1.092127734136852,1.0918044448605644,-2449,-347069,-348417,0.02826421346641501,-268.71127298901916,0.13289219235457023
2023-08-22T04:00:00-04:00,1.09256,1.09287,1.09181,1.09182,1.0913292837733497,1.0922471111111112,1.092106666666659,1.0917937777777693,1.0916330000000039,1.0906146000000014,1.0900407000000016,1.0886947500000042,1.0920661873094817,1.091921155888451,-2922,-349991,-347743.2,0.03023029992149738,-270.6903679586317,0.11737304454673353
2023-08-22T04:15:00-04:00,1.09182,1.09198,1.09156,1.09173,1.0915345697205476,1.0921717777777777,1.0921399999999926,1.0919268888888802,1.0916475000000039,1.090657000000001,1.0900712000000015,1.088712300000004,1.0919989498475853,1.09200092471076,-2375,-352366,-348265.6,0.03951686391684663,-270.8861419873176,0.027486875017196617
2023-08-22T04:30:00-04:00,1.09173,1.09188,1.09141,1.09142,1.09304,1.0920277777777778,1.0920811111111035,1.0920191111111026,1.091644500000004,1.0906984000000013,1.0900973000000014,1.0887302000000043,1.0918831598780683,1.0920191397686074,-2179,-354545,-349718.2,0.039512536222644556,-271.50487555697316,-0.04853702092585919
2023-08-22T04:45:00-04:00,1.09142,1.09142,1.09067,1.091,1.0930074,1.0918115555555556,1.0919866666666591,1.092055777777769,1.0916185000000038,1.0907326000000013,1.0901188000000017,1.0887492500000042,1.0917065279024547,1.0919565118148853,-2317,-356862,-352166.6,0.03290453758093905,-272.3965029781311,-0.07784952145441383
2023-08-22T05:00:00-04:00,1.091,1.09123,1.0907499999999999,1.09077,1.092913904,1.0915682222222223,1.091873333333326,1.0920375555555468,1.0915780000000037,1.0907588000000012,1.0901410000000016,1.0887666500000042,1.0915192223219639,1.0918348094519077,-2123,-358985,-354549.8,0.02628348472355931,-272.8440648479752,-0.09342455966806995
2023-08-22T05:15:00-04:00,1.09077,1.09081,1.08988,1.08995,1.09282414784,1.0911835555555558,1.0916377777777702,1.0919437777777692,1.0915060000000039,1.0907666000000014,1.0901575000000014,1.0887786000000041,1.091205377857571,1.0916626475615254,-2833,-361818,-356915.2,0.016539050001791327,-274.9738080569011,-0.1941267501167619
2023-08-22T05:30:00-04:00,1.08995,1.0905,1.08982,1.09044,1.0926474989696,1.0909440000000001,1.0914022222222146,1.0917962222222137,1.0914680000000039,1.0907906000000012,1.0901769000000017,1.088795200000004,1.0910523022860568,1.0914733180492198,2589,-359229,-358287.8,0.005750295804580342,-273.8098922809478,-0.19403968660759133
2023-08-22T05:45:00-04:00,1.09044,1.09076,1.09033,1.09066,1.0924212990520321,1.0907955555555555,1.0911499999999925,1.0916099999999915,1.0914555000000037,1.0908192000000012,1.0901975000000015,1.0888119500000042,1.0909738418288455,1.0912914544393753,2489,-356740,-358726.8,-0.009301911603638625,-273.30772801698123,-0.20769857172920447
2023-08-22T06:00:00-04:00,1.09066,1.0910199999999999,1.09018,1.09018,1.0922131951278695,1.0906015555555555,1.090885555555548,1.0913897777777692,1.0914020000000035,1.0908382000000012,1.0902096000000017,1.0888265000000041,1.0908150734630764,1.0911131635514995,-1968,-358708,-359096,-0.03131423355581274,-274.1738457805373,-0.2178370066632541
2023-08-22T06:15:00-04:00,1.09018,1.09019,1.08871,1.08889,1.09202173951764,1.0902024444444445,1.0905599999999924,1.0911271111111023,1.0912825000000037,1.0908234000000012,1.0902044000000015,1.0888352000000043,1.0904300587704612,1.090895330841199,-3032,-361740,-359647,-0.05464955384484753,-277.7615835853035,-0.2683592533567895
2023-08-22T06:30:00-04:00,1.08889,1.08928,1.08873,1.08911,1.091690565565876,1.0899124444444444,1.0902688888888814,1.0908533333333246,1.0911825000000035,1.0908114000000013,1.0901979000000015,1.0888459000000044,1.090166047016369,1.0906874646729585,2407,-359333,-359150,-0.07002037114915698,-277.2752718366418,-0.2399860771436222
2023-08-22T06:45:00-04:00,1.08911,1.08917,1.08855,1.08867,1.0913925090092884,1.0895926666666669,1.0899633333333258,1.090565555555547,1.0910890000000038,1.0907920000000013,1.0901833000000014,1.0888555500000043,1.089866837613095,1.0904503717383662,-2351,-361684,-359641,-0.08742458205864279,-278.22507488683874,-0.2519653295706538
2023-08-22T07:00:00-04:00,1.08867,1.08877,1.0883,1.08842,1.091051407928174,1.0892840000000001,1.0896766666666593,1.0902708888888804,1.0909385000000036,1.0907686000000012,1.0901659000000015,1.0888656500000042,1.0895774700904761,1.0901710973906922,-2042,-363726,-361038.2,-0.10567782035918602,-278.6939956801004,-0.2364802933088934
2023-08-22T07:15:00-04:00,1.08842,1.0887499999999999,1.08827,1.08835,1.0906662108182295,1.0890186666666666,1.0894077777777702,1.0899753333333249,1.0907585000000037,1.0907438000000014,1.0901553000000015,1.0888734000000042,1.089331976072381,1.0898744779125533,-2114,-365840,-362464.6,-0.11654018488547307,-278.8299542255149,-0.22186162068997944
2023-08-22T07:30:00-04:00,1.08835,1.08867,1.08805,1.08865,1.0902828170873127,1.088867111111111,1.089263333333326,1.0897159999999915,1.0905985000000036,1.0907230000000012,1.0901444000000016,1.088881900000004,1.0891955808579048,1.089627582330042,1772,-364068,-362930.2,-0.12158670475028621,-278.34150841304654,-0.11927152621680617
2023-08-22T07:45:00-04:00,1.08865,1.08906,1.08847,1.08848,1.0898809100115965,1.0887104444444444,1.089045555555548,1.0894713333333246,1.0904330000000038,1.0906946000000013,1.0901303000000013,1.0888901000000042,1.0890524646863238,1.089404865864033,-2204,-366272,-364318,-0.12036881371299142,-278.6856777971461,-0.17974395656800773
2023-08-22T08:00:00-04:00,1.08848,1.08899,1.08838,1.08884,1.0895513462095092,1.0886693333333333,1.088843333333326,1.0892473333333248,1.0902715000000036,1.0906690000000012,1.0901127000000015,1.0888976000000041,1.0890099717490591,1.0892334926912257,2938,-363334,-364648,-0.12217490992440262,-277.71397413699583,-0.166871435644466
2023-08-22T08:15:00-04:00,1.08884,1.08907,1.08835,1.08862,1.0892811038917976,1.0886246666666668,1.0886699999999925,1.0890459999999913,1.0900745000000036,1.0906460000000013,1.0900883000000015,1.088902850000004,1.0889319773992472,1.08910439415298,-3524,-366858,-365274.4,-0.1258361888784849,-278.42599794214664,-0.14309563558311525
2023-08-22T08:30:00-04:00,1.08862,1.08899,1.0875,1.08755,1.08907,1.0884006666666666,1.0885211111111037,1.088868666666658,1.0898055000000038,1.0906080000000014,1.0900528000000014,1.0889075000000041,1.0886555819193977,1.0889691153223833,-5177,-372035,-366513.4,-0.12810497950082309,-283.5144493760717,-0.12306109891723654
2023-08-22T08:45:00-04:00,1.08755,1.08765,1.08648,1.08662,1.08907,1.0880204444444446,1.088244444444437,1.0886648888888804,1.0895085000000035,1.0905504000000013,1.0900099000000014,1.0889090500000043,1.0882484655355182,1.088779692257906,-5377,-377412,-369182.2,-0.12139722838986441,-288.11250004040943,-0.2286270441002381
2023-08-22T09:00:00-04:00,1.08662,1.08711,1.08601,1.0866,1.08899,1.0876915555555555,1.088014444444437,1.088458666666658,1.0892475000000037,1.0904884000000015,1.0899715000000014,1.088910650000004,1.0879187724284145,1.088552953806324,-5602,-383014,-372530.6,-0.11841706674469478,-288.2156087628694,-0.19014026288958236
2023-08-22T09:15:00-04:00,1.0866,1.08681,1.08565,1.08584,1.0883939999999999,1.0872566666666665,1.0877277777777703,1.088235555555547,1.0889530000000036,1.0904044000000013,1.0899304000000014,1.088909100000004,1.0875030179427316,1.0882515630450587,-4874,-387888,-377441.4,-0.1182862507151311,-291.62462772108813,-0.23704084820198332
2023-08-22T09:30:00-04:00,1.08584,1.08606,1.08515,1.0853599999999999,1.0878451999999998,1.086783111111111,1.0873955555555481,1.087980666666658,1.0886500000000034,1.0903134000000014,1.0898828000000014,1.0889029000000041,1.0870744143541853,1.0878800504360462,-6392,-394280,-382925.8,-0.11856412714573253,-294.4502373873375,-0.2747277989617355
2023-08-22T09:45:00-04:00,1.0853599999999999,1.08558,1.08411,1.08438,1.0873061599999998,1.08618,1.0869211111111035,1.087660666666658,1.0883190000000036,1.0901866000000013,1.0898281000000014,1.088893350000004,1.0865355314833482,1.0874560403488365,-6648,-400928,-388704.4,-0.12427496064700792,-300.45289088479444,-0.3922289073623292
2023-08-22T10:00:00-04:00,1.08438,1.08501,1.08425,1.08445,1.0866669279999999,1.0856857777777777,1.0864733333333259,1.0873064444444358,1.0880030000000036,1.0900652000000013,1.0897823000000013,1.0888829500000041,1.0861184251866787,1.0870300322790687,7269,-393659,-391953.8,-0.13424457667371945,-299.98365500807216,-0.3702410701161233
2023-08-22T10:15:00-04:00,1.08445,1.08538,1.08412,1.08417,1.0861555423999998,1.0852251111111113,1.085954444444437,1.0868944444444357,1.0877140000000034,1.0899362000000012,1.0897312000000015,1.0888775000000042,1.085728740149343,1.0865920258232542,-4867,-398526,-395056.2,-0.14501254802605654,-301.2402920130048,-0.4288968076117659
2023-08-22T10:30:00-04:00,1.08417,1.08442,1.08328,1.08395,1.0857464339199998,1.0848242222222222,1.0854355555555477,1.0864359999999913,1.0873895000000036,1.0897974000000012,1.0896837000000015,1.0888716500000042,1.0853729921194744,1.0861660206586028,-5514,-404040,-398286.6,-0.16374298708758664,-302.3591940302167,-0.42898348367657696
2023-08-22T10:45:00-04:00,1.08395,1.0854,1.08378,1.08511,1.08328,1.084759111111111,1.0851644444444366,1.085989777777769,1.0871120000000034,1.0896778000000014,1.0896476000000015,1.088869500000004,1.0853203936955795,1.0858152165268817,6664,-397376,-398905.8,-0.1727200662199145,-295.2276473721602,-0.2243575008045605
2023-08-22T11:00:00-04:00,1.08511,1.08548,1.08444,1.08522,1.08328,1.0847702222222222,1.0850088888888811,1.0856073333333245,1.0868640000000036,1.0895646000000014,1.0896163000000014,1.088862150000004,1.0853003149564637,1.0855681732215048,5168,-392208,-397161.8,-0.17036499023513932,-294.70375578513193,-0.12883988882956746
2023-08-22T11:15:00-04:00,1.08522,1.08534,1.08477,1.0849,1.083368,1.0847484444444446,1.0848199999999923,1.0852766666666576,1.0866645000000037,1.0894470000000014,1.0895826000000015,1.088856450000004,1.085220251965171,1.0853885385772033,-3509,-395717,-397573.4,-0.1630957252985312,-295.7384584260714,-0.1564513160316616
2023-08-22T11:30:00-04:00,1.0849,1.08527,1.08485,1.08514,1.08345248,1.0848124444444442,1.0847422222222147,1.0850342222222131,1.0864660000000037,1.0893226000000014,1.0895529000000015,1.0888501000000042,1.0852042015721368,1.085283630861762,3140,-392577,-396383.6,-0.160124951628717,-295.04383219323887,-0.06446621970086965
2023-08-22T11:45:00-04:00,1.08514,1.08557,1.08445,1.08454,1.0835335808,1.084772,1.0846511111111037,1.0848773333333244,1.0862595000000037,1.0891846000000016,1.0895110000000015,1.088837450000004,1.0850713612577094,1.085223304689409,-2931,-395508,-394677.2,-0.1520917547487854,-296.66445257401904,-0.07555096926363795
2023-08-22T12:00:00-04:00,1.08454,1.08511,1.0844799999999999,1.08474,1.0836557659519999,1.0847897777777777,1.0846911111111035,1.0847826666666576,1.0860755000000037,1.0890498000000015,1.0894748000000016,1.0888254500000043,1.0850050890061675,1.0851602437515266,2420,-393088,-393819.6,-0.14059666119065234,-296.2181804217702,0.03319869418470813
2023-08-22T12:15:00-04:00,1.08474,1.08485,1.08463,1.08479,1.0837706199948798,1.0848095555555555,1.0847288888888815,1.0847266666666575,1.0858975000000037,1.0889152000000015,1.0894365000000015,1.0888108500000042,1.084962071204934,1.0850925950012207,1994,-391094,-393596.8,-0.12092711224499103,-296.126268995991,0.0313522984001113
2023-08-22T12:30:00-04:00,1.08479,1.08494,1.0846,1.08485,1.083878582795187,1.084833777777778,1.084804444444437,1.0847235555555466,1.0857075000000038,1.0887806000000015,1.0894001000000015,1.088799350000004,1.0849396569639471,1.0850364760009759,1491,-389603,-392374,-0.10191292297408036,-296.04380142162154,0.06272079101985979
2023-08-22T12:45:00-04:00,1.08485,1.085,1.08474,1.08494,1.0839800678274756,1.084860888888889,1.0849144444444372,1.0847579999999912,1.085530500000004,1.0886516000000015,1.0893618000000016,1.088788050000004,1.0849397255711577,1.08498358080078,1665,-387938,-391446.2,-0.07856453919838798,-295.9056717262721,0.09133262604364098
2023-08-22T13:00:00-04:00,1.08494,1.08518,1.08477,1.08494,1.0840754637578272,1.084866,1.0848955555555482,1.08480688888888,1.0853355000000038,1.0885264000000014,1.0893181000000016,1.088775050000004,1.084939780456926,1.0849572646406234,0,-387938,-389932.2,-0.0539271919297043,-295.9056717262721,-0.015666614444618837
2023-08-22T13:15:00-04:00,1.08494,1.0854,1.0847499999999999,1.08538,1.0841651359323574,1.084962888888889,1.0849133333333258,1.0848513333333245,1.0851735000000038,1.0884158000000015,1.0892742000000017,1.088765100000004,1.085027824365541,1.084961811712498,1569,-386369,-388588.4,-0.03626696805749001,-295.26936004083325,0.014743554302347722
2023-08-22T13:30:00-04:00,1.08538,1.0855,1.08524,1.08538,1.0842494277764159,1.0850562222222222,1.084966666666659,1.0848988888888802,1.085065000000004,1.0882984000000016,1.0892261000000019,1.088757450000004,1.0850982594924328,1.0849890493699976,0,-386369,-387643.4,-0.02058023989770496,-295.26936004083325,0.044243709097616
2023-08-22T13:45:00-04:00,1.08538,1.08546,1.08504,1.08525,1.084328662109831,1.0851128888888888,1.0849788888888814,1.084933777777769,1.084996500000004,1.0881778000000013,1.0891770000000016,1.088746550000004,1.0851286075939461,1.0850268394959977,-1919,-388288,-387380.4,-0.007263056495743782,-295.4992058091355,0.010136940855562831
2023-08-22T14:00:00-04:00,1.08525,1.08547,1.08505,1.08545,1.084403142383241,1.0852071111111112,1.0850799999999925,1.08496688888888,1.0849390000000039,1.0880646000000014,1.0891345000000017,1.0887380500000041,1.085192886075157,1.0850774715967977,1655,-386633,-387119.4,0.0007285373343396715,-295.19420696094386,0.083906541021997
2023-08-22T14:15:00-04:00,1.08545,1.08549,1.08515,1.0853599999999999,1.0844731538402466,1.085263111111111,1.0851488888888814,1.0850175555555466,1.0849150000000038,1.0879610000000015,1.0890863000000017,1.088728100000004,1.0852263088601255,1.0851347772774373,-1461,-388094,-387150.6,0.0137288482254506,-295.3153456591798,0.05715655364417675
2023-08-22T14:30:00-04:00,1.0853599999999999,1.0855299999999999,1.08526,1.08539,1.0845389646098318,1.0853113333333333,1.085215555555548,1.085077999999991,1.0849165000000038,1.0878402000000016,1.0890377000000016,1.088719000000004,1.0852590470881005,1.0851810218219493,1481,-386613,-387199.4,0.02169534434531931,-295.2744099327846,0.0553102443791108
2023-08-22T14:45:00-04:00,1.08539,1.08551,1.0852,1.08523,1.0846008267332419,1.085314222222222,1.0852577777777703,1.0851362222222134,1.0849590000000038,1.0877058000000015,1.0889908000000017,1.088708650000004,1.0852532376704804,1.0852120174575588,-1626,-388239,-387573.4,0.026321610846023146,-295.5141025778249,0.03502788403925196
2023-08-22T15:00:00-04:00,1.08523,1.08525,1.08494,1.08504,1.0846589771292474,1.0852706666666667,1.0852688888888815,1.0851942222222135,1.0849885000000037,1.0875696000000017,1.0889406000000017,1.088695000000004,1.0852105901363844,1.0852284139660464,-1688,-389927,-387901.2,0.025175318707718244,-295.809634400572,0.009217099563108466
2023-08-22T15:15:00-04:00,1.08504,1.08515,1.08463,1.08464,1.08557,1.085144888888889,1.0852355555555482,1.0852253333333248,1.0850120000000039,1.0874266000000015,1.0888875000000018,1.088682100000004,1.0850964721091076,1.0852091311728365,-1777,-391704,-388915.4,0.02157615667937113,-296.4647254571228,-0.027651298689325397
2023-08-22T15:30:00-04:00,1.08464,1.0847,1.08434,1.08449,1.0855511999999998,1.0849957777777777,1.085136666666659,1.0852228888888802,1.0850390000000039,1.0872750000000015,1.0888349000000017,1.088666400000004,1.084975177687286,1.0851589049382686,-1514,-393218,-389940.2,0.01602388968431641,-296.6741036840001,-0.08199893124989012
2023-08-22T15:45:00-04:00,1.08449,1.08469,1.08439,1.08459,1.0855027519999998,1.0848864444444444,1.0850488888888816,1.085189555555547,1.0850130000000038,1.0871156000000015,1.0887824000000017,1.0886497000000042,1.0848981421498287,1.0850867239506143,1471,-391747,-390967,0.005933631975589609,-296.53846389017997,-0.07278556818810632
2023-08-22T16:00:00-04:00,1.08459,1.08468,1.08454,1.08467,1.0854562419199998,1.0848106666666666,1.0849844444444372,1.0851348888888803,1.0849855000000037,1.0869504000000014,1.0887332000000016,1.088635250000004,1.084852513719863,1.0850065791604908,722,-391025,-391524.2,0.001321048605699967,-296.48520874307366,-0.053443906933888494
2023-08-22T16:15:00-04:00,1.08467,1.08474,1.08458,1.08469,1.0854115922431997,1.0847517777777778,1.0848999999999929,1.0850611111111026,1.0849750000000038,1.0867930000000015,1.0886823000000017,1.0886211000000041,1.0848200109758903,1.084928463328392,869,-390156,-391570,-0.0015141939218309656,-296.4691854364459,-0.07001704362246938
2023-08-22T16:30:00-04:00,1.08469,1.0849,1.08469,1.08484,1.0853687285534717,1.0847397777777776,1.084842222222215,1.0849824444444358,1.0849600000000037,1.0866534000000014,1.0886340000000017,1.088606200000004,1.0848240087807122,1.084873970662713,447,-389709,-391171,-0.00687314181550336,-296.40737054002386,-0.04791037075254791
2023-08-22T16:45:00-04:00,1.08484,1.08491,1.08446,1.08453,1.0853275794113328,1.0846773333333333,1.0847466666666594,1.084904444444436,1.0849595000000039,1.0865094000000013,1.0885832000000017,1.088589800000004,1.0847652070245697,1.0848319765301697,-1049,-390758,-390679,-0.011846172685167395,-296.7071290297551,-0.07923419231797629
2023-08-22T17:00:00-04:00,1.08453,1.08453,1.0841399999999999,1.08432,1.0852880762348796,1.0845919999999998,1.0846455555555483,1.0848237777777692,1.0849385000000038,1.0863674000000014,1.0885329000000017,1.088574750000004,1.0846761656196557,1.0847875812241354,-129,-390887,-390507,-0.02074307251133754,-296.7321075918972,-0.08385319241082226
2023-08-22T17:15:00-04:00,1.08432,1.08452,1.08417,1.0845,1.0852191916607867,1.0845628888888887,1.0845855555555484,1.0847439999999915,1.0849240000000038,1.0862374000000015,1.0884850000000017,1.088559000000004,1.0846409324957247,1.0847452649793077,118,-390769,-390455.8,-0.02641850796623454,-296.7125192784842,-0.049767750497676115
2023-08-22T17:30:00-04:00,1.0845,1.08454,1.08441,1.08449,1.0851544401611395,1.0845437777777778,1.0845688888888816,1.0846777777777692,1.0849060000000037,1.0861118000000014,1.0884353000000018,1.088543850000004,1.0846107459965797,1.0847034119834453,-125,-390894,-390603.4,-0.030171658918594264,-296.71367188337126,-0.013829473373662643
2023-08-22T17:45:00-04:00,1.08449,1.08452,1.08446,1.0844799999999999,1.085093573751471,1.0845259999999999,1.0845677777777705,1.0846228888888805,1.0848830000000036,1.0860024000000015,1.0883845000000016,1.088529900000004,1.0845845967972638,1.084655529586756,-97,-390991,-390859.8,-0.03002291222213548,-296.714566313011,-0.0009220924121075817
2023-08-22T18:00:00-04:00,1.0844799999999999,1.08462,1.08446,1.08458,1.0850363593263828,1.0845284444444443,1.0845666666666594,1.0845868888888806,1.0848650000000037,1.0858852000000012,1.0883379000000015,1.0885166000000042,1.084583677437811,1.084619223669404,424,-390567,-390821.6,-0.02761361481538007,-296.6754692342266,-0.0009220073944848715
2023-08-22T18:15:00-04:00,1.08458,1.0847,1.08457,1.08465,1.0849825777667998,1.084545111111111,1.0845644444444371,1.0845706666666584,1.0848285000000035,1.0857650000000012,1.0882921000000014,1.0885047500000042,1.0845969419502488,1.0846033789355227,318,-390249,-390694,-0.025787959327098483,-296.65494516039166,-0.0018438787834208583
2023-08-22T18:30:00-04:00,1.08465,1.08476,1.08465,1.08468,1.084932023100792,1.0845682222222224,1.0845633333333262,1.0845662222222139,1.0847935000000037,1.0856550000000014,1.0882466000000015,1.088493600000004,1.084613553560199,1.0845979031484174,349,-389900,-390520.2,-0.02262386831239311,-296.645292276973,-0.0009219223925585622
2023-08-22T18:45:00-04:00,1.08468,1.0847,1.08459,1.08459,1.0848845017147444,1.0845735555555556,1.0845355555555483,1.0845595555555472,1.0847605000000036,1.0855690000000013,1.0881962000000016,1.088482450000004,1.0846088428481593,1.0845975225187332,-273,-390173,-390376,-0.02007861123049864,-296.667944118991,-0.023044872976667848
2023-08-22T19:00:00-04:00,1.08459,1.0847,1.08456,1.08469,1.0848398316118597,1.0846044444444443,1.0845533333333262,1.0845566666666584,1.0847225000000036,1.0854806000000012,1.0881460000000016,1.0884715500000042,1.0846250742785275,1.084605618014986,293,-389880,-390153.8,-0.019003595274440663,-296.64092930233215,0.014752934450862398
2023-08-22T19:15:00-04:00,1.08469,1.08474,1.08462,1.08474,1.084797841715148,1.084641777777778,1.084599999999993,1.084563333333325,1.0846915000000035,1.0854020000000013,1.0880970000000016,1.088459250000004,1.084648059422822,1.084618494411988,209,-389671,-389974.6,-0.013951330139139993,-296.63129521332974,0.03873395307659058
2023-08-22T19:30:00-04:00,1.08474,1.08478,1.08469,1.08478,1.0841399999999999,1.0846777777777779,1.084631111111104,1.0845766666666585,1.0846610000000037,1.0853292000000012,1.0880489000000015,1.088447850000004,1.0846744475382577,1.08463399552959,247,-389424,-389809.6,-0.007164616277834157,-296.62218703994256,0.025818349469807097
2023-08-22T19:45:00-04:00,1.08478,1.0848,1.08461,1.08463,1.0841527999999998,1.0846775555555557,1.0846466666666597,1.084593333333325,1.0846310000000037,1.0852548000000013,1.0879993000000017,1.0884349000000042,1.0846655580306062,1.0846443964236714,-608,-390032,-389836,-0.0026297477590166984,-296.70625938640916,0.012909293769424245
2023-08-22T20:00:00-04:00,1.08463,1.08523,1.08457,1.08508,1.0841786879999997,1.0847642222222222,1.0847133333333265,1.0846288888888809,1.0846330000000035,1.0851834000000011,1.0879532000000016,1.0884215000000041,1.084748446424485,1.0846723171389365,1188,-388844,-389570.2,0.003468304526241836,-296.2133724111272,0.05532605488346083
2023-08-22T20:15:00-04:00,1.08508,1.08535,1.08498,1.0853,1.0842417667199997,1.0848815555555555,1.0847933333333262,1.084676888888881,1.0846660000000035,1.0851198000000013,1.0879072000000016,1.0884092500000042,1.084858757139588,1.0847190537111486,1318,-387526,-389099.4,0.009886750174614574,-295.9461478746876,0.06638514447987533
2023-08-22T20:30:00-04:00,1.0853,1.08533,1.08474,1.08486,1.0843304253823998,1.084894888888889,1.0848166666666597,1.084720222222214,1.0846845000000036,1.0850402000000012,1.0878546000000018,1.0883951500000042,1.0848590057116705,1.0847612429689184,-1175,-388701,-388905.4,0.011502235912069279,-296.4225138564438,0.01936108422072037
2023-08-22T20:45:00-04:00,1.08486,1.08496,1.08464,1.0847,1.0844119913518078,1.0848715555555555,1.084818888888882,1.0847577777777697,1.0846900000000037,1.0849618000000012,1.0878039000000017,1.0883816000000044,1.0848272045693363,1.0847917943751342,-1470,-390171,-389054.8,0.011041166649927546,-296.6393160244654,0.0018438617841122708
2023-08-22T21:00:00-04:00,1.0847,1.0850899999999999,1.08446,1.08501,1.08535,1.0849097777777779,1.0848655555555484,1.0848015555555475,1.0847070000000036,1.084911000000001,1.0877595000000015,1.0883703500000044,1.084863763655469,1.0848314355001067,1568,-388603,-388769,0.012239445344472723,-296.1911921192381,0.038724310568978786
2023-08-22T21:15:00-04:00,1.08501,1.08547,1.08501,1.0853599999999999,1.08446,1.0850086666666667,1.084939999999993,1.0848468888888807,1.0847405000000037,1.0848858000000012,1.0877181000000018,1.0883608000000045,1.084963010924375,1.0848743484000847,1605,-386998,-388399.8,0.016308523014413392,-295.67345495552553,0.061768800302385796
2023-08-22T21:30:00-04:00,1.0853599999999999,1.08563,1.08505,1.08555,1.08446,1.0851306666666667,1.085029999999993,1.084894222222214,1.0847760000000037,1.0848648000000012,1.0876766000000015,1.0883524500000044,1.0850804087395,1.0849186787200673,2036,-384962,-387887,0.020460607295360124,-295.3170386512576,0.0746722716964413
2023-08-22T21:45:00-04:00,1.08555,1.0856,1.0853,1.0855,1.0845068,1.0852246666666667,1.085109999999993,1.0849528888888806,1.0848245000000036,1.0848580000000012,1.0876312000000017,1.0883425500000043,1.0851643269916,1.0849797429760533,-1614,-386576,-387462,0.024568697977838137,-295.39137884747163,0.06637290510516712
2023-08-22T22:00:00-04:00,1.0855,1.08577,1.08541,1.08555,1.084551728,1.0853126666666666,1.0852122222222151,1.0850315555555474,1.0848860000000038,1.0848618000000012,1.0875876000000018,1.0883301500000042,1.08524146159328,1.0850625943808416,1772,-384804,-386388.6,0.02718808324484439,-295.3097574748321,0.08482155205001078
2023-08-22T22:15:00-04:00,1.08555,1.08556,1.08523,1.08534,1.08462482432,1.085338222222222,1.085241111111104,1.0851066666666582,1.0849280000000037,1.084881000000001,1.0875338000000017,1.0883151000000044,1.085261169274624,1.0851420755046728,-1554,-386358,-385939.6,0.029254191491697355,-295.61037927944733,0.023961366903816027
2023-08-22T22:30:00-04:00,1.08534,1.08571,1.08534,1.08545,1.0846935348608,1.0853799999999998,1.0852577777777705,1.085170222222214,1.0849760000000037,1.0849010000000012,1.0874831000000016,1.0883019000000043,1.0852989354196991,1.0852092604037376,1489,-384869,-385513.8,0.02849366726961335,-295.4594680442583,0.013821063300478624
2023-08-22T22:45:00-04:00,1.08545,1.08551,1.08531,1.08545,1.084758122769152,1.0854184444444444,1.085323333333326,1.0852288888888804,1.0850245000000036,1.084926600000001,1.0874314000000016,1.0882893000000045,1.0853291483357592,1.0852590083229896,0,-384869,-385495.2,0.025661653274393327,-295.4594680442583,0.054384897590480846
2023-08-22T23:00:00-04:00,1.08545,1.0855299999999999,1.08519,1.08524,1.0848188354030028,1.0854017777777778,1.085383333333326,1.0852835555555473,1.0850575000000038,1.084952400000001,1.0873749000000015,1.0882778000000044,1.0853113186686074,1.0852884066583908,-979,-385848,-385349.6,0.02582756839510162,-295.648873360026,0.049783350235086656
2023-08-22T23:15:00-04:00,1.08524,1.08539,1.08522,1.08532,1.0848759052788226,1.0853891111111111,1.0854177777777705,1.0853246666666583,1.0850910000000038,1.084956600000001,1.0873172000000013,1.0882677500000044,1.085313054934886,1.0853027253267122,915,-384933,-385375.4,0.028293105514242183,-295.58142284216814,0.02857116524271965
2023-08-22T23:30:00-04:00,1.08532,1.0859699999999999,1.08529,1.08573,1.0849295509620933,1.0854515555555555,1.0854588888888816,1.0853682222222139,1.0851435000000036,1.084966800000001,1.0872657000000014,1.0882608000000042,1.0853964439479087,1.0853297802613693,1379,-383554,-384814.6,0.030187536615726138,-295.0604797101886,0.03409007149703357
2023-08-22T23:45:00-04:00,1.08573,1.08584,1.08559,1.08575,1.0850127868851258,1.085509777777778,1.085481111111104,1.0854128888888805,1.0852015000000037,1.084983800000001,1.0872154000000014,1.0882529000000043,1.085467155158327,1.0853634242090948,1292,-382262,-384293.2,0.029084692272147793,-295.0366800546574,0.018423840449539677
2023-08-23T00:00:00-04:00,1.08575,1.0858,1.08559,1.08572,1.0850893639343158,1.0855575555555554,1.0855055555555486,1.085449333333325,1.0852530000000038,1.084995400000001,1.0871590000000015,1.0882439000000044,1.0855177241266616,1.0854011393672753,-970,-383232,-383965.8,0.025691374412071172,-295.0634818045998,0.020267157991718934
2023-08-23T00:15:00-04:00,1.08572,1.08576,1.0855,1.0856,1.0851598148195705,1.0855764444444442,1.0855111111111038,1.0854748888888806,1.0852960000000036,1.0850166000000008,1.0871006000000014,1.0882319000000045,1.0855341793013293,1.0854457114938196,-1191,-384423,-383680.8,0.022618914941801016,-295.19511795388337,0.004605960112374692
2023-08-23T00:30:00-04:00,1.0856,1.0858,1.08549,1.08575,1.085224629634005,1.085624222222222,1.0855566666666594,1.0855026666666583,1.0853445000000037,1.0850368000000008,1.0870433000000015,1.0882201000000042,1.0855773434410634,1.0854985691950552,1024,-383399,-383374,0.02002924752799542,-295.05362937613825,0.037776180735992544
2023-08-23T00:45:00-04:00,1.08575,1.08607,1.08568,1.08606,1.0852842592632845,1.0857248888888889,1.0856244444444372,1.0855357777777694,1.0854160000000037,1.0850622000000008,1.0869887000000016,1.0882097500000043,1.0856738747528507,1.0855540553560437,973,-382426,-383148.4,0.02104598132346914,-294.775821409295,0.056197890275922376
2023-08-23T01:00:00-04:00,1.08606,1.08623,1.08592,1.08617,1.085362833336956,1.0858340000000002,1.0857044444444373,1.0855804444444361,1.0854705000000038,1.0850886000000008,1.0869346000000015,1.0882000000000043,1.0857730998022805,1.0856152442848344,1326,-381100,-382916,0.02092172274996461,-294.64151943702825,0.06633193606338882
2023-08-23T01:15:00-04:00,1.08617,1.08629,1.08598,1.08616,1.0854668933365212,1.0859251111111112,1.0858066666666595,1.0856406666666583,1.0855135000000038,1.0851130000000009,1.0868823000000014,1.0881896500000041,1.0858504798418245,1.0856817954278668,-1450,-382550,-382779.6,0.022723713423558046,-294.65486909684216,0.08477387490325015
2023-08-23T01:30:00-04:00,1.08616,1.08626,1.08595,1.08611,1.0855821282694083,1.0859857777777777,1.0858944444444374,1.085717333333325,1.0855760000000036,1.0851364000000008,1.0868314000000014,1.088179250000004,1.0859023838734596,1.085755436342293,-1398,-383948,-382684.6,0.027184140640149183,-294.71922425630316,0.07278959200971569
2023-08-23T01:45:00-04:00,1.08611,1.08633,1.08584,1.08623,1.0856812303116912,1.086052888888889,1.0859499999999929,1.0857959999999918,1.0856525000000037,1.0851534000000007,1.0867846000000014,1.0881702000000042,1.0859679070987678,1.085833549073834,1989,-381959,-382396.6,0.029555548245166822,-294.49946750974874,0.046051965037343066
2023-08-23T02:00:00-04:00,1.08623,1.0863099999999999,1.08546,1.08559,1.08633,1.0859808888888889,1.085932222222215,1.0858575555555472,1.0856815000000037,1.085157600000001,1.0867280000000015,1.0881577500000044,1.0858923256790143,1.0858772392590668,-2706,-384665,-382844.4,0.02436110224147386,-296.0938259789495,-0.014736357356660186
2023-08-23T02:15:00-04:00,1.08559,1.08562,1.08525,1.08548,1.08633,1.0858904444444446,1.0859055555555486,1.0858977777777696,1.0856875000000037,1.085162200000001,1.0866700000000014,1.0881436500000043,1.0858098605432114,1.0858845914072528,-2020,-386685,-383961.4,0.01981217687912302,-296.29850730431184,-0.02210514681501842
2023-08-23T02:30:00-04:00,1.08548,1.08602,1.0852,1.08587,1.0863099999999999,1.0858833333333333,1.0859355555555483,1.0859235555555473,1.0857035000000037,1.0851706000000008,1.0866176000000012,1.0881325000000044,1.0858218884345692,1.085878873125802,2200,-384485,-384348.4,0.018956456292104344,-295.50807357913976,0.024871039056742122
2023-08-23T02:45:00-04:00,1.08587,1.08647,1.0858,1.0861399999999999,1.0852,1.0859242222222223,1.085978888888882,1.0859404444444363,1.0857355000000037,1.085186200000001,1.0865736000000015,1.0881226500000043,1.0858855107476553,1.0858754985006411,2622,-381863,-383931.4,0.021341908693226865,-294.8561170834267,0.03591987105686304
2023-08-23T03:00:00-04:00,1.0861399999999999,1.08629,1.08579,1.08603,1.0852,1.0859344444444443,1.0859755555555486,1.0859455555555475,1.0857595000000038,1.085199000000001,1.0865196000000015,1.0881115000000043,1.0859144085981243,1.0858647988005123,-3480,-385343,-384608.2,0.02159579031233824,-295.2085578369202,-0.0027622783271618965
2023-08-23T03:15:00-04:00,1.08603,1.08716,1.08598,1.08671,1.0852254,1.0860813333333335,1.0860355555555485,1.0859662222222142,1.0858280000000038,1.0852286000000009,1.0864672000000015,1.0881043000000046,1.0860735268784993,1.0859010390404094,4343,-381000,-383875.2,0.022493739557078306,-292.4892591066825,0.04971597447913171
2023-08-23T03:30:00-04:00,1.08671,1.08671,1.08115,1.08222,1.08716,1.0853182222222222,1.085597777777771,1.0859046666666585,1.0856665000000036,1.085172200000001,1.0863709000000015,1.0880747500000045,1.0853028215027996,1.085799631232327,-12773,-393773,-385292.8,-0.0002017651818817549,-345.26393680358535,-0.3627458201370014
2023-08-23T03:45:00-04:00,1.08222,1.08308,1.08176,1.08181,1.08716,1.0845606666666665,1.0851199999999932,1.0857415555555476,1.0854845000000037,1.085115600000001,1.0862711000000014,1.0880432000000047,1.0846042572022396,1.085556104985861,-5420,-399193,-388234.4,-0.024307812980892032,-347.31730857642276,-0.3959083334100571
2023-08-23T04:00:00-04:00,1.08181,1.0829199999999999,1.08177,1.0828,1.0870398,1.0840966666666667,1.084738888888882,1.0854935555555478,1.0853625000000036,1.085081800000001,1.0861784000000014,1.0880196000000044,1.0842434057617918,1.0852276839886883,5432,-393761,-390614,-0.043180889845448385,-342.34630627472444,-0.3157710613774287
2023-08-23T04:15:00-04:00,1.0828,1.08303,1.0823,1.0827499999999999,1.0869220039999998,1.0836988888888888,1.0844233333333264,1.0851831111111032,1.0852340000000036,1.0850450000000011,1.0860803000000014,1.0879934500000046,1.0839447246094334,1.0848337471909502,-4003,-397764,-393098.2,-0.06432645897297126,-342.5311511214186,-0.26160889470243603
2023-08-23T04:30:00-04:00,1.0827499999999999,1.0827499999999999,1.08154,1.08242,1.0868065639199997,1.083298222222222,1.0840833333333264,1.0847926666666587,1.0850685000000035,1.085000000000001,1.0859752000000014,1.0879662000000045,1.0836397796875468,1.0843469977527596,-7128,-404892,-397876.6,-0.08082204405097496,-344.703619373554,-0.28190293694955804
2023-08-23T04:45:00-04:00,1.08242,1.08253,1.08178,1.0819,1.0866934326415998,1.0828615555555554,1.0836422222222153,1.0844015555555475,1.0848760000000035,1.0849442000000011,1.0858686000000015,1.0879370000000046,1.0832918237500375,1.083944798202207,-3487,-408379,-400797.8,-0.09702294710080524,-346.37879167266107,-0.3656054592170156
2023-08-23T05:00:00-04:00,1.0819,1.08202,1.08136,1.08145,1.0865825639887678,1.082423111111111,1.083121111111104,1.08400177777777,1.0846625000000036,1.084876400000001,1.0857649000000016,1.0879028000000046,1.08292345900003,1.0836086385617651,-2938,-411317,-403222.6,-0.11891231254063091,-347.6008084949184,-0.43180437144381584
2023-08-23T05:15:00-04:00,1.08145,1.08183,1.08101,1.08177,1.0864739127089924,1.0821528888888887,1.0826477777777708,1.0835835555555478,1.0844710000000037,1.084821200000001,1.0856653000000016,1.0878682500000045,1.082692767200024,1.0832985108494115,3341,-407976,-406065.6,-0.1418835197507463,-346.61220985420493,-0.39225435761444455
2023-08-23T05:30:00-04:00,1.08177,1.08205,1.08135,1.08145,1.0862553562006327,1.0819133333333333,1.082063333333326,1.0831115555555475,1.0842560000000039,1.084763800000001,1.0855656000000016,1.0878314500000044,1.0824442137600192,1.0829984086795288,-3171,-411147,-408742.2,-0.16592251415927453,-347.5502281020761,-0.48402977795364377
2023-08-23T05:45:00-04:00,1.08145,1.08157,1.08083,1.08099,1.0860455419526074,1.0816986666666666,1.0819266666666596,1.0826802222222143,1.0840025000000035,1.084693600000001,1.0854655000000015,1.0877921500000045,1.0821533710080153,1.0827011269436224,-3312,-414459,-410655.6,-0.1978115716736052,-348.9590033575206,-0.11365526417919318
2023-08-23T06:00:00-04:00,1.08099,1.0812,1.0806,1.08096,1.085732609435451,1.0815053333333333,1.081832222222215,1.082318222222214,1.0837420000000038,1.084623000000001,1.0853674000000018,1.0877542000000044,1.0819146968064122,1.0824257015548973,-2679,-417138,-412407.4,-0.18707429942668266,-349.0333518713828,-0.07857202281361954
2023-08-23T06:15:00-04:00,1.08096,1.0812,1.08079,1.0808,1.0853220006806148,1.081298888888889,1.0816099999999926,1.0820159999999919,1.0834740000000038,1.0845494000000009,1.0852759000000016,1.0877167000000045,1.0816917574451297,1.0821793612439172,-2321,-419459,-414035.8,-0.1728406671925759,-349.37689834858816,-0.18470631695604006
2023-08-23T06:30:00-04:00,1.0808,1.0812,1.08051,1.08093,1.0849442406261656,1.081162888888889,1.0814077777777706,1.0817679999999918,1.0832150000000036,1.0844764000000007,1.0851808000000016,1.0876788500000045,1.0815394059561036,1.081948688995133,2405,-417054,-415851.4,-0.16715303152752442,-349.0876218867081,-0.16809051027475713
2023-08-23T06:45:00-04:00,1.08093,1.08098,1.08063,1.08074,1.084500816563549,1.0810293333333332,1.0812211111111039,1.0815995555555475,1.0829405000000034,1.0843982000000008,1.0850816000000016,1.0876395500000045,1.081379524764883,1.0817357511961059,-2270,-419324,-417486.8,-0.16214084477292487,-349.48663014811245,-0.1552077751704425
2023-08-23T07:00:00-04:00,1.08074,1.0809199999999999,1.08037,1.08062,1.0841017349071942,1.080909111111111,1.0810788888888814,1.0814299999999917,1.0826920000000038,1.0843170000000009,1.0849860000000016,1.0875978000000046,1.0812276198119064,1.0815506009568843,-2912,-422236,-419042.2,-0.1541331510945423,-349.8099641599935,-0.11831037988725111
2023-08-23T07:15:00-04:00,1.08062,1.0812,1.08055,1.08101,1.083653926718331,1.080895333333333,1.0810299999999924,1.0812695555555472,1.0824685000000036,1.084245400000001,1.0849072000000017,1.0875558000000045,1.0811840958495251,1.0814044807655068,1944,-420292,-419673,-0.1422397772579884,-349.1083669287742,-0.04068611586296139
2023-08-23T07:30:00-04:00,1.08101,1.08184,1.081,1.08161,1.0832598555121313,1.0810113333333333,1.0810122222222147,1.0811499999999916,1.0822555000000036,1.0841838000000008,1.0848322000000017,1.0875150500000046,1.0812692766796201,1.0813199846124049,2615,-417677,-419316.6,-0.12376061216866469,-347.65694649788105,-0.014790574706262698
2023-08-23T07:45:00-04:00,1.08161,1.0816999999999999,1.08087,1.08112,1.0829130728506755,1.0810328888888887,1.0809755555555478,1.0810635555555472,1.0820045000000034,1.0841114000000007,1.0847567000000016,1.0874700000000046,1.0812394213436962,1.0812599876899234,-2668,-420345,-419974.8,-0.10889179595532217,-348.8656261513603,-0.03051458689721591
2023-08-23T08:00:00-04:00,1.08112,1.08128,1.08046,1.081,1.0826079041085945,1.0810377777777778,1.0809766666666591,1.0810146666666582,1.0817530000000035,1.0840358000000008,1.0846825000000018,1.0874242000000045,1.081191537074957,1.0812223901519382,-3678,-424023,-420914.6,-0.09045340694455992,-349.27386945460177,0.0009250779378223215
2023-08-23T08:15:00-04:00,1.081,1.08103,1.08045,1.08057,1.0823393556155632,1.0809564444444444,1.080933333333326,1.0809855555555472,1.0814460000000035,1.0839546000000007,1.0846047000000016,1.0873800000000045,1.0810672296599655,1.0811903121215498,-2909,-426932,-421853.8,-0.07032162436143735,-350.43101099021675,-0.03607904085256536
2023-08-23T08:30:00-04:00,1.08057,1.08099,1.0803,1.08087,1.0821030329416956,1.080943777777778,1.0809411111111036,1.0809677777777693,1.0813785000000036,1.0838704000000008,1.0845269000000017,1.0873356500000044,1.0810277837279725,1.0811590496972394,4063,-422869,-422369.2,-0.045456166701401124,-349.3029952207619,0.006476683937825176
2023-08-23T08:45:00-04:00,1.08087,1.08106,1.08023,1.08041,1.0818506083298582,1.0808375555555556,1.0808833333333259,1.0809419999999916,1.0813085000000036,1.0837726000000005,1.0844462000000017,1.0872882500000045,1.080904226982378,1.081086039757791,-4182,-427051,-424244,-0.04109568530508727,-351.0827837244669,-0.048106722914513796
2023-08-23T09:00:00-04:00,1.08041,1.08175,1.08033,1.08168,1.08023,1.080996888888889,1.0809877777777703,1.080944444444436,1.0812525000000035,1.0837090000000007,1.0843746000000016,1.0872436500000047,1.0810593815859024,1.0810500318062322,5883,-421168,-424408.6,-0.033587503880571294,-344.1674367728473,0.08697744138275079
2023-08-23T09:15:00-04:00,1.08168,1.08295,1.0815,1.08282,1.08023,1.0813633333333332,1.0812322222222148,1.0809955555555473,1.0812560000000038,1.0836714000000007,1.0843166000000017,1.0872024500000046,1.0814115052687219,1.0810940254449852,5873,-415295,-422663,-0.014439927654767905,-337.9777873386343,0.20358682978290055
2023-08-23T09:30:00-04:00,1.08282,1.0835299999999999,1.08252,1.08263,1.08033,1.081642888888889,1.081412222222215,1.081091333333325,1.0812665000000037,1.0836238000000007,1.0842674000000017,1.0871601000000046,1.0816552042149774,1.0812116203559874,-6915,-422210,-421718.6,0.004676817386404112,-339.19114689977965,0.14985985328534931
2023-08-23T09:45:00-04:00,1.08263,1.08449,1.08263,1.08377,1.080522,1.0821144444444444,1.081652222222215,1.0812335555555472,1.0813600000000037,1.0835920000000008,1.0842389000000017,1.0871244000000047,1.0820781633719818,1.0814216962847891,14342,-407868,-418718.4,0.024254593973572113,-324.08914529258345,0.19970229565184677
2023-08-23T10:00:00-04:00,1.08377,1.08447,1.08347,1.0843099999999999,1.0808394399999999,1.082646,1.082006666666659,1.081458222222214,1.0815030000000037,1.0835672000000007,1.0842160000000016,1.0870937500000046,1.0825245306975855,1.0817457570278308,10115,-397753,-412858.8,0.03860597556066137,-319.0492383012478,0.2950643776823853
2023-08-23T10:15:00-04:00,1.0843099999999999,1.08538,1.08412,1.08496,1.0811314848,1.0832366666666666,1.0824466666666592,1.0817499999999916,1.0816625000000035,1.0835564000000004,1.0842072000000018,1.0870688000000046,1.0830116245580683,1.0821362056222639,7734,-390019,-406629,0.05864841853565123,-314.4130180321363,0.3663274745605887
2023-08-23T10:30:00-04:00,1.08496,1.08508,1.08409,1.08488,1.08155633632,1.0837233333333331,1.0829255555555481,1.082088666666658,1.0818340000000037,1.0835430000000006,1.0842024000000017,1.0870426000000046,1.0833852996464546,1.0825309644978103,-6271,-396290,-402828,0.08081651086620678,-314.87541295913735,0.3988635627492931
2023-08-23T10:45:00-04:00,1.08488,1.08534,1.08425,1.08454,1.081938702688,1.0840462222222222,1.083333333333326,1.0824728888888804,1.0820115000000037,1.0835270000000006,1.084204000000002,1.0870160500000048,1.0836162397171636,1.0829231715982477,-5476,-401766,-398739.2,0.10389847024084523,-316.59158433292987,0.33954129543794
2023-08-23T11:00:00-04:00,1.08454,1.08534,1.08445,1.08527,1.0822828324192,1.0844335555555558,1.0838733333333257,1.0829171111111024,1.0822270000000036,1.0835234000000005,1.0842122000000018,1.0869972500000047,1.0839469917737308,1.0832969372785974,4039,-397727,-396711,0.12570460495941926,-313.87294786032436,0.44982923149543824
2023-08-23T11:15:00-04:00,1.08527,1.08531,1.0848,1.08527,1.08259254917728,1.0847128888888888,1.0842722222222145,1.0833702222222137,1.0824505000000038,1.0835198000000006,1.084223200000002,1.0869772000000046,1.0842115934189847,1.083634349822877,0,-397727,-396705.8,0.15162027311295143,-313.87294786032436,0.3318911323126971
2023-08-23T11:30:00-04:00,1.08527,1.08626,1.08507,1.08547,1.0828712942595522,1.0849524444444445,1.0845666666666591,1.0837942222222137,1.0826775000000037,1.0835244000000006,1.084238400000002,1.0869610500000046,1.0844632747351877,1.0839246798583013,3468,-394259,-397553.8,0.16605614027703164,-313.2338442271272,0.24473134962413343
2023-08-23T11:45:00-04:00,1.08547,1.08628,1.08547,1.08613,1.083277938948406,1.0852651111111111,1.0849555555555481,1.0842002222222136,1.0829470000000039,1.0835406000000005,1.084248600000002,1.0869481000000045,1.0847966197881502,1.0842069438866404,2991,-391268,-396549.4,0.17371836367114804,-311.4152218792039,0.3232868108218005
2023-08-23T12:00:00-04:00,1.08613,1.08644,1.0856,1.08603,1.083698227495629,1.08548,1.085206666666659,1.0845748888888802,1.083217500000004,1.0835466000000007,1.0842567000000018,1.0869365000000046,1.0850432958305203,1.0844923551093117,-2897,-394165,-395029.2,0.18181162692259478,-311.6819486982771,0.20853133044835628
2023-08-23T12:15:00-04:00,1.08603,1.08682,1.08602,1.08674,1.0841369110963284,1.0857866666666667,1.0854766666666593,1.084895555555547,1.0835040000000036,1.0835664000000007,1.084275100000002,1.0869288500000045,1.0853826366644161,1.084779484087449,2743,-391422,-393768.2,0.18227698101521794,-309.8886925267165,0.2241056524425814
2023-08-23T12:30:00-04:00,1.08674,1.0867499999999999,1.08635,1.08636,1.0846198670989893,1.0859633333333334,1.085632222222215,1.0851675555555471,1.0837415000000037,1.0835792000000006,1.084287300000002,1.0869201000000046,1.0855781093315329,1.0850527872699587,-1737,-393159,-392854.6,0.17764202133576087,-310.4960687160535,0.12903701518950633
2023-08-23T12:45:00-04:00,1.08636,1.08661,1.08615,1.08628,1.0850158910211711,1.0860928888888888,1.0857877777777705,1.0854117777777694,1.0839995000000038,1.0835928000000006,1.084304700000002,1.0869078500000047,1.0857184874652264,1.0853038298159663,-2091,-395250,-393052.8,0.16926678883435878,-310.6500508214331,0.12904653049183742
2023-08-23T13:00:00-04:00,1.08628,1.0865,1.086,1.08603,1.0853406306373603,1.0861413333333334,1.0859533333333262,1.085611333333325,1.0842510000000039,1.0835984000000005,1.0843176000000019,1.0868962000000044,1.0857807899721812,1.0855006638527727,-1937,-397187,-394236.6,0.1582709669940512,-311.0958382795468,0.1373854352997576
2023-08-23T13:15:00-04:00,1.08603,1.08701,1.0859699999999999,1.08664,1.0856069171226355,1.0862786666666668,1.0861055555555483,1.085791111111103,1.0845545000000039,1.0836100000000006,1.0843361000000018,1.0868863000000044,1.085952631977745,1.0856825310822176,2684,-394503,-394304.2,0.15283031627933008,-309.58829244747955,0.1262358675721335
2023-08-23T13:30:00-04:00,1.08664,1.08695,1.08657,1.08668,1.0858875336981084,1.0863935555555555,1.086262222222215,1.085948222222214,1.0848450000000038,1.0836202000000006,1.0843544000000018,1.0868772500000043,1.086098105582196,1.0858256248657736,1839,-392664,-394552.6,0.13896443769541905,-309.5205975347209,0.12992158633336712
2023-08-23T13:45:00-04:00,1.08668,1.08678,1.08641,1.08647,1.0859699999999999,1.0864351111111112,1.086373333333326,1.0860964444444363,1.0851480000000038,1.0836264000000007,1.0843697000000019,1.0868657500000045,1.086172484465757,1.0859444998926184,-1802,-394466,-394814,0.12541164893540474,-309.86883252570266,0.0921259915059939
2023-08-23T14:00:00-04:00,1.08647,1.08648,1.08612,1.08612,1.08701,1.0863844444444444,1.086372222222215,1.0862133333333253,1.0853700000000037,1.0836266000000006,1.0843815000000019,1.0868498000000044,1.0861619875726056,1.0860331999140942,-2354,-396820,-395128,0.10631407674226653,-310.6271599530593,-0.0009207001003623426
2023-08-23T14:15:00-04:00,1.08612,1.08615,1.08574,1.08594,1.0869922,1.086298,1.086362222222215,1.086295111111103,1.0855260000000038,1.0836208000000007,1.084387100000002,1.0868306500000045,1.0861175900580844,1.086100559931275,-1759,-398579,-395406.4,0.08585402578146117,-310.9186747028108,-0.008287063893276016
2023-08-23T14:30:00-04:00,1.08594,1.0859699999999999,1.08563,1.08568,1.086942112,1.0861615555555555,1.0862444444444372,1.0863228888888807,1.0856785000000038,1.0836226000000007,1.084390100000002,1.0868081000000045,1.0860300720464675,1.0861160479450196,-2224,-400803,-396666.4,0.07007308235605295,-311.4511534769602,-0.0975394298544326
2023-08-23T14:45:00-04:00,1.08568,1.08624,1.08557,1.08587,1.08686338528,1.0860866666666664,1.0861899999999927,1.0863084444444362,1.0857835000000038,1.0836304000000008,1.0843963000000019,1.0867866500000047,1.085998057637174,1.0860960383560152,2227,-398576,-397848.8,0.04783889428885267,-311.06141616946644,-0.04510475348872395
2023-08-23T15:00:00-04:00,1.08587,1.08639,1.08583,1.08611,1.0867599144576001,1.0860706666666669,1.0861711111111036,1.0862679999999916,1.0858735000000037,1.0836352000000007,1.084402900000002,1.0867687000000046,1.0860204461097391,1.0860656306848113,1947,-396629,-398281.4,0.03526917635400515,-310.6310884138419,-0.0156497403984243
2023-08-23T15:15:00-04:00,1.08611,1.08659,1.08601,1.08657,1.0866647213009921,1.0861504444444445,1.0862311111111036,1.0862397777777693,1.0859540000000036,1.0836438000000006,1.0844150000000021,1.0867506500000044,1.0861303568877914,1.0860593045478484,1404,-395225,-397962.4,0.028025735790891973,-310.0364525114009,0.04972238335957431
2023-08-23T15:30:00-04:00,1.08657,1.08665,1.0863099999999999,1.08662,1.08557,1.0862282222222222,1.0862288888888814,1.0862131111111026,1.0860410000000038,1.0836556000000008,1.084427300000002,1.0867325000000045,1.086228285510233,1.0860814436382782,1764,-393461,-396938.8,0.026177666110035754,-309.95527964633027,-0.0018405359640847956
2023-08-23T15:45:00-04:00,1.08662,1.08665,1.08629,1.08639,1.0855915999999999,1.0862604444444444,1.0861966666666594,1.086203555555547,1.0861335000000039,1.0836492000000006,1.0844389000000019,1.0867148500000046,1.0862606284081864,1.0861275549106222,-1716,-395177,-395813.6,0.01725331594726003,-310.3184976986392,-0.026686789119163275
2023-08-23T16:00:00-04:00,1.08639,1.08639,1.08619,1.0862,1.0856127679999998,1.0862611111111111,1.0861666666666592,1.0861988888888803,1.0861800000000037,1.0837288000000007,1.0844505000000018,1.0866955500000046,1.0862485027265492,1.0861776439284971,-882,-396059,-395310.2,0.0055548565100150115,-310.47275169582247,-0.024851123362816502
2023-08-23T16:15:00-04:00,1.0862,1.08659,1.08609,1.08617,1.0856335126399999,1.0862617777777779,1.0861722222222145,1.0861991111111027,1.0862250000000038,1.0838160000000006,1.084465800000002,1.0866766500000047,1.0862328021812393,1.086220115142797,-1357,-397416,-395467.6,-0.0011530146947799165,-310.5102309814052,0.004603542886615247
2023-08-23T16:30:00-04:00,1.08617,1.08635,1.08616,1.08627,1.0856538423871998,1.0862813333333334,1.0862088888888812,1.0861946666666582,1.0862650000000038,1.0838854000000004,1.084483600000002,1.0866592500000047,1.0862402417449915,1.086242092114237,824,-396592,-395741,-0.004155931605766291,-310.43436808701483,0.03038841924969736
2023-08-23T16:45:00-04:00,1.08627,1.08644,1.08616,1.08629,1.0856737655394557,1.0862975555555556,1.086276666666659,1.0862042222222137,1.0862730000000036,1.0839562000000007,1.0845006000000017,1.0866415000000047,1.0862501933959932,1.0862464736913893,1437,-395155,-396079.8,-0.00452839981759511,-310.4079105764513,0.05618598482057323
2023-08-23T17:00:00-04:00,1.08629,1.08652,1.08619,1.08637,1.0856932902286667,1.0863162222222222,1.0863322222222147,1.0862313333333247,1.0862900000000038,1.0840352000000006,1.0845176000000019,1.0866254000000048,1.0862741547167944,1.086249178953111,169,-394986,-396041.6,0.0007715295092586267,-310.3954645445445,0.04604602760921354
2023-08-23T17:15:00-04:00,1.08637,1.08646,1.08622,1.08646,1.0857124244240934,1.086341777777778,1.0863711111111036,1.0862722222222136,1.0862760000000038,1.0841264000000006,1.084535300000002,1.0866088000000047,1.0863113237734356,1.0862617431624884,113,-394873,-395804.4,0.004317853645564944,-310.3861030931053,0.032225096905476654
2023-08-23T17:30:00-04:00,1.08646,1.08653,1.08637,1.08642,1.0857311759356116,1.0863515555555554,1.0863544444444369,1.0863086666666582,1.0862790000000035,1.0842258000000005,1.0845511000000019,1.0865925500000049,1.0863330590187485,1.08628179452999,-260,-395133,-395347.8,0.00857445706087359,-310.3956754657651,-0.013804909025658217
2023-08-23T17:45:00-04:00,1.08642,1.08647,1.08599,1.0862,1.0857495524168994,1.0863206666666665,1.08630777777777,1.086328444444436,1.0862750000000037,1.0843144000000007,1.0845678000000019,1.0865755000000048,1.0863064472149988,1.0862950356239915,-1769,-396902,-395409.8,0.0058697743010436,-310.75389788435075,-0.038651966648862064
2023-08-23T18:00:00-04:00,1.0862,1.0867,1.08617,1.0867,1.0857675613685613,1.0863991111111113,1.0863422222222145,1.0863415555555471,1.0863085000000035,1.0844194000000007,1.084591600000002,1.0865622500000047,1.086385157771999,1.0863220284991928,789,-396113,-395601.4,0.004764994170037728,-310.3907051021744,0.02853487237548509
2023-08-23T18:15:00-04:00,1.0867,1.08672,1.0865,1.08652,1.085804858913819,1.0864346666666667,1.0863777777777701,1.0863506666666582,1.0863025000000035,1.0845300000000007,1.084611800000002,1.0865484000000047,1.0864121262175992,1.0863496227993537,-520,-396633,-395930.8,0.0038136668672757073,-310.4768374294037,0.02946050451112833
2023-08-23T18:30:00-04:00,1.08652,1.08654,1.08635,1.08649,1.0858597673789898,1.0864571111111112,1.0864133333333257,1.0863591111111028,1.0862930000000035,1.0846406000000008,1.084631800000002,1.0865335500000048,1.0864277009740793,1.0863728982394825,-193,-396826,-396321.4,0.007140809397225502,-310.48216636950605,0.029461318209845228
2023-08-23T18:45:00-04:00,1.08649,1.08649,1.08639,1.08645,1.0859113813362504,1.0864644444444442,1.0864333333333256,1.0863748888888805,1.0862920000000036,1.0847536000000007,1.084651500000002,1.0865180000000048,1.0864321607792633,1.0863927185915854,-244,-397070,-396708.8,0.010726664682639579,-310.4911494250335,0.01657046590625231
2023-08-23T19:00:00-04:00,1.08645,1.08646,1.08628,1.08632,1.0859598984560754,1.0864417777777777,1.086436666666659,1.0864006666666581,1.0863020000000039,1.0848614000000005,1.084668900000002,1.086503400000005,1.0864097286234107,1.0864133748732678,-413,-397483,-396825,0.011844560094551594,-310.54056725374164,0.002761693470433723
2023-08-23T19:15:00-04:00,1.08632,1.08645,1.08626,1.08629,1.086005504548711,1.0864124444444445,1.08642777777777,1.0864177777777693,1.0863195000000039,1.0849724000000007,1.084685300000002,1.0864887000000047,1.0863857828987284,1.0864134998986137,-515,-397998,-397202,0.011099260794760915,-310.55478958233726,-0.007363973600162008
2023-08-23T19:30:00-04:00,1.08629,1.08657,1.08628,1.08646,1.0860483742757883,1.0864188888888888,1.08642777777777,1.0864277777777693,1.0863585000000038,1.0850892000000005,1.084703100000002,1.0864748500000048,1.0864006263189827,1.0864111999188903,501,-397497,-397374.8,0.009648071153178324,-310.4763851047116,0
2023-08-23T19:45:00-04:00,1.08646,1.0866,1.08609,1.08654,1.086088671819241,1.0864413333333334,1.0864411111111034,1.086433333333325,1.086392000000004,1.0851998000000007,1.084722600000002,1.0864594000000047,1.0864285010551862,1.0864113599351115,689,-396808,-397371.2,0.006614443683485537,-310.4256515296144,0.011045452035135584
2023-08-23T20:00:00-04:00,1.08654,1.0869199999999999,1.0863099999999999,1.08686,1.08609,1.086525111111111,1.0865144444444368,1.0864495555555471,1.086429500000004,1.0853048000000005,1.084744300000002,1.0864451500000047,1.086514800844149,1.0864278879480889,1215,-395593,-397075.8,0.00632486949232647,-310.0678184079623,0.060762290554214955
2023-08-23T20:15:00-04:00,1.08686,1.0875299999999999,1.0867499999999999,1.08714,1.08609,1.086650222222222,1.0865633333333256,1.0864748888888804,1.086458000000004,1.0854252000000004,1.0847683000000021,1.0864326500000048,1.0866398406753193,1.0864739103584704,1660,-393933,-396365.8,0.010462080328211549,-309.64016443228917,0.040489555535105914
2023-08-23T20:30:00-04:00,1.08714,1.08721,1.08686,1.0869,1.086234,1.0867175555555555,1.0866055555555478,1.086510444444436,1.0864720000000039,1.0855432000000005,1.084789500000002,1.0864192000000046,1.0866918725402555,1.086535128286776,-971,-394904,-395747,0.010856388000635481,-309.8545250482172,0.03497404557670793
2023-08-23T20:45:00-04:00,1.0869,1.0873,1.08664,1.08696,1.0863635999999999,1.0867884444444444,1.08665777777777,1.0865564444444362,1.0865005000000039,1.0856710000000005,1.0848128000000021,1.0864060500000046,1.0867454980322044,1.0866041026294202,1804,-393100,-394867.6,0.013415788643531917,-309.75493906974646,0.04325856657677203
2023-08-23T21:00:00-04:00,1.08696,1.08701,1.08639,1.08645,1.0875299999999999,1.0867468888888887,1.08665777777777,1.0865997777777694,1.086513000000004,1.0857826000000006,1.0848265000000021,1.0863898500000047,1.0866863984257635,1.0866556821035358,-1833,-394933,-394492.6,0.012784630043679012,-310.61497991761576,0
2023-08-23T21:15:00-04:00,1.08645,1.08655,1.08598,1.0861,1.0875072,1.0866353333333334,1.0866333333333256,1.0866235555555472,1.086509500000004,1.0858964000000004,1.0848345000000021,1.0863708500000047,1.0865691187406108,1.0866665456828282,-1822,-396755,-394725,0.010001595346791394,-311.2019374398209,-0.020251859488906305
2023-08-23T21:30:00-04:00,1.0861,1.08636,1.08588,1.08606,1.0874461119999999,1.0865206666666667,1.08660777777777,1.0866324444444362,1.0864990000000039,1.0859840000000005,1.084846500000002,1.0863505500000048,1.0864672949924887,1.086632036546262,-1758,-398513,-395641,0.008090724812637999,-311.2666828592114,-0.021172983273338837
2023-08-23T21:45:00-04:00,1.08606,1.0862,1.08584,1.08609,1.08735214528,1.0864171111111112,1.086566666666659,1.0866246666666584,1.0864890000000038,1.0860494000000005,1.084860400000002,1.0863321500000047,1.086391835993991,1.0865720292370091,1574,-396939,-396048,0.007038898460862369,-311.2232045983419,-0.03405555657824324
2023-08-23T22:00:00-04:00,1.08609,1.08639,1.08606,1.08615,1.0872311736576,1.0863337777777777,1.0865233333333255,1.0865977777777693,1.0864780000000038,1.0861198000000005,1.0848718000000022,1.0863156500000049,1.0863434687951927,1.0864916233896067,1605,-395334,-396494.8,0.004799278399181895,-311.13453791326066,-0.03589375448672966
2023-08-23T22:15:00-04:00,1.08615,1.08634,1.08584,1.08589,1.087119879764992,1.086207111111111,1.086415555555548,1.086549333333325,1.086449500000004,1.0861622000000006,1.084877100000002,1.0862976000000049,1.0862527750361541,1.086404898711685,-1248,-396582,-396824.6,0.0009204289201483809,-311.43328118076505,-0.08924792521575138
2023-08-23T22:30:00-04:00,1.08589,1.0865,1.08588,1.08629,1.0870174893837925,1.086182,1.0863211111111033,1.0864868888888803,1.086443000000004,1.0862018000000004,1.084884500000002,1.0862805500000048,1.0862602200289233,1.0863431189693475,1514,-395068,-396487.2,-0.003580933479397748,-310.8755819662959,-0.07818680206781256
2023-08-23T22:45:00-04:00,1.08629,1.08673,1.08629,1.0865,1.0869232902330892,1.086217777777778,1.0862766666666588,1.0864206666666583,1.086458000000004,1.0862326000000007,1.0848945000000019,1.0862628500000049,1.0863081760231386,1.0863112951754776,1557,-393511,-395486.8,-0.009822330219376505,-310.574584994953,-0.036801913699508325
2023-08-23T23:00:00-04:00,1.0865,1.0867,1.08629,1.08662,1.086836627014442,1.0862864444444444,1.0862388888888812,1.0863551111111025,1.0864540000000038,1.0862674000000005,1.084905200000002,1.086246400000005,1.086370540818511,1.0863070361403815,1323,-392188,-394536.6,-0.014240144320906614,-310.42846442431346,-0.03127989990432095
2023-08-23T23:15:00-04:00,1.08662,1.08712,1.0865799999999999,1.08708,1.08584,1.0864546666666668,1.086308888888881,1.086312222222214,1.0864820000000037,1.0863182000000005,1.0849226000000018,1.086228200000005,1.0865124326548088,1.0863408289123047,1664,-390524,-393574.6,-0.014800913036805731,-309.7240415349867,0.05798702195224175
2023-08-23T23:30:00-04:00,1.08708,1.0871,1.08659,1.08662,1.0858656,1.0865168888888888,1.0863666666666587,1.086302444444436,1.0864885000000037,1.0863452000000005,1.0849343000000018,1.0862087000000051,1.086533946123847,1.0863970631298432,-1540,-392064,-392671,-0.01367445847802621,-310.37569550709566,0.047877727649374265
2023-08-23T23:45:00-04:00,1.08662,1.08668,1.08646,1.08659,1.0858906879999999,1.0865615555555554,1.0864255555555478,1.0863233333333249,1.0864955000000038,1.0863716000000003,1.084945700000002,1.086188550000005,1.0865451568990776,1.086454050503874,-1425,-393489,-392355.2,-0.00960275872199835,-310.4150376874347,0.04880025044656091
2023-08-24T00:00:00-04:00,1.08659,1.08691,1.08639,1.08673,1.0859152742399998,1.0866224444444443,1.0864966666666591,1.086367333333325,1.0865160000000036,1.0863968000000004,1.084960600000002,1.086167750000005,1.086582125519262,1.0865088404030987,697,-392792,-392211.4,-0.004663263302304331,-310.3252338055657,0.05892697658573175
2023-08-24T00:15:00-04:00,1.08673,1.08695,1.08666,1.0869,1.0859393687551997,1.0867031111111112,1.086579999999992,1.0864355555555472,1.0865465000000036,1.0864122000000003,1.084976400000002,1.086146800000005,1.0866457004154095,1.0865638723224784,993,-391799,-392133.6,0.0002498113269448711,-310.1698962332156,0.06905123601712733
2023-08-24T00:30:00-04:00,1.0869,1.0869199999999999,1.08647,1.08654,1.0859629813800957,1.0866951111111112,1.0866522222222144,1.0865042222222137,1.0865505000000035,1.0864224000000005,1.084984500000002,1.0861251000000047,1.0866245603323277,1.0865862978579823,-1227,-393026,-392634,0.0027435118795270668,-310.5762997661992,0.05985873338920512
2023-08-24T00:45:00-04:00,1.08654,1.087,1.08653,1.08698,1.0859861217524938,1.0867606666666667,1.0867288888888809,1.086576666666658,1.0865725000000037,1.0864272000000004,1.0849968000000019,1.086106100000005,1.086695648265862,1.0866186382863854,1260,-391766,-392574.4,0.01049610417069596,-310.0660562408803,0.06351894982003696
2023-08-24T01:00:00-04:00,1.08698,1.08735,1.08698,1.08729,1.0860087993174439,1.086872888888889,1.0868166666666588,1.0866548888888803,1.0865940000000038,1.0864458000000006,1.085012500000002,1.086085750000005,1.0868145186126896,1.0866725106291075,1362,-390404,-391957.4,0.016411949126316782,-309.6776222310549,0.07271053842614528
2023-08-24T01:15:00-04:00,1.08729,1.0875299999999999,1.08721,1.08737,1.0860624473447462,1.0869835555555556,1.0868999999999922,1.086735555555547,1.0866055000000039,1.0864676000000004,1.085030200000002,1.086065400000005,1.0869256148901516,1.0867412085032857,1377,-389027,-391204.4,0.022183025296881966,-309.57630611483955,0.06902136901584993
2023-08-24T01:30:00-04:00,1.08737,1.08766,1.08722,1.08727,1.0861505005040615,1.0870575555555555,1.0869211111111035,1.0868037777777693,1.0866240000000036,1.0864924000000002,1.085045400000002,1.086044350000005,1.0869944919121213,1.086810966802628,-1810,-390837,-391012,0.027594965332368795,-309.7427627947185,0.017478014497545026
2023-08-24T01:45:00-04:00,1.08727,1.08734,1.08686,1.08708,1.0862712604637366,1.0870893333333334,1.0869722222222142,1.086867777777769,1.0866300000000038,1.0865012000000005,1.085055600000002,1.086022150000005,1.0870115935296971,1.0868883734421018,-1952,-392789,-390964.6,0.02680595068466842,-310.0838740182415,0.04233310632973137
2023-08-24T02:00:00-04:00,1.08708,1.08734,1.08679,1.08682,1.0863823596266375,1.087058888888889,1.0869977777777702,1.0869215555555471,1.086648500000004,1.0865040000000006,1.085062100000002,1.085998350000005,1.0869732748237577,1.086943898753681,-3020,-395809,-391773.2,0.029260165245467786,-310.80617596474076,0.021167137558780448
2023-08-24T02:15:00-04:00,1.08682,1.08689,1.08607,1.08613,1.08766,1.0868853333333335,1.0869311111111033,1.0869444444444358,1.0866500000000037,1.0864972000000004,1.085061800000002,1.085972050000005,1.0868046198590062,1.0869419190029443,-2953,-398762,-393444.8,0.026429613788719192,-312.6809758396046,-0.055211506077860545
2023-08-24T02:30:00-04:00,1.08613,1.08627,1.08564,1.08571,1.0876282000000002,1.086641111111111,1.086798888888881,1.0869242222222135,1.0866325000000037,1.0864890000000003,1.085057800000002,1.085944600000005,1.0865856958872049,1.0868739352023549,-2874,-401636,-395966.6,0.018752155577859295,-313.7923345167429,-0.10948569325605156
2023-08-24T02:45:00-04:00,1.08571,1.08616,1.08565,1.08567,1.087548672,1.0864153333333333,1.0867022222222142,1.0868804444444358,1.0866115000000038,1.0864836000000002,1.085052200000002,1.0859184000000048,1.086402556709764,1.0867555481618836,-2549,-404185,-398636.2,0.009141777309014986,-313.8862454137597,-0.08007068308577212
2023-08-24T03:00:00-04:00,1.08567,1.08605,1.08537,1.08548,1.08747232512,1.086170888888889,1.0865355555555476,1.0867931111111022,1.0865780000000036,1.0864796000000003,1.085051100000002,1.0858895500000048,1.0862180453678112,1.0865968385295062,-4763,-408948,-401868,0.002059803547596872,-314.7198044141922,-0.13799701926438912
2023-08-24T03:15:00-04:00,1.08548,1.08594,1.08531,1.08569,1.0873461856128,1.0860017777777777,1.0863577777777698,1.0866651111111023,1.0865680000000038,1.0864760000000004,1.085053200000002,1.085861600000005,1.086112436294249,1.0864246708236045,3681,-405267,-403759.6,-0.007796732734860277,-314.0076678478804,-0.1471548528911372
2023-08-24T03:30:00-04:00,1.08569,1.0858,1.08519,1.08545,1.087183290763776,1.0858202222222222,1.0861444444444368,1.086507777777769,1.0865260000000037,1.0864628000000003,1.085049000000002,1.0858333000000049,1.0859799490353992,1.086259736658883,-3512,-408779,-405763,-0.022803362958920277,-314.7840220558035,-0.1765728316948161
2023-08-24T03:45:00-04:00,1.08545,1.08579,1.08539,1.08561,1.0869839616873984,1.0857133333333333,1.085959999999992,1.0863399999999914,1.0864815000000037,1.0864436000000004,1.085043700000002,1.0858086500000048,1.0859059592283193,1.086123789327106,3194,-405585,-406552.8,-0.03602276109022784,-314.313212714056,-0.15267596825075602
2023-08-24T04:00:00-04:00,1.08561,1.08627,1.08551,1.08584,1.0868045655186587,1.0856893333333333,1.0858222222222145,1.0861639999999912,1.0864425000000035,1.0864280000000002,1.085041800000002,1.085780700000005,1.0858927673826555,1.0860218314616843,3275,-402310,-406177.8,-0.046293151094160614,-313.619363173245,-0.11406704198404256
2023-08-24T04:15:00-04:00,1.08584,1.08644,1.0856,1.08628,1.0866431089667927,1.0857808888888887,1.0857622222222145,1.0860093333333247,1.0864025000000035,1.0864258000000002,1.0850375000000019,1.0857523500000048,1.0859702139061245,1.0859722651693469,2724,-399586,-404305.4,-0.05216713645697838,-312.5155541406067,-0.04968624059181695
2023-08-24T04:30:00-04:00,1.08628,1.0864,1.08582,1.0859699999999999,1.0864977980701134,1.0858224444444444,1.0857444444444366,1.0858866666666582,1.0863700000000036,1.0864212000000002,1.085075000000002,1.0857229500000047,1.0859701711248995,1.085943812135477,-2856,-402442,-403740.4,-0.05512838158266463,-313.33059262055673,-0.014731201605715708
2023-08-24T04:45:00-04:00,1.0859699999999999,1.08625,1.08568,1.08619,1.08644,1.0859115555555554,1.0857977777777699,1.0858173333333248,1.0863500000000035,1.0864216000000002,1.085118800000002,1.0856949500000048,1.0860141368999197,1.0859506497083813,2310,-400132,-402011,-0.05269227684000772,-312.8626238921386,0.044210700831717124
2023-08-24T05:00:00-04:00,1.08619,1.08635,1.08557,1.0859,1.08519,1.085932,1.0858233333333256,1.0857899999999914,1.0863085000000035,1.0864142000000003,1.0851498000000022,1.085664100000005,1.0859913095199358,1.0859677197667046,-2416,-402548,-401403.6,-0.04792025564458696,-313.50766757694487,0.021185074654376978
2023-08-24T05:15:00-04:00,1.0859,1.08598,1.08557,1.0856999999999999,1.0852132,1.0859073333333333,1.08584777777777,1.0857951111111024,1.0862485000000035,1.0864024,1.085179300000002,1.0856298000000049,1.0859330476159486,1.0859757758133632,-2389,-404937,-401929,-0.04313105413953824,-313.94767126052574,0.020267531414663278
2023-08-24T05:30:00-04:00,1.0856999999999999,1.08575,1.08467,1.08481,1.08635,1.085699777777778,1.0857499999999922,1.085792666666658,1.0861620000000036,1.0863712000000003,1.085203200000002,1.085589200000005,1.0857084380927589,1.08592342065069,-3011,-407948,-403601.4,-0.04014067649903479,-316.4159313692109,-0.08105444463889248
2023-08-24T05:45:00-04:00,1.08481,1.08521,1.08471,1.08483,1.0863163999999998,1.0855157777777777,1.0856811111111033,1.0857799999999915,1.0860545000000035,1.0863386000000002,1.085232500000002,1.0855505500000049,1.0855327504742072,1.0858359365205517,2274,-405674,-404247.8,-0.04056458963841438,-316.3740069769212,-0.05711916716569763
2023-08-24T06:00:00-04:00,1.08483,1.08561,1.08464,1.08532,1.0862834719999999,1.0854435555555555,1.0856488888888811,1.0857502222222137,1.0859560000000035,1.0863166000000002,1.085271200000002,1.085518050000005,1.0854902003793658,1.085731149216441,2188,-403486,-404918.6,-0.03448591865157619,-315.3857230983409,-0.02671309217858176
2023-08-24T06:15:00-04:00,1.08532,1.08554,1.08516,1.08537,1.0862177331199998,1.0853877777777778,1.0855966666666592,1.0857048888888803,1.0858560000000037,1.0863000000000003,1.085307200000002,1.085486250000005,1.0854661603034927,1.0856261193731522,1940,-401546,-404718.2,-0.02827951863838887,-315.29634853600004,-0.043284461799157375
2023-08-24T06:30:00-04:00,1.08537,1.0855,1.08514,1.08533,1.0861546237951998,1.0853344444444444,1.0854911111111034,1.085633555555547,1.0857590000000035,1.0862726000000003,1.0853460000000021,1.0854558000000052,1.085438928242794,1.0855272954985213,-2031,-403577,-404446.2,-0.02403250527878059,-315.37119858713476,-0.08745443163825224
2023-08-24T06:45:00-04:00,1.08533,1.08565,1.08531,1.08547,1.0860940388433917,1.0853302222222223,1.0854355555555477,1.085570666666658,1.0856785000000035,1.0862516000000002,1.0853908000000019,1.085428150000005,1.0854451425942353,1.0854746363988168,2117,-401460,-403148.6,-0.02360020437988444,-315.09812035286495,-0.04604178752635386
2023-08-24T07:00:00-04:00,1.08547,1.08559,1.085,1.08557,1.0860358772896561,1.085357111111111,1.085366666666659,1.0855077777777693,1.0856160000000035,1.0862332000000001,1.085436900000002,1.085402150000005,1.0854701140753882,1.085462109119053,2009,-399451,-401904,-0.020663060097619465,-314.91303923592943,-0.057080252994417637
2023-08-24T07:15:00-04:00,1.08557,1.08585,1.08519,1.0853599999999999,1.0859800421980699,1.0853557777777778,1.0853066666666589,1.085439333333325,1.0855775000000034,1.0862114000000003,1.0854825000000021,1.0853792000000049,1.0854480912603106,1.0854536872952418,-2482,-401933,-401593.4,-0.021905737776586547,-315.39317409595697,-0.0497283359425552
2023-08-24T07:30:00-04:00,1.0853599999999999,1.0855,1.08496,1.08496,1.085926440510147,1.0852864444444443,1.0852244444444366,1.0853648888888803,1.0855400000000035,1.0861842000000002,1.0855228000000021,1.085351800000005,1.0853504730082484,1.085430549836193,-2180,-404113,-402106.8,-0.025433717704779323,-316.196594159346,-0.06815879156304347
2023-08-24T07:45:00-04:00,1.08496,1.08508,1.08415,1.08422,1.0858749828897412,1.0850855555555556,1.085158888888881,1.085298444444436,1.0854675000000036,1.0861428000000002,1.0855576000000022,1.0853196000000052,1.0851243784065987,1.085367639868954,-2370,-406483,-402688,-0.03253342177345518,-317.81305928248406,-0.05438740424591315
2023-08-24T08:00:00-04:00,1.08422,1.08427,1.08367,1.08379,1.0857714839163566,1.0848117777777777,1.0850433333333254,1.0852199999999914,1.0853830000000038,1.0860894,1.085589300000002,1.0852876500000053,1.084857502725279,1.0852501118951625,-3063,-409546,-404305.2,-0.033685573817146056,-319.02784041546425,-0.09586755528515342
2023-08-24T08:15:00-04:00,1.08379,1.08441,1.08359,1.08429,1.0856033652030481,1.084661111111111,1.084928888888881,1.0851324444444357,1.0853130000000037,1.0860444000000002,1.0856221000000021,1.0852646500000052,1.084744002180223,1.0851048895161295,3096,-406450,-405705,-0.03344163180395833,-317.5995194307718,-0.09490288578484561
2023-08-24T08:30:00-04:00,1.08429,1.08429,1.08175,1.0818,1.0854020286827433,1.0840353333333332,1.0845322222222142,1.0849775555555468,1.0851305000000038,1.0859432000000002,1.0856240000000021,1.0852281000000052,1.0841552017441785,1.0848463116129032,-6932,-413382,-407994.8,-0.04881503734826703,-333.51839722176794,-0.32892009176592785
2023-08-24T08:45:00-04:00,1.0818,1.08243,1.08141,1.08208,1.084963785240814,1.0835448888888888,1.0841711111111032,1.0847668888888802,1.0849540000000037,1.0858420000000002,1.0856336000000022,1.085195150000005,1.0837401613953428,1.084524249290322,5068,-408314,-408835,-0.06435461706939133,-332.2066575286646,-0.29944809412805096
2023-08-24T09:00:00-04:00,1.08208,1.08283,1.08208,1.08282,1.0844662553071,1.0832746666666666,1.0838766666666588,1.0845104444444358,1.0848030000000037,1.0857604000000003,1.0856518000000022,1.085167150000005,1.0835561291162743,1.084210599432257,3720,-404594,-408457.2,-0.07525272255585483,-329.6626681748277,-0.2441338774908603
2023-08-24T09:15:00-04:00,1.08282,1.08328,1.08232,1.08287,1.084038379564106,1.0830733333333333,1.0835766666666589,1.0842171111111025,1.0846325000000037,1.0856786,1.085674800000002,1.085139750000005,1.0834189032930195,1.0839228795458051,4172,-400422,-406632.4,-0.0861936886409822,-329.4700230445194,-0.2487172637416219
2023-08-24T09:30:00-04:00,1.08287,1.08374,1.08203,1.08348,1.08141,1.0830540000000002,1.08336777777777,1.08390488888888,1.0845080000000036,1.0856192000000002,1.085700900000002,1.0851139000000052,1.0834311226344155,1.0836603036366437,7003,-393419,-404026.2,-0.09318088718298602,-325.5251081424536,-0.17321441733617252
2023-08-24T09:45:00-04:00,1.08348,1.08441,1.08341,1.08421,1.0814565999999999,1.0832224444444443,1.0832844444444367,1.0836553333333245,1.0844090000000037,1.0855814000000001,1.0857389000000022,1.085092550000005,1.0835868981075325,1.0835466429093146,5737,-387682,-398886.2,-0.09606412822813772,-321.65977606433546,-0.06912697242294909
2023-08-24T10:00:00-04:00,1.08421,1.08444,1.08358,1.0842,1.0815747359999999,1.0834055555555555,1.0832822222222145,1.083477555555547,1.0843240000000036,1.0855442000000002,1.0857641000000022,1.085069350000005,1.083709518486026,1.0835405143274512,-5802,-393484,-395920.2,-0.09434235683732987,-321.7132896825451,-0.0018446440759171553
2023-08-24T10:15:00-04:00,1.0842,1.08486,1.08365,1.08391,1.0817466518399999,1.083531111111111,1.0832955555555477,1.0833613333333247,1.0842345000000038,1.0855006000000003,1.0857750000000024,1.0850458000000052,1.0837496147888208,1.0835792114619607,-6271,-399755,-394952.4,-0.0884701579549293,-323.39064625882327,0.01107225569528211
2023-08-24T10:30:00-04:00,1.08391,1.0847499999999999,1.08348,1.08462,1.0819957196927998,1.083796,1.0833322222222144,1.0833124444444358,1.0842250000000038,1.0854700000000002,1.0857949000000024,1.0850311500000052,1.0839236918310566,1.0836801691695679,6758,-392997,-393467.4,-0.07607608662691955,-318.96391341200024,0.030434662313582293
2023-08-24T10:45:00-04:00,1.08462,1.08478,1.08381,1.08394,1.0822248621173758,1.0839175555555556,1.0835699999999922,1.08335288888888,1.0841805000000038,1.0854310000000003,1.0857966000000023,1.085017750000005,1.0839269534648452,1.0837793353356537,-6943,-399940,-394771.6,-0.07548606755648446,-323.3168112010878,0.19781845073024668
2023-08-24T11:00:00-04:00,1.08394,1.08406,1.0833,1.08354,1.0824356731479856,1.0839115555555556,1.0837322222222143,1.0834424444444357,1.0840915000000038,1.0853760000000003,1.0857889000000023,1.085002450000005,1.0838495627718763,1.0838318682685226,-4668,-404608,-398156.8,-0.05377484665385593,-325.03941577329635,0.13492532899600926
2023-08-24T11:15:00-04:00,1.08354,1.08366,1.0829,1.08306,1.0826296192961467,1.083777111111111,1.0837588888888812,1.083537777777769,1.0839760000000038,1.0853072000000004,1.0857699000000023,1.0849885500000052,1.083691650217501,1.0838282946148177,-3125,-407733,-401006.6,-0.034812379941020224,-326.42376706628056,0.02216434864520585
2023-08-24T11:30:00-04:00,1.08306,1.08323,1.08251,1.08252,1.08486,1.0835293333333333,1.0837199999999925,1.083622666666658,1.083835500000004,1.0852252000000002,1.0857463000000025,1.084974350000005,1.0834573201740008,1.0837698356918537,-3002,-410735,-403202.6,-0.025063658617409064,-327.9205262485973,-0.03232151597145294
2023-08-24T11:45:00-04:00,1.08252,1.08281,1.08225,1.08254,1.084813,1.0832933333333332,1.083615555555548,1.0836793333333248,1.083689000000004,1.0851344000000003,1.0857263000000024,1.084965150000005,1.0832738561392006,1.0836398685534825,2763,-407972,-406197.6,-0.015852894976577665,-327.8694786928936,-0.08675748514046783
2023-08-24T12:00:00-04:00,1.08254,1.08263,1.08222,1.08236,1.08471048,1.0830422222222222,1.0834099999999924,1.0836473333333247,1.083528500000004,1.0850492000000003,1.0856972000000022,1.0849547000000053,1.0830910849113604,1.0834726948427855,-2507,-410479,-408305.4,-0.012524092398599756,-328.2863316498284,-0.17063115079181224
2023-08-24T12:15:00-04:00,1.08236,1.08277,1.08236,1.08257,1.0845610512000001,1.0828742222222223,1.0832288888888812,1.083546666666658,1.083389000000004,1.0849688000000002,1.0856702000000023,1.0849467000000053,1.0829868679290884,1.083300155874228,2197,-408282,-409040.2,-0.014477122717826313,-327.86006866893473,-0.15034126544918097
2023-08-24T12:30:00-04:00,1.08257,1.08262,1.08206,1.08245,1.084420588128,1.0827184444444446,1.083066666666659,1.0834082222222137,1.083263500000004,1.0848832000000004,1.0856400000000022,1.084939200000005,1.0828794943432707,1.0831377246993819,-2296,-410578,-409609.2,-0.017841577865157904,-328.11457415125943,-0.13469753023775194
2023-08-24T12:45:00-04:00,1.08245,1.08251,1.08178,1.08212,1.08423174107776,1.082529111111111,1.0827888888888813,1.0832219999999915,1.083158500000004,1.0847876000000003,1.0855999000000023,1.0849242500000051,1.0827275954746165,1.0829917797595052,-1874,-412452,-409952.6,-0.02188382930944489,-328.68588922354905,-0.23049547306890403
2023-08-24T13:00:00-04:00,1.08212,1.0824,1.08197,1.08222,1.083986566969984,1.082415333333333,1.08259777777777,1.0830184444444357,1.083080000000004,1.0847012000000003,1.085561800000002,1.0849092500000053,1.082626076379693,1.0828622238076036,1917,-410535,-410465.2,-0.035251099233548695,-328.50873696686773,-0.1586803697621588
2023-08-24T13:15:00-04:00,1.08222,1.08237,1.08204,1.08206,1.0837659102729855,1.0823077777777779,1.0824333333333258,1.0828231111111024,1.082968500000004,1.0846028,1.0855150000000022,1.0848950500000052,1.0825128611037544,1.0827465790460824,-1983,-412518,-410873,-0.045005948910403756,-328.8019121068576,-0.1365893275744251
2023-08-24T13:30:00-04:00,1.08206,1.08227,1.08159,1.08161,1.083567319245687,1.0821431111111113,1.0822722222222145,1.082631777777769,1.082959000000004,1.0844892000000002,1.0854675000000023,1.0848774000000052,1.0823322888830036,1.0826156632368655,-1929,-414447,-412106,-0.05104881144067083,-329.6041319467927,-0.13387993278303617
2023-08-24T13:45:00-04:00,1.08161,1.08177,1.08136,1.08159,1.0833300409362046,1.0820066666666668,1.0821688888888812,1.0824522222222135,1.0829345000000041,1.0843736000000002,1.0854206000000022,1.0848626500000054,1.082183831106403,1.0824765305894917,-1827,-416274,-413245.2,-0.06370056950559337,-329.63791491847365,-0.0859106529209507
2023-08-24T14:00:00-04:00,1.08159,1.082,1.08159,1.08192,1.083054235205136,1.0819568888888886,1.0820999999999925,1.0823144444444357,1.0828895000000043,1.0842666,1.0853795000000022,1.0848485500000051,1.0821310648851223,1.0823572244715929,1537,-414737,-413702.2,-0.06853817905481135,-329.1689664259766,-0.057272710477217
2023-08-24T14:15:00-04:00,1.08192,1.08194,1.08112,1.08124,1.082817042276417,1.0817848888888888,1.081975555555548,1.0821899999999913,1.0828080000000042,1.0841498,1.0853255000000022,1.0848308000000053,1.0819528519080979,1.0822225795772742,-2293,-417030,-415001.2,-0.07360032507964154,-330.6101450713478,-0.10347758601574429
2023-08-24T14:30:00-04:00,1.08124,1.08157,1.0811,1.08112,1.0825455155121904,1.081613777777778,1.0818144444444369,1.0820662222222137,1.0826900000000044,1.0840358,1.0852699000000021,1.0848121500000054,1.0817862815264783,1.0820772636618188,-1800,-418830,-416263.6,-0.07736193599212696,-330.8099157050645,-0.1339405304044959
2023-08-24T14:45:00-04:00,1.08112,1.08149,1.08086,1.0809,1.082285322719996,1.0814308888888888,1.0816422222222146,1.0819402222222136,1.082524500000004,1.0839312,1.085214200000002,1.0847919500000054,1.0816090252211825,1.0819326109294547,-2185,-421015,-417577.2,-0.08144818273369352,-331.25454719833095,-0.14319368100142643
2023-08-24T15:00:00-04:00,1.0809,1.08097,1.0807,1.08081,1.0820002581759969,1.0812644444444446,1.081496666666659,1.0818057777777692,1.0823550000000044,1.0838332000000002,1.085161100000002,1.0847713000000054,1.0814492201769461,1.0817856887435633,-1876,-422891,-418900.6,-0.08165393092323145,-331.4107503623608,-0.12105866262520999
2023-08-24T15:15:00-04:00,1.08081,1.08127,1.08078,1.08107,1.0817402065407975,1.081179111111111,1.0813688888888813,1.081659555555547,1.0822130000000043,1.0837412,1.085112400000002,1.0847497500000054,1.081373376141557,1.0816341509948502,1945,-420946,-420142.4,-0.07759533653591313,-330.9428605389877,-0.1062630518748484
2023-08-24T15:30:00-04:00,1.08107,1.08125,1.08056,1.08059,1.081532165232638,1.0810233333333334,1.081205555555548,1.0815055555555468,1.0820115000000041,1.0836434000000001,1.0850615000000021,1.0847258000000055,1.0812167009132456,1.08148692079588,-1985,-422931,-421322.6,-0.0780599211874058,-331.8242095728154,-0.1358519860266605
2023-08-24T15:45:00-04:00,1.08059,1.08082,1.08056,1.08059,1.0813377321861104,1.0809002222222222,1.0810922222222148,1.0813611111111026,1.0818440000000042,1.0835414,1.0850087000000022,1.0847025000000055,1.0810913607305965,1.0813479366367036,0,-422931,-422142.8,-0.07392338832823055,-331.8242095728154,-0.09430386183559887
2023-08-24T16:00:00-04:00,1.08059,1.08087,1.08049,1.08073,1.08125,1.0808277777777777,1.0809966666666593,1.0812319999999915,1.0817035000000041,1.0834470000000003,1.084954900000002,1.0846789000000054,1.0810190885844773,1.0812299493093627,1050,-421881,-422316,-0.06793848472597722,-331.6881727781014,-0.07951256945793535
2023-08-24T16:15:00-04:00,1.08073,1.08096,1.08069,1.08078,1.0810980000000001,1.0807844444444445,1.0808699999999927,1.0811066666666582,1.0815895000000042,1.0833504,1.084897000000002,1.0846560000000056,1.0809712708675818,1.0811343594474896,731,-421150,-421967.8,-0.06328459135745823,-331.654353045143,-0.10536823425021433
2023-08-24T16:30:00-04:00,1.08078,1.08089,1.08069,1.08081,1.0809764000000002,1.0807724444444444,1.0808222222222148,1.080997333333325,1.081504000000004,1.0832498000000002,1.084838900000002,1.0846331000000056,1.0809390166940656,1.0810474875579914,493,-420657,-421910,-0.06364749081989261,-331.6406684839927,-0.03976915393436521
2023-08-24T16:45:00-04:00,1.08081,1.08115,1.08081,1.08103,1.08049,1.080814,1.0808122222222147,1.0809186666666584,1.0814285000000041,1.0831448000000001,1.084785300000002,1.0846121000000055,1.0809572133552525,1.0809955900463926,756,-419901,-421304,-0.059032781752878606,-331.4867838974327,-0.00832470031080227
2023-08-24T17:00:00-04:00,1.08103,1.0811,1.08053,1.0811,1.0805031999999999,1.0808715555555557,1.080834444444437,1.0808671111111028,1.081365500000004,1.0830474000000003,1.084734300000002,1.0845924000000056,1.080985770684202,1.0809744720371137,72,-419829,-420683.6,-0.05288055704884877,-331.4821216771428,0.01850309926912554
2023-08-24T17:15:00-04:00,1.0811,1.08124,1.0810899999999999,1.08114,1.080516136,1.0809326666666668,1.0808711111111036,1.0808419999999916,1.081294000000004,1.0829464000000002,1.084684000000002,1.0845749000000056,1.0810166165473616,1.0809739776296905,156,-419673,-420242,-0.0452915104287323,-331.476349778151,0.030532656063502507
2023-08-24T17:30:00-04:00,1.08114,1.08125,1.08112,1.08124,1.08053,1.0810064444444443,1.0808899999999926,1.0808459999999915,1.081233500000004,1.0828532000000002,1.084633700000002,1.0845586500000055,1.0810612932378894,1.0809919821037521,375,-419298,-419871.6,-0.03546024330676201,-331.44166416851675,0.015725161182902448
2023-08-24T17:45:00-04:00,1.08124,1.08159,1.08124,1.08128,1.0805732,1.0810844444444443,1.080966666666659,1.0808748888888804,1.081191500000004,1.0827648000000003,1.084583600000002,1.0845421000000057,1.0811050345903115,1.0810251856830013,564,-418734,-419487,-0.028367013932285256,-331.4207992356619,0.06385400568208845
2023-08-24T18:00:00-04:00,1.08128,1.08128,1.08102,1.08104,1.080654544,1.0810991111111112,1.0810166666666592,1.0809157777777694,1.0811325000000038,1.0826894000000002,1.0845303000000022,1.0845239500000057,1.081092027672249,1.0810521485464006,-567,-419301,-419367,-0.019449571831751444,-331.5466500791067,0.041643916749189006
2023-08-24T18:15:00-04:00,1.08104,1.0810899999999999,1.08099,1.08105,1.08072938048,1.0811057777777777,1.0810522222222148,1.080959333333325,1.081082000000004,1.0826138,1.084476200000002,1.0845057500000055,1.0810836221377993,1.0810717188371202,392,-418909,-419183,-0.010042415993676427,-331.54302394131344,0.029609615722715015
2023-08-24T18:30:00-04:00,1.08105,1.08108,1.08083,1.08087,1.0807982300416,1.0810693333333334,1.0810622222222148,1.080997555555547,1.081045000000004,1.0825248000000003,1.0844207000000021,1.0844859000000056,1.0810408977102395,1.0810765750696958,-438,-419347,-419117.8,-0.003506220237139936,-331.615953038025,0.008327319158378529
2023-08-24T18:45:00-04:00,1.08087,1.08093,1.08064,1.08073,1.08159,1.0810028888888887,1.0810533333333259,1.0810302222222137,1.081002000000004,1.082432,1.0843660000000022,1.0844669000000053,1.0809787181681916,1.0810600600557563,-357,-419704,-419199,-0.00009250437063905082,-331.6621935664882,-0.007401856015403263
2023-08-24T19:00:00-04:00,1.08073,1.08074,1.07924,1.0796999999999999,1.081571,1.080732222222222,1.080905555555548,1.0810179999999916,1.080891000000004,1.0823194000000003,1.0842960000000021,1.0844438000000054,1.0807229745345532,1.0809836480446047,-1508,-421212,-419694.6,-0.0020352656019731034,-333.09940730164885,-0.12303081320592893
2023-08-24T19:15:00-04:00,1.0796999999999999,1.08019,1.07968,1.08012,1.08147776,1.080575111111111,1.0807966666666593,1.0809739999999917,1.080835000000004,1.0822124000000002,1.084232000000002,1.0844219000000053,1.0806023796276425,1.0808857184356833,510,-420702,-419974.8,-0.0025244581664893777,-332.90101886041515,-0.09064841365275932
2023-08-24T19:30:00-04:00,1.08012,1.08019,1.07959,1.07977,1.0813882496,1.0803697777777777,1.080644444444437,1.0808924444444359,1.0807675000000039,1.0820964000000002,1.0841648000000021,1.0843983000000055,1.080435903702114,1.0807561747485461,-779,-421481,-420489.2,-0.008353721966270215,-333.15344451682375,-0.12671809386389304
2023-08-24T19:45:00-04:00,1.07977,1.08001,1.0796999999999999,1.07989,1.081302319616,1.0802188888888888,1.0804944444444369,1.0807788888888805,1.080717000000004,1.0819870000000003,1.084099200000002,1.0843753500000053,1.0803267229616913,1.0806133397988364,597,-420884,-420796.6,-0.014500838061022508,-333.08709705393807,-0.12485664607302378
2023-08-24T20:00:00-04:00,1.07989,1.08042,1.07979,1.08033,1.0812198268313602,1.0801859999999999,1.0803888888888813,1.0806459999999913,1.080693000000004,1.0818944000000004,1.0840393000000021,1.0843541000000054,1.080327378369353,1.0804830718390688,1604,-419280,-420711.8,-0.020410078665865878,-332.4335490073778,-0.08785883397454927
2023-08-24T20:15:00-04:00,1.08033,1.08034,1.07971,1.07974,1.0811406337581058,1.0800562222222223,1.080244444444437,1.0805137777777694,1.0806265000000037,1.0818048000000002,1.083973800000002,1.0843295500000054,1.0802099026954823,1.0803804574712548,-1437,-420717,-420612.8,-0.029946769132959884,-333.218336988828,-0.12025456967365489
2023-08-24T20:30:00-04:00,1.07974,1.0798699999999999,1.0795,1.07952,1.0810646084077815,1.0799113333333332,1.0800744444444372,1.080369333333325,1.0805730000000036,1.0817194000000003,1.0839044000000022,1.0843037500000055,1.080071922156386,1.0802743659770033,-1233,-421950,-420862.4,-0.03718482904786368,-333.46956413610405,-0.1415290689607355
2023-08-24T20:45:00-04:00,1.07952,1.0796999999999999,1.07933,1.07945,1.0809916240714703,1.0797864444444443,1.0799166666666595,1.0802237777777695,1.0805160000000036,1.0816226000000002,1.0838335000000021,1.0842780500000055,1.0799475377251087,1.080176692781602,-1384,-423334,-421233,-0.04697035068209092,-333.55930772584765,-0.13137565109587432
2023-08-24T21:00:00-04:00,1.07945,1.07951,1.07919,1.07929,1.0809215591086114,1.0796611111111112,1.0797566666666596,1.080076222222214,1.0804440000000035,1.0815724000000002,1.083757800000002,1.0842510500000053,1.079816030180087,1.0800745542252814,-1412,-424746,-422005.4,-0.055866980525244525,-333.768599494804,-0.13324327075216622
2023-08-24T21:15:00-04:00,1.07929,1.07948,1.07916,1.07945,1.0808176655620947,1.079599777777778,1.0797288888888816,1.079944222222214,1.0803775000000035,1.0815198000000004,1.083680900000002,1.0842246000000055,1.0797428241440696,1.0799576433802247,1441,-423305,-422810.4,-0.06207596592591386,-333.5549775766912,-0.023154579975906406
2023-08-24T21:30:00-04:00,1.07945,1.07945,1.07873,1.07895,1.0806850523171272,1.0794439999999998,1.0795988888888817,1.079815111111103,1.0802845000000034,1.0814424000000002,1.083601400000002,1.0841954500000055,1.0795842593152558,1.0798325147041794,-2352,-425657,-423798.4,-0.06095695678025798,-334.64442127487075,-0.1083212976335864
2023-08-24T21:45:00-04:00,1.07895,1.079,1.07883,1.07889,1.0804895470854146,1.0793022222222222,1.079501111111104,1.0797004444444362,1.0801775000000036,1.0813628000000002,1.083520700000002,1.0841667500000056,1.0794454074522046,1.0797072117633433,-2091,-427748,-424958,-0.06388480633083485,-334.760700991262,-0.08149883771543866
2023-08-24T22:00:00-04:00,1.07889,1.07895,1.07843,1.07853,1.0803135923768732,1.079108,1.079349999999993,1.079587111111103,1.0800490000000036,1.0812638000000003,1.0834415000000022,1.0841340000000055,1.0792623259617637,1.0795701694106743,-1571,-429319,-426155,-0.06435035940248798,-335.28490642462395,-0.12593875302114363
2023-08-24T22:15:00-04:00,1.07853,1.0788,1.07828,1.07875,1.0800875612916485,1.078988,1.0791744444444373,1.0794706666666585,1.0799295000000035,1.0811546000000003,1.083368000000002,1.0841012500000056,1.079159860769411,1.079438935528539,1476,-427843,-426774.4,-0.06455103301474639,-334.98382995943507,-0.14625160830486192
2023-08-24T22:30:00-04:00,1.07875,1.07884,1.07843,1.07862,1.0798345027108176,1.078877111111111,1.0790499999999925,1.0793348888888807,1.0797985000000034,1.0810430000000002,1.083293600000002,1.0840700500000056,1.079051888615529,1.0793007484228307,-1532,-429375,-427988.4,-0.06928100943617177,-335.168451048659,-0.10372867542186175
2023-08-24T22:45:00-04:00,1.07862,1.07872,1.07844,1.07858,1.079616872331303,1.078783111111111,1.0789455555555483,1.0792042222222142,1.0796635000000034,1.0809364000000001,1.083218500000002,1.0840394500000055,1.0789575108924232,1.0791753987382644,-1348,-430723,-429001.6,-0.06830124522851311,-335.2184408504425,-0.08707573736474923
2023-08-24T23:00:00-04:00,1.07858,1.07877,1.0784799999999999,1.07851,1.0794297102049206,1.0786959999999999,1.078841111111104,1.0790722222222142,1.0795370000000033,1.0808142000000003,1.083142100000002,1.0840069500000056,1.0788680087139386,1.0790599189906112,-1371,-432094,-429870.8,-0.0654470006323413,-335.3074189512788,-0.08708138403816211
2023-08-24T23:15:00-04:00,1.07851,1.07862,1.0783,1.07839,1.0792687507762317,1.0786057777777778,1.078741111111104,1.0789504444444364,1.0794040000000034,1.0807032000000003,1.0830671000000023,1.0839721000000053,1.0787724069711508,1.0789619351924884,-890,-432984,-430603.8,-0.0635842663567697,-335.4064444586919,-0.08338815332302929
2023-08-24T23:30:00-04:00,1.07839,1.0785,1.07818,1.07826,1.0791303256675593,1.0785095555555555,1.0786088888888816,1.0788373333333252,1.0792735000000033,1.0805976000000004,1.0829868000000022,1.0839356500000055,1.0786699255769208,1.0788639481539906,-1179,-434163,-431867.8,-0.06082587660805116,-335.5485730021687,-0.11024132660151229
2023-08-24T23:45:00-04:00,1.07826,1.07834,1.07797,1.0780399999999999,1.0789782735607498,1.0783957777777777,1.0785077777777705,1.0787288888888809,1.0791390000000034,1.0804972000000004,1.0829022000000021,1.0838983500000057,1.0785439404615367,1.078762358523192,-872,-435035,-432999.8,-0.061411493629902586,-335.7264892746819,-0.08434125770426697
2023-08-25T00:00:00-04:00,1.0780399999999999,1.07824,1.07795,1.078,1.078796784319815,1.078294222222222,1.0784088888888816,1.0786215555555476,1.0790540000000033,1.0804068000000004,1.082816000000002,1.0838606000000055,1.0784351523692293,1.0786578868185532,-1028,-436063,-434067.8,-0.058175402611787885,-335.7646325717765,-0.08249219104819171
2023-08-25T00:15:00-04:00,1.078,1.07809,1.07781,1.07791,1.078627427455852,1.0781944444444445,1.0783399999999927,1.0785213333333252,1.0789435000000034,1.0803142000000003,1.0827243000000022,1.0838234500000055,1.0783301218953834,1.078550309454842,-1151,-437214,-435091.8,-0.059362751825944894,-335.86072719144266,-0.057485651766762624
2023-08-25T00:30:00-04:00,1.07791,1.07795,1.07765,1.07781,1.0784639419646815,1.0780884444444445,1.0782355555555485,1.0784202222222141,1.0788455000000032,1.0802232000000003,1.0826362000000023,1.0837852500000056,1.0782260975163067,1.0784410475638733,-971,-438185,-436132,-0.055846664206630016,-335.9508089236837,-0.08713789107765124
2023-08-25T00:45:00-04:00,1.07781,1.07833,1.07777,1.07825,1.07765,1.0780913333333333,1.0781944444444373,1.0783373333333253,1.078763500000003,1.0801368000000005,1.0825528000000022,1.0837492500000057,1.0782308780130454,1.0783532380510983,1159,-437026,-436704.6,-0.05377582855283719,-335.47766430635784,-0.03430309098662935
2023-08-25T01:00:00-04:00,1.07825,1.07827,1.07784,1.07811,1.07765,1.0780744444444443,1.078142222222215,1.0782642222222143,1.0786525000000033,1.0800500000000004,1.0824666000000023,1.0837136000000056,1.0782067024104363,1.0782857904408782,-1489,-438515,-437400.6,-0.05065027823649761,-335.6709960939767,-0.04357581264256638
2023-08-25T01:15:00-04:00,1.07811,1.07839,1.07805,1.07821,1.0776636,1.0780880000000002,1.0781088888888817,1.0782042222222141,1.0785760000000033,1.0799718000000005,1.0823797000000024,1.0836780500000058,1.078207361928349,1.0782402323527023,1243,-437272,-437642.4,-0.044725988752787146,-335.55570173625813,-0.02781615376771555
2023-08-25T01:30:00-04:00,1.07821,1.07844,1.07817,1.07841,1.077692656,1.0781482222222223,1.0781111111111037,1.0781584444444365,1.0785205000000033,1.0798956000000004,1.0822984000000024,1.0836414500000056,1.0782478895426792,1.0782237858821615,1047,-436225,-437444.6,-0.0397837874111159,-335.36149096099155,0.0018546166043946091
2023-08-25T01:45:00-04:00,1.07841,1.07914,1.0783,1.079,1.07773749664,1.078326,1.078193333333326,1.078149999999992,1.0784980000000033,1.0798344000000004,1.0822186000000023,1.0836077000000055,1.0783983116341433,1.0782582287057287,2631,-433594,-436526.4,-0.03183305878591669,-333.9220662523931,0.06862908760409947
2023-08-25T02:00:00-04:00,1.079,1.079,1.07836,1.07879,1.0778496969088,1.0784453333333333,1.0782766666666594,1.0781664444444363,1.0784730000000031,1.0797780000000003,1.0821336000000024,1.0835730500000056,1.0784766493073146,1.0783073829645826,-3122,-436716,-436464.4,-0.024005739830936693,-334.5296844173608,0.06957070238581393
2023-08-25T02:15:00-04:00,1.07879,1.07908,1.07861,1.07902,1.077952921156096,1.078594,1.0783899999999926,1.0782159999999918,1.0784515000000032,1.0797266000000005,1.0820501000000022,1.0835401500000055,1.0785853194458517,1.0783831063716658,2882,-433834,-435528.2,-0.013727190522134846,-333.91523674913947,0.0946196660482394
2023-08-25T02:30:00-04:00,1.07902,1.07907,1.07839,1.07847,1.0780478874636084,1.07861,1.0784522222222153,1.0782846666666586,1.0784275000000032,1.0796576000000004,1.0819621000000024,1.0835037500000055,1.0785622555566814,1.078454085097332,-2594,-436428,-435359.4,-0.005042499171931188,-335.2374550583461,0.051952389346060064
2023-08-25T02:45:00-04:00,1.07847,1.07864,1.07796,1.07809,1.07914,1.0785375555555556,1.0784833333333261,1.0783591111111033,1.0783875000000034,1.0795946000000005,1.0818722000000023,1.0834639000000055,1.078467804445345,1.0784980680778653,-2477,-438905,-435895.4,0.00042390394353451793,-336.11022852446024,0.025978604763368125
2023-08-25T03:00:00-04:00,1.07809,1.07905,1.07806,1.07899,1.0791164,1.0786388888888887,1.0785655555555482,1.0784335555555475,1.0784105000000035,1.0795520000000005,1.0817939000000023,1.0834280000000056,1.0785722435562761,1.0785328544622919,3424,-435481,-436272.8,0.01092430963591545,-333.25184007822696,0.06862972408995714
2023-08-25T03:15:00-04:00,1.07899,1.07921,1.07829,1.07852,1.07796,1.0786297777777778,1.0786111111111039,1.0785004444444364,1.0783990000000034,1.0795044000000005,1.0817178000000023,1.0833898000000055,1.0785617948450208,1.0785498835698333,-2601,-438082,-436546,0.013472143660652561,-334.3848162874596,0.038029514613538644
2023-08-25T03:30:00-04:00,1.07852,1.07904,1.0781,1.07842,1.077985,1.0785915555555556,1.0786344444444371,1.0785493333333254,1.0783890000000036,1.0794566000000005,1.0816449000000024,1.0833513500000054,1.0785334358760166,1.0785395068558663,-3065,-441147,-438008.6,0.017804154302832543,-334.6690020234682,0.0194767253132547
2023-08-25T03:45:00-04:00,1.07842,1.0784799999999999,1.0768199999999999,1.07711,1.07921,1.0782866666666666,1.0784899999999926,1.0785568888888808,1.0783155000000035,1.0793774000000003,1.0815593000000023,1.0833057500000054,1.0782487487008132,1.0784768054846925,-2531,-443678,-439458.6,0.014272535658343907,-337.7435091728161,-0.12054784358454379
2023-08-25T04:00:00-04:00,1.07711,1.07779,1.07659,1.07778,1.0791622,1.0781446666666668,1.078354444444437,1.078531111111103,1.0782790000000035,1.0793212000000003,1.0814823000000022,1.0832667000000056,1.0781549989606505,1.0784142443877536,3930,-439748,-439627.2,0.011963386473195706,-335.2989120564586,-0.11306765523632983
2023-08-25T04:15:00-04:00,1.07778,1.07838,1.07774,1.07781,1.079059312,1.0780357777777778,1.0782455555555484,1.0784671111111028,1.0782500000000037,1.0792656000000003,1.0814035000000022,1.0832283500000055,1.0780859991685203,1.0783169955102025,3078,-436670,-439865,0.004018832869277088,-335.2132359444507,-0.09084251800628305
2023-08-25T04:30:00-04:00,1.07781,1.07854,1.07781,1.07853,1.0789605395200002,1.0780926666666666,1.0781911111111038,1.0783831111111029,1.0782635000000036,1.0792216000000006,1.0813343000000024,1.0831916500000056,1.0781747993348163,1.0782395964081615,2004,-434666,-439181.8,0.000989245051615066,-333.874521328702,-0.04541157717188758
2023-08-25T04:45:00-04:00,1.07853,1.07883,1.07847,1.07863,1.0788657179392,1.0781804444444443,1.0782088888888817,1.0782979999999918,1.0782930000000035,1.0791786000000005,1.0812645000000023,1.0831541000000053,1.078265839467853,1.078186077126529,2296,-432370,-437426.4,-0.004261633375733354,-333.66163897957864,0.014835832243821151
2023-08-25T05:00:00-04:00,1.07863,1.0791,1.07847,1.07907,1.07659,1.0783526666666665,1.0783177777777704,1.0782635555555475,1.0783465000000036,1.0791438000000004,1.0811968000000025,1.0831193000000054,1.0784266715742825,1.0782216617012228,2028,-430342,-434759.2,-0.003245759646697287,-332.83436734797186,0.09090150172990946
2023-08-25T05:15:00-04:00,1.07907,1.07911,1.07884,1.07908,1.0766402,1.078505111111111,1.0783277777777704,1.0782582222222143,1.0784050000000036,1.0791048000000005,1.0811248000000024,1.0830811500000055,1.078557337259426,1.0783021293609778,2082,-428260,-432461.6,0.0011657682745594938,-332.8150729555783,0.008341133838139883
2023-08-25T05:30:00-04:00,1.07908,1.07925,1.07872,1.07884,1.076738992,1.0786075555555557,1.078363333333326,1.0782817777777698,1.0784565000000037,1.0790596000000006,1.0810535000000023,1.0830642500000054,1.0786138698075407,1.078407703488782,-1873,-430133,-431154.2,-0.004331711038947983,-333.2316500397611,0.029670288914447392
2023-08-25T05:45:00-04:00,1.07884,1.07947,1.07883,1.07899,1.0768896524799998,1.078732888888889,1.0784266666666595,1.078328888888881,1.0784935000000038,1.0790166000000005,1.0809815000000023,1.0830501500000054,1.0786890958460325,1.0785105627910252,2417,-427716,-429764.2,-0.0051836532125621206,-332.89559464693207,0.052855102835626146
2023-08-25T06:00:00-04:00,1.07899,1.07975,1.07894,1.07971,1.0770960802815999,1.0789895555555555,1.0787155555555483,1.0784302222222142,1.078573500000004,1.0789860000000004,1.0809196000000023,1.0830347000000053,1.078893276676826,1.0786360502328196,2173,-425543,-428398.8,0.000331131968165106,-331.4455719405121,0.24138667359879082
2023-08-25T06:15:00-04:00,1.07971,1.07982,1.07949,1.07963,1.07736147225344,1.0791724444444446,1.0789211111111041,1.078550888888881,1.078644500000004,1.0789530000000005,1.0808589000000022,1.0830191000000053,1.0790406213414607,1.0787588401862553,-1839,-427382,-427806.8,0.01698372264497584,-331.58183075074794,0.17164913062036125
2023-08-25T06:30:00-04:00,1.07963,1.07997,1.07948,1.07975,1.0776564955830272,1.0793382222222223,1.0791366666666595,1.0787126666666587,1.078711500000004,1.0789272000000003,1.0808083000000024,1.0830057500000054,1.0791824970731685,1.0788838721490037,2200,-425182,-427191.2,0.02844701544738308,-331.3373025327475,0.17999461871758965
2023-08-25T06:45:00-04:00,1.07975,1.08034,1.07974,1.08028,1.0779803862014035,1.079566888888889,1.079331111111104,1.0789062222222143,1.0787755000000039,1.0789118000000004,1.0807628000000025,1.0829976500000056,1.0794019976585347,1.0790414977192024,2054,-423128,-425790.2,0.04308634351410863,-330.3290876681957,0.16225788805132155
2023-08-25T07:00:00-04:00,1.08028,1.08114,1.08019,1.08075,1.078357924409179,1.0798506666666667,1.0795666666666597,1.0791342222222142,1.078873500000004,1.0789094000000004,1.0807171000000024,1.0829941500000053,1.079671598126828,1.0792379981753615,3057,-420071,-424261.2,0.05593597531119191,-328.99907137612274,0.1965456180525409
2023-08-25T07:15:00-04:00,1.08075,1.08096,1.08046,1.0804799999999999,1.0788586980155268,1.0800333333333332,1.0797233333333263,1.07933577777777,1.078946500000004,1.0789044000000005,1.0806682000000023,1.0829877000000054,1.0798332785014624,1.0794259985402888,-1893,-421964,-423545.4,0.06561935214807976,-329.4719929583577,0.13066807528704452
2023-08-25T07:30:00-04:00,1.0804799999999999,1.0807,1.08018,1.0802,1.079269332372732,1.0801286666666667,1.0798477777777709,1.0795211111111034,1.079033000000004,1.0789144000000004,1.0806169000000023,1.0829814500000055,1.07990662280117,1.0795991988322307,-1610,-423574,-422783.8,0.07088092084750264,-329.8892149337758,0.10379211921266356
2023-08-25T07:45:00-04:00,1.0802,1.0804799999999999,1.07993,1.08024,1.0796060525456403,1.0802071111111111,1.080003333333326,1.0796944444444363,1.079140500000004,1.0789168000000005,1.0805646000000022,1.0829777000000054,1.079973298240936,1.0797573590657843,2380,-421194,-421986.2,0.0738143674789052,-329.80108310633636,0.12976901116014125
2023-08-25T08:00:00-04:00,1.08024,1.08103,1.08001,1.08098,1.0798821630874251,1.0804024444444444,1.0802244444444373,1.079873111111103,1.079240000000004,1.0789410000000006,1.0805187000000023,1.0829778000000054,1.0801746385927489,1.0799118872526272,2375,-418819,-421124.4,0.08088232374210848,-328.17412983669266,0.18443173708747612
2023-08-25T08:15:00-04:00,1.08098,1.08112,1.08057,1.08091,1.07993,1.0805395555555555,1.0803577777777709,1.0800313333333253,1.079359500000004,1.0789614000000005,1.0804742000000023,1.0829783500000054,1.0803217108741991,1.0800419098021015,-2477,-421296,-421369.4,0.09019351257926499,-328.33453058416256,0.1111409545155727
2023-08-25T08:30:00-04:00,1.08091,1.0815,1.08081,1.08141,1.08001,1.0807499999999999,1.0805555555555486,1.0801977777777698,1.079509000000004,1.0789830000000007,1.0804387000000022,1.0829807500000053,1.0805393686993594,1.080183127841681,3157,-418139,-420604.4,0.09318175802665733,-326.87418698478814,0.16487129850040225
2023-08-25T08:45:00-04:00,1.08141,1.08173,1.08105,1.08127,1.0803079999999998,1.080892888888889,1.0807244444444375,1.080373111111103,1.079717000000004,1.0790136000000006,1.0804092000000023,1.0829834000000054,1.0806854949594875,1.0803389022733443,-3187,-421326,-420154.8,0.09579007959363256,-327.28677795398585,0.14077332715906143
2023-08-25T09:00:00-04:00,1.08127,1.08148,1.08071,1.08075,1.0805923999999998,1.0808980000000001,1.0807766666666598,1.0805277777777698,1.0798655000000041,1.0790382000000005,1.0803788000000023,1.0829840500000052,1.08069839596759,1.0804839218186753,-2670,-423996,-420715.2,0.0889831087772287,-328.5708235670146,0.04350723886401604
2023-08-25T09:15:00-04:00,1.08075,1.08084,1.08023,1.08043,1.08173,1.0808286666666667,1.0807411111111043,1.080631111111103,1.079996500000004,1.0790578000000004,1.0803402000000022,1.0829811500000053,1.080644716774072,1.0805779374549398,-3348,-427344,-422420.2,0.07867627021049071,-329.5621351561891,-0.02960906777701577
2023-08-25T09:30:00-04:00,1.08043,1.08096,1.0799,1.08003,1.0817,1.0806864444444444,1.0806911111111044,1.0806977777777698,1.0800715000000043,1.0790726000000004,1.080322500000002,1.0829732500000053,1.0805217734192576,1.0806179499639514,-4712,-432056,-424572.2,0.06221351360420892,-331.3066257756645,-0.041648156374929614
2023-08-25T09:45:00-04:00,1.08003,1.08084,1.07998,1.08077,1.081628,1.0807022222222225,1.0807544444444375,1.0807375555555476,1.0801785000000044,1.0790990000000003,1.0803094000000022,1.0829715000000055,1.080571418735406,1.0806243599711607,4297,-427759,-426496.2,0.05501670913767177,-328.3624668171172,0.05276800592482498
2023-08-25T10:00:00-04:00,1.08077,1.08391,1.07942,1.08314,1.07942,1.0811793333333333,1.0810766666666598,1.080807999999992,1.0803820000000042,1.0791828000000003,1.080312600000002,1.0829822000000053,1.0810851349883248,1.080704287976928,20938,-406821,-423595.2,0.062340462764436784,-282.4479244075392,0.2684588609938442
2023-08-25T10:15:00-04:00,1.08314,1.08417,1.079,1.07904,1.08417,1.080772,1.080861111111104,1.080824888888881,1.0803800000000043,1.0791858000000003,1.0802743000000021,1.0829745500000054,1.08067610799066,1.080699830381542,-17551,-424372,-423670.4,0.05136494189553562,-348.88356522959344,-0.17946678014394835
2023-08-25T10:30:00-04:00,1.07904,1.0791,1.07769,1.07772,1.08417,1.0801437777777778,1.0805066666666596,1.080777999999992,1.0803240000000043,1.0791696000000004,1.080216700000002,1.0829588000000054,1.0800848863925279,1.0805878643052333,-13206,-437578,-425717.2,0.027184981300782507,-365.03859191998475,-0.2951217030095037
2023-08-25T10:45:00-04:00,1.07772,1.07832,1.07658,1.07714,1.08417,1.0794704444444445,1.0800322222222154,1.0806462222222142,1.0802315000000042,1.0791374000000002,1.080146000000002,1.0829424500000053,1.0794959091140224,1.0803826914441863,-9770,-447348,-428775.6,-0.0002204233714622364,-370.29654389266807,-0.3948548654071995
2023-08-25T11:00:00-04:00,1.07714,1.07846,1.0768,1.07786,1.0837146,1.0790359999999999,1.0796533333333265,1.0804259999999917,1.0801390000000042,1.0791222000000003,1.0800826000000021,1.0829233500000053,1.0791687272912178,1.0801021531553485,7667,-439681,-431160,-0.02810537996478258,-365.17163905207127,-0.3153698891118697
2023-08-25T11:15:00-04:00,1.07786,1.07878,1.07683,1.07855,1.083286524,1.0788153333333332,1.079408888888882,1.0800924444444362,1.0800850000000042,1.0791216000000003,1.0800290000000021,1.0829020000000054,1.0790449818329741,1.0796941225242787,6276,-433405,-436476.8,-0.04817618719880732,-361.1540115308727,-0.20356234096693976
2023-08-25T11:30:00-04:00,1.07855,1.07906,1.0783,1.07899,1.08288413256,1.0787315555555554,1.079248888888882,1.0797699999999917,1.0800470000000042,1.0791312000000002,1.0799727000000021,1.0828838000000054,1.0790339854663793,1.0793656980194224,6039,-427366,-437075.6,-0.06165156351050206,-358.69037053138265,-0.13328026804143794
2023-08-25T11:45:00-04:00,1.07899,1.0791,1.07838,1.07862,1.0825058846064,1.0786057777777778,1.0790922222222152,1.0794871111111028,1.0799640000000044,1.0791358000000002,1.0799195000000024,1.0828580500000053,1.0789511883731033,1.0791389584155375,-4690,-432056,-435971.2,-0.07343175969892006,-360.2986338146382,-0.13055192911309255
2023-08-25T12:00:00-04:00,1.07862,1.07955,1.07854,1.07945,1.082150331530016,1.0786773333333333,1.0789455555555485,1.0792697777777696,1.0798990000000042,1.0791596000000003,1.0798786000000022,1.0828337500000054,1.0790509506984827,1.0790499667324296,4383,-427673,-432036.2,-0.0751453013461013,-356.92590755330383,-0.12213514438779646
2023-08-25T12:15:00-04:00,1.07945,1.07979,1.0790899999999999,1.07968,1.081816111638215,1.0788242222222222,1.078561111111104,1.0790513333333251,1.0798590000000043,1.0791924000000004,1.0798448000000023,1.0828073500000055,1.079176760558786,1.0790515733859434,3207,-424466,-428993.2,-0.08052418106619111,-356.2425873439381,-0.3194416234281828
2023-08-25T12:30:00-04:00,1.07968,1.08001,1.07939,1.07958,1.0815019449399221,1.0790279999999999,1.0786211111111041,1.0788937777777696,1.0798280000000042,1.0792240000000002,1.0798154000000024,1.0827808500000056,1.0792574084470288,1.0790940587087543,-2780,-427246,-427761.4,-0.10952622861457469,-356.50007104281184,0.05004448398576373
2023-08-25T12:45:00-04:00,1.07958,1.07974,1.07924,1.07963,1.0812066282435269,1.0792297777777777,1.0788333333333264,1.0788106666666584,1.0797975000000044,1.0792584000000003,1.0797863000000023,1.0827563000000056,1.0793319267576231,1.0791536469670029,2715,-424531,-427194.4,-0.10155145110344688,-356.3743276981775,0.17722599562039104
2023-08-25T13:00:00-04:00,1.07963,1.08026,1.07961,1.08013,1.0809290305489152,1.0794891111111111,1.0791655555555488,1.078825333333325,1.0797550000000042,1.0793048,1.0797640000000024,1.0827306000000054,1.0794915414060986,1.079261717573602,2574,-421957,-425174.6,-0.07874817869745568,-355.1822526354247,0.27758694320144534
2023-08-25T13:15:00-04:00,1.08013,1.08025,1.07956,1.07991,1.0806680887159803,1.0796379999999999,1.0793933333333263,1.0789148888888807,1.0797050000000044,1.0793380000000001,1.0797374000000024,1.0827038000000053,1.079575233124879,1.0793665740588811,-2755,-424712,-424582.4,-0.048379250990298404,-355.7433887949613,0.19019167609892612
2023-08-25T13:30:00-04:00,1.07991,1.07996,1.07923,1.07935,1.0804228033930214,1.0796293333333333,1.0794822222222153,1.079099111111103,1.0796020000000044,1.0793628000000002,1.0797064000000025,1.0826732000000054,1.0795301864999032,1.0794372592471047,-2384,-427096,-425108.4,-0.027702003885498934,-356.97963996403996,0.07417365907933188
2023-08-25T13:45:00-04:00,1.07935,1.07991,1.07907,1.07988,1.08025,1.0797088888888888,1.0795811111111042,1.0792911111111032,1.0795325000000042,1.0793962000000001,1.0796840000000025,1.0826419500000055,1.0796001491999225,1.0795058073976833,2228,-424868,-424632.8,-0.008636233719846342,-355.88561115040227,0.08248454573258858
2023-08-25T14:00:00-04:00,1.07988,1.08047,1.0798699999999999,1.08045,1.07658,1.0798826666666665,1.0797844444444378,1.0794813333333253,1.0795175000000043,1.0794370000000002,1.0796663000000024,1.0826140500000054,1.079770119359938,1.0795934459181462,2080,-422788,-424284.2,0.00850421902783877,-354.78771138376163,0.1696612337987427
2023-08-25T14:15:00-04:00,1.08045,1.08108,1.0803,1.08105,1.0766578,1.0801357777777778,1.0799622222222154,1.0796406666666587,1.0795485000000042,1.0794780000000004,1.0796562000000025,1.0825856000000054,1.0800260954879504,1.0797003567345165,2723,-420065,-423905.8,0.02968938839253084,-353.2755636675319,0.14822363240539588
2023-08-25T14:30:00-04:00,1.08105,1.08125,1.0806499999999999,1.0807,1.076834688,1.0802833333333335,1.0800755555555488,1.0797771111111032,1.0795820000000043,1.0795162000000003,1.0796471000000023,1.0825573000000055,1.0801608763903603,1.0798174853876128,-2732,-422797,-423522.8,0.04007644783125817,-354.160074097207,0.09447243627741747
2023-08-25T14:45:00-04:00,1.0807,1.0809199999999999,1.08051,1.08072,1.07709960672,1.080412222222222,1.0802022222222154,1.0799211111111033,1.0795795000000044,1.0795502000000001,1.0796384000000023,1.0825295000000055,1.0802727011122881,1.0799659883100898,2154,-420643,-422232.2,0.04666474950123119,-354.1202110454814,0.10559662090812343
2023-08-25T15:00:00-04:00,1.08072,1.0809,1.08061,1.08083,1.0773486303168,1.0805377777777776,1.080335555555549,1.0800719999999921,1.0794640000000042,1.0795974000000002,1.0796275000000022,1.0825035000000056,1.0803841608898306,1.0801227906480713,2273,-418370,-420932.6,0.05797793089586152,-353.8888560229038,0.11114919000026562
2023-08-25T15:15:00-04:00,1.08083,1.08108,1.08076,1.0809199999999999,1.0775827124977921,1.0806546666666668,1.0804233333333264,1.08019977777777,1.0795580000000042,1.0796540000000003,1.0796243000000023,1.0824749000000056,1.0804913287118645,1.080267032518457,1578,-416792,-419733.4,0.07972580744774048,-353.7574570054821,0.0731393443381673
2023-08-25T15:30:00-04:00,1.0809199999999999,1.08107,1.08063,1.08075,1.0778027497479246,1.08072,1.08051666666666,1.080310666666659,1.079709500000004,1.0796892000000002,1.0796206000000022,1.0824452500000055,1.0805430629694917,1.080370426014765,-1482,-418274,-419375.2,0.07792021051610819,-353.9905362342869,0.07778425979944384
2023-08-25T15:45:00-04:00,1.08075,1.08077,1.07994,1.08028,1.078009584763049,1.0806726666666666,1.080619999999993,1.0804195555555478,1.079866500000004,1.0797244000000001,1.0796144000000023,1.0824143000000055,1.0804904503755932,1.0804363408118116,-1533,-419807,-418777.2,0.07004794378888898,-354.6572121537875,0.0861629684532242
2023-08-25T16:00:00-04:00,1.08028,1.08033,1.07954,1.07968,1.078204009677266,1.0804846666666668,1.0805977777777709,1.0804986666666587,1.0799575000000041,1.0797496000000002,1.0796031000000021,1.0823821000000056,1.0803283603004745,1.0804474726494488,-1360,-421167,-418882,0.06189528513689176,-355.4125718753411,-0.018520576360334294
2023-08-25T16:15:00-04:00,1.07968,1.07977,1.07922,1.07924,1.07838676909663,1.080213111111111,1.0804633333333262,1.0805242222222142,1.079992000000004,1.0797922000000002,1.0795848000000021,1.0823486000000053,1.0801106882403797,1.0803927781195586,-829,-421996,-419607.2,0.049880084080147366,-355.750412717072,-0.11199037438103877
2023-08-25T16:30:00-04:00,1.07924,1.07937,1.07912,1.07927,1.0785585629508323,1.0799744444444443,1.0802655555555485,1.0804926666666586,1.080006000000004,1.0798220000000003,1.0795716000000022,1.0823165500000054,1.0799425505923037,1.0802830224956463,419,-421577,-420564.2,0.03577741807336813,-355.73876563208626,-0.16465473382360804
2023-08-25T16:45:00-04:00,1.07927,1.07946,1.07884,1.07946,1.0787200491737823,1.0798133333333333,1.080127777777771,1.0804148888888807,1.0800480000000041,1.0798550000000002,1.0795603000000022,1.0822845000000054,1.079846040473843,1.0801436179965167,531,-421046,-421118.6,0.018981832996990557,-355.6452857799639,-0.11474044600720902
2023-08-27T17:00:00-04:00,1.07948,1.07959,1.0792,1.07957,1.07884,1.0797017777777778,1.0799999999999932,1.080290888888881,1.080054000000004,1.0798758000000002,1.0795487000000024,1.0822518000000054,1.0797908323790744,1.0800036943972129,89,-420957,-421348.6,0.004329704817409548,-355.63621643047435,-0.1064105411207329
2023-08-27T17:15:00-04:00,1.07957,1.07957,1.07956,1.07957,1.07884,1.0796157777777777,1.0798599999999932,1.0801433333333252,1.0800485000000042,1.0798946000000003,1.0795366000000022,1.0822168000000054,1.0797466659032595,1.07988735551777,0,-420957,-421306.6,-0.006847246441240735,-355.63621643047435,-0.11657707502567831
2023-08-27T17:30:00-04:00,1.07957,1.07957,1.07954,1.07956,1.0789846,1.0795557777777776,1.079708888888882,1.0799924444444364,1.0800475000000043,1.0799044000000002,1.0795241000000022,1.0821815000000052,1.0797093327226077,1.0798070844142156,-538,-421495,-421206.4,-0.01807717897235012,-355.6411998961134,-0.12581874699328405
2023-08-27T17:45:00-04:00,1.07956,1.07959,1.07944,1.07959,1.0791205240000001,1.079532,1.0795799999999933,1.0798553333333252,1.0800455000000042,1.0799146000000002,1.079509700000002,1.0821475000000054,1.0796854661780861,1.0797556675313722,144,-421351,-421161.2,-0.030435783274914665,-355.63719826581956,-0.10733287069165393
2023-08-27T18:00:00-04:00,1.07959,1.08008,1.07959,1.07991,1.0792482925600002,1.0795979999999998,1.0795388888888822,1.0797375555555475,1.080034500000004,1.0799360000000002,1.079497800000002,1.0821160500000055,1.079730372942469,1.0797325340250974,403,-420948,-421141.6,-0.039447427385639534,-355.51774551060697,-0.03425037953123093
2023-08-27T18:15:00-04:00,1.07991,1.07991,1.0795,1.0796,1.0793683950064001,1.0796102222222224,1.0795299999999932,1.0796435555555477,1.080019000000004,1.0799482000000002,1.079482400000002,1.0820832000000054,1.079704298353975,1.0797152272200774,-435,-421383,-421226.8,-0.04340773420434757,-355.64261702767783,-0.007409602845294903
2023-08-27T18:30:00-04:00,1.0796,1.07977,1.07949,1.07955,1.079481291306016,1.0796142222222223,1.0795644444444377,1.0795844444444367,1.0800290000000041,1.0799450000000002,1.0794655000000022,1.0820496000000055,1.07967343868318,1.0797005817760614,-434,-421817,-421398.8,-0.043024824150578886,-355.66271706472855,0.028723916830365116
2023-08-27T18:45:00-04:00,1.07955,1.07965,1.07944,1.07946,1.08125,1.0795933333333332,1.079585555555549,1.07955977777777,1.0800080000000043,1.0799416000000002,1.0794473000000022,1.0820154500000054,1.0796307509465441,1.0796848654208486,-332,-422149,-421529.6,-0.0414725899953137,-355.69039526397825,0.01760449192510998
2023-08-27T19:00:00-04:00,1.07946,1.07992,1.07933,1.0799,1.0812138,1.0796562222222224,1.0796344444444377,1.0795706666666587,1.0799805000000045,1.0799446000000001,1.0794359000000022,1.0819831000000053,1.0796846007572354,1.0796846923366785,727,-421422,-421543.8,-0.035727418710395274,-355.39406191211714,0.040761121301391055
2023-08-27T19:15:00-04:00,1.0799,1.0801,1.07981,1.0799,1.081138448,1.0797093333333334,1.0796711111111046,1.0795971111111033,1.0799230000000042,1.0799370000000001,1.0794244000000022,1.0819503000000055,1.0797276806057883,1.0796841538693425,0,-421422,-421638.6,-0.02922902655291352,-355.39406191211714,0.03056772603908626
2023-08-27T19:30:00-04:00,1.0799,1.0799,1.07959,1.07966,1.0810661100799999,1.0797071111111112,1.0796811111111042,1.0796273333333253,1.0798710000000042,1.0799152,1.0794123000000022,1.0819165000000053,1.0797141444846305,1.0796861230954735,-690,-422112,-421784.4,-0.022268159794447052,-355.5474094442961,0.008336652556123782
2023-08-27T19:45:00-04:00,1.07966,1.07977,1.07948,1.07969,1.0809966656768,1.079708888888889,1.0796955555555487,1.0796535555555475,1.0798195000000042,1.0798994,1.0794019000000021,1.0818839500000055,1.0797093155877044,1.0796932984763785,790,-421322,-421685.4,-0.016704068551809538,-355.52545808923986,0.012041943013817061
2023-08-27T20:00:00-04:00,1.07969,1.0803,1.07961,1.07999,1.0809299990497279,1.0797677777777779,1.0797399999999933,1.0796844444444367,1.079777500000004,1.0798952000000002,1.0794048000000023,1.0818504000000053,1.0797654524701636,1.0797202387811022,1969,-419353,-421126.2,-0.009503280505842716,-354.97835660640686,0.03705110273344102
2023-08-27T20:15:00-04:00,1.07999,1.08021,1.07992,1.08013,1.0808659990877387,1.079845777777778,1.0797644444444379,1.0797104444444365,1.079738000000004,1.0798930000000002,1.0794049000000023,1.0818184500000054,1.079838361976131,1.0797509910248815,1267,-418086,-420459,-0.0014156135559136062,-354.8141143449044,0.020372068042717358
2023-08-27T20:30:00-04:00,1.08013,1.08042,1.08001,1.08011,1.0808045591242292,1.079914888888889,1.0798211111111045,1.0797404444444365,1.079706000000004,1.0798756,1.079408300000002,1.0817865500000052,1.0798926895809047,1.079783992819905,-991,-419077,-419990,0.004008843270236176,-354.83246398800304,0.047239718414228464
2023-08-27T20:45:00-04:00,1.08011,1.0804799999999999,1.0801,1.08024,1.08074557675926,1.0799986666666668,1.0798977777777712,1.07978377777777,1.079704000000004,1.0798622,1.0794118000000024,1.0817555000000052,1.0799621516647238,1.0798335942559234,1128,-417949,-419157.4,0.012185569956696254,-354.6967000380348,0.06391552035571112
2023-08-27T21:00:00-04:00,1.08024,1.08079,1.08022,1.0804799999999999,1.07933,1.0801151111111111,1.0800111111111044,1.079846888888881,1.079744000000004,1.0798436,1.0794133000000024,1.0817263000000055,1.080065721331779,1.0799048754047385,2052,-415897,-418072.4,0.019916593750989583,-354.24080134885503,0.09449169028957059
2023-08-27T21:15:00-04:00,1.0804799999999999,1.08099,1.08047,1.08085,1.0793591999999999,1.080282888888889,1.0801166666666602,1.0799222222222145,1.079824500000004,1.0798352000000002,1.0794244000000024,1.0816991000000054,1.0802225770654232,1.0799963003237902,2380,-413517,-416905.2,0.027628658482117433,-353.4257932043262,0.08797110843596688
2023-08-27T21:30:00-04:00,1.08085,1.0809199999999999,1.08036,1.08064,1.079424432,1.0803875555555555,1.0801988888888825,1.0800091111111034,1.079893000000004,1.079833,1.0794356000000023,1.0816700000000055,1.0803060616523386,1.0800898402590318,-2690,-416207,-416529.4,0.028306051074496293,-353.94843741952735,0.06852486341327557
2023-08-27T21:45:00-04:00,1.08064,1.0807,1.08017,1.08025,1.07948705472,1.0803977777777776,1.080264444444438,1.0800977777777703,1.079932500000004,1.0798294000000002,1.0794436000000025,1.0816385500000054,1.080294849321871,1.0801702722072253,-1847,-418054,-416324.8,0.02722449092992457,-354.6150146330306,0.05464683326231113
2023-08-27T22:00:00-04:00,1.08025,1.08064,1.08012,1.08063,1.0795471725312,1.0804708888888888,1.0803688888888825,1.0801919999999925,1.079985500000004,1.0798414,1.0794570000000023,1.0816074000000053,1.0803618794574967,1.08025021776578,1796,-416258,-415986.6,0.031045959131105277,-353.98323495240106,0.08706202706331825
2023-08-27T22:15:00-04:00,1.08063,1.0807,1.08051,1.08064,1.079604885629952,1.0805251111111112,1.0804411111111045,1.0802779999999925,1.0800390000000042,1.0798388,1.0794689000000024,1.0815749000000054,1.0804175035659973,1.0803205742126236,1568,-414690,-415745.2,0.035122914769973396,-353.9687248980808,0.06018574246058199
2023-08-27T22:30:00-04:00,1.08064,1.0809,1.08062,1.08085,1.079660290204754,1.0806068888888887,1.0805211111111044,1.0803588888888815,1.080103500000004,1.079793,1.0794879000000024,1.0815446500000052,1.080504002852798,1.0803768593700984,1323,-413367,-415715.2,0.03743998998323565,-353.7116272522412,0.06665864294113245
2023-08-27T22:45:00-04:00,1.08085,1.08099,1.0808,1.08087,1.0797134785965639,1.0806766666666665,1.080605555555549,1.0804402222222147,1.080167500000004,1.0798296,1.0795077000000026,1.0815142000000053,1.0805772022822384,1.0804310874960783,1141,-412226,-414919,0.038513526024545504,-353.6905142393348,0.07036320374777513
2023-08-27T23:00:00-04:00,1.08087,1.08097,1.08076,1.08082,1.0797645394527013,1.0807195555555555,1.0806699999999934,1.0805213333333257,1.080213000000004,1.0798916,1.0795306000000024,1.0814860500000052,1.0806257618257906,1.0804972699968622,-1315,-413541,-414016.4,0.039662019813949054,-353.7513448665149,0.053691772198752395
2023-08-27T23:15:00-04:00,1.08082,1.08091,1.08075,1.0808,1.0798135578745933,1.0807455555555556,1.0807055555555491,1.0805886666666589,1.080273000000004,1.0799648,1.0795511000000024,1.0814595500000055,1.0806606094606326,1.0805570159974895,-1106,-414647,-413694.2,0.04092120541022694,-353.77181080903995,0.02961646675552514
2023-08-27T23:30:00-04:00,1.0808,1.08098,1.0807,1.0809,1.0798606155596095,1.0807844444444443,1.0807111111111045,1.0806426666666589,1.0803405000000041,1.0800256,1.0795739000000026,1.0814337500000053,1.080708487568506,1.080615212797991,875,-413772,-413510.6,0.03907634367095216,-353.6908522598172,0.00462598880509631
2023-08-27T23:45:00-04:00,1.0809,1.08103,1.08081,1.08096,1.0799057909372252,1.0808342222222223,1.08074666666666,1.08068777777777,1.080415500000004,1.0800738,1.0795977000000025,1.0814081000000053,1.0807587900548048,1.0806661702383926,934,-412838,-413404.8,0.033877282782881823,-353.6390065756651,0.02961208172933409
2023-08-28T00:00:00-04:00,1.08096,1.08112,1.0809,1.08108,1.0799732434809917,1.080900888888889,1.0808388888888822,1.0807344444444367,1.080474500000004,1.0801156,1.0796234000000025,1.0813827500000055,1.080823032043844,1.0807153361907138,952,-411886,-413336.8,0.030807350924958593,-353.53332273907534,0.07683406618839236
2023-08-28T00:15:00-04:00,1.08108,1.08113,1.08086,1.08089,1.0800649840025123,1.080911111111111,1.080867777777771,1.0807739999999921,1.0805240000000038,1.080161,1.0796484000000024,1.0813577500000056,1.080836425635075,1.0807574689525707,-821,-412707,-413170,0.03236613930675754,-353.6776136333663,0.024060039051287393
2023-08-28T00:30:00-04:00,1.08089,1.0809199999999999,1.08066,1.08067,1.080171485602261,1.0808715555555557,1.0808711111111045,1.080807111111103,1.080574500000004,1.0801854,1.0796725000000025,1.0813296500000054,1.08080314050806,1.080785975162056,-844,-413551,-412950.8,0.02934183591415457,-353.8493979962524,0.002776132662123787
2023-08-28T00:45:00-04:00,1.08067,1.08079,1.08058,1.08075,1.080267337042035,1.0808473333333333,1.0808599999999933,1.0808368888888809,1.080627500000004,1.0802068,1.0796996000000023,1.0813009000000056,1.0807925124064481,1.0808027801296445,754,-412797,-412755.8,0.02555499148622842,-353.7935807717527,-0.009251977610213163
2023-08-28T01:00:00-04:00,1.08075,1.08102,1.08052,1.0809199999999999,1.0803536033378316,1.0808593333333332,1.0808655555555489,1.0808606666666587,1.0806740000000041,1.0802336,1.0797288000000023,1.0812724000000054,1.0808180099251585,1.0808146241037153,1473,-411324,-412453,0.02078130845584958,-353.5618805635643,0.004625903207590503
2023-08-28T01:15:00-04:00,1.0809199999999999,1.0811,1.08076,1.08091,1.0804312430040484,1.0808682222222221,1.0808755555555492,1.0808679999999922,1.080713000000004,1.0802591999999998,1.0797588000000025,1.0812415500000054,1.080836407940127,1.0808172992829719,-1375,-412699,-412615.6,0.017096736242008453,-353.57460120894024,0.00832701097316348
2023-08-28T01:30:00-04:00,1.08091,1.08134,1.0809,1.0812599999999999,1.0805011187036435,1.080945111111111,1.0809266666666604,1.0808797777777701,1.0807705000000039,1.0802817999999998,1.0797933000000024,1.0812147500000053,1.0809211263521015,1.0808342394263772,1467,-411232,-412320.6,0.016188216881719054,-353.09958478759177,0.042561065877119254
2023-08-28T01:45:00-04:00,1.0812599999999999,1.08138,1.08084,1.08101,1.0806017844592062,1.0809617777777778,1.0809388888888825,1.0808933333333255,1.080809000000004,1.0803038,1.0798209000000023,1.0811868500000055,1.0809389010816812,1.0808613915411016,-1410,-412642,-412138.8,0.014165229582608399,-353.4255933331773,0.010176704598025211
2023-08-28T02:00:00-04:00,1.08101,1.08154,1.081,1.0815,1.0807107346349174,1.0810739999999999,1.0809988888888826,1.0809211111111037,1.080860000000004,1.0803468,1.0798548000000026,1.0811607000000054,1.081051120865345,1.0809131132328809,1883,-410759,-411731.2,0.014164443238417814,-352.57206746385157,0.0499555950266416
2023-08-28T02:15:00-04:00,1.0815,1.08185,1.08146,1.08148,1.08084,1.0811702222222221,1.081043333333327,1.080956666666659,1.080891500000004,1.0803788,1.0798875000000026,1.0811336000000054,1.081136896692276,1.0809768905863044,-1752,-412511,-411968.6,0.014569129130134072,-352.6044669090664,0.037000037000032925
2023-08-28T02:30:00-04:00,1.08148,1.0819,1.08145,1.0818,1.081,1.0813215555555555,1.081144444444438,1.081010444444437,1.080949500000004,1.0804058,1.0799214000000026,1.0811099000000053,1.081269517353821,1.081063512469043,1726,-410785,-411585.8,0.017044330678687415,-352.0937593601518,0.08418988056140667
2023-08-28T02:45:00-04:00,1.0818,1.0818699999999999,1.08156,1.0816,1.08118,1.0814126666666666,1.0812477777777714,1.0810746666666593,1.081017000000004,1.0804168,1.0799474000000027,1.0810830000000053,1.0813356138830568,1.0811464099752341,-1621,-412406,-411820.6,0.01938275613117903,-352.39344506915563,0.08605772344933008
2023-08-28T03:00:00-04:00,1.0816,1.08196,1.08151,1.08182,1.081324,1.0815271111111109,1.0813666666666601,1.0811602222222148,1.081076500000004,1.0804391999999998,1.0799777000000026,1.0810556500000053,1.0814324911064455,1.0812451279801871,2496,-409910,-411274.2,0.02310352847496607,-351.8857527614631,0.09900532037935732
2023-08-28T03:15:00-04:00,1.08182,1.08195,1.08136,1.08148,1.08196,1.0815497777777776,1.0814288888888823,1.0812462222222146,1.0811185000000039,1.0804543999999998,1.0800023000000025,1.0810262000000055,1.0814419928851564,1.0813233023841495,-2219,-412129,-411548.2,0.02611107513955739,-352.58315158936426,0.05180771935019391
2023-08-28T03:30:00-04:00,1.08148,1.08208,1.08137,1.0814,1.08136,1.081544,1.081483333333327,1.0813342222222144,1.081146000000004,1.0804657999999998,1.0800316000000025,1.0809968500000053,1.081433594308125,1.0813826419073191,-2471,-414600,-411966,0.027202530681189035,-352.76593814112687,0.045332173816495305
2023-08-28T03:45:00-04:00,1.0814,1.08162,1.08078,1.08089,1.08208,1.0814253333333332,1.0814422222222158,1.08139377777777,1.0811470000000039,1.0804652,1.0800596000000025,1.0809659000000054,1.0813248754465,1.081393713525855,-2156,-416756,-413160.2,0.026841309894828767,-353.7827311871783,-0.03421933669977448
2023-08-28T04:00:00-04:00,1.08089,1.08105,1.08058,1.08058,1.08208,1.081252888888889,1.081394444444438,1.0814231111111035,1.0811350000000037,1.0804617999999997,1.0800755000000024,1.0809347000000054,1.0811759003572,1.0813617708206835,-1999,-418755,-414430,0.021829214148445974,-354.35604577053056,-0.03977761537820468
2023-08-28T04:15:00-04:00,1.08058,1.0806499999999999,1.0801399999999999,1.08036,1.08202,1.081046,1.0812677777777715,1.0814033333333257,1.081113000000004,1.0804633999999997,1.0800939000000025,1.0809058500000055,1.08101272028576,1.0812778166565464,-2021,-420776,-416603.2,0.0178434096550685,-354.7675099841938,-0.10540915395283577
2023-08-28T04:30:00-04:00,1.08036,1.0808,1.07994,1.08073,1.0819072,1.0809384444444443,1.0811844444444383,1.0813544444444372,1.0811045000000041,1.0804843999999998,1.0801170000000024,1.0808809500000054,1.080956176228608,1.0811806533252366,1858,-418918,-417961,0.011029384235463775,-354.13118505546635,-0.06934941006768765
2023-08-28T04:45:00-04:00,1.08073,1.08074,1.08001,1.08006,1.081749824,1.0807135555555556,1.0809911111111048,1.0812559999999927,1.0810595000000043,1.0805007999999998,1.0801465000000023,1.0808529000000053,1.0807769409828865,1.081049322660189,-2149,-421067,-419254.4,0.001594562629718356,-355.4634604619045,-0.16084303937882
2023-08-28T05:00:00-04:00,1.08006,1.0807,1.08002,1.08051,1.08160503808,1.0806173333333333,1.0808699999999938,1.0811415555555484,1.0810310000000043,1.0805255999999996,1.0801738000000025,1.0808280500000054,1.0807235527863093,1.0809290581281508,1415,-419652,-419833.6,-0.00835620239875165,-354.8739098813811,-0.10077662721891767
2023-08-28T05:15:00-04:00,1.08051,1.08061,1.0801,1.08025,1.0814718350336,1.0804933333333335,1.0806955555555493,1.0810017777777705,1.0809990000000043,1.0805413999999998,1.0801982000000023,1.0808008500000055,1.0806288422290473,1.0808196465025202,-1655,-421307,-420344,-0.017188768535989513,-355.27214775053574,-0.14512580651125614
2023-08-28T05:30:00-04:00,1.08025,1.0806499999999999,1.08005,1.0806,1.081349288230912,1.0804742222222221,1.0805977777777716,1.0808677777777707,1.0809955000000042,1.0805619999999998,1.0802189000000024,1.0807766000000054,1.0806230737832379,1.0807417172020157,1401,-419906,-420170,-0.02719754297006382,-354.81822504745764,-0.08136997447941635
2023-08-28T05:45:00-04:00,1.0806,1.0809199999999999,1.08043,1.08076,1.081236545172439,1.0805066666666667,1.0805266666666604,1.080736222222215,1.080996000000004,1.0805857999999997,1.0802402000000024,1.0807523500000054,1.0806504590265902,1.080680573761612,1625,-418281,-420042.6,-0.0342544955719566,-354.57761797731155,-0.05918254115035824
2023-08-28T06:00:00-04:00,1.08076,1.08121,1.08058,1.08112,1.07994,1.0806253333333333,1.080552222222216,1.0806484444444373,1.081006000000004,1.0806169999999997,1.0802607000000024,1.0807287500000053,1.0807443672212722,1.0806740590092894,1954,-416327,-419094.6,-0.03847400823906671,-353.92674266734423,0.02127876102102661
2023-08-28T06:15:00-04:00,1.08112,1.08172,1.08106,1.08158,1.0799653999999999,1.080830888888889,1.080663333333327,1.0806071111111037,1.0810395000000041,1.0806567999999996,1.0802857000000023,1.0807052500000054,1.0809114937770177,1.0807116472074312,1834,-414493,-418062.8,-0.03499737905072653,-353.1464037595451,0.09254289363118785
2023-08-28T06:30:00-04:00,1.08158,1.08222,1.08157,1.08184,1.0800355839999998,1.0810662222222223,1.0808277777777715,1.0806335555555484,1.0810685000000042,1.0806953999999995,1.0803157000000025,1.0806846000000052,1.0810971950216142,1.0808053177659445,2198,-412295,-416260.4,-0.027437349769441097,-352.6180286046792,0.13699137324594818
2023-08-28T06:45:00-04:00,1.08184,1.08194,1.08103,1.08118,1.0801666489599997,1.0811366666666666,1.0808777777777716,1.0806895555555482,1.081077000000004,1.0807269999999998,1.0803376000000025,1.0806595500000054,1.0811137560172914,1.0809034542127551,-2255,-414550,-415189.2,-0.019500012112997532,-353.9937403550302,0.04163852211006093
2023-08-28T07:00:00-04:00,1.08118,1.08125,1.08067,1.08102,1.0802898500223996,1.081165111111111,1.0809844444444383,1.0807811111111039,1.081053000000004,1.0807563999999996,1.0803507000000026,1.0806351500000055,1.0810950048138332,1.0809923633702037,-1923,-416473,-414827.6,-0.016861534558030147,-354.2783183161466,0.08888395089162379
2023-08-28T07:15:00-04:00,1.08102,1.08112,1.08062,1.08075,1.0804056590210556,1.0811182222222222,1.081011111111105,1.0808728888888814,1.081016500000004,1.0807821999999998,1.0803619000000024,1.0806104000000054,1.0810260038510666,1.0810486906961625,-1715,-418188,-415199.8,-0.007175639299062847,-354.7066637676646,0.022211733348142818
2023-08-28T07:30:00-04:00,1.08075,1.08098,1.08066,1.08086,1.0805145194797923,1.081088,1.0810788888888827,1.080955999999993,1.0809695000000041,1.0808013999999997,1.0803730000000025,1.0805906500000055,1.0809928030808533,1.0810649525569296,1738,-416450,-415591.2,-0.0012069851842936995,-354.5297680933646,0.05646841009025683
2023-08-28T07:45:00-04:00,1.08086,1.08095,1.08027,1.08041,1.08222,1.0809542222222224,1.0810577777777715,1.0810019999999927,1.0809100000000043,1.0808115999999997,1.0803743000000026,1.0805685500000055,1.0808762424646827,1.0810207620455432,-2268,-418718,-416875.8,0.0063965321282232375,-355.47401619210046,-0.017582824356830694
2023-08-28T08:00:00-04:00,1.08041,1.08112,1.08035,1.08061,1.082181,1.0808646666666668,1.081041111111105,1.0810346666666593,1.080849500000004,1.0808305999999996,1.0803729000000024,1.0805450000000056,1.0808229939717462,1.0809626096364342,2814,-415904,-417146.6,0.010850789094393862,-354.9531028351342,-0.01387912209925168
2023-08-28T08:15:00-04:00,1.08061,1.08085,1.08024,1.0806,1.08214278,1.0807764444444445,1.0809833333333272,1.081034444444437,1.080805500000004,1.0808487999999996,1.0803741000000024,1.0805211500000056,1.080778395177397,1.080899287709147,-2947,-418851,-417622.2,0.014746058943010428,-354.9803744687487,-0.04809826846234238
2023-08-28T08:30:00-04:00,1.0806,1.08096,1.08027,1.08069,1.0820666688,1.0807177777777779,1.0808844444444385,1.0810091111111038,1.080770000000004,1.0808627999999998,1.0803790000000024,1.0804979500000056,1.0807607161419177,1.0808462301673174,3783,-415068,-416998.2,0.01424870466337562,-354.6652995103925,-0.08228702453818094
2023-08-28T08:45:00-04:00,1.08069,1.08111,1.0806,1.08102,1.081993602048,1.0807448888888889,1.0807933333333273,1.0809519999999928,1.080776500000004,1.0808805999999997,1.0803868000000023,1.0804757000000056,1.0808125729135343,1.0808101841338535,2983,-412085,-416125.2,0.0107417821843108,-353.7544092458389,-0.07579679065294508
2023-08-28T09:00:00-04:00,1.08102,1.08132,1.08058,1.08073,1.0819234579660801,1.080732222222222,1.0807433333333274,1.0808891111111039,1.0807840000000042,1.0808929999999999,1.0803843000000024,1.0804515000000057,1.0807960583308274,1.0807941473070826,-3464,-415549,-415491.4,0.0011764052757443487,-354.68367974962274,-0.041621191660968705
2023-08-28T09:15:00-04:00,1.08073,1.08099,1.0801,1.08055,1.081856119647437,1.0806935555555557,1.080691111111105,1.080819111111104,1.0807935000000042,1.0808991999999997,1.0803807000000023,1.0804274500000057,1.080746846664662,1.0807789178456655,-2918,-418467,-416004,-0.004520574562222691,-355.1696845796915,-0.04347745647630871
2023-08-28T09:30:00-04:00,1.08055,1.0807,1.07991,1.0807,1.0817507524685908,1.0806953333333333,1.0806855555555497,1.0807595555555487,1.080792000000004,1.0809035999999999,1.0803736000000024,1.080406150000006,1.0807374773317295,1.0807707342765318,5970,-412497,-414733.2,-0.00897933035682096,-354.340939958896,-0.004626416840167061
2023-08-28T09:45:00-04:00,1.0807,1.08114,1.08037,1.0807,1.0816034922711035,1.0806982222222221,1.0806677777777718,1.0807162222222153,1.080824000000004,1.0809005999999999,1.0803679000000022,1.0803885500000059,1.0807299818653837,1.0807645874212253,0,-412497,-414219,-0.009309789069036992,-354.340939958896,-0.014803027219060561
2023-08-28T10:00:00-04:00,1.0807,1.08083,1.0798699999999999,1.08029,1.0814680128894152,1.0806226666666667,1.0806544444444384,1.0806884444444376,1.080813000000004,1.0808935999999998,1.0803633000000021,1.0803710500000059,1.080641985492307,1.0807304699369795,-5087,-417584,-415318.8,-0.01559693295552288,-356.2708650074757,-0.011106894604837053
2023-08-28T10:15:00-04:00,1.08029,1.08094,1.07992,1.08076,1.0813082116004737,1.0806437777777778,1.080671111111105,1.080673999999993,1.080838500000004,1.0809037999999997,1.0803666000000023,1.0803534000000057,1.0806655883938456,1.0807043759495834,4175,-413409,-414890.8,-0.013459916764262673,-354.45445459915953,0.013881048666944822
2023-08-28T10:30:00-04:00,1.08076,1.08141,1.08064,1.08087,1.0798699999999999,1.0806835555555554,1.080701111111105,1.0806759999999929,1.0808520000000041,1.0809085999999997,1.0803750000000023,1.0803487500000057,1.0807064707150764,1.0806963007596662,3514,-409895,-413176.4,-0.013785574182894809,-354.0967988754094,0.02498611882287548
2023-08-28T10:45:00-04:00,1.08087,1.08115,1.08035,1.08055,1.0799007999999999,1.0806533333333335,1.0806855555555495,1.0806759999999929,1.080841500000004,1.0809067999999997,1.0803728000000021,1.0803411000000058,1.080675176572061,1.0806838406077328,-4189,-414084,-413493.8,-0.014027921025845016,-355.33698502175486,-0.012954686357792613
2023-08-28T11:00:00-04:00,1.08055,1.08075,1.08026,1.0805,1.079930984,1.0806162222222222,1.0806277777777717,1.0806679999999929,1.0808105000000041,1.0808997999999996,1.0803464000000023,1.0803295000000057,1.0806401412576487,1.0806658724861857,-3679,-417763,-414547,-0.014640488550710047,-355.50722240086697,-0.04810271780356292
2023-08-28T11:15:00-04:00,1.0805,1.0807,1.08041,1.0805,1.0799605643199999,1.0805906666666667,1.0806022222222162,1.0806575555555484,1.0807565000000041,1.0808923999999998,1.0803610000000021,1.0803176500000058,1.080612113006119,1.0806598979889481,0,-417763,-414582.8,-0.01672048503930998,-355.50722240086697,-0.021281911300690504
2023-08-28T11:30:00-04:00,1.0805,1.08101,1.08047,1.0807,1.0799895530336,1.0806102222222225,1.0806188888888828,1.0806471111111042,1.080699500000004,1.0808899999999997,1.0803908000000022,1.0803037500000057,1.0806296904048953,1.080652718391158,3784,-413979,-414696.8,-0.013121353129501225,-354.80680592701236,0.013881819443810514
2023-08-28T11:45:00-04:00,1.0807,1.08099,1.08052,1.08089,1.080017961972928,1.0806644444444444,1.080639999999994,1.080634888888882,1.080685000000004,1.0808917999999996,1.0804283000000021,1.0802871500000057,1.0806817523239163,1.0806477747129262,2771,-411208,-414959.4,-0.005789852160336785,-354.3196309478324,0.017581197372065555
2023-08-28T12:00:00-04:00,1.08089,1.08099,1.0807,1.08084,1.0800458027334694,1.0807044444444442,1.0806555555555493,1.080628888888882,1.080676000000004,1.0808905999999996,1.0804581000000022,1.0802703500000057,1.0807134018591331,1.0806554197703406,-1994,-413202,-414783,-0.002996315413151445,-354.4118697510407,0.012954566484688535
2023-08-28T12:15:00-04:00,1.08084,1.08085,1.0804,1.08059,1.0800730866788,1.0806913333333332,1.0806888888888828,1.080641111111104,1.0806680000000042,1.0808831999999997,1.0804785000000023,1.0802537500000056,1.0806887214873064,1.0806651358162722,-1662,-414864,-414203.2,-0.0021194926787874934,-354.7962929774203,0.027770320932339183
2023-08-28T12:30:00-04:00,1.08059,1.08105,1.08047,1.08098,1.080099824945224,1.0807495555555555,1.0807133333333274,1.0806633333333264,1.0806740000000041,1.0808811999999997,1.0804984000000022,1.0802355500000056,1.0807469771898452,1.0806921086530172,1693,-413171,-413284.8,0.003251912150920506,-354.18526566826495,0.020356045745596525
2023-08-28T12:45:00-04:00,1.08098,1.08125,1.0806499999999999,1.08074,1.0801260284463197,1.080754888888889,1.0806988888888829,1.0806793333333267,1.0806905000000042,1.0808781999999997,1.0805196000000021,1.0802195500000056,1.0807455817518763,1.0807152869224133,-1582,-414753,-413439.6,0.0035956291956136246,-354.53650250890956,-0.01202734833975996
2023-08-28T13:00:00-04:00,1.08074,1.08097,1.08054,1.08061,1.0801517078773932,1.080737111111111,1.0807055555555494,1.0806924444444377,1.080690500000004,1.0808769999999996,1.0805312000000022,1.0802049000000056,1.080718465401501,1.0807226295379304,-2201,-416954,-414588.8,0.0003084458648326858,-354.801256288727,0.0055527277775365355
2023-08-28T13:15:00-04:00,1.08061,1.081,1.08037,1.08099,1.0801768737198454,1.0807939999999998,1.0807599999999935,1.0807133333333265,1.0807100000000038,1.0808817999999996,1.0805443000000023,1.0801945500000056,1.0807727723212008,1.0807345036303437,1519,-415435,-415035.4,0.0027054655693633037,-354.2670950279579,0.045349375289206795
2023-08-28T13:30:00-04:00,1.08099,1.0811,1.08079,1.08095,1.0802015362454485,1.080832,1.0808099999999936,1.0807375555555487,1.0807230000000039,1.0808823999999995,1.0805580000000021,1.0801867000000056,1.0808082178569607,1.0807584029042745,-1509,-416944,-415451.4,0.005327129364798635,-354.32293273228424,0.041647385469695646
2023-08-28T13:45:00-04:00,1.08095,1.08105,1.08067,1.08084,1.0802257055205395,1.080838,1.0808255555555495,1.080759999999993,1.0807140000000042,1.0808809999999998,1.080570100000002,1.0801782000000055,1.0808145742855686,1.0807719223234193,-1848,-418792,-416575.6,0.007812190189360731,-354.5109895341716,0.012954566484688535
2023-08-28T14:00:00-04:00,1.08084,1.08085,1.08054,1.08064,1.0802493914101288,1.080800888888889,1.0807977777777715,1.0807797777777708,1.0807095000000042,1.0808685999999996,1.0805752000000022,1.0801696000000056,1.0807796594284549,1.080778737858735,-1718,-420510,-417727,0.008931514189267263,-354.8288904260704,-0.023129088066302903
2023-08-28T14:15:00-04:00,1.08064,1.08095,1.08058,1.08081,1.0802726035819261,1.0808033333333333,1.0807944444444382,1.0807975555555485,1.0807225000000042,1.0808645999999995,1.0805842000000023,1.0801608000000056,1.080785727542764,1.0807921902869877,1135,-419375,-418211.2,0.007838730998205897,-354.650338827018,-0.0027756189630263953
2023-08-28T14:30:00-04:00,1.08081,1.08101,1.08071,1.08081,1.0802953515102875,1.0808064444444445,1.0808188888888826,1.0808093333333262,1.0807280000000041,1.0808507999999997,1.0805988000000022,1.0801526000000055,1.0807905820342112,1.0807957522295897,0,-419375,-418999.2,0.006415436527452483,-354.650338827018,0.02035924818849971
2023-08-28T14:45:00-04:00,1.08081,1.08121,1.08079,1.08115,1.0803176444800817,1.0808726666666668,1.0808377777777716,1.0808148888888818,1.0807505000000042,1.0808441999999996,1.080611500000002,1.0801477500000056,1.0808624656273689,1.0808066017836713,1495,-417880,-419186.4,0.009614151749582635,-354.1800434004398,0.015726470424985057
2023-08-28T15:00:00-04:00,1.08115,1.08135,1.08088,1.0811,1.08033949159048,1.0809251111111113,1.0808777777777716,1.0808253333333262,1.0807910000000043,1.0808301999999996,1.080618000000002,1.0801421500000057,1.0809099725018951,1.0808256814269366,-1270,-419150,-419258,0.00896188818279358,-354.238777156163,0.03331050946572866
2023-08-28T15:15:00-04:00,1.0811,1.08142,1.08099,1.08141,1.0803609017586704,1.0810315555555556,1.0809666666666606,1.080859111111104,1.0808235000000042,1.0808263999999996,1.0806216000000022,1.0801389000000057,1.081009978001516,1.080871745141549,1539,-417611,-418678.2,0.01022591743592492,-353.7974766289222,0.07403225955709385
2023-08-28T15:30:00-04:00,1.08141,1.08176,1.08138,1.08172,1.0804032656883236,1.0811822222222223,1.0810477777777716,1.0809097777777708,1.0808660000000043,1.0808243999999996,1.0806318000000021,1.0801394500000054,1.0811519824012128,1.0809449961132387,1324,-416287,-418060.6,0.0162656141306558,-353.41793510443097,0.0675306894605981
2023-08-28T15:45:00-04:00,1.08172,1.08199,1.08169,1.08179,1.080484669747024,1.0813306666666667,1.081141111111105,1.0809742222222152,1.080928000000004,1.0808305999999996,1.0806425000000022,1.0801404500000056,1.0812795859209703,1.0810427968905905,1565,-414722,-417130,0.019613103773845845,-353.31666120730415,0.07770942226744547
2023-08-28T16:00:00-04:00,1.08179,1.08182,1.08151,1.0816999999999999,1.0806050961672622,1.0814424444444446,1.0812366666666604,1.081053999999993,1.080988000000004,1.0808365999999996,1.0806512000000021,1.0801393500000054,1.0813636687367763,1.081143037512472,-823,-415545,-416663,0.02148433542190355,-353.38513105819953,0.07956774360681144
2023-08-28T16:15:00-04:00,1.0816999999999999,1.08177,1.08165,1.08172,1.0807158884738812,1.0815391111111112,1.0813566666666605,1.0811497777777708,1.0810490000000041,1.0808531999999995,1.0806592000000022,1.0801417500000055,1.081434934989421,1.0812480300099772,640,-414905,-415814,0.02424952029576951,-353.37329783272105,0.09994077583653851
2023-08-28T16:30:00-04:00,1.08172,1.08176,1.08166,1.0816999999999999,1.0808178173959708,1.0816077777777777,1.0814555555555492,1.0812475555555485,1.081099000000004,1.0808755999999995,1.0806687000000021,1.0801446500000054,1.0814879479915367,1.0813436240079812,-387,-415292,-415350.2,0.02876752876770898,-353.3804531039558,0.08234564817126372
2023-08-28T16:45:00-04:00,1.0816999999999999,1.08195,1.08168,1.08188,1.080911592004293,1.0816926666666666,1.0815744444444382,1.081352888888882,1.0811485000000038,1.0809059999999995,1.0806847000000024,1.0801495500000053,1.0815663583932293,1.0814264992063847,603,-414689,-415030.6,0.033465674999928835,-353.2801110497818,0.09899982420591077
2023-08-28T17:00:00-04:00,1.08188,1.08188,1.081,1.08174,1.0809978646439498,1.0817257777777778,1.081639999999994,1.0814526666666595,1.081193500000004,1.0809261999999995,1.0807053000000024,1.0801542000000055,1.0816010867145835,1.0814907993651073,-279,-414968,-415079.8,0.03832244499066995,-353.31621486905937,0.0545715210655199
2023-08-28T17:15:00-04:00,1.08174,1.08179,1.08124,1.08172,1.081,1.0817417777777778,1.0817088888888826,1.081547111111104,1.0812500000000038,1.0809593999999996,1.0807301000000022,1.0801574500000055,1.0816248693716668,1.0815430394920853,-408,-415376,-415046,0.039717091694345535,-353.32375827135564,0.05734899639256914
2023-08-28T17:30:00-04:00,1.08172,1.0818,1.08157,1.0818,1.081,1.0817599999999998,1.081752222222216,1.081626222222215,1.0812910000000038,1.0809851999999995,1.0807554000000024,1.0801635000000054,1.0816598954973335,1.0815880315936677,410,-414966,-415058.2,0.04086000669420844,-353.2934361917047,0.036064027519637554
2023-08-28T17:45:00-04:00,1.0818,1.0823099999999999,1.0816,1.08192,1.0810792,1.0817935555555556,1.0817744444444382,1.081689999999993,1.0813500000000038,1.0810185999999995,1.0807800000000023,1.0801701500000054,1.0817119163978668,1.0816328252749339,846,-414120,-414823.8,0.04143521107799153,-353.1995925976948,0.018489072957879854
2023-08-28T18:00:00-04:00,1.08192,1.08232,1.08191,1.08217,1.08120228,1.0818726666666667,1.0818166666666604,1.0817384444444373,1.0814280000000038,1.0810499999999994,1.0808060000000024,1.0801773500000056,1.0818035331182934,1.0816802602199467,326,-413794,-414644.8,0.03929690076757686,-353.1242635530334,0.035126965492382714
2023-08-28T18:15:00-04:00,1.08217,1.08273,1.08215,1.08238,1.0813364064,1.0819853333333331,1.081892222222216,1.0817888888888816,1.0814975000000038,1.0810823999999994,1.0808341000000024,1.0801853500000056,1.0819188264946347,1.081743808175957,540,-413254,-414302,0.03695575788602345,-353.0194741022078,0.06286401035407359
2023-08-28T18:30:00-04:00,1.08238,1.08245,1.0822,1.08227,1.081531509504,1.082060888888889,1.081953333333327,1.0818377777777706,1.0815635000000037,1.0811053999999993,1.0808612000000024,1.0801926500000056,1.0819890611957077,1.081816646540765,-243,-413497,-413926.2,0.03658823311872248,-353.0441696804705,0.05084495063417987
2023-08-28T18:45:00-04:00,1.08227,1.0826,1.0822,1.08258,1.08169929817344,1.0821862222222225,1.0820511111111049,1.0818975555555483,1.0816505000000038,1.0811253999999995,1.0808911000000025,1.0802004000000054,1.0821072489565662,1.0819061172326117,300,-413197,-413572.4,0.03736046509088974,-352.9582391825356,0.08135342516411334
2023-08-28T19:00:00-04:00,1.08258,1.0829,1.08252,1.0829,1.0818435964291584,1.0823559999999999,1.0821644444444383,1.0819755555555486,1.0817635000000039,1.0811465999999994,1.0809210000000025,1.0802094000000055,1.082265799165253,1.0820168937860886,507,-412690,-413286.4,0.03938208946961878,-352.80837496926733,0.0942803268384683
2023-08-28T19:15:00-04:00,1.0829,1.08296,1.08271,1.0829,1.082012621000493,1.082503111111111,1.0822933333333271,1.082070888888882,1.0818680000000038,1.0811809999999995,1.0809540000000026,1.0802182000000056,1.0823926393322023,1.0821347150288705,0,-412690,-413065.6,0.03885876371221613,-352.80837496926733,0.10723464048662802
2023-08-28T19:30:00-04:00,1.0829,1.08298,1.08241,1.08243,1.0821831492204042,1.0825304444444446,1.082372222222216,1.082166888888882,1.0819490000000038,1.0812091999999993,1.0809828000000026,1.0802241500000056,1.0824001114657618,1.082230972023096,-852,-413542,-413123.2,0.03810334514555657,-353.17815980627904,0.06563620900047965
2023-08-28T19:45:00-04:00,1.08243,1.08271,1.08242,1.08255,1.0823425193763234,1.0825660000000001,1.0824555555555493,1.0822673333333264,1.0820190000000038,1.0812451999999995,1.0810137000000026,1.0802305000000054,1.0824300891726093,1.0823191776184764,541,-413001,-413024,0.03811363055234134,-353.1181836415386,0.06932889628395325
2023-08-28T20:00:00-04:00,1.08255,1.08313,1.08255,1.08308,1.08241,1.0826908888888889,1.0825844444444381,1.0823739999999928,1.0821180000000037,1.0812895999999994,1.0810455000000025,1.0802407000000056,1.0825600713380874,1.0824097420947805,1290,-411711,-412726.8,0.04144615300679023,-352.48661927961524,0.10721679976338823
2023-08-28T20:15:00-04:00,1.08308,1.08317,1.08267,1.08268,1.08242,1.08271,1.0826411111111045,1.0824693333333262,1.082181500000004,1.0813349999999995,1.0810733000000026,1.0802488500000056,1.08258405707047,1.082473393675824,-978,-412689,-412726.6,0.04151367830390184,-352.84781143531933,0.047127530794608095
2023-08-28T20:30:00-04:00,1.08268,1.08273,1.08252,1.08262,1.08317,1.0827057777777778,1.0826677777777711,1.082544222222215,1.082226500000004,1.0813751999999994,1.0811029000000025,1.0802576000000057,1.082591245656376,1.0825131149406588,-1043,-413732,-412935,0.04034541554382244,-352.9056124476223,0.022173358709512186
2023-08-28T20:45:00-04:00,1.08262,1.08274,1.08211,1.08237,1.08317,1.0826462222222224,1.0826788888888823,1.082605555555548,1.0822555000000038,1.0814105999999994,1.0811297000000026,1.0802658000000056,1.082546996525101,1.0825424919525264,-1472,-415204,-413267.4,0.03739181322587513,-353.2455285770119,0.009239838487622219
2023-08-28T21:00:00-04:00,1.08237,1.08286,1.08234,1.08277,1.0831275999999999,1.0826644444444444,1.0826999999999933,1.082654444444437,1.0823090000000037,1.0814521999999995,1.0811575000000027,1.0802811500000056,1.0825915972200808,1.0825747935620211,1028,-414176,-413502.4,0.0376981927044517,-352.8656215211992,0.01755066600158071
2023-08-28T21:15:00-04:00,1.08277,1.08316,1.08272,1.0830899999999999,1.08211,1.0827424444444445,1.0827211111111044,1.0826817777777702,1.0823775000000038,1.0814935999999995,1.0811871000000026,1.0802960000000055,1.0826912777760647,1.0826010348496165,1185,-412991,-413758.4,0.03629241062311538,-352.515408641271,0.017545479730345596
2023-08-28T21:30:00-04:00,1.0830899999999999,1.08357,1.08306,1.08345,1.082131,1.0828882222222223,1.0827822222222154,1.082709999999992,1.0824650000000038,1.0815479999999995,1.0812205000000028,1.0803144000000056,1.0828430222208518,1.0826528278796927,1699,-411292,-413479,0.033760063349749146,-351.95069102777603,0.050789546587870577
2023-08-28T21:45:00-04:00,1.08345,1.08369,1.08333,1.08349,1.0821885599999999,1.0830297777777778,1.0828999999999933,1.0827564444444366,1.0825455000000037,1.0816067999999994,1.0812530000000027,1.0803324000000054,1.0829724177766815,1.082729062303754,1415,-409877,-412708,0.031333593457015446,-351.89845049983285,0.09792781057436148
2023-08-28T22:00:00-04:00,1.08349,1.08355,1.08325,1.08327,1.0822786463999998,1.0831037777777779,1.0829799999999932,1.0828166666666588,1.0826220000000037,1.0816581999999995,1.0812809000000025,1.0803471000000056,1.0830319342213452,1.082826049843003,-1784,-411661,-411999.4,0.032976777697901194,-352.2606873455815,0.0665096300401879
2023-08-28T22:15:00-04:00,1.08327,1.08327,1.08294,1.08306,1.0823633276159998,1.083119777777778,1.082977777777771,1.0828722222222142,1.0826890000000038,1.0817053999999995,1.0813030000000026,1.0803637000000055,1.0830375473770761,1.082915239874402,-1303,-412964,-411757,0.03187965956341938,-352.51328365121174,-0.0018465856631210088
2023-08-28T22:30:00-04:00,1.08306,1.0833,1.08298,1.08323,1.08244292795904,1.0831702222222221,1.0830388888888818,1.0829357777777697,1.0827605000000038,1.0817641999999994,1.0813289000000026,1.0803822500000053,1.0830760379016608,1.0829921918995211,1178,-411786,-411516,0.02662179415866928,-352.32838161439014,0.05079986699669601
2023-08-28T22:45:00-04:00,1.08323,1.08357,1.08312,1.08355,1.0825177522814975,1.0832724444444446,1.0831422222222153,1.0830077777777698,1.0828420000000039,1.0818199999999996,1.0813619000000025,1.0804027500000055,1.0831708303213288,1.0830577535196166,1197,-410589,-411375.4,0.026958374159550262,-351.9747725009054,0.08590271748167386
2023-08-28T23:00:00-04:00,1.08355,1.08362,1.08329,1.08341,1.0825880871446076,1.0833259999999998,1.083257777777771,1.0830793333333255,1.0829040000000039,1.0818707999999997,1.0813897000000026,1.0804233500000056,1.083218664257063,1.083107002815693,-1130,-411719,-411743.8,0.027699783423848868,-352.1207740698224,0.09608544213161209
2023-08-28T23:15:00-04:00,1.08341,1.08383,1.08332,1.08376,1.082654201915931,1.0834264444444444,1.083367777777771,1.083156888888881,1.0829730000000037,1.0819349999999996,1.0814209000000026,1.0804449000000056,1.0833269314056504,1.083166002252554,1019,-410700,-411551.6,0.03354170111143911,-351.7915819818778,0.09143216010787576
2023-08-28T23:30:00-04:00,1.08376,1.08379,1.08355,1.0836,1.0827482657626566,1.083472888888889,1.0834244444444379,1.0832462222222143,1.083039500000004,1.0819969999999994,1.0814484000000026,1.0804681500000055,1.0833815451245203,1.083234801802043,-998,-411698,-411298.4,0.03583950444683432,-351.9389208760981,0.047087499653769356
2023-08-28T23:45:00-04:00,1.0836,1.08369,1.08354,1.08364,1.082834804501644,1.083516,1.083445555555549,1.0833275555555477,1.0830925000000038,1.0820597999999995,1.0814761000000026,1.0804919000000055,1.0834332360996162,1.083306241441634,568,-411130,-411167.2,0.034892059286811994,-351.91795372954954,0.01753657298443975
2023-08-29T00:00:00-04:00,1.08364,1.08364,1.08321,1.08321,1.0829144201415126,1.083468888888889,1.0834144444444378,1.0833819999999923,1.083108000000004,1.0821099999999995,1.0815000000000026,1.0805153000000056,1.083388588879693,1.0833497931533067,-969,-412099,-411469.2,0.029905394841989803,-352.302463345289,-0.025842416635138116
2023-08-29T00:15:00-04:00,1.08321,1.08325,1.08307,1.08318,1.0829876665301916,1.083422,1.0834044444444377,1.0834113333333257,1.0831220000000037,1.0821557999999996,1.0815238000000025,1.0805374500000056,1.0833468711037544,1.0833754345226452,-790,-412889,-411703.2,0.025811880587598396,-352.32434275925306,-0.008308178016553903
2023-08-29T00:30:00-04:00,1.08318,1.08319,1.08264,1.08266,1.08383,1.0832731111111111,1.0833599999999932,1.0834097777777703,1.0831335000000037,1.0821921999999995,1.0815414000000023,1.0805576500000056,1.0832094968830035,1.0833519476181155,-633,-413522,-412267.6,0.02123534299715379,-352.62822577038696,-0.036932395250489906
2023-08-29T00:45:00-04:00,1.08266,1.08268,1.0824,1.08242,1.0838062000000002,1.083085111111111,1.0832699999999933,1.0833788888888811,1.083127000000004,1.0822287999999995,1.0815560000000024,1.0805768500000055,1.0830515975064028,1.0832859580944922,-842,-414364,-412800.8,0.015370350260402059,-352.8148771660236,-0.07477636328388038
2023-08-29T01:00:00-04:00,1.08242,1.0826,1.0823099999999999,1.0824,1.0837499520000002,1.0829111111111112,1.0831422222222153,1.0833182222222146,1.0830930000000039,1.0822571999999995,1.0815692000000026,1.0805963000000056,1.0829212780051223,1.083183566475593,-1265,-415629,-413700.6,0.00836669606533515,-352.83825071787953,-0.10613261962991873
2023-08-29T01:15:00-04:00,1.0824,1.08241,1.08216,1.08218,1.0836635548800002,1.0827186666666668,1.083005555555549,1.0832364444444367,1.083068000000004,1.0822859999999996,1.0815821000000025,1.0806152500000055,1.082773022404098,1.0830604531804744,-1312,-416941,-414669,-0.0003253599622218556,-353.10491738454635,-0.11353042707747431
2023-08-29T01:30:00-04:00,1.08218,1.08239,1.0821,1.08222,1.0835432704896002,1.0825615555555557,1.0828344444444378,1.0831224444444367,1.0830480000000038,1.0823181999999996,1.0815976000000025,1.0806350500000055,1.0826624179232782,1.0829235625443792,1362,-415579,-415207,-0.009290533855952408,-353.05457455802946,-0.1420978814497764
2023-08-29T01:45:00-04:00,1.08222,1.08247,1.08207,1.08216,1.0833989434406401,1.0824266666666666,1.0826744444444376,1.0829853333333257,1.0830375000000037,1.0823415999999997,1.0816117000000025,1.0806556500000055,1.0825619343386226,1.082794050035503,-1575,-417154,-415933.4,-0.022041830672085903,-353.1418950658744,-0.13289036544849445
2023-08-29T02:00:00-04:00,1.08216,1.08232,1.08202,1.08226,1.0832394702277632,1.0823437777777778,1.0825211111111044,1.0828355555555478,1.0830120000000039,1.0823677999999994,1.0816251000000026,1.0806769500000055,1.082501547470898,1.082684040028402,1838,-415316,-416123.8,-0.03393130460721,-352.97204957167764,-0.12734856594440377
2023-08-29T02:15:00-04:00,1.08226,1.08234,1.08155,1.08178,1.0830687443958764,1.0821955555555556,1.0823622222222153,1.0826795555555477,1.0829465000000038,1.0823865999999995,1.0816338000000025,1.0806963000000054,1.0823572379767186,1.0825712320227212,-1907,-417223,-416442.6,-0.04675486170510571,-353.81783524240376,-0.13201502940335136
2023-08-29T02:30:00-04:00,1.08178,1.08202,1.08157,1.08157,1.0828257452925363,1.082037111111111,1.0821833333333266,1.0825151111111033,1.0828525000000038,1.0824051999999995,1.0816369000000026,1.0807151000000055,1.082199790381375,1.0824565856181767,-1806,-419029,-416860.2,-0.055218662738072126,-354.16842408671596,-0.14863642238594799
2023-08-29T02:45:00-04:00,1.08157,1.08166,1.08082,1.08087,1.0826216260457304,1.0817744444444446,1.0819844444444378,1.0823451111111033,1.082721500000004,1.0824063999999995,1.0816355000000026,1.0807282000000056,1.0819338323051,1.082310868494541,-2458,-421487,-418041.8,-0.0652126491778916,-355.75925963134074,-0.1653335303788778
2023-08-29T03:00:00-04:00,1.08087,1.08144,1.08085,1.08143,1.082297333357499,1.0816635555555556,1.0818744444444377,1.0821851111111034,1.082629500000004,1.0824187999999997,1.0816348000000024,1.0807448000000055,1.08183306584408,1.0821650947956325,2882,-418605,-418332,-0.06751888866288532,-354.26609209037866,-0.09146172465402029
2023-08-29T03:15:00-04:00,1.08143,1.08255,1.08135,1.08238,1.08082,1.0817646666666667,1.0818722222222155,1.0820553333333254,1.082595500000004,1.0824433999999996,1.0816438000000026,1.0807656500000056,1.081942452675264,1.0820532758365058,2576,-416029,-418474.6,-0.06397633249550826,-352.0031624509198,-0.0018477457501968795
2023-08-29T03:30:00-04:00,1.08238,1.08298,1.08229,1.08289,1.08085,1.0819682222222222,1.0819511111111044,1.0819731111111035,1.0825785000000039,1.0824791999999996,1.0816547000000023,1.0807880500000056,1.082131962140211,1.0820082206692043,2748,-413281,-417686.2,-0.05870295758023382,-350.7083491690779,0.06560830915374415
2023-08-29T03:45:00-04:00,1.08289,1.08296,1.08162,1.08205,1.0809352,1.081988,1.0819322222222156,1.0819228888888812,1.0825035000000036,1.0824919999999996,1.0816592000000025,1.0808033000000057,1.0821155697121687,1.0819913765353628,-3157,-416438,-417168,-0.05471631882627044,-353.1572405615553,-0.015708451146717255
2023-08-29T04:00:00-04:00,1.08205,1.08228,1.08119,1.08132,1.0810169920000001,1.0818655555555554,1.0818388888888821,1.0818937777777702,1.0823990000000037,1.0824839999999996,1.0816542000000025,1.0808159500000054,1.081956455769735,1.0819959012282898,-2959,-419397,-416750,-0.05322595758530335,-355.15351614955927,-0.07762253271234863
2023-08-29T04:15:00-04:00,1.08132,1.08151,1.08082,1.08102,1.08298,1.0817017777777778,1.0817011111111043,1.0818591111111036,1.082262000000004,1.0824685999999994,1.0816496000000024,1.0808259500000055,1.081769164615788,1.0819831209826316,-2572,-421969,-417422.8,-0.05324915306411688,-355.86708845008076,-0.11457505590153086
2023-08-29T04:30:00-04:00,1.08102,1.08145,1.08084,1.08144,1.0829368000000001,1.0816495555555556,1.0816633333333265,1.0818173333333259,1.082154000000004,1.0824633999999995,1.0816500000000024,1.0808408000000054,1.0817033316926306,1.081935296786105,2453,-419516,-418120.2,-0.05062332025593182,-354.91404410307547,-0.03142968071142071
2023-08-29T04:45:00-04:00,1.08144,1.08163,1.08093,1.08101,1.0828944640000002,1.081518888888889,1.0816011111111044,1.0817473333333258,1.0820225000000039,1.0824491999999994,1.0816512000000025,1.0808554000000052,1.0815646653541044,1.0818218374288835,-2601,-422117,-419887.4,-0.046347290474314656,-355.94824849721647,-0.051776584039858166
2023-08-29T05:00:00-04:00,1.08101,1.08132,1.08057,1.08093,1.0828529747200002,1.0813846666666667,1.081607777777771,1.081682444444437,1.081908500000004,1.0824337999999996,1.0816547000000023,1.0808651000000054,1.0814377322832835,1.0816862699431065,-2508,-424625,-421524.8,-0.04034085957783198,-356.133852700693,0.005551083849116821
2023-08-29T05:15:00-04:00,1.08093,1.08107,1.08055,1.08079,1.0827616557312,1.0812211111111112,1.08153666666666,1.0816219999999928,1.081789000000004,1.0824119999999997,1.0816590000000026,1.0808764500000054,1.081308185826627,1.081556615954485,-2356,-426981,-423041.6,-0.030432731075503594,-356.4389973446571,-0.059180899364727625
2023-08-29T05:30:00-04:00,1.08079,1.08108,1.0807,1.08085,1.0826289563873281,1.0810837777777778,1.0813666666666597,1.0815551111111037,1.081698500000004,1.0823941999999998,1.0816602000000024,1.0808886000000053,1.0812165486613015,1.0814460927635876,2062,-424919,-423631.6,-0.02554076022699525,-356.3245255231188,-0.14135516177311197
2023-08-29T05:45:00-04:00,1.08085,1.0816,1.08075,1.08135,1.0825042190040886,1.0810804444444444,1.0811955555555486,1.081461555555548,1.081645000000004,1.0823867999999996,1.0816731000000024,1.0809098000000052,1.0812432389290412,1.0813540742108696,2419,-422500,-424228.4,-0.02929740809265435,-355.2054988311635,-0.14221204369787097
2023-08-29T06:00:00-04:00,1.08135,1.08162,1.08104,1.08134,1.0823869658638432,1.0811093333333335,1.0811166666666598,1.0813646666666592,1.0815920000000039,1.0823775999999996,1.0816814000000023,1.0809276000000052,1.081262591143233,1.0812936593686953,-2229,-424729,-424750.8,-0.03887429207382649,-355.2261119536494,-0.06561619148837747
2023-08-29T06:15:00-04:00,1.08134,1.08147,1.08082,1.08098,1.0822767479120126,1.081082,1.081078888888882,1.0812588888888814,1.081532000000004,1.0823587999999997,1.0816887000000022,1.0809434500000052,1.0812060729145865,1.0812473274949561,-2414,-427143,-425254.4,-0.04251783794329785,-356.02978147479894,-0.0314430510857107
2023-08-29T06:30:00-04:00,1.08098,1.08127,1.08089,1.08102,1.0821731430372918,1.0810702222222222,1.081078888888882,1.0811673333333258,1.081472000000004,1.0823357999999996,1.0816929000000024,1.0809559000000055,1.0811688583316692,1.0812194619959645,2076,-425067,-424871.6,-0.04018640645356674,-355.9529622922053,0
2023-08-29T06:45:00-04:00,1.08102,1.08111,1.0804,1.08066,1.0820757544550543,1.0809864444444444,1.0809922222222152,1.081092444444437,1.081397000000004,1.0823013999999997,1.0816919000000023,1.0809660500000056,1.0810670866653354,1.0811895695967713,-2313,-427380,-425363.8,-0.03664889190250594,-356.72323481260304,-0.07212605415002246
2023-08-29T07:00:00-04:00,1.08066,1.0811,1.08037,1.08089,1.08194169409865,1.080966,1.080978888888882,1.0810491111111036,1.081328500000004,1.0822737999999998,1.0816896000000025,1.0809751500000053,1.0810316693322684,1.0811472556774167,2369,-425011,-425866,-0.03614453056342511,-356.21903367626055,-0.01110072987300025
2023-08-29T07:15:00-04:00,1.08089,1.08112,1.08056,1.08062,1.081784524688785,1.0808942222222222,1.0809444444444376,1.081014666666659,1.081270500000004,1.0822345999999998,1.0816800000000024,1.0809828500000054,1.0809493354658146,1.081084604541933,-2013,-427024,-426325,-0.032531546175260176,-356.7218693024575,-0.028679007891355822
2023-08-29T07:30:00-04:00,1.08062,1.08121,1.08062,1.08102,1.0816430722199064,1.0809093333333333,1.080969999999993,1.0809928888888813,1.081243000000004,1.0821969999999999,1.0816718000000025,1.0809937500000055,1.0809634683726517,1.081036083633546,2230,-424794,-425855.2,-0.0283532021544322,-355.8964172471555,0.02128072983652463
2023-08-29T07:45:00-04:00,1.08102,1.08117,1.08037,1.08041,1.0815157649979157,1.0807973333333334,1.0809211111111043,1.080961333333326,1.081220000000004,1.0821471999999996,1.0816641000000022,1.0810008500000055,1.0808527746981214,1.0809728669068366,-2784,-427578,-426357.4,-0.026760307188372297,-357.4673780064384,-0.04070870148494203
2023-08-29T08:00:00-04:00,1.08041,1.08063,1.07967,1.08011,1.081401188498124,1.080635111111111,1.0807833333333265,1.0809195555555482,1.081154000000004,1.0821007999999996,1.0816550000000023,1.0810028500000053,1.080704219758497,1.080900293525469,-2794,-430372,-426955.8,-0.030258305508249574,-358.243194594586,-0.11467147547048873
2023-08-29T08:15:00-04:00,1.08011,1.08027,1.0786,1.07887,1.0811934458783492,1.0802524444444441,1.080508888888882,1.080825555555548,1.080978500000004,1.0820271999999997,1.0816362000000024,1.0809990500000055,1.0803373758067976,1.0807614348203747,-3871,-434243,-428802.2,-0.041925913853001616,-362.6872234434992,-0.22842029333974256
2023-08-29T08:30:00-04:00,1.07887,1.07976,1.07869,1.07959,1.0808303634553804,1.0800686666666668,1.0803544444444375,1.080707555555548,1.080813500000004,1.0819573999999996,1.081623500000002,1.0809982500000055,1.080187900645438,1.0806091478562994,4036,-430207,-429438.8,-0.04582988974022224,-359.99373859360975,-0.12858702288664012
2023-08-29T08:45:00-04:00,1.07959,1.07982,1.07902,1.07923,1.0805181125716272,1.079843777777778,1.0801555555555487,1.080544666666659,1.0806725000000041,1.0818883999999998,1.0816117000000023,1.0809930000000054,1.0799963205163503,1.0804157182850394,-3566,-433773,-431234.6,-0.0459033729151303,-361.1828566847374,-0.16558435551610332
2023-08-29T09:00:00-04:00,1.07923,1.07965,1.07836,1.07836,1.0802495768115994,1.0794846666666666,1.0798999999999932,1.0803404444444369,1.080524500000004,1.0818031999999997,1.0815892000000025,1.0809810500000054,1.0796690564130802,1.080178974628031,-5559,-439332,-433585.4,-0.05426627492453576,-365.6641350035384,-0.21283289841392936
2023-08-29T09:15:00-04:00,1.07836,1.07888,1.0782,1.07843,1.0799472445217435,1.0791906666666666,1.0796266666666599,1.0801091111111036,1.0803950000000042,1.0817243999999997,1.0815675000000025,1.0809708000000056,1.0794212451304641,1.0799223797024244,3361,-435971,-434705.2,-0.06217572277548447,-365.44596110984793,-0.22759022657253808
2023-08-29T09:30:00-04:00,1.07843,1.07975,1.07836,1.07961,1.0782,1.0791873333333335,1.0795144444444373,1.0799102222222146,1.080303500000004,1.0816611999999999,1.0815567000000024,1.0809678500000055,1.0794589961043712,1.079746703761939,5399,-430572,-433971,-0.06781264228626038,-359.5384659548543,-0.0934648627639647
2023-08-29T09:45:00-04:00,1.07961,1.0806499999999999,1.07957,1.08035,1.0782,1.0793544444444443,1.0794399999999933,1.079727333333326,1.0802705000000041,1.0816063999999996,1.0815500000000025,1.0809684000000055,1.079637196883497,1.0796365630095508,5080,-425492,-433028,-0.06551055653538577,-356.0564678259005,-0.06197850178536664
2023-08-29T10:00:00-04:00,1.08035,1.08504,1.08035,1.0836,1.078298,1.0801864444444444,1.0797944444444374,1.0796551111111037,1.0804040000000041,1.0816093999999998,1.0815787000000023,1.0809815000000054,1.0804297575067976,1.0797232504076404,19267,-406225,-427518.4,-0.05303889416043918,-298.0958532102671,0.29525828157827155
2023-08-29T10:15:00-04:00,1.0836,1.0848,1.08335,1.08456,1.07870252,1.0811395555555556,1.080288888888882,1.0797328888888815,1.080592500000004,1.0816308,1.0816188000000024,1.0809997500000055,1.081255806005438,1.0800406003261118,10550,-395675,-418787,-0.030622263429711673,-288.7492308403882,0.4119950745757437
2023-08-29T10:30:00-04:00,1.08456,1.08461,1.08265,1.08283,1.0790827688,1.0816477777777778,1.0807288888888822,1.079953333333326,1.0806915000000041,1.0816219999999999,1.0816401000000022,1.0810068500000054,1.0815706448043505,1.0804704802608893,-8985,-404660,-412524.8,-0.014439507408601702,-303.08135631062504,0.36705071046557636
2023-08-29T10:45:00-04:00,1.08283,1.08355,1.08227,1.08279,1.079440202672,1.08206,1.0810844444444376,1.080267333333326,1.080763500000004,1.0816165999999998,1.0816610000000024,1.0810144500000056,1.0818145158434804,1.080941584208711,-8299,-412959,-409002.2,0.013283916283789063,-303.38792336177835,0.29640882186754874
2023-08-29T11:00:00-04:00,1.08279,1.08461,1.08259,1.08458,1.07977619051168,1.0827591111111112,1.081678888888882,1.080715111111104,1.0809255000000042,1.0816435999999998,1.0817039000000026,1.0810336000000056,1.0823676126747843,1.0814876673669684,6485,-406474,-405198.6,0.045216157816213694,-292.6673311878562,0.4957238030818443
2023-08-29T11:15:00-04:00,1.08458,1.0847499999999999,1.08402,1.0846,1.0800920190809793,1.0833433333333333,1.0823722222222154,1.0812306666666598,1.081106500000004,1.0816645999999996,1.0817423000000026,1.0810544500000054,1.0828140901398275,1.0819645338935744,4456,-402018,-404357.2,0.08052200777798257,-292.5851611312448,0.5786564783560243
2023-08-29T11:30:00-04:00,1.0846,1.08569,1.08443,1.08539,1.0803888979361205,1.0839468888888888,1.083145555555549,1.081801999999993,1.081325000000004,1.0817042,1.0817875000000023,1.0810812500000053,1.0833292721118621,1.0823792271148593,4323,-397695,-404761.2,0.1260991953328275,-289.43637816978406,0.6453826395779121
2023-08-29T11:45:00-04:00,1.08539,1.08557,1.08483,1.085,1.0808129861012308,1.0843177777777777,1.0837444444444377,1.0824051111111044,1.081542000000004,1.081729,1.0818320000000026,1.0811024000000053,1.0836634176894897,1.082797781691887,-4184,-401879,-404205,0.16930189551568514,-290.93976404951434,0.4992543603708752
2023-08-29T12:00:00-04:00,1.085,1.08558,1.08496,1.08516,1.0812031472131323,1.084600888888889,1.0842788888888821,1.083043999999993,1.081755500000004,1.0817601999999997,1.0818786000000025,1.0811125000000055,1.0839627341515918,1.0832274253535092,3440,-398439,-401301,0.20076597992622708,-290.4324829435237,0.4452260841393975
2023-08-29T12:15:00-04:00,1.08516,1.08519,1.08466,1.085,1.0815620954360816,1.084745111111111,1.0844344444444376,1.083595111111104,1.081974500000004,1.0817873999999998,1.0819236000000025,1.0811423000000056,1.0841701873212735,1.0835879402828072,-2846,-401285,-400263.2,0.2256195062437644,-290.85210769931996,0.129198966408275
2023-08-29T12:30:00-04:00,1.085,1.08533,1.08481,1.08528,1.0818923278011952,1.0849142222222221,1.0845144444444377,1.0840235555555484,1.082187500000004,1.0818287999999998,1.0819694000000024,1.0811801000000054,1.0843921498570188,1.0839035522262452,2369,-398916,-399642.8,0.22059189157929335,-290.24075286061014,0.06638636866563896
2023-08-29T12:45:00-04:00,1.08528,1.08641,1.08523,1.08629,1.0821961415770995,1.0852693333333332,1.0848988888888822,1.0843742222222152,1.082481500000004,1.0818909999999997,1.0820234000000024,1.0812258500000056,1.084771719885615,1.084192041780996,2645,-396271,-399358,0.21333882386499448,-287.7792221957127,0.3195330753673262
2023-08-29T13:00:00-04:00,1.08629,1.08741,1.08626,1.08729,1.0826175274193897,1.0857475555555556,1.0853988888888821,1.0847051111111041,1.082840500000004,1.0819835999999998,1.0820879000000025,1.0812730000000057,1.085275375908492,1.0845144334247965,3949,-392322,-397446.6,0.22420802817637517,-284.14391302412827,0.4155930512841983
2023-08-29T13:15:00-04:00,1.08729,1.08741,1.08684,1.0869199999999999,1.0831926241290628,1.0860517777777778,1.085658888888882,1.084981111111104,1.0832430000000042,1.0820735999999997,1.0821512000000026,1.0813148500000056,1.0856043007267937,1.084842746739837,-3146,-395468,-396852.4,0.2323321636338594,-285.21448297326845,0.21575171955962552
2023-08-29T13:30:00-04:00,1.0869199999999999,1.08764,1.08683,1.08747,1.0836987092335753,1.086414,1.0859777777777708,1.085289777777771,1.0836370000000042,1.0821749999999997,1.0822161000000026,1.0813572500000057,1.0859774405814349,1.0852041973918691,2495,-392973,-395190,0.221120210545653,-283.951970552851,0.2646136824635744
2023-08-29T13:45:00-04:00,1.08747,1.08768,1.08705,1.08734,1.0842504899408747,1.0866864444444444,1.0861944444444376,1.085625777777771,1.0840425000000042,1.0822781999999997,1.0822821000000027,1.0814008500000056,1.0862499524651479,1.0855757579134948,-2627,-395600,-394526.8,0.2122751765373755,-284.2660113999547,0.1796589244418961
2023-08-29T14:00:00-04:00,1.08734,1.08735,1.08666,1.08686,1.0847992115503347,1.0868195555555555,1.0864011111111043,1.0859262222222152,1.0844675000000041,1.0823709999999997,1.0823446000000025,1.0814379000000054,1.0863719619721184,1.0858958063307955,-2280,-397880,-394848.6,0.192250340504368,-285.2725043092564,0.17142857142856893
2023-08-29T14:15:00-04:00,1.08686,1.08689,1.08603,1.08621,1.085260137702281,1.0867813333333332,1.0865177777777708,1.0861499999999928,1.084856500000004,1.0824519999999997,1.0823968000000026,1.0814705500000057,1.0863395695776947,1.0861086450646362,-1664,-399544,-396293,0.16887400353733728,-286.26766467949733,0.09675992480371516
2023-08-29T14:30:00-04:00,1.08621,1.08676,1.08615,1.08667,1.085647315669916,1.0868117777777775,1.0867033333333265,1.0863588888888818,1.0852095000000042,1.0825401999999997,1.0824540000000027,1.0815060000000054,1.0864056556621557,1.0862689160517083,1462,-398082,-396815.8,0.14656466436698273,-285.6485210516536,0.1539170506912498
2023-08-29T14:45:00-04:00,1.08667,1.0872,1.08666,1.08717,1.0859725451627293,1.0869051111111112,1.0869133333333265,1.0865459999999931,1.085550500000004,1.0826479999999998,1.0825173000000026,1.0815437000000054,1.0865585245297247,1.0863851328413665,2206,-395876,-397396.4,0.13334000252746883,-284.63349349038856,0.17414860681114064
2023-08-29T15:00:00-04:00,1.08717,1.0881399999999999,1.08694,1.0881,1.08615,1.0871424444444444,1.0871144444444376,1.086729999999993,1.0857755000000042,1.0827785999999997,1.0825919000000026,1.0815835500000055,1.0868668196237798,1.0865085062730928,2709,-393167,-396909.8,0.12527682001640184,-282.3161282209272,0.16662217271631788
2023-08-29T15:15:00-04:00,1.0881,1.0891899999999999,1.08809,1.08884,1.0865082,1.0874875555555557,1.0872866666666599,1.086907111111104,1.0859895000000042,1.0829379999999997,1.0826722000000026,1.0816282000000053,1.0872614556990239,1.0866864050184741,2700,-390467,-395427.2,0.12575232357004795,-280.47989993308613,0.1425562637382796
2023-08-29T15:30:00-04:00,1.08884,1.08902,1.08839,1.08861,1.08694,1.0877522222222225,1.0874744444444377,1.0870984444444376,1.0862785000000041,1.0830815999999999,1.0827502000000027,1.0816745000000054,1.0875311645592192,1.086924724014779,-1539,-392006,-393919.6,0.12012679539137971,-280.80498901871846,0.15548522430355421
2023-08-29T15:45:00-04:00,1.08861,1.08872,1.08844,1.08853,1.08739,1.0879633333333334,1.0875922222222156,1.0872762222222154,1.0865655000000043,1.0832045999999997,1.082824000000003,1.0817177500000055,1.0877309316473753,1.0871897792118228,-1825,-393831,-393069.4,0.10993201572731941,-280.9391050014856,0.09747395330446458
2023-08-29T16:00:00-04:00,1.08853,1.08853,1.08827,1.08842,1.08775,1.088128888888889,1.0877122222222155,1.0874359999999932,1.086757500000004,1.0833151999999997,1.0828972000000028,1.0817576000000053,1.0878687453179003,1.0874518233694581,-1014,-394845,-392863.2,0.09397569559345305,-281.0415734681333,0.09932495815476024
2023-08-29T16:15:00-04:00,1.08842,1.08851,1.08827,1.08829,1.088038,1.0882444444444446,1.0878711111111043,1.0875873333333268,1.0869420000000043,1.0834399999999997,1.0829660000000028,1.0817938000000056,1.0879529962543202,1.087669058695566,-623,-395468,-393323.4,0.08644621494413626,-281.1159840816832,0.13157168356550453
2023-08-29T16:30:00-04:00,1.08829,1.08832,1.08787,1.0879,1.0891899999999999,1.0882502222222223,1.0880588888888822,1.0877417777777711,1.0870675000000043,1.0835715999999997,1.0830278000000026,1.0818298000000055,1.087942397003456,1.0878052469564525,-477,-395945,-394419,0.08154471466377237,-281.2869219750756,0.1555868570534419
2023-08-29T16:45:00-04:00,1.0879,1.08806,1.08781,1.08798,1.0891635999999998,1.0882344444444445,1.0882044444444379,1.0878877777777711,1.0872165000000042,1.0837107999999998,1.0830897000000028,1.0818661000000054,1.087949917602765,1.0878889975651616,813,-395132,-395044.2,0.08647209532669091,-281.2271370683747,0.12055177744852828
2023-08-29T17:00:00-04:00,1.08798,1.08798,1.08715,1.0876,1.0891094559999999,1.0881135555555554,1.0882522222222155,1.0880197777777711,1.0873385000000044,1.0838339999999997,1.0831487000000026,1.0818999500000053,1.0878799340822118,1.087918798052129,-357,-395489,-395375.8,0.08362849745965557,-281.3518268604665,0.039552231941640266
2023-08-29T17:15:00-04:00,1.0876,1.08793,1.08759,1.08775,1.0889918886399998,1.088013111111111,1.0882133333333266,1.0881199999999933,1.0874760000000043,1.0839687999999996,1.0832090000000028,1.0819341000000053,1.0878539472657696,1.087915838441703,403,-395086,-395424,0.07761056505693899,-281.29624576447526,-0.03216616119842592
2023-08-29T17:30:00-04:00,1.08775,1.08788,1.08749,1.08779,1.0888813753215998,1.0879284444444446,1.08809666666666,1.0881651111111046,1.0876015000000046,1.0841059999999998,1.0832699000000028,1.0819693000000052,1.0878411578126157,1.0878934707533618,183,-394903,-395311,0.06253363465330075,-281.2895162770011,-0.09643290106902716
2023-08-29T17:45:00-04:00,1.08779,1.08793,1.08773,1.08785,1.0887774928023037,1.087879111111111,1.0880122222222157,1.088155777777771,1.0876795000000044,1.0842471999999999,1.0833296000000028,1.0820071500000055,1.0878429262500926,1.087873576602689,277,-394626,-395047.2,0.042171850290130125,-281.27423759269624,-0.06981379924859168
2023-08-29T18:00:00-04:00,1.08785,1.08826,1.08778,1.08821,1.0886798432341656,1.0879186666666667,1.08797666666666,1.0881102222222154,1.0877255000000043,1.0843943999999999,1.0833943000000028,1.0820498000000054,1.087916341000074,1.087866861282151,415,-394211,-394863,0.030085194687123083,-281.13690248215715,-0.029397444259698674
2023-08-29T18:15:00-04:00,1.08821,1.08822,1.08801,1.08817,1.0885880526401157,1.0879573333333332,1.0879488888888824,1.0880495555555487,1.0877880000000044,1.0845307999999998,1.083458800000003,1.0820944500000054,1.0879670728000592,1.0878842890257203,-242,-394453,-394655.8,0.022922003898169657,-281.1457978240488,-0.02296907443816371
2023-08-29T18:30:00-04:00,1.08817,1.08817,1.088,1.08809,1.0885017694817087,1.0879855555555555,1.08792666666666,1.0879922222222156,1.0878190000000045,1.0846657999999998,1.0835217000000028,1.0821385500000054,1.0879916582400473,1.087911831220576,-288,-394741,-394586.8,0.014765462039226341,-281.16697098633045,-0.01837745453876981
2023-08-29T18:45:00-04:00,1.08809,1.08848,1.08809,1.08845,1.08715,1.0880902222222224,1.0879877777777711,1.0879704444444376,1.0878745000000045,1.0848151999999998,1.0835870000000027,1.0821835000000055,1.0880833265920378,1.0879602649764604,411,-394330,-394472.2,0.011945810058738553,-281.03098958773296,0.05055611729017634
2023-08-29T19:00:00-04:00,1.08845,1.0885,1.08821,1.08823,1.0871766,1.0881386666666666,1.088015555555549,1.0879711111111043,1.0879430000000045,1.0849593999999998,1.0836476000000028,1.0822268000000053,1.0881126612736303,1.0880142119811678,-344,-394674,-394481.8,0.0110830387488021,-281.1005196534227,0.02297836357286747
2023-08-29T19:15:00-04:00,1.08823,1.08823,1.08747,1.08766,1.087229536,1.0880675555555557,1.0880222222222156,1.0879802222222157,1.0880155000000045,1.0850993999999998,1.0837004000000028,1.0822672500000052,1.0880221290189043,1.088035369584934,-1130,-395804,-394800.4,0.004639656280447003,-281.6923982085075,0.005516734093432423
2023-08-29T19:30:00-04:00,1.08766,1.08774,1.08709,1.0871,1.0885,1.0878831111111111,1.0879499999999933,1.0879804444444379,1.0880370000000044,1.0852235999999997,1.0837487000000028,1.0823049500000055,1.0878377032151234,1.0880094956679467,-1018,-396822,-395274.2,-0.0038516400762995465,-282.2165325887367,-0.05975637784417738
2023-08-29T19:45:00-04:00,1.0871,1.08713,1.08686,1.0869,1.0884718,1.087673111111111,1.0878511111111047,1.0879653333333266,1.0880235000000043,1.0853491999999998,1.083791900000003,1.0823415000000054,1.0876501625720987,1.087941196534357,-686,-397508,-395827.6,-0.012670892923512825,-282.3427399293677,-0.08181726252310256
2023-08-29T20:00:00-04:00,1.0869,1.08711,1.08671,1.08688,1.088407328,1.0874788888888889,1.0877433333333266,1.0879164444444378,1.0879625000000046,1.0854663999999998,1.0838317000000028,1.0823763500000054,1.0874961300576789,1.0878237572274854,-1382,-398890,-396739.6,-0.019765968481901743,-282.36817005173396,-0.0891667049685081
2023-08-29T20:15:00-04:00,1.08688,1.08715,1.08676,1.08697,1.08830548832,1.0873242222222224,1.087605555555549,1.0878344444444377,1.0878690000000044,1.0855975999999998,1.0838724000000028,1.0824132000000053,1.0873909040461431,1.0876794057819879,1230,-397660,-397336.8,-0.02290969797171792,-282.2663188814117,-0.11394859448083623
2023-08-29T20:30:00-04:00,1.08697,1.08718,1.08673,1.08693,1.0882097590208,1.0871891111111114,1.0874677777777713,1.087723555555549,1.0877850000000042,1.0857339999999998,1.083917400000003,1.0824501000000053,1.0872987232369145,1.08753472462559,-1170,-398830,-397942,-0.026317275505169765,-282.30937434752394,-0.11395278311294466
2023-08-29T20:45:00-04:00,1.08693,1.08707,1.08674,1.08697,1.088119773479552,1.0870895555555555,1.087343333333327,1.0876022222222155,1.0877070000000044,1.0858959999999998,1.083961600000003,1.0824876500000054,1.0872329785895316,1.0874137797004715,1877,-396953,-397968.2,-0.030171604282483108,-282.24029906208693,-0.10293266182025475
2023-08-29T21:00:00-04:00,1.08697,1.08709,1.08682,1.08695,1.088035187070779,1.087010888888889,1.08717666666666,1.0874673333333267,1.0876335000000044,1.0860431999999998,1.084000300000003,1.0825229000000054,1.0871763828716252,1.087319023760377,-1350,-398303,-398127.2,-0.03373744422855781,-282.26513875407466,-0.13781064816940006
2023-08-29T21:15:00-04:00,1.08695,1.0871,1.08673,1.08709,1.0879556758465323,1.0869935555555554,1.0870499999999934,1.08732866666666,1.0875735000000044,1.0862003999999998,1.0840444000000031,1.0825588500000054,1.0871591062973,1.087251619008301,1703,-396600,-397669.2,-0.04042073997252232,-282.04579103798864,-0.10475726638671429
2023-08-29T21:30:00-04:00,1.08709,1.08718,1.08673,1.0868,1.0878809352957404,1.0869435555555556,1.086954444444438,1.0871984444444378,1.0875185000000045,1.0863691999999998,1.0840862000000029,1.0825945500000054,1.0870872850378401,1.0871908952066405,-2702,-399302,-397997.6,-0.047048222128665974,-282.7665961231239,-0.07906882665539625
2023-08-29T21:45:00-04:00,1.0868,1.08723,1.08676,1.08687,1.087810679177996,1.0869266666666666,1.0869288888888822,1.08709066666666,1.0874630000000045,1.0865379999999998,1.084131200000003,1.0826304500000055,1.087043828030272,1.087139916165312,1964,-397338,-397699.2,-0.04980461737035271,-282.6400963071504,-0.021157207248638808
2023-08-29T22:00:00-04:00,1.08687,1.08698,1.08673,1.08695,1.0877446384273162,1.086930888888889,1.086934444444438,1.0870088888888823,1.0874305000000044,1.0866847999999998,1.0841730000000032,1.0826652500000054,1.0870250624242177,1.0870983329322492,1823,-395515,-397411.6,-0.04667587134619879,-282.50591282614516,0.004600239212448755
2023-08-29T22:15:00-04:00,1.08695,1.08703,1.08663,1.08671,1.0876825601216773,1.086886,1.086915555555549,1.08695666666666,1.0873785000000042,1.0868119999999997,1.084209200000003,1.0826981500000052,1.0869620499393742,1.0870554663457992,-1421,-396936,-397138.2,-0.04452751264247561,-282.8196715086973,-0.01564110113352012
2023-08-29T22:30:00-04:00,1.08671,1.08678,1.08635,1.08664,1.087598355311943,1.0868308888888887,1.0868788888888823,1.0869224444444379,1.0873210000000042,1.0868727999999996,1.0842411000000032,1.0827308000000053,1.0868976399514994,1.087003173076639,-1835,-398771,-397572.4,-0.04187576447771564,-282.93787231664055,-0.030359623540662708
2023-08-29T22:45:00-04:00,1.08664,1.0868,1.08655,1.08672,1.0874735197807488,1.0867991111111113,1.086855555555549,1.0869026666666601,1.0872645000000043,1.0869159999999998,1.0842734000000032,1.0827632000000051,1.0868621119611994,1.0869581384613107,1470,-397301,-397172.2,-0.039490845323744694,-282.8296488019533,-0.019320471419506637
2023-08-29T23:00:00-04:00,1.08672,1.08688,1.08665,1.0867499999999999,1.087361167802674,1.086778,1.0868311111111046,1.0868831111111046,1.0871915000000043,1.0869943999999998,1.084308200000003,1.0827945500000054,1.0868396895689596,1.0869173107690484,1000,-396301,-396964.8,-0.036330524998868914,-282.8020427948862,-0.02023974902712209
2023-08-29T23:15:00-04:00,1.0867499999999999,1.08688,1.08666,1.08684,1.0872600510224066,1.086779777777778,1.0868188888888826,1.0868599999999935,1.0871250000000043,1.0870753999999998,1.0843460000000031,1.0828245000000052,1.0868397516551678,1.0868802486152382,724,-395577,-396977.2,-0.03152776506318456,-282.7420842027536,-0.010120060720369336
2023-08-29T23:30:00-04:00,1.08684,1.0869199999999999,1.08668,1.08689,1.087169045920166,1.086794,1.0867966666666602,1.0868362222222159,1.0870650000000042,1.0871216,1.0843826000000032,1.0828557500000051,1.0868498013241341,1.0868577988921904,1045,-394532,-396496.4,-0.026474645183039023,-282.6940090490972,-0.018397740757432963
2023-08-29T23:45:00-04:00,1.08689,1.08694,1.08682,1.0869199999999999,1.0870871413281493,1.0868186666666668,1.0868099999999936,1.086822444444438,1.0869885000000041,1.0871679999999997,1.084416300000003,1.0828891000000052,1.0868638410593072,1.086851039113752,904,-393628,-395467.8,-0.022914620587792072,-282.66905712203925,0.01104158998894902
2023-08-30T00:00:00-04:00,1.0869199999999999,1.08693,1.08649,1.08656,1.0870134271953344,1.0867686666666667,1.0867755555555492,1.0868064444444383,1.086905000000004,1.0871913999999998,1.084447800000003,1.0829187500000053,1.0868030728474458,1.0868392312910014,-1151,-394779,-394963.4,-0.01684458254983863,-283.0502811311659,-0.028522270372724656
2023-08-30T00:15:00-04:00,1.08656,1.0865799999999999,1.08641,1.08647,1.086947084475801,1.0867075555555556,1.0867222222222157,1.0867846666666605,1.0868455000000041,1.0872207999999999,1.0844749000000031,1.082947900000005,1.0867364582779566,1.0868185850328007,-1230,-396009,-394905,-0.012815137371472421,-283.15216229741526,-0.044160264961593074
2023-08-30T00:30:00-04:00,1.08647,1.08654,1.08634,1.08634,1.08693,1.086631111111111,1.0866811111111045,1.086757111111105,1.086807500000004,1.0872443999999997,1.0845023000000031,1.0829753500000052,1.0866571666223652,1.0867820680262401,-945,-396954,-395180.4,-0.012645000164065575,-283.265234908716,-0.03404772202335319
2023-08-30T00:45:00-04:00,1.08634,1.08642,1.08602,1.08605,1.0868592,1.086504888888889,1.0866155555555492,1.0867208888888826,1.086765000000004,1.0872653999999997,1.0845264000000032,1.0830012500000052,1.0865357332978922,1.0867192544209918,-1027,-397981,-395870.2,-0.01411783263640417,-283.5393940117594,-0.05429581094015409
2023-08-30T01:00:00-04:00,1.08605,1.08622,1.0859,1.08603,1.086741712,1.0863877777777777,1.0865388888888825,1.0866666666666605,1.086722500000004,1.0872803999999998,1.0845546000000033,1.0830273000000052,1.0864345866383138,1.086633403536793,-1357,-399338,-397012.2,-0.015919317585537714,-283.56438365312016,-0.06349381625440384
2023-08-30T01:15:00-04:00,1.08603,1.08611,1.08556,1.0856,1.0866070380800001,1.0862,1.0864111111111048,1.0865937777777717,1.0866540000000042,1.0872665999999997,1.0845788000000032,1.0830513000000053,1.086267669310651,1.086526322829434,-1700,-401038,-398264,-0.020617833878314104,-284.23747739822875,-0.1058201058201044
2023-08-30T01:30:00-04:00,1.0856,1.08709,1.08556,1.08651,1.08556,1.0862197777777778,1.086374444444438,1.086524222222216,1.086633000000004,1.0872509999999997,1.0846173000000032,1.0830793500000053,1.086316135448521,1.086442258263547,3202,-397836,-398629.4,-0.020811066280982143,-281.5534132862164,-0.03036325494092428
2023-08-30T01:45:00-04:00,1.08651,1.08674,1.08633,1.08664,1.08556,1.0862728888888888,1.0863466666666604,1.0864573333333272,1.086616500000004,1.0872453999999998,1.0846595000000032,1.0831077500000053,1.0863809083588167,1.086387006610837,1938,-395898,-398418.2,-0.02138102395755009,-281.3215332298893,-0.023001407686137645
2023-08-30T02:00:00-04:00,1.08664,1.08752,1.08663,1.08714,1.08556,1.0864315555555555,1.0863711111111047,1.0864084444444382,1.0866260000000043,1.0872388,1.0847069000000034,1.0831380500000052,1.0865327266870535,1.0863864052886694,3601,-392297,-397281.4,-0.0198251756063816,-279.664590728233,0.02024068008686095
2023-08-30T02:15:00-04:00,1.08714,1.08767,1.08709,1.0873,1.0856384000000001,1.0866173333333333,1.0864533333333268,1.086391333333327,1.0866365000000042,1.087238,1.0847581000000033,1.0831701000000051,1.0866861813496427,1.0864367242309352,2735,-389562,-395326.2,-0.01786166586740634,-279.26206667429346,0.06810484464732393
2023-08-30T02:30:00-04:00,1.0873,1.0874,1.0869,1.08727,1.0857602960000001,1.0867806666666666,1.086542222222216,1.0864175555555493,1.0866600000000042,1.0872461999999998,1.0848086000000032,1.083203100000005,1.086802945079714,1.0865437793847477,-2210,-391772,-393473,-0.012116564416950778,-279.32304340564633,0.07363295811204285
2023-08-30T02:45:00-04:00,1.08727,1.0873,1.08647,1.08691,1.08587487824,1.0868542222222224,1.0866055555555494,1.0864637777777717,1.0866620000000045,1.0872601999999998,1.0848561000000034,1.083233900000005,1.0868243560637714,1.0866454235077978,-2155,-393927,-392691.2,-0.00854947675514111,-280.03657362353135,0.05246976084834945
2023-08-30T03:00:00-04:00,1.08691,1.0873599999999999,1.08659,1.08664,1.0859825855456,1.086861111111111,1.086671111111105,1.0865286666666605,1.0866465000000043,1.0872595999999997,1.0848999000000032,1.0832625000000053,1.086787484851017,1.0867267388062378,-3669,-397596,-393030.8,-0.004780919093103604,-280.94799223224777,0.05432530730630178
2023-08-30T03:15:00-04:00,1.08664,1.0867499999999999,1.08586,1.08619,1.08767,1.086764888888889,1.0866888888888826,1.086592222222216,1.0866205000000042,1.0872399999999998,1.0849440000000035,1.0832889000000052,1.0866679878808136,1.0867537910449898,-3363,-400959,-394763.2,-0.00016214472752623343,-282.3406797828627,0.014732558032461162
2023-08-30T03:30:00-04:00,1.08619,1.0867499999999999,1.08613,1.08655,1.0876337999999999,1.0867371111111113,1.0867944444444382,1.0866604444444383,1.0866160000000042,1.0872089999999996,1.0849938000000034,1.0833153500000052,1.086644390304651,1.0867454328359916,2818,-398141,-396479,0.005324519610230225,-281.40669953999566,0.08750921149594754
2023-08-30T03:45:00-04:00,1.08655,1.0867,1.0861399999999999,1.08646,1.0875983239999998,1.0866702222222222,1.0867888888888828,1.0867097777777714,1.0866030000000042,1.0871613999999998,1.0850497000000034,1.083342600000005,1.0866075122437209,1.086706346268793,-2717,-400858,-398296.2,0.014027919108952114,-281.6317513093572,-0.0046018904566092825
2023-08-30T04:00:00-04:00,1.08646,1.08649,1.08551,1.08579,1.0875635575199998,1.0864704444444444,1.0866944444444384,1.0867275555555493,1.0865550000000042,1.0871049999999998,1.0850933000000034,1.083364050000005,1.0864440097949768,1.086630277015034,-5260,-406118,-400734.4,0.011477856152323695,-284.87549705241236,-0.07822277847309296
2023-08-30T04:15:00-04:00,1.08579,1.08652,1.08575,1.0861,1.0874814152191998,1.0863515555555556,1.0865788888888828,1.086709111111105,1.086518000000004,1.0870563999999998,1.0851305000000033,1.0833871500000052,1.0863752078359814,1.0865478216120268,2683,-403435,-401902.2,0.009356976316337185,-284.10948336652456,-0.09566385194178577
2023-08-30T04:30:00-04:00,1.0861,1.08673,1.08609,1.08665,1.087402558610432,1.0863657777777778,1.0865066666666605,1.0866726666666604,1.086506000000004,1.0870209999999998,1.0851681000000035,1.0834114000000052,1.0864301662687852,1.0865002572896212,2604,-400831,-401876.6,0.005679972967754856,-282.790820259997,-0.05978110916950607
2023-08-30T04:45:00-04:00,1.08665,1.08677,1.0862,1.08673,1.0873268562660146,1.0864104444444445,1.0864466666666606,1.086603111111105,1.086496500000004,1.0869897999999998,1.0852149000000033,1.0834370500000052,1.086490133015028,1.0864694058316966,2341,-398490,-401946.4,0.0011351260145675412,-282.618474058368,-0.0496656764189194
2023-08-30T05:00:00-04:00,1.08673,1.08812,1.08661,1.08803,1.08551,1.0867271111111112,1.0865711111111052,1.0865595555555494,1.086570000000004,1.0869923999999997,1.0852820000000034,1.0834681000000053,1.0867981064120225,1.0865075246653568,2606,-395884,-400951.6,0.003264971978436473,-279.50104838685786,0.10304441030076178
2023-08-30T05:15:00-04:00,1.08803,1.08884,1.08798,1.08876,1.0855622,1.0871648888888887,1.0868066666666607,1.086581999999994,1.086684500000004,1.087008,1.0853594000000035,1.0835045000000052,1.087190485129618,1.086656819732285,3074,-392810,-398290,0.010648479239627983,-277.4385868738484,0.195096812191701
2023-08-30T05:30:00-04:00,1.08876,1.08888,1.08838,1.0885,1.085693312,1.0875035555555557,1.0870633333333273,1.086678888888883,1.086792500000004,1.0870259999999998,1.0854300000000037,1.083540000000005,1.0874523881036944,1.0868722557858277,-2373,-395183,-396639.6,0.018867602101532106,-278.00526823613194,0.21266997486627887
2023-08-30T05:45:00-04:00,1.0885,1.0893599999999999,1.08845,1.08889,1.0858845132800001,1.087868888888889,1.0873233333333274,1.0868422222222163,1.0869345000000041,1.0870487999999998,1.0855088000000035,1.083580000000005,1.0877399104829555,1.0871342046286618,2252,-392931,-395059.6,0.03253487224851092,-277.1983963941478,0.2153605448437724
2023-08-30T06:00:00-04:00,1.08889,1.08894,1.08798,1.08826,1.0861625522176002,1.0880562222222223,1.0875233333333274,1.0870575555555497,1.087046000000004,1.0870581999999998,1.0855821000000037,1.0836184000000053,1.0878439283863643,1.087404963702929,-2187,-395118,-394385.2,0.03858158886780736,-278.46373081727575,0.16567568065092353
2023-08-30T06:15:00-04:00,1.08826,1.08882,1.08802,1.08843,1.086418348040192,1.0882375555555555,1.0878166666666609,1.0873066666666609,1.0871875000000042,1.0870697999999996,1.0856585000000036,1.0836587500000052,1.0879611427090914,1.0876375709623427,2094,-393024,-393813.2,0.046186159483537395,-278.13662148678486,0.24314093885557755
2023-08-30T06:30:00-04:00,1.08843,1.08914,1.08838,1.0888,1.0866536801969768,1.088434222222222,1.0881166666666608,1.0875686666666609,1.0873020000000042,1.0870815999999996,1.0857380000000034,1.0836991000000054,1.0881289141672732,1.0878252567698738,2157,-390867,-393424.6,0.059848768534649883,-277.4033726788689,0.2485958935641216
2023-08-30T06:45:00-04:00,1.0888,1.08916,1.08848,1.08904,1.0868701857812186,1.088618888888889,1.0883822222222164,1.0878324444444387,1.087422000000004,1.0870989999999996,1.0858149000000035,1.0837440000000054,1.0883111313338185,1.087997005415899,2084,-388783,-392144.6,0.07580004098981315,-276.94400456718625,0.21994202365068002
2023-08-30T07:00:00-04:00,1.08904,1.08917,1.08859,1.08876,1.0870693709187211,1.0886944444444444,1.0886077777777718,1.0880893333333275,1.0875030000000039,1.0871123999999996,1.0858891000000035,1.0837852500000054,1.088400905067055,1.0881292043327186,-2211,-390994,-391757.2,0.08591245862037629,-277.512468535452,0.1867989288967799
2023-08-30T07:15:00-04:00,1.08876,1.08883,1.0881,1.0886,1.0872526212452234,1.088692888888889,1.0886711111111054,1.088318888888883,1.087568000000004,1.0871153999999996,1.0859653000000036,1.0838270000000052,1.088440724053644,1.0882485634661745,-2304,-393298,-391393.2,0.09670882617480628,-277.8510555518742,0.052388261353083956
2023-08-30T07:30:00-04:00,1.0886,1.08862,1.08807,1.08808,1.0874212115456054,1.0885746666666667,1.0885955555555498,1.0884746666666607,1.087608500000004,1.0871123999999996,1.0860359000000035,1.0838644000000053,1.0883685792429152,1.0883300507729394,-1846,-395144,-391817.2,0.0937501094599806,-278.7328486806636,-0.06245637238693688
2023-08-30T07:45:00-04:00,1.08808,1.08857,1.08784,1.08787,1.087576314621957,1.0884295555555554,1.0885255555555498,1.0885564444444384,1.087656500000004,1.0871165999999997,1.0861080000000036,1.0838999500000055,1.088268863394332,1.0883580406183513,-2195,-397339,-393111.6,0.08293768312161395,-279.15648481036004,-0.05787781350483513
2023-08-30T08:00:00-04:00,1.08787,1.08894,1.08745,1.08856,1.0893599999999999,1.0884364444444445,1.088488888888883,1.0885777777777719,1.087752500000004,1.0871457999999996,1.0861847000000033,1.0839371500000052,1.0883270907154656,1.0883612324946805,3803,-393536,-394062.2,0.07625968131101515,-276.74436755370226,-0.03030609152439103
2023-08-30T08:15:00-04:00,1.08856,1.09021,1.08854,1.08927,1.08745,1.0885926666666665,1.0886011111111054,1.0885764444444388,1.0879065000000039,1.0871931999999997,1.0862712000000034,1.0839756000000054,1.0885156725723726,1.0883841859957442,8217,-385319,-392927.2,0.06823140281721557,-271.3849293968713,0.09280870380239606
2023-08-30T08:30:00-04:00,1.08927,1.09199,1.08925,1.0916,1.08745,1.0891924444444445,1.0889533333333274,1.0886328888888832,1.088159000000004,1.0872875999999996,1.0863770000000035,1.0840244000000052,1.089132538057898,1.0885225487965946,11876,-373443,-388956.2,0.07523502465916862,-245.98160423414828,0.2912451880231062
2023-08-30T08:45:00-04:00,1.0916,1.09257,1.09141,1.09211,1.0876316,1.0898237777777777,1.0893211111111052,1.0887779999999943,1.088441500000004,1.0873903999999996,1.0864940000000034,1.0840790500000053,1.0897280304463184,1.0887944390372755,8291,-365152,-382957.8,0.08470249119595243,-242.10801500732518,0.30400440852313776
2023-08-30T09:00:00-04:00,1.09211,1.09239,1.0913,1.09235,1.0879279039999998,1.0904295555555557,1.089688888888883,1.089010666666661,1.088769500000004,1.0874987999999997,1.0866164000000034,1.0841357000000054,1.0902524243570546,1.0891911512298198,7146,-358006,-375091.2,0.09152633416147514,-240.53762374637148,0.3039374127672008
2023-08-30T09:15:00-04:00,1.09235,1.0927,1.09201,1.09268,1.0882064297599998,1.0910277777777777,1.0901244444444385,1.0893377777777722,1.089098500000004,1.0876129999999997,1.0867545000000034,1.0841953500000052,1.0907379394856438,1.0896733209838554,5196,-352810,-366946,0.09479593162016355,-238.96790708046692,0.36004261728940684
2023-08-30T09:30:00-04:00,1.09268,1.09343,1.09245,1.09273,1.0885659153791998,1.0915488888888887,1.0905833333333272,1.0897342222222164,1.089402500000004,1.0877285999999997,1.0868859000000033,1.0842547000000053,1.091136351588515,1.090197456787084,6277,-346533,-359188.8,0.10223084892937578,-238.68067751645984,0.3793863678118654
2023-08-30T09:45:00-04:00,1.09273,1.09454,1.09273,1.09449,1.0890523238412797,1.0923302222222222,1.0912955555555495,1.0902026666666607,1.089790500000004,1.0878766,1.0870385000000033,1.0843251000000051,1.091807081270812,1.0907323654296666,6348,-340185,-352537.2,0.12198820585497422,-228.4563037004212,0.5891110947724457
2023-08-30T10:00:00-04:00,1.09449,1.0945,1.09341,1.09407,1.089710844980326,1.0928851111111113,1.0919844444444384,1.0907353333333274,1.090092500000004,1.0880219999999998,1.0871956000000034,1.0843924000000051,1.0922596650166496,1.091238692343733,-7241,-347426,-348992,0.1448369323039251,-231.2349677357244,0.5699210383593817
2023-08-30T10:15:00-04:00,1.09407,1.09429,1.09308,1.09399,1.090290343582687,1.0932862222222222,1.092587777777772,1.0913151111111055,1.0903540000000043,1.0881644,1.0873512000000034,1.0844593500000053,1.0926057320133198,1.0917093538749858,-6036,-353462,-348083.2,0.17490076800001428,-231.6763288917752,0.49882413463658837
2023-08-30T10:30:00-04:00,1.09399,1.09443,1.09327,1.09357,1.0908003023527646,1.0934826666666666,1.0930655555555495,1.0919033333333277,1.090607500000004,1.0882968,1.0874908000000034,1.0845237500000053,1.092798585610656,1.0921214830999884,-5684,-359146,-349350.4,0.19980218902103958,-233.85850605975708,0.39475979325603117
2023-08-30T10:45:00-04:00,1.09357,1.09375,1.09252,1.09287,1.0912490660704328,1.0934435555555555,1.0932066666666607,1.0924279999999942,1.090806500000004,1.08842,1.0876160000000032,1.0845830000000052,1.0928128684885248,1.0924567864799903,-4654,-363800,-352803.8,0.21369114718103843,-236.8375563263149,0.11634298277758377
2023-08-30T11:00:00-04:00,1.09287,1.09297,1.09229,1.09264,1.0916439781419809,1.0933302222222223,1.0932655555555495,1.0928219999999942,1.0910255000000042,1.0885399999999998,1.0877064000000032,1.0846425500000052,1.0927782947908198,1.0926510291839917,-4214,-368014,-358369.6,0.20682035744411367,-237.72441386655282,0.04852990999076481
2023-08-30T11:15:00-04:00,1.09264,1.09344,1.09245,1.09328,1.0919915007649432,1.093333111111111,1.0933688888888828,1.0930988888888833,1.0912680000000041,1.0886711999999998,1.087793600000003,1.0847062000000052,1.0928786358326559,1.092774823347193,3660,-364354,-361755.2,0.19558964274374227,-235.580615360183,0.08513754748936674
2023-08-30T11:30:00-04:00,1.09328,1.0933,1.09276,1.09298,1.09229,1.0932553333333332,1.0934022222222162,1.0932617777777722,1.091477000000004,1.0887958,1.0878951000000032,1.0847676000000053,1.0928989086661247,1.0928334586777542,-2762,-367116,-364486,0.18147038572622592,-236.33851818471095,0.027455430684186308
2023-08-30T11:45:00-04:00,1.09298,1.09308,1.09237,1.0925799999999999,1.09454,1.0930908888888888,1.0933855555555496,1.093325777777772,1.0916540000000041,1.0889105999999997,1.087993000000003,1.084827000000005,1.0928351269328997,1.092840766942203,-2345,-369461,-366549,0.16403369321879963,-237.19672236045105,-0.013727087203617956
2023-08-30T12:00:00-04:00,1.0925799999999999,1.09259,1.09181,1.09237,1.0944966,1.0928877777777777,1.093149999999994,1.0933144444444387,1.091834500000004,1.0890202,1.0880709000000033,1.084887400000005,1.09274210154632,1.0928266135537619,-2858,-372319,-368252.8,0.1461868796470772,-237.74604597977364,-0.19369752121991976
2023-08-30T12:15:00-04:00,1.09237,1.09256,1.09204,1.09238,1.094389136,1.0927337777777777,1.0929622222222164,1.0932537777777722,1.0920235000000038,1.0891294,1.0881487000000032,1.084945500000005,1.092669681237056,1.0928048908430092,2598,-369721,-368594.2,0.11105116779727485,-237.72226282937626,-0.15446909247124874
2023-08-30T12:30:00-04:00,1.09238,1.09259,1.09216,1.09235,1.0942859705599999,1.0926113333333334,1.092779999999994,1.0931359999999946,1.092237000000004,1.0892452,1.0882183000000032,1.0850029000000052,1.0926057449896447,1.092750312674407,-2680,-372401,-370203.6,0.0789305458293169,-237.79586359101592,-0.1499099626139257
2023-08-30T12:45:00-04:00,1.09235,1.09262,1.09196,1.0925799999999999,1.0941869317375998,1.0925713333333331,1.092669999999994,1.0929895555555498,1.092472500000004,1.0893673999999998,1.0882941000000033,1.0850630500000051,1.0926005959917158,1.092690650139525,2596,-369805,-370741.4,0.04638728500128047,-237.24926222698434,-0.09052918423146634
2023-08-30T13:00:00-04:00,1.0925799999999999,1.09305,1.09248,1.09299,1.0940918544680958,1.0926353333333332,1.0926833333333275,1.0928491111111054,1.092694000000004,1.0895004,1.0883724000000032,1.085125500000005,1.0926784767933726,1.0926593201116195,1745,-368060,-370461.2,0.018751274929991877,-236.5944360357672,0.01098026297728897
2023-08-30T13:15:00-04:00,1.09299,1.09328,1.09294,1.09301,1.094000580289372,1.0927006666666668,1.0927244444444386,1.0927639999999943,1.0928810000000042,1.0896396,1.0884525000000032,1.0851880500000053,1.092744781434698,1.0926598560892953,1335,-366725,-369342.4,0.0006362517972982447,-236.57000763294542,0.03386293747254186
2023-08-30T13:30:00-04:00,1.09301,1.09309,1.09264,1.09279,1.093912957077797,1.0927137777777776,1.092669999999994,1.09270555555555,1.092940500000004,1.0897747999999998,1.0885276000000033,1.0852485000000052,1.0927538251477584,1.0926766848714355,-1344,-368069,-369012,-0.013328737917742188,-236.84052665838905,-0.044819259476081286
2023-08-30T13:45:00-04:00,1.09279,1.09282,1.09191,1.09203,1.093828838794685,1.0925857777777777,1.0925644444444385,1.0926624444444388,1.0929365000000042,1.0899033999999999,1.0885850000000032,1.0853042000000053,1.0926090601182068,1.092677347897148,-1652,-369721,-368476,-0.026639547833316717,-237.98943907523017,-0.08691833336383158
2023-08-30T14:00:00-04:00,1.09203,1.09205,1.09167,1.09199,1.0937480852428976,1.0924708888888888,1.092498888888883,1.0926282222222166,1.0929185000000041,1.0900129999999997,1.0886320000000032,1.085359950000005,1.0924852480945655,1.092654278317718,-1887,-371608,-368836.6,-0.03517536704707897,-238.05855805547802,-0.05400062238004251
2023-08-30T14:15:00-04:00,1.09199,1.09219,1.09169,1.09177,1.0936234001283238,1.092325111111111,1.092432222222216,1.0925779999999943,1.092873000000004,1.0901155999999999,1.0886805000000033,1.085415850000005,1.0923421984756523,1.092587022654174,-1644,-373252,-369875,-0.040060757799078826,-238.3897698797623,-0.054926444336640144
2023-08-30T14:30:00-04:00,1.09177,1.09213,1.09175,1.09203,1.0935061961206243,1.0922446666666668,1.0923933333333273,1.0925117777777722,1.092838000000004,1.0902133999999999,1.0887261000000032,1.0854711000000052,1.0922797587805217,1.092494018123339,1658,-371594,-370848.8,-0.040340765742261815,-237.99492481166166,-0.03204013255459185
2023-08-30T14:45:00-04:00,1.09203,1.09243,1.09195,1.09234,1.093396024353387,1.0922340000000001,1.0923922222222162,1.0924562222222165,1.092730500000004,1.0903142,1.0887761000000034,1.0855291000000051,1.0922918070244174,1.0924016144986706,1799,-369795,-371194,-0.03900806567554425,-237.4842337134317,-0.000915457499871238
2023-08-30T15:00:00-04:00,1.09234,1.09245,1.0921399999999999,1.09237,1.0932924628921836,1.0922295555555557,1.0923688888888827,1.0924171111111056,1.092645500000004,1.0904161999999997,1.088831200000003,1.085587900000005,1.0923074456195339,1.092341291598936,2196,-367599,-370769.6,-0.029589950398468783,-237.42392282121872,-0.019220560508138668
2023-08-30T15:15:00-04:00,1.09237,1.09237,1.09213,1.09215,1.0931951151186525,1.0921857777777777,1.0922755555555494,1.092372444444439,1.092553500000004,1.0905209999999999,1.0888906000000034,1.085643700000005,1.092275956495627,1.0922994332791482,-1286,-368885,-370225,-0.025160099820813804,-237.68291931508082,-0.07685340213542229
2023-08-30T15:30:00-04:00,1.09215,1.09217,1.09193,1.09196,1.0931036082115333,1.0921226666666668,1.092158888888883,1.0923177777777724,1.092473000000004,1.0906273999999998,1.0889435000000034,1.085698750000005,1.0922127651965017,1.0922735466233182,-1187,-370072,-369589,-0.0257420227404382,-237.8894202535965,-0.09606499483078795
2023-08-30T15:45:00-04:00,1.09196,1.09219,1.09189,1.09216,1.0930175917188414,1.092122888888889,1.0920888888888827,1.0922568888888833,1.092437500000004,1.0907467999999998,1.0889934000000034,1.085755350000005,1.0922022121572013,1.0922580372986541,1469,-368603,-368990.8,-0.02737818863684727,-237.62036277896377,-0.057650600755855055
2023-08-30T16:00:00-04:00,1.09216,1.09236,1.09209,1.09235,1.092936736215711,1.092175111111111,1.0921244444444382,1.0922033333333279,1.092423000000004,1.0908627999999998,1.0890359000000034,1.085813900000005,1.092231769725761,1.092246029838923,877,-367726,-368577,-0.029139840722310024,-237.4677935583368,0.02930322427038414
2023-08-30T16:15:00-04:00,1.09235,1.09239,1.0922,1.09223,1.0928607320427683,1.0921962222222221,1.0921511111111049,1.092159777777772,1.092370500000004,1.0909781999999997,1.0890698000000034,1.0858710000000051,1.0922314157806088,1.0922308238711378,-505,-368231,-368703.4,-0.02552233607598153,-237.52327028282983,0.021978223243804246
2023-08-30T16:30:00-04:00,1.09223,1.09242,1.09223,1.09238,1.0927892881202022,1.0922420000000002,1.0922188888888826,1.092148444444439,1.0923405000000037,1.0911099999999998,1.0891075000000034,1.085928850000005,1.092261132624487,1.09222785909691,423,-367808,-368488,-0.018029807596079226,-237.4651781227537,0.05587257389376879
2023-08-30T16:45:00-04:00,1.09238,1.09239,1.09224,1.09231,1.09272213083299,1.0922602222222222,1.0922499999999937,1.092166666666661,1.0923270000000038,1.0912341999999997,1.0891453000000033,1.0859846500000052,1.0922709060995897,1.0922394872775274,-536,-368344,-368142.4,-0.010166039499066528,-237.49952514485227,0.02564032123658104
2023-08-30T17:00:00-04:00,1.09231,1.09231,1.09193,1.09217,1.0926590029830106,1.0922442222222222,1.0922311111111052,1.0921951111111055,1.0923170000000038,1.0913445999999996,1.0891828000000034,1.086040000000005,1.0922507248796718,1.0922491898220215,-60,-368404,-368102.6,-0.007097173293269119,-237.5072152694506,-0.015562919969973037
2023-08-30T17:15:00-04:00,1.09217,1.09246,1.09202,1.09242,1.09259966280403,1.092282,1.0922366666666603,1.0922175555555498,1.0923190000000038,1.0914583999999996,1.0892241000000034,1.0860950500000053,1.0922845799037375,1.092259751857617,230,-368174,-368192.2,-0.006582744664215861,-237.45456778783145,0.004577203694708155
2023-08-30T17:30:00-04:00,1.09242,1.09246,1.09223,1.09235,1.092543883035788,1.0923046666666667,1.0922588888888827,1.0922391111111054,1.0923190000000038,1.0915447999999996,1.0892686000000034,1.0861482000000051,1.09229766392299,1.092273001486093,-520,-368694,-368284.8,-0.006635066544400199,-237.48788830558104,0.018312502861326557
2023-08-30T17:45:00-04:00,1.09235,1.09254,1.09226,1.0923,1.09167,1.0923128888888889,1.0922966666666605,1.0922546666666608,1.0923050000000039,1.0916155999999997,1.0893118000000033,1.086200750000005,1.092298131138392,1.0922804011888738,-545,-369239,-368571,-0.005043882210925962,-237.51283452245286,0.03113667167295569
2023-08-30T18:00:00-04:00,1.0923,1.09277,1.09223,1.09263,1.0916873999999999,1.0923795555555553,1.0923488888888828,1.0922744444444388,1.0922870000000038,1.0916981999999997,1.0893621000000033,1.086255400000005,1.0923645049107136,1.0922991209510986,458,-368781,-368658.4,0.0008718878510824023,-237.37446594239248,0.043033987694108045
2023-08-30T18:15:00-04:00,1.09263,1.09282,1.09263,1.09267,1.091730704,1.0924437777777778,1.0923844444444384,1.0923051111111053,1.0922700000000038,1.0917737999999997,1.0894113000000032,1.0863101500000052,1.092425603928571,1.0923340967608786,297,-368484,-368674.4,0.006935964611554099,-237.36359309431032,0.02929463999634714
2023-08-30T18:30:00-04:00,1.09267,1.09291,1.09259,1.09274,1.09179606176,1.0925148888888887,1.092441111111105,1.0923459999999943,1.092267500000004,1.0918633999999998,1.0894608000000034,1.0863653500000052,1.0924884831428567,1.0923748774087023,295,-368189,-368677.4,0.011683597711314815,-237.3446944332324,0.04669346199976291
2023-08-30T18:45:00-04:00,1.09274,1.09277,1.09263,1.09265,1.0918851768192,1.0925566666666666,1.092471111111105,1.0923884444444387,1.0922985000000038,1.0919477999999998,1.0895088000000033,1.0864192000000052,1.0925207865142854,1.0924195019269614,-223,-368412,-368621,0.016139157729798376,-237.36306110783025,0.02471667368498073
2023-08-30T19:00:00-04:00,1.09265,1.09305,1.09262,1.093,1.091967162673664,1.0926624444444444,1.0925477777777717,1.092438666666661,1.092349000000004,1.0920317999999998,1.0895567000000033,1.0864755000000053,1.0926166292114283,1.0924832015415689,456,-367956,-368364.4,0.017585793957003867,-237.21699420626064,0.06316888062913271
2023-08-30T19:15:00-04:00,1.093,1.09316,1.09293,1.09297,1.0920754464062976,1.0927468888888887,1.0926366666666605,1.0924962222222165,1.092409000000004,1.0921103999999997,1.0896047000000033,1.0865317500000053,1.0926873033691427,1.0925477612332548,-324,-368280,-368264.2,0.01935488089581592,-237.22588716142988,0.07324867007882581
2023-08-30T19:30:00-04:00,1.09297,1.09316,1.09293,1.0931,1.0922055928375418,1.0928395555555555,1.0927122222222159,1.092561777777772,1.0924625000000039,1.0921971999999998,1.0896548000000033,1.0865882500000053,1.092769842695314,1.0926166089866034,399,-367881,-368143.6,0.02206938758457624,-237.17842931720728,0.06224712107065176
2023-08-30T19:45:00-04:00,1.0931,1.09314,1.09285,1.09293,1.0923201216970368,1.092883111111111,1.0927766666666605,1.092628888888883,1.092492000000004,1.0922837999999997,1.0896996000000034,1.086643300000005,1.0928018741562513,1.0926792871892823,-692,-368573,-368220.4,0.02281387383440223,-237.28604984597865,0.05309653499336522
2023-08-30T20:00:00-04:00,1.09293,1.0931899999999999,1.0928,1.09288,1.0924209070933923,1.0929037777777777,1.092841111111105,1.092702888888883,1.092517500000004,1.0923797999999996,1.0897461000000035,1.0866968500000054,1.092817499325001,1.0927386297514254,-1002,-369575,-368453,0.025310861136181542,-237.33188992722802,0.053098965485674714
2023-08-30T20:15:00-04:00,1.09288,1.0931899999999999,1.09288,1.09306,1.0925285801003175,1.0929475555555555,1.0928888888888824,1.0927711111111051,1.092563000000004,1.0924835999999996,1.0898001000000035,1.0867502500000052,1.0928659994600007,1.0927885038011398,993,-368582,-368578.2,0.02925894625106595,-237.16834040669525,0.0393545848091239
2023-08-30T20:30:00-04:00,1.09306,1.0932,1.09296,1.09303,1.092621178886273,1.0929757777777778,1.0929288888888824,1.0928295555555496,1.0926165000000039,1.0925729999999998,1.0898594000000035,1.0868040500000051,1.0928987995680006,1.0928308030409115,-889,-369471,-368816.4,0.029083488746281073,-237.1927397992263,0.03294681834404861
2023-08-30T20:45:00-04:00,1.09303,1.09339,1.09288,1.0933,1.0927137902644692,1.09305,1.0929911111111048,1.0928853333333275,1.092673500000004,1.0926535999999998,1.0899234000000033,1.0868576500000051,1.0929790396544006,1.0928726424327286,1825,-367646,-368769.4,0.029007702120463528,-236.74192875103915,0.05124732324248164
2023-08-30T21:00:00-04:00,1.0933,1.09354,1.09321,1.09345,1.0928355080168648,1.0931417777777779,1.0930799999999938,1.092945999999994,1.0927285000000038,1.0926905999999996,1.0899891000000035,1.0869104000000052,1.0930732317235206,1.0929269139461826,1249,-366397,-368334.2,0.029882005951389127,-236.57056681927284,0.07321649201483861
2023-08-30T21:15:00-04:00,1.09345,1.09374,1.0934,1.09344,1.09288,1.0932137777777777,1.0931288888888826,1.0930035555555495,1.0927890000000038,1.0927171999999996,1.0900538000000035,1.086963100000005,1.0931465853788165,1.0929927311569458,-1301,-367698,-367958.8,0.03236010442765521,-236.5824649399003,0.04025617566331162
2023-08-30T21:30:00-04:00,1.09344,1.09395,1.09344,1.09372,1.0930520000000001,1.093332,1.093212222222216,1.0930682222222163,1.0928560000000038,1.0927445999999996,1.0901217000000036,1.087019550000005,1.0932612683030531,1.0930717849255562,2638,-365060,-367254.4,0.03245386609759038,-235.9069454783842,0.0686203646943675
2023-08-30T21:45:00-04:00,1.09372,1.09383,1.09277,1.09288,1.09395,1.0932655555555555,1.0931877777777714,1.093119999999994,1.0928845000000038,1.0927485999999995,1.0901808000000035,1.087071200000005,1.0931850146424424,1.0931290279404444,-2336,-367396,-366839.4,0.029450980392442077,-237.70104268790755,-0.020126246455025795
2023-08-30T22:00:00-04:00,1.09288,1.09298,1.09235,1.09247,1.09395,1.0931220000000001,1.0931366666666602,1.0931491111111051,1.092899500000004,1.0927433999999996,1.0902360000000035,1.0871181500000051,1.0930420117139539,1.0931416223523551,-1431,-368827,-367075.6,0.02298894648258371,-238.23789028325197,-0.04208869735480817
2023-08-30T22:15:00-04:00,1.09247,1.0928,1.09246,1.09254,1.093886,1.0930026666666666,1.0930988888888826,1.0931528888888828,1.0929055000000039,1.0927043999999997,1.0902905000000034,1.0871674500000053,1.092941609371163,1.0931152978818837,1303,-367524,-367301,0.017807867618129126,-238.1544005764408,-0.03111046043481507
2023-08-30T22:30:00-04:00,1.09254,1.09255,1.09222,1.09237,1.0938245599999998,1.0928568888888888,1.093022222222216,1.0931315555555494,1.0929065000000038,1.0926703999999996,1.0903462000000035,1.0872162000000052,1.0928272874969305,1.0930514383055066,-1330,-368854,-367532.2,0.013359197716388433,-238.36134952110186,-0.06312553748191842
2023-08-30T22:45:00-04:00,1.09237,1.0924,1.09207,1.09218,1.0937282863999997,1.0926884444444445,1.0929277777777715,1.0930746666666604,1.0929005000000038,1.0926341999999996,1.0903993000000034,1.0872652500000053,1.0926978299975443,1.0929387506444048,-1561,-370415,-368603.2,0.0060478485914429,-238.63286008986537,-0.07776547761726736
2023-08-30T23:00:00-04:00,1.09218,1.09227,1.09203,1.09213,1.0935956234879998,1.092528888888889,1.0927977777777713,1.0929966666666604,1.0928755000000039,1.0926053999999994,1.0904511000000034,1.0873120500000053,1.0925842639980354,1.0928186005155234,-1221,-371636,-369451.2,-0.0014466142687458987,-238.68875746941808,-0.10701545778833746
2023-08-30T23:15:00-04:00,1.09213,1.09228,1.09205,1.09223,1.0934390611391998,1.0924153333333333,1.0926622222222158,1.0929017777777716,1.0928535000000037,1.0925925999999995,1.0905063000000035,1.0873577500000053,1.0925134111984283,1.0927128804124182,833,-370803,-369846.4,-0.00949466094140879,-238.61248449825166,-0.11157346014906935
2023-08-30T23:30:00-04:00,1.09223,1.09228,1.09201,1.09203,1.0932981550252798,1.092288888888889,1.0925055555555492,1.0927831111111048,1.0928180000000038,1.0925803999999995,1.0905602000000034,1.0874006500000055,1.0924167289587425,1.0926079043299342,-757,-371560,-370653.6,-0.019700118958642474,-238.75109999132545,-0.12895083406496116
2023-08-30T23:45:00-04:00,1.09203,1.0922,1.092,1.09205,1.0931435764222461,1.0921977777777778,1.0923199999999937,1.0926426666666604,1.0927880000000039,1.0925557999999993,1.0906135000000032,1.0874434500000054,1.092343383166994,1.0925111234639469,757,-370803,-371043.4,-0.029413802524577114,-238.73723590334257,-0.15268990235161287
2023-08-31T00:00:00-04:00,1.09205,1.09225,1.09202,1.09223,1.0929834757231316,1.0921797777777777,1.0922477777777715,1.0925066666666605,1.092749500000004,1.0925407999999994,1.0906683000000035,1.0874882500000054,1.0923207065335951,1.092435698771157,744,-370059,-370972.2,-0.041219296330228763,-238.6146041557119,-0.0594758802430312
2023-08-31T00:15:00-04:00,1.09223,1.0923,1.09196,1.09204,1.0928457891218932,1.0921382222222222,1.0921999999999936,1.092387111111105,1.092703000000004,1.0925299999999993,1.0907203000000032,1.0875331500000054,1.092264565226876,1.092371759016925,-810,-370869,-370818.8,-0.04472474215587987,-238.75550854398188,-0.03936034856793802
2023-08-31T00:30:00-04:00,1.09204,1.09213,1.09191,1.09193,1.0927040628623903,1.0920842222222222,1.0921322222222158,1.0922811111111048,1.092644500000004,1.0925211999999995,1.0907707000000033,1.0875766500000055,1.0921976521815009,1.0923086072135397,-766,-371635,-370985.2,-0.0451364268873946,-238.8326668898299,-0.05583319603858892
2023-08-31T00:45:00-04:00,1.09193,1.09203,1.09182,1.09185,1.09256113154716,1.0920277777777778,1.092074444444438,1.0921948888888826,1.092590500000004,1.0925105999999993,1.0908200000000035,1.0876181500000053,1.0921281217452008,1.0922508857708313,-874,-372509,-371175,-0.04600618703867081,-238.89670029856495,-0.047602918425082706
2023-08-31T01:00:00-04:00,1.09185,1.09193,1.09167,1.09177,1.092412905237728,1.0919668888888887,1.0920288888888825,1.0921366666666603,1.092535000000004,1.0924989999999994,1.0908721000000032,1.0876599500000053,1.0920564973961606,1.0921935086166648,-1312,-373821,-371778.6,-0.0464443648285724,-238.9928307194104,-0.03753959969968517
2023-08-31T01:15:00-04:00,1.09177,1.09187,1.09169,1.09171,1.0922643241901824,1.091903111111111,1.0919822222222155,1.0920835555555493,1.0924675000000041,1.0924815999999995,1.0909245000000032,1.0876997000000053,1.0919871979169284,1.0921268068933314,-851,-374672,-372701.2,-0.04564908394514106,-239.03959881159093,-0.03845696025199261
2023-08-31T01:30:00-04:00,1.09171,1.09202,1.09169,1.09172,1.0921454593521458,1.0918506666666667,1.091925555555549,1.09202866666666,1.092402000000004,1.0924561999999995,1.090978300000003,1.0877403000000054,1.0919337583335427,1.0920606455146649,1257,-373415,-373210.4,-0.043563791923977836,-239.0280847648202,-0.04669346199976291
2023-08-31T01:45:00-04:00,1.09172,1.09198,1.09168,1.09177,1.0920503674817166,1.0918195555555554,1.0918966666666599,1.091981555555549,1.0923255000000043,1.0924313999999995,1.0910355000000032,1.0877809500000053,1.0919010066668342,1.0920013164117315,1127,-372288,-373341,-0.04228456992420735,-238.9764689658975,-0.02380886971970999
2023-08-31T02:00:00-04:00,1.09177,1.09189,1.09134,1.09152,1.09202,1.0917442222222222,1.0918377777777712,1.0919342222222155,1.0922290000000043,1.0924059999999995,1.0910904000000032,1.0878225000000052,1.0918248053334674,1.0919406531293847,-2391,-374679,-373775,-0.039196914468812113,-239.52397439286443,-0.04853257634722947
2023-08-31T02:15:00-04:00,1.09152,1.0916,1.0911,1.09134,1.09198,1.0916446666666666,1.0917388888888822,1.0918762222222154,1.092124000000004,1.0923921999999995,1.0911478000000032,1.0878633000000053,1.091727844266774,1.0918749225035074,-1620,-376299,-374270.6,-0.03650169690134311,-239.7911247886429,-0.081484668979982
2023-08-31T02:30:00-04:00,1.09134,1.09169,1.09114,1.09164,1.09189,1.0916248888888889,1.0916944444444379,1.09181866666666,1.0920200000000042,1.0923851999999996,1.0911991000000034,1.0879082000000053,1.0917102754134191,1.0918195380028055,2057,-374242,-374184.6,-0.03405842473980277,-239.22567314204335,-0.036628694919595986
2023-08-31T02:45:00-04:00,1.09164,1.09244,1.09066,1.09072,1.09066,1.0914300000000001,1.0915599999999932,1.0917455555555489,1.0919120000000042,1.0923641999999996,1.0912399000000033,1.0879497000000051,1.0915122203307352,1.0917352304022443,-4039,-378281,-375157.8,-0.03306859848073199,-242.62961583377333,-0.11081296420101612
2023-08-31T03:00:00-04:00,1.09072,1.09088,1.08917,1.08939,1.09244,1.090996,1.09128666666666,1.091623555555549,1.0917580000000042,1.0923113999999996,1.0912624000000033,1.0879846500000054,1.0910877762645883,1.091572584321795,-6119,-384400,-377580.2,-0.04111632994746565,-250.09098997195633,-0.2253056738562904
2023-08-31T03:15:00-04:00,1.08939,1.08981,1.08898,1.08971,1.09244,1.0906806666666666,1.0910577777777712,1.0914675555555489,1.0916165000000042,1.0922587999999995,1.0912865000000032,1.088022300000005,1.0908122210116706,1.0913700674574356,4079,-380321,-378708.6,-0.04868511795240431,-248.89281484642783,-0.18868442987075584
2023-08-31T03:30:00-04:00,1.08971,1.09052,1.08966,1.0899699999999999,1.0923016,1.090463111111111,1.0908644444444378,1.09129266666666,1.091496500000004,1.0922107999999995,1.0913135000000032,1.0880610500000052,1.0906437768093364,1.091153253965948,2933,-377388,-378926.4,-0.05396927882427714,-248.19301398197786,-0.15938298632421383
2023-08-31T03:45:00-04:00,1.0899699999999999,1.09004,1.0891899999999999,1.08925,1.092168736,1.090140222222222,1.0905899999999933,1.0910717777777712,1.0913500000000043,1.0921527999999996,1.091336900000003,1.0880965000000054,1.0903650214474692,1.0908842031727581,-2869,-380257,-380129.4,-0.06290364663976997,-250.08818540871394,-0.226248488623454
2023-08-31T04:00:00-04:00,1.08925,1.08931,1.08851,1.08893,1.0920411865600002,1.0898082222222223,1.0902744444444379,1.09081466666666,1.091190000000004,1.0920921999999995,1.091359800000003,1.0881298500000052,1.0900780171579754,1.090597362538206,-3449,-383706,-381214.4,-0.07429766105909642,-251.1014330561781,-0.26012804894803426
2023-08-31T04:15:00-04:00,1.08893,1.08903,1.08857,1.08868,1.0918293153664,1.089489333333333,1.0899588888888825,1.0905491111111045,1.0910125000000042,1.0920225999999995,1.0913847000000032,1.0881643500000053,1.0897984137263803,1.0903394900305645,-2775,-386481,-381630.6,-0.08757236231058176,-251.73852634959422,-0.26018762826150266
2023-08-31T04:30:00-04:00,1.08868,1.0889199999999999,1.08847,1.0887,1.091630156444416,1.0892375555555553,1.0896655555555492,1.0902706666666602,1.0908460000000042,1.0919495999999995,1.091406200000003,1.0882000000000052,1.0895787309811042,1.0900927920244512,2387,-384094,-382385.2,-0.09802719024632238,-251.69467508016723,-0.24190444774313924
2023-08-31T04:45:00-04:00,1.0887,1.0887,1.0877,1.08776,1.0913773439288628,1.0888564444444444,1.089234444444438,1.0899446666666601,1.0906315000000042,1.0918601999999995,1.0914192000000031,1.0882344500000052,1.0892149847848833,1.0898070336195607,-3062,-387156,-384338.8,-0.11222597303228816,-254.33845206188838,-0.3554285295518563
2023-08-31T05:00:00-04:00,1.08776,1.08809,1.08645,1.0871,1.0910096095359765,1.0884295555555557,1.0888322222222158,1.0895931111111046,1.0903750000000043,1.0917545999999994,1.091432300000003,1.0882628000000052,1.0887919878279066,1.089492426895648,-4565,-391721,-386631.6,-0.13226793503650253,-257.10827261053925,-0.3318908610825837
2023-08-31T05:15:00-04:00,1.0871,1.08748,1.08696,1.08734,1.0904624563916594,1.0881311111111112,1.0886044444444378,1.0892591111111047,1.090140000000004,1.0916551999999993,1.0914447000000032,1.0882876000000052,1.0885015902623254,1.0891771415165181,3991,-387730,-387436.4,-0.14194027999290973,-256.22717611527656,-0.18817870551410487
2023-08-31T05:30:00-04:00,1.08734,1.08748,1.08703,1.08734,1.0899809616246603,1.0878782222222223,1.0883411111111048,1.088935555555549,1.0899105000000042,1.0915585999999993,1.0914516000000032,1.088309850000005,1.0882692722098604,1.0888713132132142,0,-387730,-387686.2,-0.14024379055757671,-256.22717611527656,-0.21748905672151153
2023-08-31T05:45:00-04:00,1.08734,1.08769,1.08715,1.08742,1.089557246229701,1.087694,1.0880577777777714,1.0886139999999935,1.0896890000000041,1.0914585999999993,1.091458500000003,1.088336700000005,1.0880994177678882,1.088575450570571,3156,-384574,-387782.2,-0.14157792466247418,-255.99497643532342,-0.23395139315759428
2023-08-31T06:00:00-04:00,1.08742,1.08752,1.08647,1.08652,1.0891843766821367,1.0873864444444445,1.087754444444438,1.0883179999999935,1.089426500000004,1.0913419999999994,1.091443400000003,1.0883627000000051,1.0877835342143105,1.0882891604564562,-2459,-387033,-387757.6,-0.14998055095405713,-258.03016063278193,-0.25063116823503523
2023-08-31T06:15:00-04:00,1.08652,1.08717,1.08627,1.08699,1.0888562514802804,1.0872335555555557,1.0875388888888824,1.088059333333327,1.0891905000000042,1.0912357999999993,1.091425700000003,1.0883925500000051,1.0876248273714484,1.0880557283651646,2311,-384722,-386357.8,-0.149863259938728,-257.0304827621491,-0.17815653898781858
2023-08-31T06:30:00-04:00,1.08699,1.08765,1.08681,1.08748,1.0884941762730411,1.087221777777778,1.0874055555555493,1.0878195555555492,1.0889785000000043,1.0911327999999993,1.091415500000003,1.0884227500000052,1.0875958618971586,1.0878745826921312,2365,-382357,-385283.2,-0.14470980867252908,-255.96437359831114,-0.11022522688026691
2023-08-31T06:45:00-04:00,1.08748,1.08765,1.08726,1.08732,1.0881827915948155,1.0872046666666668,1.0872522222222158,1.0876017777777716,1.0887560000000043,1.0910257999999993,1.091399800000003,1.088454300000005,1.0875406895177269,1.0877288661537046,-2110,-384467,-384630.6,-0.1379855327940993,-256.2748160892074,-0.1267566822816145
2023-08-31T07:00:00-04:00,1.08732,1.08733,1.0867499999999999,1.08708,1.0879150007715412,1.0871702222222224,1.0871766666666602,1.0874255555555492,1.0885340000000043,1.0909125999999991,1.091388000000003,1.088485050000005,1.0874485516141814,1.0875986929229633,-2697,-387164,-385148.6,-0.13238008590572115,-256.87011462137826,-0.06251378980657625
2023-08-31T07:15:00-04:00,1.08708,1.08733,1.08657,1.08673,1.0876847006635255,1.0870808888888888,1.087135555555549,1.0873017777777716,1.0883035000000043,1.0907941999999993,1.091371000000003,1.088514750000005,1.087304841291345,1.0875029543383703,-1919,-389083,-385558.6,-0.12091483680758355,-257.48796243386687,-0.034035507313032974
2023-08-31T07:30:00-04:00,1.08673,1.08674,1.08573,1.08645,1.087486642570632,1.0869437777777777,1.0870366666666602,1.087201333333327,1.0880440000000042,1.0906631999999992,1.0913475000000028,1.0885427500000049,1.087133873033076,1.0874047634706956,-3214,-392297,-387073.6,-0.10551571555318708,-258.3160614096936,-0.08185112292383775
2023-08-31T07:45:00-04:00,1.08645,1.08683,1.08622,1.08682,1.08733,1.0869004444444443,1.0869788888888825,1.0871159999999938,1.0878490000000043,1.0905401999999993,1.091325300000003,1.088570100000005,1.0870710984264607,1.0872998107765561,2149,-390148,-388631.8,-0.08922123452224519,-257.5842007626321,-0.04782312800044843
2023-08-31T08:00:00-04:00,1.08682,1.08805,1.08652,1.08792,1.08573,1.0870886666666666,1.087034444444438,1.0870724444444382,1.0877755000000042,1.0904365999999994,1.091316900000003,1.088603000000005,1.0872408787411685,1.0872398486212445,3946,-386202,-388978.8,-0.0716439993168582,-253.59034713461608,0.045980393960010385
2023-08-31T08:15:00-04:00,1.08792,1.08801,1.08728,1.08758,1.0857764,1.087197777777778,1.0871522222222156,1.0870675555555491,1.0876690000000042,1.0903295999999993,1.091306700000003,1.0886360000000053,1.0873087029929347,1.0872118788969953,-4398,-390600,-389666,-0.06225515024430904,-254.96482319903262,0.09755917976659988
2023-08-31T08:30:00-04:00,1.08758,1.0885,1.0865799999999999,1.08686,1.0858218720000001,1.0871393333333332,1.087137777777771,1.0870679999999935,1.087513500000004,1.0902091999999992,1.091294500000003,1.0886652000000052,1.0872189623943478,1.087194703117596,-10618,-401218,-392093,-0.04665887924093402,-261.9941543746708,-0.011959631643342026
2023-08-31T08:45:00-04:00,1.08686,1.08757,1.08659,1.08743,1.0859289971200001,1.0871977777777777,1.0871322222222155,1.0870871111111045,1.0874225000000042,1.0900965999999992,1.0912901000000028,1.088699050000005,1.0872611699154782,1.0872201624940763,6176,-395042,-392642,-0.03149616642632254,-258.7551723530675,-0.004597785706413499
2023-08-31T09:00:00-04:00,1.08743,1.08745,1.08544,1.086,1.0885,1.0869713333333333,1.086985555555549,1.0870884444444378,1.0872760000000041,1.089955999999999,1.091264500000003,1.0887246000000053,1.0870089359323825,1.0872077299952605,-5533,-400575,-394727.4,-0.030878781840332197,-266.0312177077101,-0.12139940403928813
2023-08-31T09:15:00-04:00,1.086,1.08637,1.0856,1.08608,1.0884388,1.086790222222222,1.0868744444444378,1.0870564444444377,1.0871460000000042,1.089811599999999,1.0912326000000028,1.0887519000000052,1.086823148745906,1.0871241839962082,4014,-396561,-396799.2,-0.029805182290941756,-265.7355270999758,-0.09198954998713176
2023-08-31T09:30:00-04:00,1.08608,1.08659,1.08462,1.08526,1.088378824,1.0864673333333332,1.0867111111111045,1.0869682222222155,1.0869740000000043,1.089647799999999,1.0911692000000028,1.0887731000000052,1.0865105189967248,1.086964547196966,-7433,-403994,-399478,-0.03157062893293096,-271.34750780121357,-0.13526818989078082
2023-08-31T09:45:00-04:00,1.08526,1.0856999999999999,1.08401,1.08494,1.08822847104,1.086113111111111,1.0865433333333268,1.0868493333333267,1.0868330000000042,1.089477799999999,1.091097500000003,1.0887957500000052,1.0861964151973797,1.0867600377575724,-8080,-412074,-401649.2,-0.03157144847464874,-273.7299783612628,-0.13898476690136688
2023-08-31T10:00:00-04:00,1.08494,1.08564,1.08445,1.08484,1.0879753627776,1.0857724444444443,1.0863233333333264,1.0866875555555489,1.0867200000000041,1.089300199999999,1.0910224000000028,1.0888194000000053,1.0859251321579038,1.0864928302060575,-6188,-418262,-406293.2,-0.033595513002834636,-274.30033248222793,-0.18218288216998868
2023-08-31T10:15:00-04:00,1.08484,1.0855299999999999,1.08456,1.08532,1.0877374410109442,1.0855717777777778,1.0860344444444376,1.0864973333333265,1.086619000000004,1.089148999999999,1.090948800000003,1.0888516500000052,1.085804105726323,1.0862518641648458,4261,-414001,-408978.4,-0.03960171290418501,-272.4150037701597,-0.2389881608941775
2023-08-31T10:30:00-04:00,1.08532,1.0854,1.0841,1.08417,1.0875137945502875,1.085198888888889,1.0856555555555487,1.0862535555555488,1.086460500000004,1.0889829999999991,1.090863200000003,1.0888745500000052,1.0854772845810585,1.0859826913318762,-5623,-419624,-413591,-0.06022821153916082,-278.37310829232814,-0.3135401533680201
2023-08-31T10:45:00-04:00,1.08417,1.08552,1.084,1.08546,1.0873035668772704,1.0851597777777777,1.0854999999999935,1.0860113333333268,1.0863625000000041,1.088841399999999,1.0907729000000028,1.0889057000000053,1.0854738276648468,1.0857753530655008,9368,-410256,-414843.4,-0.0715066227122148,-267.2265906797765,-0.12881143845572068
2023-08-31T11:00:00-04:00,1.08546,1.0859,1.08432,1.08447,1.0870392815270888,1.0849537777777778,1.0851711111111042,1.085736888888882,1.086260000000004,1.088683399999999,1.090676900000003,1.0889362500000053,1.0852730621318774,1.0855906824524002,-7224,-417480,-415924.6,-0.08058576906931592,-273.81528118886973,-0.27220142905748895
2023-08-31T11:15:00-04:00,1.08447,1.0849199999999999,1.0843,1.0848,1.0867961390049217,1.0848795555555557,1.085037777777771,1.0854797777777712,1.086150500000004,1.0885357999999992,1.090585000000003,1.0889681000000053,1.085178449705502,1.0854413459619197,3693,-413787,-415029.6,-0.09726435773758123,-272.6915156628526,-0.11049723756906904
2023-08-31T11:30:00-04:00,1.0848,1.08485,1.08375,1.08382,1.086572447884528,1.0846360000000002,1.08478666666666,1.0852302222222157,1.085967500000004,1.0883695999999992,1.090487500000003,1.0889891500000053,1.0849067597644015,1.0852618767695354,-2894,-416681,-415565.6,-0.10345146607370648,-275.3059330669824,-0.2080878020035291
2023-08-31T11:45:00-04:00,1.08382,1.08416,1.08366,1.08386,1.0862902030960753,1.0844506666666667,1.0846311111111042,1.0850253333333266,1.085794500000004,1.0882021999999991,1.090397400000003,1.0890067000000052,1.0846974078115212,1.0851059014156281,2769,-413912,-414423.2,-0.10803742104701491,-275.2037389757125,-0.12900134529972965
2023-08-31T12:00:00-04:00,1.08386,1.08442,1.08376,1.08416,1.0859745787245463,1.0843564444444445,1.0845444444444376,1.0848342222222156,1.085648500000004,1.088044799999999,1.090312600000003,1.0890095000000053,1.084589926249217,1.084929121132502,2680,-411232,-414618.4,-0.1043243326217915,-274.4619457551859,-0.07189337659225421
2023-08-31T12:15:00-04:00,1.08416,1.08421,1.0835,1.08366,1.0856968292776008,1.0841795555555556,1.0844133333333266,1.08468266666666,1.0854950000000039,1.087876999999999,1.090216400000003,1.0890050000000053,1.0844039409993735,1.0847552969060013,-2048,-413280,-413778.4,-0.10112898266076041,-275.4064557906049,-0.10877180044983213
2023-08-31T12:30:00-04:00,1.08366,1.08402,1.08354,1.08393,1.0853892731787367,1.084082888888889,1.084258888888882,1.0845268888888822,1.085369000000004,1.0877109999999992,1.090125900000003,1.0890105000000054,1.0843091527994988,1.0845814375248009,1754,-411526,-413326.2,-0.09724122712128387,-274.9694367994084,-0.12807282644749957
2023-08-31T12:45:00-04:00,1.08393,1.08425,1.08367,1.08385,1.0851247749337136,1.0840011111111112,1.0842233333333267,1.0844142222222157,1.0852205000000041,1.0875471999999993,1.0900386000000029,1.0890158000000052,1.084217322239599,1.0844435500198402,-2242,-413768,-412743.6,-0.09938910712556893,-275.13490873947853,-0.029515666362295395
2023-08-31T13:00:00-04:00,1.08385,1.08449,1.08365,1.0844,1.0848973064429936,1.0840364444444444,1.0841055555555488,1.0843091111111043,1.085044500000004,1.087396599999999,1.089958900000003,1.0890149000000051,1.0842538577916792,1.0843548400158718,2291,-411477,-412256.6,-0.08666095333603659,-273.9723401183593,-0.09765445064765729
2023-08-31T13:15:00-04:00,1.0844,1.08479,1.08417,1.08438,1.0835,1.0840913333333335,1.0840955555555487,1.0842193333333268,1.084884500000004,1.0872471999999993,1.0898789000000029,1.0890138000000054,1.0842790862333433,1.084292672012697,-1910,-413387,-412687.6,-0.08109186329561205,-274.00756697191906,-0.008298984757544746
2023-08-31T13:30:00-04:00,1.08438,1.08517,1.08424,1.0849199999999999,1.0835257999999999,1.084256222222222,1.0841088888888821,1.0841584444444379,1.084787500000004,1.0871101999999992,1.089804600000003,1.0890114500000052,1.0844072689866746,1.0842933376101573,1898,-411489,-412329.4,-0.06527785885783563,-273.06240014848083,0.011061946902645461
2023-08-31T13:45:00-04:00,1.0849199999999999,1.08507,1.08468,1.08489,1.083591568,1.0844124444444443,1.0842277777777711,1.0841522222222157,1.084660500000004,1.0869737999999993,1.089727700000003,1.0890109000000052,1.0845038151893396,1.0843322700881255,-1309,-412798,-412583.8,-0.055806158211246286,-273.09859636571343,0.09872488051520588
2023-08-31T14:00:00-04:00,1.08489,1.08523,1.08485,1.0850899999999999,1.0836547052799999,1.084584888888889,1.0843644444444378,1.0841804444444378,1.0846150000000043,1.0868411999999992,1.0896487000000028,1.0890105500000054,1.0846210521514716,1.0844130160705001,1065,-411733,-412176.8,-0.0338304438871003,-272.9022630969028,0.11348329119995593
2023-08-31T14:15:00-04:00,1.0850899999999999,1.08542,1.08505,1.08535,1.0837492229631998,1.084782,1.08449666666666,1.0842586666666603,1.084578500000004,1.0867127999999993,1.089572100000003,1.0890123000000052,1.0847668417211773,1.0845156128563997,1375,-410358,-411953,-0.01724058452005978,-272.57279733830194,0.10976239669421713
2023-08-31T14:30:00-04:00,1.08535,1.08538,1.08466,1.0847,1.0838828851261437,1.0848226666666667,1.0846122222222154,1.0843619999999936,1.0845505000000042,1.0865763999999993,1.089491200000003,1.0890094000000052,1.084753473376942,1.0846104902851195,-1809,-412167,-411709,-0.006203825296801103,-273.6561805787314,0.09597106103389715
2023-08-31T14:45:00-04:00,1.0847,1.08491,1.08437,1.08459,1.0840058543160522,1.0848182222222222,1.0846855555555488,1.0844773333333269,1.0845330000000042,1.0864413999999991,1.0894168000000028,1.0890009000000054,1.0847207787015536,1.0846731922280952,-1737,-413904,-412192,0.005312703068490891,-273.8323306663133,0.060889540837497154
2023-08-31T15:00:00-04:00,1.08459,1.085,1.08454,1.08488,1.084118985970768,1.084857111111111,1.0847999999999933,1.0845917777777712,1.0845350000000042,1.0863061999999994,1.0893457000000029,1.0889888500000053,1.084752622961243,1.0847229537824759,1634,-412270,-412086.4,0.01433555472259867,-273.39542824235565,0.09503160031370451
2023-08-31T15:15:00-04:00,1.08488,1.08494,1.08473,1.08484,1.0842230670931066,1.084865111111111,1.084848888888882,1.08468866666666,1.0845110000000042,1.0861885999999992,1.0892764000000028,1.0889784500000053,1.0847700983689943,1.0847527630259803,-1333,-413603,-412460.4,0.023463768587107834,-273.44457653525444,0.04057543341940206
2023-08-31T15:30:00-04:00,1.08484,1.08506,1.08479,1.08499,1.084318821725658,1.0848933333333333,1.08491666666666,1.0847726666666602,1.0845520000000042,1.0861005999999993,1.089206000000003,1.0889660500000053,1.0848140786951954,1.084762210420784,1195,-412408,-412870.4,0.030353177863424004,-273.2793447960119,0.05625334292406716
2023-08-31T15:45:00-04:00,1.08499,1.08502,1.08423,1.08436,1.08542,1.084782,1.0848544444444377,1.0848211111111046,1.084497000000004,1.0859935999999992,1.0891262000000028,1.0889511500000055,1.0847232629561563,1.084756168336627,-2469,-414877,-413412.4,0.029334281725343452,-274.7129709123814,-0.051616709066096486
2023-08-31T16:00:00-04:00,1.08436,1.0847,1.08425,1.08444,1.0853962000000001,1.084699111111111,1.0848044444444378,1.0848448888888822,1.084495500000004,1.0858829999999993,1.0890469000000027,1.0889390500000053,1.084666610364925,1.0847453346693012,1302,-413575,-413346.6,0.029388286311514158,-274.61691425223154,-0.04147885960787172
2023-08-31T16:15:00-04:00,1.08444,1.08445,1.08412,1.08422,1.085372876,1.0845822222222223,1.084707777777771,1.0848264444444378,1.084466500000004,1.0857823999999994,1.0889676000000028,1.0889291000000054,1.08457728829194,1.0847102677354408,-604,-414179,-413728.4,0.02430828312682139,-274.73944754130247,-0.0801776811140022
2023-08-31T16:30:00-04:00,1.08422,1.08447,1.0841399999999999,1.08427,1.08532276096,1.0844946666666668,1.084587777777771,1.0847742222222156,1.084489000000004,1.0856891999999994,1.0888907000000028,1.0889171000000053,1.084515830633552,1.084659414188352,514,-413665,-413740.8,0.01907471809495623,-274.71574386492676,-0.09950707145160269
2023-08-31T16:45:00-04:00,1.08427,1.08437,1.08413,1.08433,1.0852746505216,1.084443111111111,1.0845466666666599,1.0847002222222155,1.084512500000004,1.0856021999999994,1.0888124000000028,1.0889029000000052,1.0844786645068416,1.0845923313506813,769,-412896,-413838.4,0.0074294890121720195,-274.6731898885187,-0.03411081404996602
2023-08-31T17:00:00-04:00,1.08433,1.08435,1.08365,1.08427,1.085228464500736,1.0843877777777777,1.0845111111111043,1.0846315555555488,1.084518000000004,1.0855135999999994,1.0887316000000027,1.0888837500000053,1.0844369316054734,1.0845350650805448,-272,-413168,-413496.6,0.0016641404520093554,-274.68824065719616,-0.029504236623966288
2023-08-31T17:15:00-04:00,1.08427,1.08444,1.08409,1.08434,1.0851337566306918,1.0843535555555557,1.0844511111111044,1.0845608888888822,1.084552000000004,1.0854451999999994,1.0886527000000026,1.0888612500000052,1.0844175452843787,1.0844852520644355,186,-412982,-413378,-0.0014314129271794113,-274.6762325780277,-0.04977509033256995
2023-08-31T17:30:00-04:00,1.08434,1.0844,1.08417,1.08417,1.0850447312328502,1.0842973333333334,1.0843766666666599,1.0844946666666602,1.0845640000000039,1.0853865999999994,1.0885706000000028,1.0888390500000054,1.084368036227503,1.084443401651548,-179,-413161,-413174.4,-0.010217249368599676,-274.7042957316511,-0.06176025957744445
2023-08-31T17:45:00-04:00,1.08417,1.08424,1.08417,1.0842,1.084961047358879,1.084262,1.084288888888882,1.0844348888888822,1.084581500000004,1.0853237999999994,1.0884895000000028,1.0888174000000053,1.0843344289820025,1.084407121321238,278,-412883,-413018,-0.01730369678235553,-274.6966032111054,-0.07281173098368154
2023-08-31T18:00:00-04:00,1.0842,1.08437,1.08419,1.08437,1.0848823845173463,1.0842782222222223,1.084289999999993,1.0843835555555488,1.084580000000004,1.0852643999999994,1.0884115000000028,1.0887971500000055,1.084341543185602,1.08437969705699,215,-412668,-412972.4,-0.025302950473844874,-274.6628917187608,0.0009222029584331322
2023-08-31T18:15:00-04:00,1.08437,1.08446,1.08433,1.08435,1.0848084414463055,1.0842902222222224,1.084279999999993,1.0843373333333266,1.084578500000004,1.0852029999999995,1.088330800000003,1.0887774500000054,1.0843432345484816,1.0843609576455917,-207,-412875,-412913.8,-0.02517567873093997,-274.6667096038001,-0.008299214341055799
2023-08-31T18:30:00-04:00,1.08435,1.0844,1.0841399999999999,1.08424,1.0847389349595271,1.0842822222222221,1.0842822222222153,1.084303555555549,1.084544500000004,1.0851573999999993,1.0882497000000029,1.0887591500000056,1.0843225876387852,1.084341966116473,-238,-413113,-412940,-0.02640520798128082,-274.69085309990373,0.001844644075937635
2023-08-31T18:45:00-04:00,1.08424,1.08427,1.08409,1.08419,1.0846735988619556,1.084263777777778,1.0842733333333263,1.084282888888882,1.0845095000000042,1.0851013999999994,1.0881686000000028,1.0887402000000055,1.0842960701110282,1.084327572893178,-291,-413404,-412988.6,-0.0234774147880844,-274.7042726380134,-0.007378236048224151
2023-08-31T19:00:00-04:00,1.08419,1.08438,1.08417,1.08438,1.0846121829302382,1.0842851111111111,1.084278888888882,1.0842808888888822,1.0844740000000042,1.0850393999999994,1.0880861000000028,1.0887241000000054,1.0843128560888227,1.0843232583145421,413,-412991,-413010.2,-0.02022431158926994,-274.6318960250581,0.004611142364398612
2023-08-31T19:15:00-04:00,1.08438,1.08449,1.08424,1.0844799999999999,1.084554451954424,1.0843253333333334,1.0843022222222152,1.0842833333333266,1.0844305000000043,1.0849825999999994,1.088004200000003,1.0887077500000053,1.084346284871058,1.0843242066516332,423,-412568,-412990.2,-0.016163196914012013,-274.5928875593911,0.01936786962655256
2023-08-31T19:30:00-04:00,1.0844799999999999,1.08452,1.08434,1.0844799999999999,1.08365,1.084360888888889,1.0843177777777706,1.084290888888882,1.084419500000004,1.0849305999999992,1.087921600000003,1.0886912000000053,1.0843730278968464,1.084330165321306,0,-412568,-412928.8,-0.010407019863875603,-274.5928875593911,0.012911079550676626
2023-08-31T19:45:00-04:00,1.0844799999999999,1.08452,1.08422,1.08423,1.0836674,1.0843433333333334,1.0843244444444373,1.0842993333333264,1.0844015000000042,1.0848805999999993,1.0878374000000028,1.0886731000000054,1.0843444223174772,1.0843345322570443,-533,-413101,-412926.4,-0.00935772871069806,-274.715757506278,0.005534187442923986
2023-08-31T20:00:00-04:00,1.08423,1.0845,1.08403,1.08405,1.083684452,1.0842884444444443,1.084307777777771,1.0843062222222153,1.0843600000000042,1.0848325999999993,1.087747900000003,1.0886523000000055,1.0842855378539817,1.0843324258056353,-1385,-414486,-413142.8,-0.008093244007225275,-274.94569026962165,-0.013835085777540536
2023-08-31T20:15:00-04:00,1.08405,1.08411,1.08378,1.08398,1.08370116296,1.084222888888889,1.0842644444444374,1.0843033333333263,1.0843170000000042,1.0847757999999994,1.087658000000003,1.0886313500000053,1.0842244302831854,1.0843147406445077,-1192,-415678,-413680.2,-0.00617007989890118,-275.02266088905805,-0.03596558370298998
2023-08-31T20:30:00-04:00,1.08398,1.084,1.08369,1.0838,1.08452,1.0841299999999998,1.0842033333333263,1.0842835555555486,1.084257500000004,1.0846933999999993,1.087565000000003,1.0886099000000053,1.0841395442265482,1.0842733925156058,-1343,-417021,-414570.8,-0.006859861203856895,-275.24567238373487,-0.05072163046985092
2023-08-31T20:45:00-04:00,1.0838,1.08386,1.08361,1.08377,1.0845034,1.0840433333333332,1.084151111111104,1.0842502222222152,1.0842280000000042,1.0846171999999994,1.087473400000003,1.0885865000000055,1.0840656353812386,1.0842119140124842,-1247,-418268,-415710.8,-0.006851444863944481,-275.28018982237694,-0.04334833616175316
2023-08-31T21:00:00-04:00,1.08377,1.085,1.08377,1.08498,1.08361,1.084209111111111,1.0842388888888819,1.084233111111104,1.084255000000004,1.0845795999999992,1.0873944000000029,1.0885702500000054,1.0842485083049909,1.0841927312099868,2934,-415334,-416157.4,-0.0027492869856731244,-272.0044578866337,0.07286545716157393
2023-08-31T21:15:00-04:00,1.08498,1.0854,1.08485,1.08499,1.08361,1.0843593333333335,1.0843066666666596,1.084232888888882,1.0842935000000042,1.0845307999999994,1.087313700000003,1.0885569000000053,1.0843968066439926,1.084214984967989,2396,-412938,-415847.8,0.0022134299867930846,-271.9823745302588,0.05625334292406716
2023-08-31T21:30:00-04:00,1.08499,1.08502,1.08452,1.08458,1.0836816,1.084414,1.0843177777777706,1.0842435555555485,1.0843090000000042,1.0845023999999994,1.087229200000003,1.0885443000000052,1.084433445315194,1.0842567879743907,-1618,-414556,-415623.4,0.0024768943963814185,-272.5937903036758,0.009221009147260534
2023-08-31T21:45:00-04:00,1.08458,1.08486,1.08433,1.08463,1.083750336,1.0844764444444444,1.0843344444444374,1.0842697777777708,1.084324000000004,1.0844733999999994,1.087142500000003,1.0885329500000054,1.0844727562521552,1.0843234303795122,2076,-412480,-414715.2,0.0022792338089240877,-272.4980850537175,0.013831513720870327
2023-08-31T22:00:00-04:00,1.08463,1.08504,1.08449,1.085,1.08381632256,1.0846095555555557,1.0844199999999928,1.0843235555555486,1.084360500000004,1.0844681999999992,1.087058000000003,1.0885235500000054,1.084578205001724,1.084425944303609,1448,-411032,-413268,0.004132362060274091,-272.0041285893011,0.07101814190715415
2023-08-31T22:15:00-04:00,1.085,1.08506,1.0849,1.08494,1.0838796696575999,1.0847135555555556,1.0845188888888817,1.0843795555555487,1.084390500000004,1.0844681999999992,1.086973000000003,1.0885134000000054,1.0846505640013793,1.0845063554428869,-825,-411857,-412572.6,0.00773752149043642,-272.0497507091167,0.08209953415433398
2023-08-31T22:30:00-04:00,1.08494,1.0852,1.0845,1.08452,1.083940482871296,1.0847137777777778,1.0845788888888817,1.084433999999993,1.0844080000000038,1.0844617999999993,1.0868810000000029,1.0885013500000054,1.0846244512011034,1.0845518843543087,-1147,-413004,-412585.8,0.011281234726898716,-272.49377526347007,0.049816417277070146
2023-08-31T22:45:00-04:00,1.08452,1.08452,1.08417,1.08439,1.0839988635564441,1.084676,1.0846444444444372,1.0844993333333264,1.0844175000000038,1.0844431999999993,1.086796100000003,1.0884884500000054,1.0845775609608828,1.0845807074834466,-1916,-414920,-412658.6,0.01409591811229885,-272.7234436882109,0.05443808820814434
2023-08-31T23:00:00-04:00,1.08439,1.0845,1.08408,1.08409,1.0840549090141864,1.0845651111111112,1.0846799999999925,1.0845684444444372,1.0844035000000039,1.0844415999999995,1.086712300000003,1.0884741500000055,1.0844800487687063,1.0845821659867567,-1316,-416236,-413409.8,0.017253311459338064,-273.0875193436485,0.029526560063491147
2023-08-31T23:15:00-04:00,1.08409,1.08428,1.084,1.08415,1.0854,1.084459111111111,1.0845877777777706,1.084601999999993,1.084393500000004,1.0844153999999993,1.086628400000003,1.0884594500000053,1.084414039014965,1.0845493327894051,1171,-415065,-414216.4,0.02172383720200299,-273.0227092264074,-0.07649910597431367
2023-08-31T23:30:00-04:00,1.08415,1.08424,1.08408,1.0841399999999999,1.085372,1.0843695555555557,1.0844933333333262,1.084596888888882,1.084388500000004,1.0844087999999994,1.086546100000003,1.0884461500000056,1.084359231211972,1.0844910662315237,-786,-415851,-415015.2,0.014899870499283593,-273.0299591456991,-0.07834173586853496
2023-08-31T23:45:00-04:00,1.0841399999999999,1.08428,1.08398,1.08418,1.08534456,1.0843068888888887,1.0844488888888817,1.0845708888888819,1.084388000000004,1.0843963999999995,1.0864661000000029,1.0884327000000054,1.0843233849695777,1.0844308529852185,909,-414942,-415402.8,0.0076936757725404184,-272.9964210417641,-0.03688063582217798
2023-09-01T00:00:00-04:00,1.08418,1.08425,1.08383,1.08398,1.0852899776,1.084213111111111,1.0843766666666594,1.0845173333333262,1.084368000000004,1.0843995999999994,1.086384600000003,1.0884178500000055,1.0842547079756621,1.0843662823881743,-1142,-416084,-415635.6,0.003082768379085066,-273.2070871673152,-0.05992827047011787
2023-09-01T00:15:00-04:00,1.08398,1.08408,1.08379,1.08405,1.085202378944,1.0841477777777777,1.0842711111111036,1.0844355555555485,1.084346500000004,1.0844033999999996,1.0863028000000028,1.0884045500000052,1.0842137663805298,1.0843130259105391,732,-415352,-415458.8,-0.0008168137147037607,-273.1598169224767,-0.08755760368663654
2023-09-01T00:30:00-04:00,1.08405,1.08446,1.08405,1.0843,1.08508938862848,1.0841535555555557,1.0841999999999925,1.0843579999999928,1.0843375000000042,1.0844061999999994,1.0862255000000027,1.0883928500000053,1.084231013104424,1.084276420728431,788,-414564,-415358.6,-0.0064818632981963435,-272.978090987326,-0.05898943720389827
2023-09-01T00:45:00-04:00,1.0843,1.08472,1.08419,1.08465,1.0849854375382015,1.0842435555555556,1.084214444444437,1.084302222222215,1.084358500000004,1.0844259999999994,1.0861515000000026,1.0883825000000054,1.0843148104835392,1.0842675365827443,715,-413849,-414958.2,-0.009902772775977132,-272.7472969266418,0.011986869767266947
2023-09-01T01:00:00-04:00,1.08465,1.08472,1.08453,1.08461,1.0848898025351454,1.0843226666666665,1.0842388888888812,1.0842602222222149,1.084386500000004,1.0844395999999994,1.0860753000000027,1.0883718000000053,1.0843738483868313,1.084277629266195,-649,-414498,-414869.4,-0.01074136496976041,-272.77123091456406,0.02028790379845895
2023-09-01T01:15:00-04:00,1.08461,1.08474,1.08454,1.08465,1.0848018183323338,1.0844048888888889,1.0843011111111034,1.0842451111111036,1.084420000000004,1.0844555999999994,1.0860014000000027,1.0883608500000053,1.084429078709465,1.0843125034129557,752,-413746,-414401.8,-0.010978211324027008,-272.74349744354697,0.05165622780395483
2023-09-01T01:30:00-04:00,1.08465,1.08487,1.08454,1.0847,1.08379,1.0844846666666668,1.0843622222222147,1.0842633333333258,1.0844650000000038,1.0844615999999996,1.0859291000000026,1.0883499000000052,1.084483262967572,1.0843664027303643,887,-412859,-413903.2,-0.008514431499956725,-272.7026086775855,0.05073098740949596
2023-09-01T01:45:00-04:00,1.0847,1.08478,1.08439,1.08458,1.0838116,1.0845282222222221,1.0844111111111034,1.084305555555548,1.084505500000004,1.0844655999999995,1.0858564000000026,1.0883382000000055,1.0845026103740576,1.0844207221842908,-1201,-414060,-413802.4,-0.007974047461021599,-272.8354749078795,0.04058516427769643
2023-09-01T02:00:00-04:00,1.08458,1.08458,1.08389,1.08417,1.083832768,1.08448,1.0844099999999923,1.084344666666659,1.084465000000004,1.0844505999999994,1.0857804000000026,1.0883262500000055,1.084436088299246,1.0844449777474323,-2362,-416422,-414317,-0.009453646832812784,-273.72837354145196,-0.0009223560663214104
2023-09-01T02:15:00-04:00,1.08417,1.0842,1.08298,1.083,1.08487,1.084198,1.0843011111111036,1.0843571111111034,1.0843655000000039,1.0844127999999995,1.0856933000000029,1.0883089000000055,1.084148870639397,1.0843999821979453,-2518,-418940,-415205.4,-0.011641336184377134,-276.44571491780465,-0.09040757209542435
2023-09-01T02:30:00-04:00,1.083,1.08372,1.08284,1.08361,1.0848322,1.0840597777777778,1.0842522222222148,1.0843473333333258,1.084317000000004,1.0843831999999995,1.0856122000000028,1.0882952500000054,1.0840410965115175,1.0843223857583557,2196,-416744,-415805,-0.00899392734204515,-275.2088174108794,-0.0405885337392183
2023-09-01T02:45:00-04:00,1.08361,1.08496,1.0836,1.08494,1.08284,1.0841973333333332,1.0843233333333258,1.0843395555555477,1.084332500000004,1.0843749999999994,1.085543900000003,1.0882897000000056,1.084220877209214,1.084269908606684,3456,-413288,-415890.8,-0.00236701669784104,-270.96699609140086,0.059024255279901676
2023-09-01T03:00:00-04:00,1.08494,1.08532,1.08455,1.0847499999999999,1.08284,1.0842826666666667,1.084334444444437,1.0843242222222147,1.084320000000004,1.0843759999999996,1.0854762000000029,1.0882833000000056,1.084326701767371,1.0842347268853467,-4564,-417852,-416649.2,0.001255961425679896,-271.76626609711604,0.009219563914625823
2023-09-01T03:15:00-04:00,1.0847499999999999,1.08542,1.08447,1.08535,1.0829392,1.0844857777777777,1.0844166666666593,1.084325555555548,1.084340500000004,1.0843911999999996,1.0854163000000028,1.0882820500000054,1.0845313614138967,1.0842537815082767,3664,-414188,-416202.4,0.006174316862296247,-269.7396240136862,0.06822728907164445
2023-09-01T03:30:00-04:00,1.08535,1.08596,1.08535,1.08575,1.083088048,1.0847524444444445,1.0845388888888814,1.0843731111111037,1.0844020000000039,1.0844085999999995,1.0853574000000028,1.0882782500000054,1.0847750891311174,1.084379025206621,3177,-411011,-414616.6,0.013129836962075684,-268.56875747293907,0.10141520306090453
2023-09-01T03:45:00-04:00,1.08575,1.08587,1.08537,1.08559,1.08331780416,1.0849626666666667,1.0846377777777705,1.0844502222222148,1.084462000000004,1.0844235999999994,1.0853061000000028,1.0882730000000054,1.084938071304894,1.0845584201652962,-2956,-413967,-414061.2,0.017098723392300626,-269.0043641964019,0.08205033649857632
2023-09-01T04:00:00-04:00,1.08559,1.08564,1.08501,1.0854,1.0835291798272,1.085115111111111,1.0847288888888815,1.084531333333326,1.084527500000004,1.0844317999999995,1.0852662000000028,1.0882643000000056,1.085030457043915,1.0847203361322364,-2745,-416712,-414746,0.01911775553899575,-269.484794192994,0.0756053034354147
2023-09-01T04:15:00-04:00,1.0854,1.08547,1.08478,1.08498,1.083723645441024,1.0851653333333333,1.0848188888888817,1.0846282222222148,1.0845690000000041,1.0844441999999994,1.085218900000003,1.0882527000000055,1.085020365635132,1.0848590689057886,-2349,-419061,-414987.8,0.018897474614594456,-270.3937494168743,0.07471153047953526
2023-09-01T04:30:00-04:00,1.08498,1.08535,1.08483,1.085,1.083902553805742,1.0852015555555554,1.0850411111111038,1.084753111111104,1.084612000000004,1.0844553999999993,1.085169200000003,1.0882413500000054,1.0850162925081057,1.0849560551246307,2048,-417013,-415552.8,0.022817497776580833,-270.3559975689141,0.18467220683287183
2023-09-01T04:45:00-04:00,1.085,1.08506,1.08462,1.08484,1.0840671495012828,1.0851613333333332,1.0851777777777705,1.0848808888888817,1.084645000000004,1.0844677999999994,1.085125100000003,1.0882310000000055,1.0849810340064845,1.084997244099704,-1962,-418975,-417145.6,0.03670795378549348,-270.6453247578541,0.11350947296537171
2023-09-01T05:00:00-04:00,1.08484,1.08519,1.08477,1.08486,1.0842185775411801,1.0850977777777777,1.0851688888888817,1.084987111111104,1.084689000000004,1.0844795999999992,1.085084400000003,1.0882221000000056,1.0849568272051875,1.0850009952797628,1968,-417007,-417753.6,0.04524588897278293,-270.6090429098398,-0.007373679650494958
2023-09-01T05:15:00-04:00,1.08486,1.08559,1.08483,1.08543,1.0843578913378857,1.08515,1.0852444444444371,1.0850902222222154,1.0847580000000039,1.0845015999999992,1.0850519000000032,1.0882183000000056,1.08505146176415,1.0850051962238099,1721,-415286,-417468.4,0.0433948323935937,-269.70480641849537,0.06268725512791094
2023-09-01T05:30:00-04:00,1.08543,1.0855,1.08497,1.08508,1.0844860600308548,1.085117111111111,1.0852144444444372,1.0851693333333263,1.084797000000004,1.0845177999999995,1.085015700000003,1.0882109500000057,1.08505716941132,1.0850125569790474,-1810,-417096,-417075.4,0.04191351803178951,-270.2884460820386,-0.024876767862900672
2023-09-01T05:45:00-04:00,1.08508,1.08527,1.08474,1.08493,1.0846039752283865,1.085060222222222,1.0851233333333261,1.0851857777777707,1.084811000000004,1.0845295999999995,1.084987400000003,1.0882033000000058,1.085031735529056,1.0850156455832374,-2195,-419291,-417531,0.035275211175356404,-270.5918799302343,-0.07552383145291669
2023-09-01T06:00:00-04:00,1.08493,1.08501,1.08438,1.08487,1.08596,1.0850095555555554,1.0850433333333263,1.085158888888882,1.084824000000004,1.0845435999999993,1.0849651000000031,1.0881987000000057,1.0849993884232447,1.0850193164665893,-2391,-421682,-418072.4,0.02619716615879862,-270.72410965934114,-0.06632338175554803
2023-09-01T06:15:00-04:00,1.08487,1.0849,1.08437,1.08447,1.0859284,1.084894888888889,1.084939999999993,1.085113111111104,1.084815000000004,1.0845489999999993,1.084936400000003,1.0881905500000058,1.0848935107385957,1.0850066531732712,-1391,-423073,-419285.6,0.016487459917556933,-271.2369821694114,-0.08568269762298465
2023-09-01T06:30:00-04:00,1.08447,1.0848,1.08434,1.08469,1.085866064,1.0848448888888886,1.0849077777777707,1.0850457777777707,1.084814500000004,1.0845553999999995,1.084909900000003,1.0881807500000058,1.0848528085908766,1.0849669225386165,1828,-421245,-420477.4,0.009766915310036348,-270.8661466460684,-0.026728603292237967
2023-09-01T06:45:00-04:00,1.08469,1.08488,1.08449,1.08458,1.0857745001599999,1.0847793333333333,1.0848611111111037,1.084975111111104,1.0848145000000042,1.0845599999999995,1.0848815000000032,1.0881700000000059,1.0847982468727013,1.0849151380308926,-2332,-423577,-421773.6,0.006606420211735235,-271.10263817821084,-0.03870967741934239
2023-09-01T07:00:00-04:00,1.08458,1.08459,1.08415,1.08439,1.0856884301504,1.084685111111111,1.0848111111111038,1.0849126666666595,1.084825500000004,1.0845629999999995,1.0848602000000032,1.0881518000000057,1.084716597498161,1.0848521104247137,-1798,-425375,-422990.4,0.001817329421620335,-271.41761724845026,-0.04148077135799394
2023-09-01T07:15:00-04:00,1.08439,1.08499,1.08428,1.08488,1.085565355738368,1.0846988888888887,1.084813333333326,1.0848666666666598,1.084919500000004,1.0845767999999993,1.084839100000003,1.0881324000000057,1.0847492779985288,1.0848020883397704,1626,-423749,-423403.8,-0.000930584129884367,-270.68288159061484,0.0018435558505365693
2023-09-01T07:30:00-04:00,1.08488,1.0849199999999999,1.08406,1.08413,1.0854521272792985,1.0845622222222222,1.0846688888888818,1.0848124444444376,1.0849455000000041,1.0845717999999993,1.084805600000003,1.0881105500000057,1.084625422398823,1.084748470671816,-2038,-425787,-423946.6,-0.012619323937446709,-272.0917931753063,-0.11976820246352661
2023-09-01T07:45:00-04:00,1.08413,1.08437,1.0833,1.08332,1.0853129145513687,1.0842924444444444,1.084473333333326,1.0847255555555484,1.0848645000000041,1.0845485999999993,1.0847656000000032,1.0880827000000055,1.0843643379190584,1.0846507765374525,-2625,-428412,-425380,-0.030795931741148842,-274.0530432098962,-0.16220002211818332
2023-09-01T08:00:00-04:00,1.08332,1.08449,1.08323,1.0843099999999999,1.0850713648052044,1.0842597777777776,1.0844044444444372,1.0846342222222152,1.0848425000000042,1.0845451999999993,1.0847379000000033,1.0880629500000056,1.0843534703352466,1.0845618212299615,3067,-425345,-425733.6,-0.03512922709517448,-271.2502425600425,-0.05714654401667066
2023-09-01T08:15:00-04:00,1.0843099999999999,1.08479,1.08428,1.08429,1.0848135737324758,1.0842368888888887,1.0843399999999928,1.084539999999993,1.0847895000000043,1.0845463999999994,1.0847135000000032,1.0880422500000058,1.0843407762681974,1.0844866569839688,-2903,-428248,-426308.2,-0.0390103392539615,-271.3037881328028,-0.05346262685851991
2023-09-01T08:30:00-04:00,1.08429,1.0882,1.08371,1.08562,1.08323,1.084492888888889,1.0844677777777705,1.0844708888888817,1.0847830000000043,1.0845777999999993,1.084705200000003,1.0880263500000058,1.084596621014558,1.0844561255871745,17930,-410318,-423622,-0.033281522082750994,-249.3106866562597,0.10604258301289886
2023-09-01T08:45:00-04:00,1.08562,1.08788,1.08542,1.0864,1.0833294,1.084879333333333,1.0846577777777706,1.0844686666666594,1.0848235000000042,1.0846261999999993,1.0847010000000032,1.0880131500000056,1.0849572968116463,1.084522500469739,10664,-399654,-418395.4,-0.018343380712376282,-241.64877917482048,0.1576487291299911
2023-09-01T09:00:00-04:00,1.0864,1.08686,1.08511,1.08669,1.083426812,1.085285777777778,1.084892222222215,1.0845524444444372,1.0848880000000043,1.0846839999999993,1.0846887000000032,1.0880028000000057,1.0853038374493171,1.084710400375791,8522,-391132,-410939.4,-0.00473595409906706,-239.37394485965189,0.194545353961887
2023-09-01T09:15:00-04:00,1.08669,1.08747,1.0863099999999999,1.08746,1.0835222757599998,1.0857993333333333,1.0852333333333262,1.084718222222215,1.085012000000004,1.0847577999999993,1.0846875000000031,1.0879971000000057,1.0857350699594537,1.0849867203006325,6256,-384876,-402845.6,0.012767048113108154,-234.94110752793722,0.28310847573291237
2023-09-01T09:30:00-04:00,1.08746,1.08813,1.0853599999999999,1.0861399999999999,1.0836158302447998,1.0859806666666667,1.085373333333326,1.0849248888888816,1.085069000000004,1.0847809999999993,1.0846803000000032,1.0879874000000058,1.085816055967563,1.0852817762405056,-10939,-395815,-396359,0.02380369325921023,-248.21927867906214,0.11614187744264957
2023-09-01T09:45:00-04:00,1.0861399999999999,1.0861399999999999,1.08423,1.08527,1.0837075136399037,1.0859599999999998,1.0854999999999928,1.0851313333333263,1.085090500000004,1.0847865999999993,1.084658700000003,1.0879744000000058,1.0857068447740503,1.085503820992404,-13209,-409024,-396100.2,0.02621271665678587,-258.79971029929436,0.1051534410079897
2023-09-01T10:00:00-04:00,1.08527,1.08527,1.08236,1.08393,1.0882,1.085646,1.0855677777777704,1.085313333333326,1.0850440000000041,1.0847735999999992,1.084638000000003,1.087951250000006,1.0853514758192402,1.0855826567939229,-17407,-426431,-401455.6,0.028364231313429834,-280.292407968997,0.05630838533397329
2023-09-01T10:15:00-04:00,1.08393,1.08393,1.08125,1.08156,1.0880832,1.0848444444444445,1.085262222222215,1.085387333333326,1.0848505000000042,1.0847121999999993,1.0845928000000031,1.0879127000000057,1.0845931806553921,1.0854405254351378,-10920,-437351,-410699.4,0.026630159017538565,-304.1688575552247,-0.25361750790823734
2023-09-01T10:30:00-04:00,1.08156,1.08163,1.08099,1.08142,1.087809872,1.084076,1.084943333333326,1.085329333333326,1.0846675000000041,1.0846405999999993,1.0845544000000031,1.0878618000000058,1.0839585445243136,1.0850852203481098,-8265,-445616,-422847.4,0.017595593726488685,-305.2387011145281,-0.2646893358787712
2023-09-01T10:45:00-04:00,1.08142,1.08148,1.08041,1.08083,1.08740067968,1.0832533333333332,1.0844111111111037,1.0851368888888815,1.084462500000004,1.0845583999999995,1.0845133000000031,1.087805400000006,1.083332835619451,1.0845885762784875,-7397,-453013,-434287,0.00435580995702171,-309.2743486890141,-0.4412225272194757
2023-09-01T11:00:00-04:00,1.08083,1.08083,1.07952,1.07962,1.0868414253056,1.0822951111111112,1.0836577777777705,1.0847684444444372,1.084200000000004,1.0844603999999993,1.084461100000003,1.0877417500000057,1.0825902684955608,1.0839652610227897,-5718,-458731,-444228.4,-0.027660573405401356,-315.6757069044593,-0.6240795287187048
2023-09-01T11:15:00-04:00,1.07962,1.07968,1.07904,1.07928,1.08610928277504,1.0814195555555557,1.082834444444437,1.0842217777777705,1.0839405000000042,1.0843581999999996,1.084400700000003,1.0876747500000057,1.0819282147964486,1.0832806088182312,-4933,-463664,-451675,-0.06879500669467105,-317.2292349976773,-0.6818871987411237
2023-09-01T11:30:00-04:00,1.07928,1.07936,1.07873,1.0789199999999999,1.0852609688420352,1.0806366666666667,1.0818855555555482,1.0835464444444372,1.0836520000000043,1.0842547999999994,1.084348200000003,1.0876057000000057,1.081326571837159,1.0826272870545848,-3337,-467001,-457605,-0.11612318100236518,-318.34231038126677,-0.785316241516949
2023-09-01T11:45:00-04:00,1.0789199999999999,1.0792,1.07863,1.0786499999999999,1.0843466332041503,1.0799895555555556,1.081053333333326,1.082768444444437,1.0833555000000041,1.0841447999999994,1.084280100000003,1.0875265000000056,1.0807912574697272,1.0819938296436675,-2517,-469518,-462385.4,-0.1709235665567117,-318.97219026114664,-0.6895980260371589
2023-09-01T12:00:00-04:00,1.0786499999999999,1.07866,1.07822,1.0783099999999999,1.0834319718914862,1.0794408888888887,1.0802799999999926,1.0819422222222148,1.083051500000004,1.0840281999999994,1.0842185000000029,1.0874477000000058,1.0802950059757817,1.0813862637149336,-2592,-472110,-466204.8,-0.21569617092111354,-319.7892115377424,-0.641315064454014
2023-09-01T12:15:00-04:00,1.0783099999999999,1.07862,1.0782,1.0784,1.0824938169510188,1.0790648888888887,1.0796655555555479,1.0811437777777702,1.0827275000000043,1.0839125999999992,1.084154500000003,1.0873697500000057,1.0799160047806253,1.0808514109719465,2402,-469708,-468400.2,-0.2528559422990084,-319.5887311564046,-0.5101805467142744
2023-09-01T12:30:00-04:00,1.0784,1.07855,1.078,1.07811,1.081635053560815,1.0787537777777778,1.0792822222222145,1.0804333333333258,1.0824265000000044,1.0837951999999995,1.084097400000003,1.0872924500000056,1.0795548038245002,1.0803767287775567,-2162,-471870,-470041.4,-0.2769143602197282,-320.1701295243574,-0.3189836902252464
2023-09-01T12:45:00-04:00,1.07811,1.0785,1.07801,1.07839,1.080908042848652,1.0785753333333332,1.078945555555548,1.0798453333333256,1.0821800000000041,1.0836819999999994,1.084042700000003,1.0872200500000055,1.0793218430596,1.079975783022045,1816,-470054,-470652,-0.2810191614170904,-319.6984893392185,-0.28018716132493277
2023-09-01T13:00:00-04:00,1.07839,1.0787,1.07819,1.07857,1.0803264342789216,1.0785002222222222,1.0786944444444369,1.079373555555548,1.0818930000000042,1.0835673999999995,1.083986800000003,1.0871497000000057,1.0791714744476801,1.0796518264176358,1278,-468776,-470503.6,-0.28651312792715855,-319.4851713373823,-0.20909856314128297
2023-09-01T13:15:00-04:00,1.07857,1.07886,1.0784,1.07875,1.0798611474231372,1.0785113333333334,1.0785977777777702,1.0790371111111035,1.0816160000000041,1.0834493999999995,1.0839377000000028,1.0870770500000058,1.079087179558144,1.079410261134108,1268,-467508,-469583.2,-0.28133599159350364,-319.2735578120663,-0.08058390915321376
2023-09-01T13:30:00-04:00,1.07875,1.0789,1.07868,1.0787,1.0794889179385099,1.0785317777777779,1.0785333333333258,1.078810666666659,1.081270000000004,1.0833311999999995,1.0838854000000029,1.0870056500000056,1.0790097436465151,1.079229008907286,-821,-468329,-469307.4,-0.26529852027750683,-319.3116111144998,-0.0537395300570774
2023-09-01T13:45:00-04:00,1.0787,1.07873,1.07842,1.07844,1.0791911343508078,1.078513111111111,1.0784799999999926,1.0786502222222145,1.0808720000000043,1.0832069999999994,1.083831300000003,1.0869349500000056,1.0788957949172122,1.0790972071258285,-1044,-469373,-468808,-0.2415274244353833,-319.56324734329365,-0.044488933377805025
2023-09-01T14:00:00-04:00,1.07844,1.07846,1.0782,1.07835,1.0789529074806463,1.0784871111111112,1.078446666666659,1.078550444444437,1.0804550000000042,1.0830799999999994,1.0837708000000028,1.0868648500000058,1.0787866359337697,1.0789901657006624,-1341,-470714,-468940,-0.21141806475973293,-319.67515899345517,-0.027812543457096092
2023-09-01T14:15:00-04:00,1.07835,1.07838,1.07775,1.07775,1.0787623259845172,1.078347777777778,1.0783844444444368,1.0784884444444367,1.079969500000004,1.0829433999999993,1.083704500000003,1.0867917000000056,1.0785793087470157,1.0788717325605295,-1301,-472015,-469587.8,-0.180426105871584,-320.3990427046806,-0.051933117563585054
2023-09-01T14:30:00-04:00,1.07775,1.07783,1.07751,1.07774,1.0785598607876137,1.0782188888888888,1.0783111111111037,1.0784311111111033,1.079549500000004,1.0828147999999995,1.083632700000003,1.086718650000006,1.0784114469976125,1.0787365860484233,-1278,-473293,-470744.8,-0.14291932003709398,-320.41090074225895,-0.06120178041544
2023-09-01T14:45:00-04:00,1.07774,1.078,1.07771,1.07786,1.07838,1.0781286666666665,1.078283333333326,1.0783811111111035,1.0791790000000039,1.0827119999999995,1.083562400000003,1.0866450500000058,1.07830115759809,1.0785948688387381,1404,-471889,-471456.8,-0.11144808845585995,-320.25457361326664,-0.02318872842287535
2023-09-01T15:00:00-04:00,1.07786,1.07805,1.07763,1.07763,1.078206,1.077998,1.0781988888888816,1.0783248888888812,1.078864000000004,1.0825923999999996,1.083487800000003,1.0865682500000056,1.078166926078472,1.0784490950709902,-1388,-473277,-472237.6,-0.08221979320578703,-320.55075307998766,-0.07047543096652156
2023-09-01T15:15:00-04:00,1.07763,1.07776,1.07732,1.07738,1.0780668,1.0778342222222221,1.0780666666666592,1.0782488888888813,1.0786550000000041,1.0824411999999994,1.0834081000000029,1.0864901000000056,1.0780095408627777,1.0782936760567918,-1109,-474386,-472972,-0.06269350323478214,-320.80803062422837,-0.11033127196195187
2023-09-01T15:30:00-04:00,1.07738,1.07745,1.07723,1.07727,1.07805,1.077674888888889,1.0779022222222148,1.0781524444444368,1.0784475000000042,1.0822915999999996,1.083333800000003,1.0864125000000058,1.0778616326902222,1.078150140845433,-1245,-475631,-473695.2,-0.05581807272876336,-320.935144548749,-0.13719582850522807
2023-09-01T15:45:00-04:00,1.07727,1.07751,1.07721,1.07751,1.077886,1.0775964444444446,1.0777699999999928,1.0780442222222146,1.0782815000000041,1.0821347999999995,1.083263000000003,1.0863399000000056,1.0777913061521778,1.0780261126763462,1514,-474117,-473860,-0.05006080420483663,-320.59784749230073,-0.11031797534069013
2023-09-01T16:00:00-04:00,1.07751,1.07773,1.07749,1.07767,1.0777508,1.0775764444444444,1.0776844444444371,1.077924444444437,1.078184000000004,1.0819731999999995,1.0831909000000028,1.0862683000000057,1.0777670449217422,1.0779192901410766,897,-473220,-474126.2,-0.045664722014608444,-320.4646515126811,-0.07139942880458434
2023-09-01T16:15:00-04:00,1.07767,1.07775,1.07765,1.07771,1.07721,1.0775815555555557,1.0776133333333258,1.0778073333333258,1.078105500000004,1.0818155999999994,1.0831196000000027,1.0861980000000058,1.0777556359373939,1.077837032112861,597,-472623,-473995.4,-0.0440034821180668,-320.44249259575844,-0.059349932767651874
2023-09-01T16:30:00-04:00,1.07771,1.07771,1.07739,1.0774,1.0772208,1.0775388888888888,1.077574444444437,1.0777088888888815,1.078029500000004,1.0816555999999995,1.0830437000000028,1.0861248500000058,1.0776845087499152,1.0777720256902883,-440,-473063,-473730.8,-0.04451509772047414,-320.5690572560103,-0.0324750637903106
2023-09-01T16:45:00-04:00,1.0774,1.0775,1.0772,1.07731,1.07775,1.0774860000000002,1.0775266666666592,1.0776337777777703,1.077962500000004,1.0815021999999994,1.082973200000003,1.0860497000000056,1.0776096069999321,1.0777216205522304,-678,-473741,-473352.8,-0.041487947203291325,-320.625693602771,-0.039898305713802075
2023-09-03T17:00:00-04:00,1.07765,1.07794,1.07736,1.07768,1.0772,1.0775166666666667,1.077506666666659,1.0775811111111036,1.077931000000004,1.0813557999999996,1.0829056000000028,1.0859762500000056,1.0776236855999457,1.077688096441784,58,-473683,-473266,-0.037761304204833215,-320.6057736168802,-0.016699756925766703
2023-09-03T17:15:00-04:00,1.07768,1.07814,1.0772,1.0776,1.07814,1.0775353333333333,1.0775033333333257,1.0775448888888812,1.077891000000004,1.0812109999999995,1.0828394000000028,1.0859035000000057,1.0776189484799565,1.077658477153427,-230,-473913,-473404.6,-0.037037986023892425,-320.62284733078417,-0.0027838868628561318
2023-09-03T17:30:00-04:00,1.0776,1.07779,1.07741,1.07762,1.07814,1.0775586666666666,1.0775299999999923,1.0775282222222144,1.0778665000000038,1.0810661999999995,1.0827729000000028,1.0858318000000056,1.0776191587839652,1.0776311817227413,208,-473705,-473621,-0.03368611345721884,-320.6189869001976,0.02227626278564833
2023-09-03T17:45:00-04:00,1.07762,1.07762,1.07719,1.07742,1.07814,1.0775366666666666,1.077546666666659,1.077522666666659,1.077818000000004,1.0809059999999997,1.0827038000000029,1.0857581000000056,1.077579327027172,1.0776101453781926,-301,-474006,-473809.6,-0.030267619478623616,-320.67485074830734,0.013924085883770504
2023-09-03T18:00:00-04:00,1.07742,1.07771,1.07734,1.07754,1.0781020000000001,1.0775353333333333,1.0775499999999925,1.0775273333333257,1.0777665000000038,1.0807551999999996,1.0826365000000029,1.0856840500000056,1.0775714616217376,1.0776025163025538,444,-473562,-473773.8,-0.02400823543418296,-320.62539928091303,0.002784196898402288
2023-09-03T18:15:00-04:00,1.07754,1.07756,1.07716,1.07725,1.0780655200000002,1.0774753333333333,1.077503333333326,1.077526666666659,1.0776915000000038,1.0806015999999996,1.082565600000003,1.0856091500000056,1.07750716929739,1.0775792130420425,-718,-474280,-473893.2,-0.020589786935181934,-320.8186357268918,-0.03897296946188211
2023-09-03T18:30:00-04:00,1.07725,1.07757,1.07722,1.07735,1.0780111888000001,1.0774446666666668,1.077463333333326,1.0775186666666592,1.077624000000004,1.0804511999999995,1.082497400000003,1.0855340000000056,1.077475735437912,1.0775505704336337,429,-473851,-473880.8,-0.017374259759901006,-320.7788121019208,-0.03340416252980078
2023-09-03T18:45:00-04:00,1.07735,1.07744,1.07728,1.07734,1.0779601174720002,1.07742,1.0774566666666592,1.0775039999999925,1.0775690000000038,1.0803085999999995,1.0824288000000026,1.0854591500000055,1.0774485883503298,1.0775164563469066,-278,-474129,-473965.6,-0.014799057172944986,-320.7813925075457,-0.005568962316683589
2023-09-03T19:00:00-04:00,1.07734,1.07762,1.07729,1.0775,1.0779121104236802,1.0774286666666666,1.0774777777777702,1.0774902222222145,1.0775265000000038,1.0801647999999995,1.0823601000000027,1.0853858000000054,1.0774588706802637,1.077492365077525,389,-473740,-473912.4,-0.009717670516321037,-320.7236205878175,0.01763652059295026
2023-09-03T19:15:00-04:00,1.0775,1.07754,1.07716,1.07716,1.0778669837982593,1.077365111111111,1.0774199999999925,1.0774642222222146,1.077497000000004,1.0800163999999994,1.082288200000003,1.0853095000000055,1.0773990965442108,1.0774578920620197,-635,-474375,-474075,-0.0058512380182537405,-320.92399181751586,-0.048251800163320833
2023-09-03T19:30:00-04:00,1.07716,1.07744,1.07716,1.0774,1.0778245647703637,1.0773611111111112,1.0773977777777703,1.0774431111111036,1.0774800000000038,1.0798765999999995,1.0822198000000027,1.0852347500000055,1.0773992772353687,1.0774363136496152,902,-473473,-473913.6,-0.0069031534415146725,-320.72301888870305,-0.01855976243503879
2023-09-03T19:45:00-04:00,1.0774,1.07765,1.0774,1.07755,1.077784690884142,1.0773915555555555,1.0773899999999927,1.0774284444444366,1.0774645000000038,1.0797299999999996,1.0821534000000026,1.0851610000000056,1.077429421788295,1.077427050919692,471,-473002,-473743.8,-0.0065275564970901645,-320.657444357424,-0.006495796291829633
2023-09-03T20:00:00-04:00,1.07755,1.07764,1.07732,1.07746,1.0777472094310934,1.0774055555555555,1.0773944444444372,1.0774159999999924,1.077456000000004,1.0795965999999995,1.0820842000000028,1.0850851500000056,1.077435537430636,1.0774244407357532,-859,-473861,-473690.2,-0.006244820842287927,-320.7291904480926,0.0037125726272057326
2023-09-03T20:15:00-04:00,1.07746,1.07752,1.07738,1.07744,1.0777119768652277,1.0774146666666666,1.077383333333326,1.0773971111111034,1.077459000000004,1.0794789999999996,1.0820138000000026,1.0850090000000057,1.0774364299445087,1.0774199525886021,-651,-474512,-473844.6,-0.00521952961445868,-320.7412744233679,-0.009280397943462795
2023-09-03T20:30:00-04:00,1.07744,1.0778,1.0774,1.07773,1.07716,1.077484,1.0774366666666593,1.0774004444444367,1.0774820000000038,1.0793473999999996,1.0819463000000027,1.0849339500000057,1.077495143955607,1.0774391620708814,707,-473805,-473730.6,-0.005002892573204819,-320.55098076432415,0.044557902065447755
2023-09-03T20:45:00-04:00,1.07773,1.07802,1.07764,1.0778699999999999,1.0771727999999998,1.0775706666666667,1.0774944444444374,1.0774197777777703,1.0775000000000037,1.0792189999999995,1.0818827000000026,1.0848600500000056,1.0775701151644856,1.0774733296567047,960,-472845,-473605,-0.001900341663453939,-320.4262742051676,0.048266580034329966
2023-09-03T21:00:00-04:00,1.0778699999999999,1.07805,1.07781,1.07789,1.0772066879999997,1.0776497777777776,1.0775555555555483,1.0774528888888812,1.0775110000000037,1.0790643999999994,1.0818211000000026,1.0847845000000056,1.0776340921315886,1.0775142637253636,1304,-471541,-473312.8,0.0014318613006247783,-320.4020783373912,0.05105166428426035
2023-09-03T21:15:00-04:00,1.07789,1.07821,1.07771,1.07818,1.0772572867199997,1.0777746666666665,1.0776311111111037,1.0775002222222145,1.0775345000000036,1.0788999999999995,1.0817631000000028,1.0847105500000056,1.0777432737052708,1.0775758109802904,1547,-469994,-472539.4,0.006973537678581028,-319.9858670356815,0.0631090487238992
2023-09-03T21:30:00-04:00,1.07818,1.07819,1.07747,1.07779,1.0773335037823997,1.0778064444444446,1.077701111111104,1.0775637777777702,1.0775540000000037,1.0787219999999993,1.0817030000000027,1.0846340000000056,1.0777526189642166,1.077639048784232,-1866,-471860,-472009,0.009311274995342267,-320.66083781978045,0.058487132830789344
2023-09-03T21:45:00-04:00,1.07779,1.07791,1.0775,1.07765,1.0774036234798077,1.0777962222222222,1.0777288888888816,1.0776222222222145,1.0775710000000038,1.0785257999999995,1.0816418000000028,1.0845576000000055,1.0777320951713734,1.0776864390273855,-1573,-473433,-471934.6,0.012753698506551931,-320.8651633377385,0.023204009652875765
2023-09-03T22:00:00-04:00,1.07765,1.07816,1.07764,1.07816,1.0774681336014231,1.0778824444444446,1.0777966666666596,1.077682666666659,1.0775950000000036,1.0783661999999994,1.081573600000003,1.0844840000000056,1.0778176761370988,1.0777359512219082,1249,-472184,-471802.4,0.016049789700318593,-320.27407161036876,0.05660990209271026
2023-09-03T22:15:00-04:00,1.07816,1.07853,1.07815,1.07844,1.0775,1.078011111111111,1.0779055555555483,1.0777526666666588,1.0776370000000037,1.0782295999999993,1.0815081000000029,1.0844109000000055,1.077942140909679,1.0777975609775263,1097,-471087,-471711.6,0.020949751528563678,-319.98917883007636,0.09095465260891178
2023-09-03T22:30:00-04:00,1.07844,1.07869,1.07836,1.07864,1.0776029999999999,1.078158,1.0780388888888817,1.0778342222222146,1.0776880000000038,1.0781237999999993,1.0814487000000028,1.0843389500000056,1.0780817127277431,1.0778652487820206,1493,-469594,-471631.6,0.027302798150436798,-319.71229740876413,0.11137511137511973
2023-09-03T22:45:00-04:00,1.07864,1.07874,1.07853,1.07857,1.0777334399999998,1.0782642222222223,1.078132222222215,1.0779204444444368,1.0777455000000038,1.0780639999999995,1.081388100000003,1.0842653000000055,1.0781793701821945,1.0779505990256164,-905,-470499,-471359.4,0.03358911786837701,-319.77102877418724,0.07794159947296186
2023-09-03T23:00:00-04:00,1.07857,1.07861,1.07839,1.07847,1.0778743584,1.0783317777777779,1.0781988888888818,1.0780144444444368,1.0777920000000036,1.0780049999999994,1.081322800000003,1.0841904000000055,1.0782374961457555,1.0780516792204928,-839,-471338,-470940.4,0.035814359145918795,-319.84881695668815,0.05566533997607838
2023-09-03T23:15:00-04:00,1.07847,1.0787,1.07843,1.0784799999999999,1.077995548224,1.0783880000000001,1.0782644444444374,1.0781079999999925,1.0778535000000038,1.0779579999999995,1.0812582000000028,1.0841156000000056,1.0782859969166043,1.078145343376394,640,-470698,-470643.2,0.03731943349770728,-319.84288262379073,0.054736568666549315
2023-09-03T23:30:00-04:00,1.0784799999999999,1.07871,1.07847,1.07854,1.07809977147264,1.078443111111111,1.0783044444444372,1.0781877777777702,1.0779130000000037,1.0779363999999994,1.081198400000003,1.0840397000000057,1.0783367975332834,1.0782242747011146,673,-470025,-470430.8,0.03764864300129492,-319.8054410393384,0.03338960099428092
2023-09-03T23:45:00-04:00,1.07854,1.07871,1.07842,1.07858,1.0781894034664703,1.0784982222222224,1.078392222222215,1.078258444444437,1.0779750000000037,1.0779223999999994,1.081140300000003,1.0839682000000057,1.0783854380266267,1.0782850197608913,581,-469444,-470400.8,0.03592374200668257,-319.78389339159236,0.07329813785617499
2023-09-04T00:00:00-04:00,1.07858,1.07863,1.0783099999999999,1.0783099999999999,1.0782664869811645,1.078481777777778,1.0784655555555487,1.0783251111111036,1.0780155000000038,1.0779101999999994,1.081082500000003,1.0838974000000057,1.0783703504213014,1.0783232158087128,-547,-469991,-470299.2,0.03646112411077716,-319.92082342923453,0.061244374333028616
2023-09-04T00:15:00-04:00,1.0783099999999999,1.07839,1.07812,1.07818,1.07874,1.0784246666666668,1.0784677777777707,1.0783788888888814,1.0780665000000038,1.0779007999999992,1.0810228000000028,1.0838256000000057,1.078332280337041,1.07834217264697,-615,-470606,-470152.8,0.03837270065301394,-319.99496722832754,0.0018550122430723622
2023-09-04T00:30:00-04:00,1.07818,1.07844,1.07817,1.07827,1.0787276000000001,1.0783851111111111,1.0784488888888817,1.0784157777777703,1.078110000000004,1.0778999999999994,1.080964100000003,1.0837551000000056,1.0783198242696328,1.0783489381175755,792,-469814,-469976,0.034488241842009285,-319.9288558183588,-0.01576351025555464
2023-09-04T00:45:00-04:00,1.07827,1.0787,1.07821,1.07868,1.078715448,1.0784313333333333,1.0784533333333262,1.078445555555548,1.078166500000004,1.0779055999999994,1.0809091000000028,1.0836876000000057,1.0783918594157063,1.0783599504940602,768,-469046,-469780.2,0.031058863436696407,-319.6368324846854,0.003708373507383372
2023-09-04T01:00:00-04:00,1.07868,1.07876,1.07859,1.07876,1.07812,1.0784926666666668,1.0784744444444374,1.0784619999999925,1.078231500000004,1.0779185999999994,1.0808569000000028,1.0836207500000057,1.078465487532565,1.0783759603952479,955,-468091,-469509.6,0.02682614546654908,-319.56600517723564,0.01761591737206787
2023-09-04T01:15:00-04:00,1.07876,1.07886,1.07867,1.07882,1.0781328,1.0785617777777778,1.078513333333326,1.078471555555548,1.078300500000004,1.0779271999999995,1.080804600000003,1.0835537000000057,1.078536390026052,1.078409168316198,766,-467325,-468976.4,0.023136933638926452,-319.5234007054347,0.03245338303335748
2023-09-04T01:30:00-04:00,1.07882,1.07904,1.07869,1.07888,1.078161888,1.078635111111111,1.0785577777777706,1.078489555555548,1.078358000000004,1.0779333999999994,1.0807504000000028,1.0834879500000059,1.0786051120208417,1.0784637346529582,979,-466346,-468124.4,0.02057859411134476,-319.4689523266503,0.03708923670352515
2023-09-04T01:45:00-04:00,1.07888,1.07894,1.07853,1.07868,1.0782145747199998,1.0786595555555556,1.0785733333333263,1.0785144444444368,1.078398500000004,1.0779319999999994,1.0806907000000028,1.0834211000000058,1.0786200896166733,1.0785237877223663,-1672,-468018,-467765.2,0.018237345137383697,-319.77890338700917,0.01298051069038042
2023-09-04T02:00:00-04:00,1.07868,1.07908,1.07835,1.07864,1.0782641002367999,1.078672888888889,1.078579999999993,1.07853977777777,1.078436000000004,1.0779307999999994,1.0806310000000028,1.083353150000006,1.0786240716933386,1.0785702301778928,-2585,-470603,-468076.6,0.015763948776727953,-319.87476128740605,0.005562869699044019
2023-09-04T02:15:00-04:00,1.07864,1.0791,1.07854,1.07904,1.078329372217856,1.078764888888889,1.0786611111111042,1.0785771111111035,1.078479000000004,1.0779427999999993,1.0805749000000027,1.0832881500000058,1.078707257354671,1.0786185841423142,1523,-469080,-468274.4,0.01495070594206349,-319.3099760022322,0.06769852825255442
2023-09-04T02:30:00-04:00,1.07904,1.07942,1.07893,1.07912,1.07835,1.0788566666666666,1.0787655555555486,1.078627555555548,1.078545500000004,1.0779581999999994,1.0805191000000027,1.0832241000000058,1.0787898058837369,1.0786692673138512,2157,-466923,-468194,0.01831010168382615,-319.1500560734064,0.0871839581517152
2023-09-04T02:45:00-04:00,1.07912,1.07932,1.07897,1.079,1.0784783999999998,1.0789035555555555,1.0788466666666596,1.078685333333326,1.0786130000000038,1.0779831999999994,1.0804633000000026,1.083159850000006,1.0788318447069896,1.0787146138510804,-1548,-468471,-468619,0.02056961815769257,-319.32219633584265,0.06770103962828396
2023-09-04T03:00:00-04:00,1.079,1.07958,1.07885,1.07948,1.0785913919999999,1.0790302222222221,1.0789355555555487,1.0787577777777706,1.0786790000000037,1.0780179999999995,1.0804164000000027,1.083098400000006,1.0789614757655916,1.0787828910808641,3038,-465433,-468102,0.023706788088066616,-317.9707227491882,0.07416471984276261
2023-09-04T03:15:00-04:00,1.07948,1.0806499999999999,1.07945,1.08049,1.0787297971199998,1.079341111111111,1.079127777777771,1.078867333333326,1.0787815000000038,1.0780705999999993,1.0803913000000027,1.0830423000000058,1.0792671806124734,1.0789115128646913,2573,-462860,-466553.4,0.030197664261013286,-315.56333215371643,0.160369312914829
2023-09-04T03:30:00-04:00,1.08049,1.08069,1.08013,1.08026,1.07885,1.0795675555555555,1.079287777777771,1.0789926666666596,1.0788625000000038,1.0781231999999994,1.0803578000000027,1.0829850000000059,1.0794657444899787,1.0790632102917528,-2560,-465420,-465821.4,0.036065676519699656,-316.1082700985377,0.1334791716875946
2023-09-04T03:45:00-04:00,1.08026,1.08032,1.07948,1.0795,1.0791812,1.07961,1.0793566666666599,1.0791108888888818,1.0789090000000037,1.0781655999999995,1.0803034000000027,1.082923650000006,1.0794725955919828,1.0791997682334018,-2382,-467802,-465997.2,0.03857128670289622,-317.7840888829046,0.057467002817722344
2023-09-04T04:00:00-04:00,1.0795,1.0801,1.07949,1.07982,1.079452784,1.0797026666666665,1.0794833333333265,1.0792382222222152,1.0789765000000038,1.0782165999999995,1.0802541000000028,1.0828651500000062,1.0795420764735864,1.0793418145867215,2203,-465599,-465422.8,0.04176449819072757,-317.1310458074065,0.10568472577594085
2023-09-04T04:15:00-04:00,1.07982,1.07984,1.07918,1.07932,1.08069,1.07967,1.079558888888882,1.0793628888888818,1.0790185000000039,1.0782527999999993,1.0801938000000026,1.082805050000006,1.0794976611788691,1.0794490516693769,-1908,-467507,-465837.6,0.04394309508230187,-318.0145263875031,0.06304234962545556
2023-09-04T04:30:00-04:00,1.07932,1.07945,1.07906,1.07942,1.0806597999999998,1.0796422222222222,1.0796011111111041,1.0794575555555483,1.0790625000000038,1.0782877999999994,1.0801305000000028,1.082743950000006,1.0794821289430954,1.0794920413355011,1683,-465824,-466430.4,0.04702161847067926,-317.8585948750694,0.03521648873072796
2023-09-04T04:45:00-04:00,1.07942,1.07985,1.0793,1.07978,1.0805958079999998,1.079678,1.0796744444444375,1.0795348888888816,1.0791225000000035,1.0783291999999995,1.0800724000000028,1.082689250000006,1.0795417031544763,1.0795072330684006,1679,-464145,-466175.4,0.04840468416508455,-317.29862748517496,0.06116094595595326
2023-09-04T05:00:00-04:00,1.07978,1.07979,1.07924,1.07942,1.0805343756799999,1.079627111111111,1.0797211111111045,1.0796077777777706,1.0791780000000037,1.0783695999999994,1.0800126000000028,1.0826394000000061,1.079517362523581,1.0795161864547203,-1784,-465929,-465800.8,0.04747622327748629,-317.8934153123248,0.038924930491203616
2023-09-04T05:15:00-04:00,1.07942,1.08009,1.07939,1.07978,1.0804754006528,1.0796388888888888,1.0797544444444376,1.0796619999999926,1.0792580000000036,1.0784189999999994,1.0799606000000028,1.0825897500000061,1.0795698900188648,1.0795217491637759,1921,-464008,-465482.6,0.04821442911792283,-317.25273791149857,0.02779115870604059
2023-09-04T05:30:00-04:00,1.07978,1.08002,1.07962,1.07969,1.080418784626688,1.079626,1.0796655555555488,1.079683333333326,1.0793290000000035,1.0784591999999993,1.0799075000000027,1.082538350000006,1.079593912015092,1.0795409993310205,-1482,-465490,-465079.2,0.04349466244012926,-317.37626307403156,-0.07404048163332487
2023-09-04T05:45:00-04:00,1.07969,1.07988,1.07936,1.07945,1.0803644332416205,1.0795828888888888,1.0795755555555488,1.0796782222222148,1.0793675000000038,1.0784961999999993,1.0798536000000027,1.0824893500000061,1.0795651296120736,1.0795575994648163,-1726,-467216,-465357.6,0.028650804750811623,-317.7599287558477,-0.07498194879010399
2023-09-04T06:00:00-04:00,1.07945,1.07996,1.07933,1.07993,1.0803122559119556,1.0796537777777777,1.0796233333333267,1.0796679999999927,1.0794260000000038,1.0785423999999995,1.0798043000000028,1.082444350000006,1.079638103689659,1.0795768795718528,1856,-465360,-465600.6,0.02007739790597688,-316.9346195706144,0.039833256137114637
2023-09-04T06:15:00-04:00,1.07993,1.0803,1.0798,1.08022,1.07906,1.079773111111111,1.0796677777777712,1.079657333333326,1.0794960000000038,1.0785983999999993,1.0797522000000028,1.0824020500000062,1.0797544829517272,1.079624303657482,1664,-463696,-465154,0.02030549558580609,-316.4877757937031,0.03704321090551721
2023-09-04T06:30:00-04:00,1.08022,1.08036,1.08005,1.08032,1.0790848,1.0799035555555554,1.0797788888888824,1.0796622222222152,1.0795680000000039,1.0786539999999993,1.0797046000000028,1.082360150000006,1.0798675863613818,1.0796838429259854,1074,-462622,-464876.8,0.018319170860353697,-316.3883516023347,0.09265092836229198
2023-09-04T06:45:00-04:00,1.08032,1.0804799999999999,1.08016,1.0804799999999999,1.079135808,1.0800437777777778,1.0798966666666603,1.0797084444444374,1.0796580000000036,1.0787185999999993,1.079660100000003,1.0823237500000062,1.0799900690891053,1.079763074340788,1134,-461488,-464076.4,0.02200527173824381,-316.22040136536793,0.09820088566080291
2023-09-04T07:00:00-04:00,1.0804799999999999,1.08088,1.08028,1.08064,1.07921645952,1.0801924444444444,1.0799922222222156,1.0797917777777708,1.0797580000000038,1.0787843999999993,1.079617800000003,1.082291450000006,1.0801200552712842,1.0798740594726302,1328,-460160,-462665.2,0.024658416322166574,-316.0237480261111,0.07964585378503797
2023-09-04T07:15:00-04:00,1.08064,1.08072,1.08055,1.08062,1.0793495427584001,1.080318,1.080125555555549,1.0798922222222151,1.0798370000000035,1.0788499999999994,1.079579300000003,1.0822578500000062,1.0802200442170273,1.0799904475781037,-1007,-461167,-461826.6,0.023703705010620094,-316.04238513004964,0.1111708139556306
2023-09-04T07:30:00-04:00,1.08062,1.08067,1.08029,1.08051,1.079471979337728,1.0803948888888888,1.08020666666666,1.079999999999993,1.0799065000000039,1.0789101999999993,1.079537500000003,1.0822237000000061,1.0802780353736219,1.0800951580624827,-1079,-462246,-461536.6,0.027313717492443268,-316.1522202247173,0.06760636425939724
2023-09-04T07:45:00-04:00,1.08051,1.08062,1.07993,1.08001,1.0795846209907098,1.0803555555555555,1.0802422222222157,1.0800926666666597,1.0799570000000036,1.0789671999999992,1.0794918000000029,1.0821866500000061,1.0802244282988975,1.0801665264499858,-1780,-464026,-461817.4,0.025517965759338394,-316.9759053363778,0.029638136872609352
2023-09-04T08:00:00-04:00,1.08001,1.08017,1.07989,1.08005,1.079688251311453,1.080317111111111,1.080308888888882,1.080175111111104,1.0799855000000036,1.0790201999999993,1.079448400000003,1.082154300000006,1.080189542639118,1.0802064211599884,1819,-462207,-461961.2,0.024220441735598567,-316.9085355898013,0.05558386215201574
2023-09-04T08:15:00-04:00,1.08005,1.08011,1.07975,1.0798699999999999,1.08088,1.0802293333333333,1.0803022222222156,1.080237111111104,1.0799545000000037,1.0790665999999993,1.079398300000003,1.082118700000006,1.0801256341112944,1.0802075369279904,-1267,-463474,-462624,0.026389377581300846,-317.11969248068607,-0.0055559156612161
2023-09-04T08:30:00-04:00,1.0798699999999999,1.0801,1.07951,1.07968,1.0808574,1.080104888888889,1.0802422222222157,1.0802604444444373,1.0799255000000036,1.0791109999999995,1.0793538000000027,1.0820797000000062,1.0800365072890354,1.0801708295423922,-1675,-465149,-463420.4,0.027647002020181836,-317.4144038811323,-0.049989816889150815
2023-09-04T08:45:00-04:00,1.07968,1.07993,1.0796,1.07973,1.080803504,1.0800024444444445,1.0801766666666603,1.0802544444444373,1.0799370000000035,1.0791567999999994,1.0793179000000028,1.0820417500000061,1.0799752058312284,1.0801102636339135,1613,-463536,-463678.4,0.025447301025340843,-317.3397058224481,-0.0546134478672864
2023-09-04T09:00:00-04:00,1.07973,1.08043,1.07972,1.08024,1.08075176384,1.0800151111111111,1.0801499999999935,1.0802359999999929,1.0799580000000035,1.0792069999999994,1.0792772000000028,1.0820075500000064,1.0800281646649827,1.0800710109071305,1775,-461761,-463225.4,0.021442763299105914,-316.50130177699225,-0.022212350066618165
2023-09-04T09:15:00-04:00,1.08024,1.08054,1.08012,1.08018,1.0807020932864,1.080021111111111,1.0800988888888823,1.080193999999993,1.0800010000000033,1.0792531999999995,1.0792361000000028,1.0819748000000062,1.0800585317319862,1.0800448087257042,-1463,-463224,-463428.8,0.01707721653297854,-316.5825614970547,-0.04256736748594601
2023-09-04T09:30:00-04:00,1.08018,1.08038,1.0801399999999999,1.08037,1.080654409554944,1.0800753333333335,1.0800711111111045,1.0801477777777708,1.0800485000000033,1.0793027999999996,1.079183600000003,1.0819444000000062,1.080120825385589,1.0800438469805633,1357,-461867,-463107.4,0.009946918902400782,-316.343869797523,-0.023134867020771544
2023-09-04T09:45:00-04:00,1.08037,1.0804,1.07951,1.07956,1.0806086331727462,1.079973111111111,1.0799655555555487,1.0800924444444375,1.0800375000000035,1.0793303999999997,1.0791152000000028,1.0819081000000061,1.080008660308471,1.0800382775844504,-1568,-463435,-462764.6,-0.0004849974844125185,-317.51946704661356,-0.08792144450305933
2023-09-04T10:00:00-04:00,1.07956,1.07956,1.07851,1.07888,1.0805646878458364,1.0797560000000002,1.0798399999999932,1.080025111111104,1.0800105000000033,1.0793521999999995,1.079037100000003,1.0818629000000062,1.0797829282467768,1.07999982206756,-1832,-465267,-463110.8,-0.011609536839697239,-318.6734186565287,-0.10462866084571934
2023-09-04T10:15:00-04:00,1.07888,1.07922,1.07875,1.07908,1.0804414065750862,1.079604,1.0797322222222154,1.0799415555555485,1.0799755000000035,1.0793807999999996,1.078953300000003,1.0818204000000062,1.0796423425974215,1.0799226576540477,1023,-464244,-463607.4,-0.01872192647982958,-318.4837775472302,-0.08981065691402393
2023-09-04T10:30:00-04:00,1.07908,1.07911,1.07881,1.07896,1.080325522180581,1.0794495555555554,1.0796311111111043,1.079847999999993,1.0799390000000035,1.0793967999999996,1.0788815000000027,1.0817809000000063,1.0795058740779373,1.0798121261232378,-1445,-465689,-464100.4,-0.025200112705787345,-318.64446998894,-0.0842694027984819
2023-09-04T10:45:00-04:00,1.07896,1.07896,1.07833,1.07843,1.080216590849746,1.0792093333333332,1.0794922222222154,1.0797322222222152,1.0798880000000033,1.0793965999999997,1.0788131000000027,1.0817359000000062,1.0792906992623499,1.07964610089859,-1645,-467334,-465193.8,-0.032980247569906536,-319.4525166264427,-0.1157750444576146
2023-09-04T11:00:00-04:00,1.07843,1.07888,1.07833,1.07874,1.0800656635817665,1.079058888888889,1.0793822222222156,1.0796155555555487,1.0798285000000032,1.0793985999999998,1.0787612000000029,1.0816996000000063,1.07918055940988,1.0794804807188718,1358,-465976,-465702,-0.038555332612853606,-319.06215285688876,-0.09168958906393694
2023-09-04T11:15:00-04:00,1.07874,1.0790899999999999,1.07847,1.07903,1.079926810495225,1.0789884444444444,1.079247777777771,1.0794971111111042,1.0797690000000033,1.0794077999999996,1.078735900000003,1.0816643500000063,1.079150447527904,1.0793539845750972,1165,-464811,-465610.8,-0.041070578066080506,-318.7489633951094,-0.11201214544917382
2023-09-04T11:30:00-04:00,1.07903,1.0792,1.07902,1.07917,1.0797990656556071,1.078972888888889,1.0791355555555486,1.0793777777777709,1.0797115000000033,1.0794217999999995,1.078713400000003,1.0816339000000061,1.079154358022323,1.0792563876600776,678,-464133,-465588.6,-0.04635152627042918,-318.66099549801663,-0.09350293469606505
2023-09-04T11:45:00-04:00,1.07917,1.07995,1.07912,1.07989,1.07833,1.0791237777777778,1.0790822222222154,1.0792679999999932,1.0796820000000031,1.0794499999999996,1.078704000000003,1.0816086500000062,1.0793014864178585,1.0792155101280618,1058,-463075,-465065.8,-0.04714185159093558,-317.95511968604995,-0.04442922332164313
2023-09-04T12:00:00-04:00,1.07989,1.08001,1.0795,1.0796,1.0783624,1.0792273333333333,1.0790866666666599,1.079186888888882,1.0796300000000034,1.0794711999999995,1.0787038000000029,1.0815824500000062,1.0793611891342867,1.0792296081024495,-697,-463772,-464353.4,-0.05039420920851955,-318.1422961577277,0.0037052132350048127
2023-09-04T12:15:00-04:00,1.0796,1.07964,1.07938,1.07949,1.078428304,1.079308,1.0791544444444376,1.0791413333333264,1.0795735000000035,1.0794893999999997,1.078705900000003,1.0815533000000064,1.0793869513074295,1.0792708864819591,-547,-464319,-464022,-0.04597282385499574,-318.1980297627665,0.05654011567551529
2023-09-04T12:30:00-04:00,1.07949,1.0796,1.07947,1.0795299999999999,1.07849157184,1.0793831111111112,1.0792044444444377,1.0791326666666596,1.0795245000000036,1.0795137999999997,1.078712000000003,1.0815301000000064,1.0794155610459435,1.079323909185567,347,-463972,-463854.2,-0.03514622204555015,-318.18517183911746,0.04170219075507278
2023-09-04T12:45:00-04:00,1.0795299999999999,1.0795299999999999,1.0792,1.07939,1.0785523089664002,1.0794202222222222,1.0792522222222156,1.079155999999993,1.0794935000000034,1.0795379999999997,1.078719400000003,1.0814997500000063,1.0794104488367549,1.0793751273484535,-583,-464555,-463938.6,-0.027335830626127124,-318.26077881622774,0.039853191962644814
2023-09-04T13:00:00-04:00,1.07939,1.07955,1.07928,1.07951,1.0786106166077443,1.0794717777777778,1.0793722222222157,1.0792139999999932,1.0794665000000037,1.0795627999999997,1.078731400000003,1.0814749500000063,1.0794303590694039,1.0794009018787627,148,-464407,-464205,-0.02003583688638482,-318.2443250784685,0.10014558200346521
2023-09-04T13:15:00-04:00,1.07951,1.07955,1.07949,1.0795,1.0786665919434344,1.0794973333333333,1.07945666666666,1.0792879999999934,1.0794480000000035,1.0795791999999997,1.078742400000003,1.0814484500000063,1.079444287255523,1.07941752150301,-79,-464486,-464347.8,-0.007697794724995242,-318.24505689197645,0.07045256502955966
2023-09-04T13:30:00-04:00,1.0795,1.0796,1.07949,1.0796,1.078720328265697,1.079526,1.0795199999999936,1.0793611111111043,1.0794440000000036,1.0795959999999996,1.0787573000000028,1.0814273500000062,1.0794754298044185,1.0794352172024078,254,-464232,-464330.4,0.0014601721505244879,-318.22152748021176,0.05282522265367594
2023-09-04T13:45:00-04:00,1.0796,1.07961,1.07949,1.07949,1.078771915135069,1.07952,1.0795555555555492,1.0794313333333267,1.0794320000000037,1.0796093999999996,1.078768300000003,1.0814055000000062,1.0794783438435347,1.0794477737619261,-130,-464362,-464408.4,0.006559801168091529,-318.2347731267475,0.029652418062038232
2023-09-04T14:00:00-04:00,1.07949,1.07955,1.07949,1.07954,1.0788214385296662,1.0795168888888889,1.0795166666666602,1.0794842222222156,1.0793970000000037,1.0796225999999998,1.078778000000003,1.0813824000000063,1.0794906750748277,1.0794638190095407,202,-464160,-464329.4,0.010825747810592846,-318.225416856657,-0.03241070849809448
2023-09-04T14:15:00-04:00,1.07954,1.07959,1.07948,1.07954,1.0788689809884795,1.0795215555555555,1.0795099999999935,1.0795117777777712,1.0793650000000037,1.0796397999999996,1.078785900000003,1.0813618000000063,1.079500540059862,1.0794778552076323,0,-464160,-464280,0.010671675898913406,-318.225416856657,-0.005557613931080862
2023-09-04T14:30:00-04:00,1.07954,1.07964,1.07954,1.07957,1.0789146217489403,1.0795335555555556,1.0795188888888825,1.0795242222222157,1.0793250000000039,1.0796583999999996,1.0787946000000028,1.0813400000000062,1.0795144320478895,1.0794918841661059,141,-464019,-464186.6,0.013085176736144875,-318.2214985210696,0.007410907002367595
2023-09-04T14:45:00-04:00,1.07957,1.07959,1.07952,1.0795299999999999,1.0789584368789826,1.0795357777777779,1.0795188888888823,1.0795239999999935,1.0793235000000037,1.0796681999999995,1.078805500000003,1.0813184000000065,1.0795175456383117,1.0795003073328844,-158,-464177,-464175.6,0.017162246763331706,-318.2273527037534,0
2023-09-04T15:00:00-04:00,1.0795299999999999,1.0795299999999999,1.07935,1.07936,1.0790004994038234,1.079504,1.0795155555555491,1.0795159999999935,1.0793475000000037,1.0796729999999997,1.0788156000000029,1.0812932000000064,1.0794860365106493,1.0795018458663073,-119,-464296,-464162.4,0.016469725573932927,-318.24609234044715,-0.0027793475944722936
2023-09-04T15:15:00-04:00,1.07936,1.0794,1.07931,1.07934,1.0790408794276705,1.0794688888888888,1.07949666666666,1.0795119999999934,1.0793605000000037,1.0796797999999996,1.0788315000000028,1.0812680000000063,1.0794568292085194,1.0794950766930458,-63,-464359,-464202.2,0.01397670284838465,-318.2472596988818,-0.015747885614769988
2023-09-04T15:30:00-04:00,1.07934,1.07938,1.07933,1.07934,1.0790796442505637,1.0794375555555555,1.0794788888888822,1.079505777777771,1.0793795000000037,1.0796769999999996,1.0788475000000028,1.0812401000000063,1.0794334633668154,1.0794816613544365,0,-464359,-464242,0.011254469692350541,-318.2472596988818,-0.014821676702171188
2023-09-04T15:45:00-04:00,1.07934,1.0794,1.07928,1.07938,1.079116858480541,1.0794177777777778,1.0794544444444378,1.0794928888888822,1.0794270000000037,1.0796547999999995,1.0788627000000028,1.0812125500000063,1.0794227706934523,1.079463329083549,191,-464168,-464271.8,0.008289594948291765,-318.240181299119,-0.02037791774730335
2023-09-04T16:00:00-04:00,1.07938,1.07969,1.07937,1.07944,1.0791525841413194,1.0794148888888888,1.0794488888888825,1.079478888888882,1.0794620000000035,1.0796383999999994,1.078880800000003,1.0811843000000063,1.079426216554762,1.079445063266839,258,-463910,-464218.4,0.0023513343494002696,-318.2258397326642,-0.0046318168764977454
2023-09-04T16:15:00-04:00,1.07944,1.07962,1.07942,1.07958,1.0791868807756666,1.0794411111111109,1.079453333333327,1.0794664444444377,1.0794895000000035,1.0796399999999995,1.078902800000003,1.0811554500000062,1.0794569732438095,1.079439250613471,170,-463740,-464107.2,-0.0005205387838767776,-318.2037912630874,0.003705281879322675
2023-09-04T16:30:00-04:00,1.07958,1.07965,1.07954,1.07961,1.07921980554464,1.0794724444444443,1.0794611111111045,1.0794593333333267,1.0795115000000037,1.0796357999999995,1.0789262000000028,1.0811300000000061,1.0794875785950475,1.0794454004907768,110,-463630,-463961.4,-0.0024305892522216038,-318.20073451879796,0.006484243288809539
2023-09-04T16:45:00-04:00,1.07961,1.07967,1.07938,1.07938,1.0792514133228543,1.0794562222222222,1.0794399999999935,1.0794515555555488,1.0794860000000037,1.0796369999999995,1.0789449000000029,1.0811039500000061,1.079466062876038,1.079451920392621,-187,-463817,-463853,-0.004839077513661838,-318.24057297898264,-0.017599599840669198
2023-09-04T17:00:00-04:00,1.07938,1.07939,1.07903,1.07915,1.08001,1.079398222222222,1.0793977777777712,1.0794402222222157,1.0794635000000037,1.0796315999999997,1.0789597000000029,1.0810753000000062,1.0794028503008304,1.0794479363140967,-63,-463880,-463795.4,-0.005465645177482159,-318.25399735223397,-0.03520050392298731
2023-09-04T17:15:00-04:00,1.07915,1.07934,1.07907,1.07928,1.0799904,1.0793746666666666,1.0793888888888825,1.0794282222222158,1.0794530000000038,1.0796215999999996,1.078975400000003,1.0810475000000062,1.0793782802406644,1.0794383490512773,63,-463817,-463776.8,-0.006370058958089706,-318.24640804583544,-0.007411799584946635
2023-09-04T17:30:00-04:00,1.07928,1.0795299999999999,1.07927,1.07938,1.079971192,1.079372888888889,1.079393333333327,1.0794162222222157,1.0794455000000038,1.0796207999999996,1.0789952000000027,1.081019450000006,1.0793786241925316,1.0794226792410218,184,-463633,-463755.4,-0.005699554093444973,-318.22935964319663,0.003705968462212093
2023-09-04T17:45:00-04:00,1.07938,1.07952,1.07935,1.07945,1.0799523681599998,1.0793842222222223,1.079405555555549,1.0794051111111045,1.0794485000000038,1.0796141999999995,1.079016600000003,1.080994900000006,1.0793928993540254,1.0794037433928172,158,-463475,-463724.4,-0.004327617877717112,-318.21911302013524,0.010191413271078113
2023-09-04T18:00:00-04:00,1.07945,1.07977,1.0794,1.07975,1.0799339207968,1.0794531111111112,1.07944666666666,1.079406444444438,1.0794605000000037,1.0796153999999996,1.0790373000000029,1.0809714500000063,1.0794643194832203,1.0794033947142538,235,-463240,-463609,-0.0021174552420186463,-318.15380198210664,0.034278937908797776
2023-09-04T18:15:00-04:00,1.07975,1.07978,1.07964,1.07967,1.079915842380864,1.0794977777777777,1.0794722222222157,1.079421333333327,1.0794690000000036,1.0796197999999995,1.0790580000000027,1.0809487000000062,1.0795054555865762,1.0794239157714032,-184,-463424,-463517.8,-0.00013675135225788178,-318.16743476747365,0.02130734454902102
2023-09-04T18:30:00-04:00,1.07967,1.07968,1.07944,1.07952,1.0798981255332467,1.0795073333333334,1.079465555555549,1.0794366666666604,1.0794650000000037,1.0796115999999996,1.079077000000003,1.0809249500000062,1.079508364469261,1.0794499326171223,-156,-463580,-463470.4,0.0005161256172979395,-318.18910805653417,-0.005557716889896903
2023-09-04T18:45:00-04:00,1.07952,1.07952,1.07945,1.07946,1.0798807630225817,1.0795062222222223,1.0794488888888825,1.0794477777777713,1.0794635000000035,1.0795963999999996,1.0790974000000029,1.080900600000006,1.0794986915754088,1.0794739460936977,-59,-463639,-463471.6,0.00002205678681724218,-318.1923872917498,-0.013893906132758354
2023-09-04T19:00:00-04:00,1.07946,1.07946,1.0793,1.07937,1.07986374776213,1.0794904444444446,1.0794477777777713,1.0794562222222157,1.0794550000000034,1.0795773999999996,1.079115700000003,1.0808761000000062,1.079472953260327,1.079489956874958,-323,-463962,-463569,-0.0016719132684437001,-318.2193174234824,-0.0009264577813249747
2023-09-04T19:15:00-04:00,1.07937,1.0795,1.07936,1.07941,1.0798470728068874,1.0794828888888888,1.0794766666666602,1.0794622222222157,1.0794485000000036,1.0795559999999995,1.0791373000000029,1.0808514500000062,1.0794603626082617,1.0794891654999663,287,-463675,-463656,-0.0008205215073424062,-318.20868158961633,0.02409303618588027
2023-09-04T19:30:00-04:00,1.07941,1.07947,1.0793,1.07943,1.0798307313507496,1.0794735555555555,1.0794933333333268,1.0794664444444382,1.0794415000000037,1.0795317999999996,1.0791581000000028,1.0808277500000063,1.0794542900866093,1.079478932399973,316,-463359,-463643,0.002258650809327407,-318.2028265391721,0.013898154325093809
2023-09-04T19:45:00-04:00,1.07943,1.07943,1.0791,1.07912,1.0798147167237346,1.0793988888888888,1.0794644444444377,1.0794662222222158,1.0794210000000037,1.0795017999999998,1.079175900000003,1.0808023500000061,1.0793874320692876,1.0794547459199784,-568,-463927,-463712.4,0.0027616083503486707,-318.365949668972,-0.02408790231428477
2023-09-04T20:00:00-04:00,1.07912,1.07924,1.07899,1.0790899999999999,1.07979902238926,1.079324,1.0794244444444379,1.079461333333327,1.0794075000000034,1.0794733999999997,1.079191800000003,1.080775950000006,1.07932794565543,1.0794205967359827,-1119,-465046,-463993.8,0.0020161014600098685,-318.39705835011983,-0.0333503172912259
2023-09-04T20:15:00-04:00,1.0790899999999999,1.07919,1.07886,1.07895,1.0797666614936896,1.079229111111111,1.079335555555549,1.0794388888888826,1.0793880000000036,1.0794521999999995,1.0792097000000027,1.0807489500000063,1.0792523565243441,1.079376477388786,-1031,-466077,-464416.8,-0.0008073375065225821,-318.5308192041726,-0.07409122482055215
2023-09-04T20:30:00-04:00,1.07895,1.07918,1.07894,1.07911,1.0797122618040682,1.079184,1.0792733333333269,1.0793982222222156,1.0793765000000035,1.0794333999999999,1.079226800000003,1.0807233000000063,1.0792238852194753,1.0793291819110287,884,-465193,-464720.4,-0.005722007493480512,-318.39972879219806,-0.05186770031582742
2023-09-04T20:45:00-04:00,1.07911,1.07937,1.07905,1.07931,1.0796611260958242,1.0791913333333332,1.0792499999999936,1.079349555555549,1.0793730000000035,1.0794221999999996,1.0792444000000028,1.0806989000000062,1.0792411081755802,1.0792865455288227,1014,-464179,-464884.4,-0.008924931750226541,-318.2117961439973,-0.019453090262342845
2023-09-04T21:00:00-04:00,1.07931,1.07935,1.07904,1.07921,1.0796130585300747,1.0791833333333334,1.0792222222222156,1.0793011111111046,1.0793615000000034,1.0794127999999996,1.0792619000000028,1.0806730500000061,1.0792348865404642,1.0792560364230581,-859,-465038,-465106.6,-0.011047057198681294,-318.2913840288496,-0.023159728012161956
2023-09-04T21:15:00-04:00,1.07921,1.07966,1.07905,1.07966,1.07886,1.079270888888889,1.0792544444444379,1.0792671111111045,1.0793655000000035,1.0794113999999997,1.0792841000000029,1.0806489500000063,1.0793199092323713,1.0792544291384465,923,-464115,-464920.4,-0.010164605730800993,-317.906519174002,0.026867524574531766
2023-09-04T21:30:00-04:00,1.07966,1.07983,1.07904,1.0791,1.078876,1.07924,1.0792199999999934,1.0792439999999934,1.0793400000000033,1.0793885999999997,1.0792978000000029,1.0806220500000063,1.079275927385897,1.079259143310757,-1660,-465775,-464860,-0.010548648859414408,-318.7675309740133,-0.028719393001735437
2023-09-04T21:45:00-04:00,1.0791,1.0791,1.0785,1.07887,1.07983,1.0791699999999997,1.0791577777777712,1.0792208888888823,1.0793145000000035,1.0793624,1.0793078000000027,1.0805952500000062,1.0791947419087176,1.0792533146486054,-2050,-467825,-465386.4,-0.012287304985635284,-319.204469163245,-0.05187923255791427
2023-09-04T22:00:00-04:00,1.07887,1.07889,1.07856,1.07866,1.07983,1.0790704444444443,1.07910666666666,1.0791922222222154,1.0792900000000034,1.0793281999999997,1.0793155000000028,1.0805683000000064,1.079087793526974,1.079222651718884,-1432,-469257,-466402,-0.016245347993007343,-319.4832052482229,-0.04262732596932009
2023-09-04T22:15:00-04:00,1.07866,1.07879,1.07852,1.07862,1.0798034,1.0789731111111112,1.0790544444444379,1.07915866666666,1.0792570000000035,1.0793093999999999,1.0793199000000027,1.0805415000000063,1.0789942348215793,1.0791745213751072,-1367,-470624,-467519.2,-0.01854007294224985,-319.5338977741347,-0.043555217822421714
2023-09-04T22:30:00-04:00,1.07862,1.07863,1.07833,1.07844,1.0797773320000001,1.0788502222222223,1.0789977777777713,1.0791073333333265,1.0792100000000036,1.0793005999999998,1.0793264000000027,1.0805147000000064,1.0788833878572635,1.0790872171000856,-1259,-471883,-469072.8,-0.020857252031414728,-319.7439995708748,-0.04726817739469025
2023-09-04T22:45:00-04:00,1.07844,1.07882,1.07844,1.07873,1.0797194387200002,1.0787966666666666,1.078955555555549,1.0790544444444379,1.0791740000000034,1.0792935999999997,1.0793372000000028,1.0804895000000063,1.0788527102858108,1.0790025736800684,1654,-470229,-469963.6,-0.020028301724171027,-319.2992274926879,-0.03521420429799066
2023-09-04T23:00:00-04:00,1.07873,1.07876,1.07817,1.07818,1.0796638611712002,1.0786415555555555,1.0788299999999935,1.0789888888888823,1.0790955000000033,1.0792779999999997,1.0793374000000027,1.0804555000000062,1.0787181682286486,1.0789072589440545,-1009,-471238,-470646.2,-0.02304332515774167,-319.813675037486,-0.1046965190723773
2023-09-04T23:15:00-04:00,1.07818,1.07875,1.07807,1.07863,1.079574229500928,1.0786015555555555,1.0787655555555489,1.0789206666666602,1.0790435000000034,1.0792819999999999,1.0793393000000027,1.0804237000000063,1.0787005345829188,1.0788298071552433,1224,-470014,-470797.6,-0.02440365498764947,-319.30281414227363,-0.05374301572446743
2023-09-04T23:30:00-04:00,1.07863,1.07886,1.07857,1.07885,1.0794538911408538,1.0786184444444444,1.0786755555555487,1.0788448888888822,1.0790100000000034,1.0792841999999998,1.0793414000000028,1.0803950500000064,1.078730427666335,1.0787770457241945,755,-469259,-470524.6,-0.024122098595852074,-319.14882250473335,-0.07502361854657738
2023-09-04T23:45:00-04:00,1.07885,1.07886,1.07861,1.07884,1.0793431798495854,1.0786513333333334,1.0786466666666599,1.0787746666666602,1.0789790000000035,1.0792803999999998,1.0793441000000028,1.0803661000000064,1.078752342133068,1.0787508365793554,-746,-470005,-470149,-0.0287214286216264,-319.1557372750907,-0.02409415253451274
2023-09-05T00:00:00-04:00,1.07884,1.07893,1.07868,1.07873,1.0792413254616187,1.0786680000000002,1.0786311111111044,1.0787097777777714,1.0789470000000034,1.0792715999999998,1.0793467000000028,1.0803347500000064,1.0787478737064544,1.0787298692634844,-966,-470971,-470297.4,-0.028929783377223142,-319.2542319545613,-0.012976540268987828
2023-09-05T00:15:00-04:00,1.07873,1.07908,1.0786499999999999,1.07908,1.0791476194246892,1.0787577777777777,1.078677777777771,1.0786793333333269,1.0789305000000033,1.0792553999999996,1.0793527000000027,1.0803054500000064,1.0788142989651635,1.0787490954107872,791,-470180,-470085.8,-0.02570392293740624,-318.9975875671798,0.03893719985909248
2023-09-05T00:30:00-04:00,1.07908,1.0794,1.07893,1.07935,1.07807,1.0788922222222224,1.0787588888888822,1.0786779999999934,1.0789265000000035,1.0792503999999996,1.0793608000000028,1.0802796000000066,1.0789214391721307,1.0787932763286296,1163,-469017,-469886.4,-0.01904407987276438,-318.70658968009076,0.06767907140606697
2023-09-05T00:45:00-04:00,1.07935,1.07936,1.07902,1.07921,1.0780966,1.0789824444444445,1.0788444444444378,1.0787117777777713,1.0789310000000034,1.0792447999999997,1.0793671000000027,1.0802537000000065,1.0789791513377045,1.0788430210629034,-1023,-470040,-470042.6,-0.012604964131227999,-318.8392806515088,0.07139942880456375
2023-09-05T01:00:00-04:00,1.07921,1.07937,1.07898,1.079,1.078122668,1.0790135555555556,1.0788744444444376,1.078757333333327,1.0789265000000037,1.0792341999999997,1.0793740000000027,1.0802282500000064,1.0789833210701636,1.0788892168503226,-1391,-471431,-470327.8,-0.006885100906201116,-319.10995086397907,0.025029432758891704
2023-09-05T01:15:00-04:00,1.079,1.07902,1.07869,1.07876,1.07814821464,1.0789906666666667,1.0789388888888822,1.0788188888888823,1.0789170000000037,1.0792215999999997,1.0793798000000028,1.0802013000000066,1.0789386568561308,1.0789273734802578,-1208,-472639,-470661.4,-0.005150660118422345,-319.3786440984554,0.05379435715743429
2023-09-05T01:30:00-04:00,1.07876,1.07881,1.07819,1.07839,1.0781732503472001,1.0788808888888892,1.0789122222222156,1.0788657777777713,1.0788810000000035,1.0791991999999997,1.0793810000000028,1.0801725500000066,1.0788289254849046,1.078930298784206,-1005,-473644,-471354.2,-0.0007326741323450708,-319.7233454221975,-0.02225044732670313
2023-09-05T01:45:00-04:00,1.07839,1.07861,1.07821,1.07858,1.07819,1.0788144444444445,1.0788822222222154,1.078890444444438,1.0788445000000035,1.0791807999999998,1.079380000000003,1.0801445500000064,1.0787791403879237,1.0789018390273646,2028,-471616,-471874,0.001143174936904044,-319.36603498719694,-0.02502664874634958
2023-09-05T02:00:00-04:00,1.07858,1.07863,1.07803,1.07805,1.0794,1.0786479999999998,1.0787944444444377,1.078880444444438,1.0787865000000034,1.0791497999999997,1.079372900000003,1.0801149000000065,1.0786333123103389,1.0788326712218916,-3311,-474927,-472851.4,-0.0007106617803794542,-320.9930167595277,-0.07322679915465392
2023-09-05T02:15:00-04:00,1.07805,1.07813,1.0762099999999999,1.07677,1.0793726,1.0782431111111113,1.0785766666666599,1.0788208888888824,1.0786420000000034,1.0790953999999997,1.0793524000000028,1.0800785000000064,1.0782606498482712,1.078688136977513,-3483,-478410,-474247.2,-0.009129235183498527,-325.1284835746103,-0.18169514150899316
2023-09-05T02:30:00-04:00,1.07677,1.07688,1.07577,1.07668,1.0792460959999999,1.0778637777777778,1.0783099999999932,1.0786951111111045,1.0785210000000034,1.0790381999999996,1.0793304000000028,1.0800404000000063,1.077944519878617,1.0784893095820103,-3069,-481479,-476015.2,-0.014980449916572276,-325.38500075098017,-0.2224116840271303
2023-09-05T02:45:00-04:00,1.07668,1.07691,1.0762,1.0766499999999999,1.07903753024,1.0775317777777778,1.078009999999993,1.07851466666666,1.0784100000000034,1.0789803999999996,1.0793101000000027,1.0800004000000065,1.0776856159028936,1.078260647665608,-3139,-484618,-478210,-0.026696610201395386,-325.4724640641286,-0.2501505535739238
2023-09-05T03:00:00-04:00,1.0766499999999999,1.07717,1.07649,1.07688,1.0788414784256,1.0773057777777777,1.0777511111111042,1.0782884444444378,1.0783210000000034,1.0789265999999997,1.0792925000000029,1.0799617500000067,1.0775244927223149,1.0780097181324861,4211,-480407,-479968.2,-0.0408168131882851,-324.572886671289,-0.21589866661724255
2023-09-05T03:15:00-04:00,1.07688,1.07691,1.07607,1.07615,1.0786571897200639,1.0769855555555554,1.0774344444444375,1.0780164444444378,1.0781975000000035,1.0788589999999996,1.0792636000000027,1.0799192500000065,1.077249594177852,1.077732974505989,-4266,-484673,-481917.4,-0.05811619440700494,-327.4647409168879,-0.26413345690454304
2023-09-05T03:30:00-04:00,1.07615,1.07659,1.07582,1.07624,1.07848395833686,1.0767466666666665,1.0771544444444374,1.0777319999999935,1.0780875000000034,1.0787965999999998,1.0792348000000027,1.0798769500000065,1.0770476753422815,1.0774903796047908,3421,-481252,-482485.8,-0.0732105163425927,-327.17863767849127,-0.2336015425117594
2023-09-05T03:45:00-04:00,1.07624,1.07675,1.07544,1.07565,1.0783211208366483,1.0764457777777776,1.076849999999993,1.0774399999999933,1.0779335000000034,1.0787227999999998,1.079201300000003,1.0798323000000065,1.0767681402738252,1.0772551036838327,-3816,-485068,-483203.6,-0.08974528876965861,-329.2705874294765,-0.25408247480039364
2023-09-05T04:00:00-04:00,1.07565,1.07588,1.0751,1.07534,1.0780906311697165,1.0761437777777778,1.0764899999999928,1.0771359999999932,1.0777915000000031,1.0786428,1.0791599000000027,1.0797881500000066,1.0764825122190602,1.077014482947066,-4149,-489217,-484123.4,-0.10307939247151136,-330.4663202421945,-0.30039496374864466
2023-09-05T04:15:00-04:00,1.07534,1.07535,1.07418,1.0742,1.0777915680527448,1.0756857777777777,1.0760622222222151,1.0767982222222154,1.0775700000000032,1.0785391999999998,1.0790970000000029,1.0797441500000065,1.076026009775248,1.0767147863576525,-3252,-492469,-486535.8,-0.12615537849461858,-333.91386241490244,-0.3571262928435517
2023-09-05T04:30:00-04:00,1.0742,1.07541,1.0742,1.07539,1.0773581798864154,1.0755513333333333,1.0759088888888817,1.0764931111111042,1.0773970000000033,1.0784581999999998,1.0790483000000028,1.0797030500000064,1.0758988078201985,1.0764446290861218,3268,-489201,-487441.4,-0.1365416835527557,-330.293568242495,-0.1281610743241302
2023-09-05T04:45:00-04:00,1.07539,1.07542,1.07481,1.07483,1.0769767983000456,1.0753355555555555,1.0757033333333264,1.0762028888888822,1.077196500000003,1.0783631999999999,1.0790016000000027,1.0796525000000066,1.075685046256159,1.0761721032688973,-2853,-492054,-489601.8,-0.13680464417023555,-331.7792432069268,-0.17182449752945436
2023-09-05T05:00:00-04:00,1.07483,1.07556,1.07466,1.07555,1.07664118250404,1.075304888888889,1.075581111111104,1.0759491111111044,1.077037500000003,1.0782819999999997,1.0789589000000026,1.0796065000000066,1.0756580370049271,1.0759500826151176,2422,-489632,-490514.6,-0.13277051461814557,-330.1568098918908,-0.10216876422234514
2023-09-05T05:15:00-04:00,1.07555,1.0756999999999999,1.0748199999999999,1.0749,1.0763458406035553,1.0751686666666664,1.075361111111104,1.0757233333333265,1.0768285000000029,1.0781923999999998,1.0789147000000028,1.0795542500000064,1.0755064296039416,1.075754866092094,-2249,-491881,-491047.4,-0.1321076334306354,-331.51597497022294,-0.18386449743704894
2023-09-05T05:30:00-04:00,1.0749,1.07516,1.07445,1.07472,1.0760859397311286,1.0750404444444446,1.075202222222215,1.0755513333333266,1.0765970000000027,1.0781037999999996,1.0788677000000026,1.0794991000000065,1.0753491436831533,1.0756194928736749,-2071,-493952,-491344,-0.1329114791767805,-331.86277932411645,-0.13288110393532895
2023-09-05T05:45:00-04:00,1.07472,1.0754,1.07468,1.07483,1.0758572269633933,1.0749659999999999,1.0750455555555483,1.0753786666666598,1.0763780000000027,1.0780147999999996,1.0788182000000026,1.0794453000000066,1.0752453149465226,1.07548879429894,2562,-491390,-491781.8,-0.1252058564755289,-331.60055288374116,-0.13101167025943408
2023-09-05T06:00:00-04:00,1.07483,1.07488,1.07433,1.07473,1.0756559597277862,1.074902888888889,1.074943333333326,1.07522666666666,1.0761645000000029,1.0779217999999997,1.0787713000000025,1.0793919500000064,1.075142251957218,1.0753802354391515,-1717,-493107,-491992.4,-0.11943922496327501,-331.76029907616226,-0.0855296797285392
2023-09-05T06:15:00-04:00,1.07473,1.07492,1.07451,1.0746,1.0754788445604517,1.0748342222222222,1.0748611111111037,1.0750826666666597,1.0759565000000029,1.0778247999999997,1.0787195000000027,1.0793400500000065,1.0750338015657743,1.0752553883513212,-2117,-495224,-493110.8,-0.10974918454756358,-332.01637269465243,-0.06881544441757612
2023-09-05T06:30:00-04:00,1.0746,1.0748,1.07433,1.07436,1.0753229832131974,1.074734,1.0748788888888816,1.0749862222222153,1.075755000000003,1.0777169999999996,1.0786662000000027,1.0792868500000066,1.0748990412526194,1.0751339106810567,-1820,-497044,-494143.4,-0.09940474003775923,-332.42284952323985,0.01489480543659821
2023-09-05T06:45:00-04:00,1.07436,1.07457,1.07384,1.07395,1.0751858252276136,1.0745482222222222,1.0747188888888817,1.0748895555555484,1.0755235000000027,1.0776025999999996,1.0786112000000025,1.0792324000000064,1.0747092330020955,1.0750059285448452,-2009,-499053,-495163.6,-0.08209287243136297,-333.18952922092035,-0.1339049089167751
2023-09-05T07:00:00-04:00,1.07395,1.07399,1.07349,1.0737,1.0749974096957478,1.0743444444444443,1.0745933333333262,1.0747991111111044,1.0753060000000028,1.0774861999999998,1.0785489000000026,1.0791766000000065,1.0745073864016765,1.074858342835876,-2295,-501348,-497155.2,-0.0762171025101119,-333.72377196965135,-0.10513290473841011
2023-09-05T07:15:00-04:00,1.0737,1.07375,1.0729,1.07331,1.0747562241444282,1.0740877777777778,1.0743444444444372,1.0746793333333264,1.0751330000000028,1.0773631999999997,1.0784798000000024,1.0791160000000066,1.0742679091213412,1.0746834742687006,-2436,-503784,-499290.6,-0.06937730491848876,-334.6086001339433,-0.20826553856166796
2023-09-05T07:30:00-04:00,1.07331,1.07386,1.0733,1.07352,1.0744221037984312,1.073922888888889,1.074191111111104,1.0745453333333266,1.0749750000000027,1.0772461999999998,1.0784118000000025,1.0790582000000066,1.074118327297073,1.0745003794149601,2479,-501305,-500506.8,-0.07387432240509732,-334.1235678506327,-0.12838403572424756
2023-09-05T07:45:00-04:00,1.07352,1.07378,1.07321,1.07325,1.0741481251147136,1.0737346666666665,1.0740277777777705,1.0743751111111042,1.0748050000000027,1.0771229999999996,1.0783395000000024,1.0789998000000065,1.0739446618376582,1.074309503531968,-2159,-503464,-501790.8,-0.07404060205316292,-334.6665758989224,-0.13677981241624426
2023-09-05T08:00:00-04:00,1.07325,1.07352,1.07307,1.0734299999999999,1.0739234625940652,1.0736151111111112,1.0738722222222148,1.0742057777777707,1.074632500000003,1.077003,1.0782674000000023,1.0789426000000064,1.0738417294701266,1.0741360028255742,2688,-500776,-502135.4,-0.07178705094859535,-334.2157582888599,-0.1302531563130977
2023-09-05T08:15:00-04:00,1.0734299999999999,1.07353,1.07225,1.07242,1.07378,1.0733246666666667,1.073615555555548,1.0740102222222152,1.074446000000003,1.0768689999999999,1.0781854000000024,1.0788823500000064,1.0735573835761012,1.0739460022604592,-3365,-504141,-502694,-0.07446464823709649,-337.38191723727743,-0.21493770528412107
2023-09-05T08:30:00-04:00,1.07242,1.07373,1.07165,1.07311,1.07165,1.0732235555555556,1.0734499999999925,1.0738313333333263,1.0742895000000028,1.0767493999999997,1.0781114000000025,1.0788244500000064,1.073467906860881,1.0737860018083674,6013,-498128,-501562.8,-0.07607914713326133,-333.51312515954623,-0.13865624418388156
2023-09-05T08:45:00-04:00,1.07311,1.07481,1.07249,1.0744,1.07165,1.0734135555555555,1.0734544444444367,1.0736839999999928,1.0742270000000027,1.0766583999999997,1.0780553000000026,1.0787735500000064,1.0736543254887048,1.0736932014466936,9614,-488514,-499004.6,-0.06979107888697711,-321.95600613167386,0.0037231468036821925
2023-09-05T09:00:00-04:00,1.0744,1.07487,1.07333,1.07339,1.07165,1.0734006666666667,1.0733922222222145,1.0735568888888816,1.0741295000000028,1.0765439999999997,1.0779887000000026,1.0787185500000063,1.0736014603909638,1.0736245611573547,-8058,-496572,-497626.2,-0.06880950512725559,-329.5310061316735,-0.05214395456025829
2023-09-05T09:15:00-04:00,1.07339,1.0747,1.07331,1.07454,1.0718432,1.0736302222222223,1.0734855555555478,1.0734795555555483,1.0741465000000028,1.0764485999999998,1.0779354000000025,1.0786668500000063,1.0737891683127712,1.0736140489258839,5470,-491102,-495691.4,-0.05977267498107318,-323.67060124621725,0.07823414361553058
2023-09-05T09:30:00-04:00,1.07454,1.07473,1.07329,1.07339,1.072024808,1.073611111111111,1.0734944444444368,1.0734553333333259,1.0740465000000028,1.0763321999999997,1.0778725000000025,1.0786131500000062,1.073709334650217,1.073644439140707,-7020,-498122,-494487.6,-0.059069919206471824,-331.1835835456197,0.0074535781833841115
2023-09-05T09:45:00-04:00,1.07339,1.07395,1.07257,1.07291,1.0721955195200001,1.0734942222222221,1.073426666666659,1.0734506666666594,1.0739505000000027,1.0761971999999997,1.0778043000000026,1.0785611000000062,1.0735494677201736,1.0736607513125656,-6912,-505034,-495868.8,-0.05180492545814446,-334.27450110587296,-0.0568224159773455
2023-09-05T10:00:00-04:00,1.07291,1.07301,1.07189,1.07197,1.07487,1.073202888888889,1.073284444444437,1.0734166666666591,1.0737715000000028,1.0760545999999998,1.0777216000000025,1.0784994000000063,1.073233574176139,1.0735766010500523,-7625,-512659,-500697.8,-0.053563082402389724,-340.95493096485416,-0.1192639180060515
2023-09-05T10:15:00-04:00,1.07197,1.0727,1.07168,1.0725,1.0748104,1.073046,1.0731811111111036,1.073374444444437,1.0736515000000026,1.0759271999999998,1.0776448000000025,1.0784404500000064,1.073086859340911,1.0734736808400416,5409,-507250,-502833.4,-0.04702870729130681,-338.2806303780844,-0.08663815991726292
2023-09-05T10:30:00-04:00,1.0725,1.07272,1.07139,1.07145,1.074685184,1.0726997777777778,1.0730733333333258,1.0732919999999928,1.0734880000000027,1.075783,1.0775556000000026,1.0783696000000063,1.0727594874727289,1.0732677446720333,-5020,-512270,-507067,-0.050176362461893685,-343.1953156927697,-0.09044963726897255
2023-09-05T10:45:00-04:00,1.07145,1.0715999999999999,1.07073,1.07084,1.07448747296,1.0722531111111113,1.0728211111111037,1.0731573333333262,1.0732885000000028,1.0756273999999997,1.0774684000000025,1.0782918000000061,1.072375589978183,1.0730009957376265,-6270,-518540,-511150.6,-0.04769172071706687,-346.76496429979755,-0.2115346982136029
2023-09-05T11:00:00-04:00,1.07084,1.07152,1.07059,1.07131,1.0741868751232,1.071950888888889,1.0724777777777703,1.0729675555555485,1.0731175000000028,1.0754848,1.0773927000000025,1.078214900000006,1.0721624719825464,1.0727235965901012,4895,-513645,-512872.8,-0.048852823879355925,-344.61651074931393,-0.28760238272524546
2023-09-05T11:15:00-04:00,1.07131,1.07148,1.07096,1.07104,1.07382718761088,1.0716633333333334,1.0722166666666593,1.0727539999999929,1.0729395000000028,1.0753309999999998,1.0773123000000027,1.078132800000006,1.0719379775860371,1.0724644772720806,-3309,-516954,-513731.8,-0.06379865612743758,-345.4504710409195,-0.2189325408285967
2023-09-05T11:30:00-04:00,1.07104,1.07232,1.07092,1.07231,1.073503468849792,1.071682,1.0719688888888816,1.0725115555555484,1.072837000000003,1.0752135999999997,1.0772458000000027,1.078063650000006,1.0720123820688297,1.0722495818176643,3632,-513322,-514946.2,-0.06370749763640772,-341.1437784804172,-0.2075306642842476
2023-09-05T11:45:00-04:00,1.07231,1.07324,1.07229,1.07266,1.07059,1.0718202222222222,1.0718877777777704,1.0722744444444374,1.0727725000000028,1.0750941999999997,1.0771881000000025,1.0780006000000062,1.0721419056550636,1.0721260654541311,2912,-510410,-514574.2,-0.07369037790603593,-340.1933070682327,-0.06800883183187094
2023-09-05T12:00:00-04:00,1.07266,1.07309,1.0726,1.07274,1.070643,1.0719906666666665,1.0718688888888817,1.0720839999999932,1.0727245000000027,1.0749719999999998,1.0771281000000028,1.077944650000006,1.072261524524051,1.0721032523633047,2507,-507903,-512446.8,-0.07438236271957704,-340.0063326308525,-0.015844758647044346
2023-09-05T12:15:00-04:00,1.07274,1.07301,1.07249,1.0726,1.07069494,1.0721368888888887,1.0719388888888814,1.0719762222222156,1.0726890000000027,1.0748472,1.0770638000000026,1.077899850000006,1.0723292196192409,1.0721366018906435,-2288,-510191,-511756,-0.07239283902161356,-340.304932477973,0.0587703014076801
2023-09-05T12:30:00-04:00,1.0726,1.07285,1.07237,1.0727,1.0707458412000002,1.072289111111111,1.0719611111111038,1.0719251111111043,1.0726480000000027,1.0747266,1.0769991000000028,1.0778562500000062,1.0724033756953928,1.0722296815125147,1570,-508621,-510089.4,-0.0628815509566914,-340.15855917944606,0.018648018648016594
2023-09-05T12:45:00-04:00,1.0727,1.0732,1.07263,1.07295,1.0707957243760002,1.072486888888889,1.0721277777777702,1.0719568888888822,1.0726330000000028,1.074604,1.0769297000000027,1.077816850000006,1.0725127005563142,1.0723297452100116,1914,-506707,-508766.4,-0.05615755367906986,-339.71248851663245,0.1399972000560042
2023-09-05T13:00:00-04:00,1.07295,1.07314,1.07248,1.0725,1.0708446098884803,1.0725613333333333,1.072312222222215,1.072041777777771,1.0725865000000028,1.0744669999999998,1.0768587000000027,1.0777812500000061,1.0725101604450513,1.072403396168009,-1724,-508431,-508370.6,-0.04304075975467546,-340.43554178099714,0.15501849015725924
2023-09-05T13:15:00-04:00,1.0725,1.07276,1.0724,1.07274,1.0708925176907107,1.072646888888889,1.0724711111111036,1.0721622222222156,1.0726025000000028,1.0743376,1.0767912000000026,1.0777485500000061,1.072556128356041,1.072462316934407,1194,-507237,-508237.4,-0.022264674817909474,-340.1683529698083,0.13348143861254375
2023-09-05T13:30:00-04:00,1.07274,1.07293,1.07259,1.07264,1.0709394673368964,1.0726806666666668,1.0726488888888814,1.0723042222222154,1.0725790000000028,1.0742104,1.0767223000000028,1.077717150000006,1.0725729026848327,1.0725110535475255,-1289,-508526,-507904.4,-0.01084143666330137,-340.2885125611352,0.14938751120406762
2023-09-05T13:45:00-04:00,1.07264,1.0728,1.07225,1.0723,1.0709854779901584,1.072610888888889,1.0726477777777705,1.0724415555555489,1.0724740000000028,1.0740811999999997,1.0766514000000027,1.0776854000000062,1.0725183221478662,1.07253404283802,-1433,-509959,-508172,0.0045018886623640255,-340.742737650634,-0.0009325661422597487
2023-09-05T14:00:00-04:00,1.0723,1.07241,1.07207,1.07236,1.0710305684303552,1.0725533333333335,1.0726144444444374,1.0725388888888823,1.072422500000003,1.0739605999999997,1.0765799000000027,1.077655650000006,1.072486657718293,1.0725288342704158,1593,-508366,-508503.8,0.01402638505578823,-340.65360214750996,-0.02796785561128102
2023-09-05T14:15:00-04:00,1.07236,1.07267,1.07229,1.07245,1.071074757061748,1.0725204444444443,1.0725822222222152,1.0725928888888823,1.0723180000000028,1.0738379999999998,1.0765094000000028,1.077625900000006,1.0724793261746344,1.0725226674163324,1534,-506832,-508184,0.016242690123605224,-340.52485806902894,-0.027033577567735285
2023-09-05T14:30:00-04:00,1.07245,1.07249,1.07228,1.07235,1.0711180619205132,1.072474,1.0725544444444373,1.0726095555555493,1.0722660000000028,1.073724,1.0764369000000027,1.0775971000000062,1.0724534609397074,1.0725021339330656,-985,-507817,-508300,0.02233254036331623,-340.6167038427247,-0.023307850083916046
2023-09-05T14:45:00-04:00,1.07235,1.07235,1.07207,1.07216,1.071160500682103,1.072395111111111,1.072494444444437,1.0725786666666601,1.0722285000000027,1.0736317999999998,1.0763636000000028,1.077565950000006,1.0723947687517659,1.0724665071464523,-1218,-509035,-508401.8,0.023692704512430354,-340.83251024921503,-0.050340262888038126
2023-09-05T15:00:00-04:00,1.07216,1.07231,1.07192,1.07198,1.071202090668461,1.0722922222222224,1.0723866666666595,1.072526444444438,1.0722290000000028,1.0735377999999998,1.0762880000000026,1.077533000000006,1.0723118150014126,1.0724252057171615,-1266,-510301,-508470.2,0.021108917662982066,-341.0450531532593,-0.0904049582925707
2023-09-05T15:15:00-04:00,1.07198,1.07249,1.07192,1.07244,1.0712428488550918,1.0723028888888888,1.0723799999999928,1.072479555555549,1.0722260000000028,1.0734536,1.0762170000000026,1.077501450000006,1.0723374520011302,1.072395364573729,1114,-509187,-508634.4,0.014264765053474899,-340.5670218467049,-0.005594405594400838
2023-09-05T15:30:00-04:00,1.07244,1.07273,1.0723799999999999,1.07257,1.07128279187799,1.072340888888889,1.072361111111104,1.072435333333327,1.0722820000000028,1.0733674,1.0761470000000026,1.077470800000006,1.072383961600904,1.0723762916589827,1273,-507914,-508850.8,0.014606683190593136,-340.4127101835816,-0.015847269608665983
2023-09-05T15:45:00-04:00,1.07257,1.07267,1.07202,1.07213,1.07132193604043,1.0722946666666666,1.0723044444444372,1.0723853333333266,1.072346500000003,1.0732869999999999,1.0760730000000027,1.0774392500000058,1.0723331692807232,1.072352233327186,-1573,-509487,-509184.8,0.005897564457038781,-341.0580014000057,-0.04754624105012031
2023-09-05T16:00:00-04:00,1.07213,1.07216,1.07193,1.07208,1.0713602973196215,1.0722497777777777,1.072279999999993,1.072342444444438,1.0723850000000028,1.0732038,1.0760002000000026,1.0774079000000059,1.0722825354245786,1.0723297866617485,-843,-510330,-509443.8,-0.004831473497077515,-341.0973156622688,-0.02051664646088865
2023-09-05T16:15:00-04:00,1.07208,1.07213,1.0719,1.0720399999999999,1.071397891373229,1.0722017777777777,1.0722444444444372,1.0723139999999936,1.072435000000003,1.0731315999999997,1.0759272000000026,1.077379350000006,1.072234028339663,1.0723142293293983,-619,-510949,-509573.4,-0.010497456897611016,-341.120410953665,-0.029840725129629788
2023-09-05T16:30:00-04:00,1.0720399999999999,1.0723,1.0720399999999999,1.07219,1.0714347335457644,1.0721908888888887,1.0722155555555486,1.0722811111111048,1.0724290000000027,1.0730685999999998,1.0758557000000026,1.077351600000006,1.0722252226717304,1.0722917834635184,327,-510622,-509860.4,-0.01718848589000499,-341.07465706388473,-0.024243554478057438
2023-09-05T16:45:00-04:00,1.07219,1.07224,1.07214,1.0722,1.071470838874849,1.0721877777777777,1.0721988888888818,1.0722486666666604,1.072406000000003,1.0730286,1.0757839000000027,1.077323300000006,1.0722201781373843,1.0722590267708143,612,-510010,-510279.6,-0.019031312414355107,-341.06894912032993,-0.013987970345490975
2023-09-05T17:00:00-04:00,1.0722,1.07241,1.0721,1.0721,1.0715062220973521,1.0721680000000002,1.072192222222215,1.0722262222222159,1.072374000000003,1.0729627999999998,1.0757105000000027,1.0772956500000062,1.0721961425099076,1.0722316214166514,-142,-510152,-510412.6,-0.01887636976880942,-341.08219291812884,-0.005596179674670663
2023-09-05T17:15:00-04:00,1.0721,1.07227,1.07199,1.07222,1.071540897655405,1.0721735555555556,1.0722188888888817,1.0722139999999936,1.072355000000003,1.0729106,1.0756369000000028,1.0772698500000062,1.072200914007926,1.0722152971333208,120,-510032,-510353,-0.016008206148188774,-341.0687613352541,0.02238847739696804
2023-09-05T17:30:00-04:00,1.07222,1.07244,1.0722099999999999,1.07237,1.071574879702297,1.0722037777777778,1.0722111111111041,1.072207333333327,1.072338500000003,1.0728469999999999,1.075564500000003,1.077245350000006,1.072234731206341,1.0722154377066562,239,-509793,-510121.8,-0.011350178312128416,-341.0353260327975,-0.006527171683265683
2023-09-05T17:45:00-04:00,1.07237,1.0724,1.0722,1.07226,1.071608182108251,1.0722135555555554,1.0721766666666597,1.072199555555549,1.072304000000003,1.0727942,1.0754933000000029,1.0772191000000062,1.0722397849650727,1.0722183501653249,-257,-510050,-510007.4,-0.011075077389882783,-341.061688202571,-0.02890254249140219
2023-09-05T18:00:00-04:00,1.07226,1.07261,1.07222,1.0726,1.071640818466086,1.0722982222222222,1.072228888888882,1.072205555555549,1.072309000000003,1.0727517999999998,1.0754278000000028,1.0771937500000062,1.072311827972058,1.0722366801322596,291,-509759,-509957.2,-0.009241216625301633,-340.9694158059508,0.04383796741066572
2023-09-05T18:15:00-04:00,1.0726,1.07262,1.07246,1.0725,1.0716728020967643,1.0723524444444443,1.0722755555555485,1.0722222222222157,1.072297000000003,1.0727052,1.0753600000000028,1.0771677000000062,1.0723494623776464,1.0722673441058073,-176,-509935,-509913.8,-0.005790747947714752,-340.9858245324099,0.03917618088203184
2023-09-05T18:30:00-04:00,1.0725,1.07256,1.07237,1.07255,1.071704146054829,1.0724073333333333,1.0723322222222154,1.0722448888888825,1.0722925000000032,1.0726615999999998,1.0752917000000028,1.077143450000006,1.072389569902117,1.0723050752846455,112,-509823,-509872,-0.0005639809771960925,-340.98060308718846,0.04757285175926369
2023-09-05T18:45:00-04:00,1.07255,1.07263,1.07255,1.07262,1.0717348631337325,1.0724648888888888,1.072379999999993,1.0722786666666602,1.0723085000000032,1.072622,1.0752234000000027,1.077120000000006,1.0724356559216937,1.072345260227716,82,-509741,-509861.6,0.004933727735738883,-340.9752513553345,0.04010483216593425
2023-09-05T19:00:00-04:00,1.07262,1.0728199999999999,1.07249,1.07249,1.0717649658710577,1.072486888888889,1.0724122222222152,1.0723257777777715,1.072315000000003,1.0725845999999999,1.0751508000000027,1.077094050000006,1.072446524737355,1.0723866081821725,-544,-510285,-509908.6,0.006887621199711378,-341.041183372265,0.027047192687922165
2023-09-05T19:15:00-04:00,1.07249,1.07272,1.07247,1.07266,1.0717944665536365,1.0725364444444443,1.0724744444444374,1.0723748888888824,1.072325500000003,1.0725588,1.0750807000000029,1.077069350000006,1.0724892197898839,1.0724220865457377,379,-509906,-509938,0.009845037248854991,-340.9811082200491,0.05223393340172502
2023-09-05T19:30:00-04:00,1.07266,1.07277,1.07243,1.07249,1.0718233772225638,1.0725395555555555,1.0725044444444374,1.0724206666666602,1.072332500000003,1.0725346,1.075010400000003,1.077043700000006,1.0724893758319072,1.07245006923659,-509,-510415,-510034,0.013304320795996265,-341.0617768382506,0.02518139933968705
2023-09-05T19:45:00-04:00,1.07249,1.07272,1.0723799999999999,1.07245,1.0718517096781126,1.0725286666666667,1.072513333333326,1.0724568888888821,1.0723470000000028,1.0725173999999997,1.0749403000000028,1.077018850000006,1.0724815006655257,1.0724684553892714,-586,-511001,-510269.6,0.015005040166122583,-341.0836325198887,0.0074601117151596895
2023-09-05T20:00:00-04:00,1.07245,1.0726,1.07208,1.07212,1.0718794754845504,1.07245,1.0724977777777707,1.0724804444444378,1.072354000000003,1.0724893999999998,1.0748678000000027,1.076991750000006,1.0724092005324206,1.0724631643114169,-973,-511974,-510716.2,0.012851335713181615,-341.3830310932487,-0.013056534795667934
2023-09-05T20:15:00-04:00,1.07212,1.07231,1.07203,1.0720399999999999,1.0719066859748594,1.0723584444444445,1.0724355555555485,1.0724851111111042,1.0723340000000028,1.0724651999999997,1.0747941000000028,1.076965700000006,1.0723353604259365,1.0724409314491332,-1106,-513080,-511275.2,0.01053327128259204,-341.4655591684642,-0.05220958418796531
2023-09-05T20:30:00-04:00,1.0720399999999999,1.07217,1.07169,1.07169,1.07324,1.0722093333333331,1.0723455555555486,1.0724593333333268,1.0722900000000029,1.0724303999999998,1.0747167000000026,1.0769374000000058,1.0722062883407493,1.0723843451593063,-1323,-514403,-512174.6,0.005377831521787307,-341.8974926784077,-0.07552447552447342
2023-09-05T20:45:00-04:00,1.07169,1.07195,1.0715,1.07193,1.073209,1.0721262222222223,1.0722766666666594,1.0724137777777711,1.0722800000000028,1.0724205999999998,1.0746448000000028,1.076910350000006,1.0721510306725994,1.072316676127445,1723,-512680,-512627.6,0.002904378017020864,-341.5116348277232,-0.05780616288283464
2023-09-05T21:00:00-04:00,1.07193,1.07217,1.07188,1.0721,1.07314064,1.072090888888889,1.0722188888888817,1.072354888888882,1.072281000000003,1.0724003999999998,1.0745749000000029,1.0768833500000057,1.0721408245380795,1.0722485409019555,1608,-511072,-512641.8,-0.0011590881837453054,-341.2566181755164,-0.048479424213594184
2023-09-05T21:15:00-04:00,1.0721,1.07212,1.07152,1.0718699999999999,1.0730750144,1.072021111111111,1.0721499999999928,1.0722853333333267,1.0722725000000028,1.0723497999999998,1.0745041000000028,1.0768569000000057,1.0720866596304635,1.072184032721564,-1929,-513001,-512847.2,-0.0072210535008394305,-341.67045084038006,-0.05780939682421887
2023-09-05T21:30:00-04:00,1.0718699999999999,1.07195,1.0714299999999999,1.07154,1.073012013824,1.0718991111111111,1.0720255555555485,1.0722033333333265,1.072240000000003,1.0723127999999997,1.0744284000000028,1.0768276000000057,1.0719773277043707,1.0721124261772508,-2109,-515110,-513253.2,-0.013860644783972628,-342.3197553269315,-0.10441332761546156
2023-09-05T21:45:00-04:00,1.07154,1.07176,1.07131,1.07144,1.07291709299456,1.0717819999999998,1.071908888888882,1.0721159999999934,1.072202000000003,1.0722507999999997,1.0743497000000028,1.076797050000006,1.0718698621634966,1.0720451409418001,-1786,-516896,-513751.8,-0.021908631280998875,-342.4864313259609,-0.09790301075068257
2023-09-05T22:00:00-04:00,1.07144,1.07192,1.07144,1.07191,1.0727885255549952,1.0717822222222222,1.0718488888888817,1.072030444444438,1.072192500000003,1.0722211999999995,1.0742767000000029,1.0767693000000058,1.0718778897307972,1.0719905127534397,1398,-515498,-514315.4,-0.026030436201631594,-341.8731818672885,-0.050351997762132034
2023-09-05T22:15:00-04:00,1.07191,1.07248,1.07183,1.07245,1.0726702435105955,1.0719024444444443,1.0718855555555484,1.071963777777771,1.0722040000000028,1.0722119999999997,1.0742046000000027,1.0767443500000058,1.0719923117846377,1.0719608102027514,1300,-514198,-514940.6,-0.027584461034644063,-341.21827613826275,0.03078013655187306
2023-09-05T22:30:00-04:00,1.07245,1.07273,1.07244,1.0727,1.07131,1.0720653333333332,1.071958888888882,1.071925555555549,1.0722205000000027,1.0722265999999996,1.0741406000000027,1.0767192000000059,1.0721338494277102,1.0719702481622007,1538,-512660,-514872.4,-0.024306317332873473,-340.8597512653082,0.06156486698258507
2023-09-05T22:45:00-04:00,1.0727,1.07342,1.0726499999999999,1.0734,1.0713384,1.0723535555555554,1.072148888888882,1.0719502222222155,1.0722775000000027,1.0722445999999997,1.0740859000000027,1.0766968500000058,1.0723870795421682,1.07205219852976,1719,-510941,-514038.6,-0.016196068800409767,-339.7380024072865,0.15956106709961632
2023-09-05T23:00:00-04:00,1.0734,1.07344,1.07291,1.07311,1.0714216639999998,1.0725457777777776,1.072279999999993,1.072024444444438,1.072303000000003,1.0722777999999997,1.0740304000000027,1.0766729500000058,1.0725316636337345,1.0721845588238077,-1247,-512188,-513097,-0.006727753782613958,-340.0749038419799,0.11008181504388895
2023-09-05T23:15:00-04:00,1.07311,1.0734,1.07309,1.07335,1.07154276416,1.0727597777777778,1.072418888888882,1.072138444444438,1.0723455000000028,1.0723279999999997,1.0739777000000026,1.0766488000000058,1.0726953309069875,1.0723480470590456,1416,-510772,-512151.8,0.00318392000525882,-339.75821682946486,0.1165936013431558
2023-09-05T23:30:00-04:00,1.07335,1.07336,1.07305,1.07314,1.0716565983103998,1.072904,1.072559999999993,1.0722733333333268,1.0723750000000027,1.0723645999999996,1.0739247000000025,1.0766255500000057,1.07278426472559,1.072506437647236,-968,-511740,-511660.2,0.010039942185096887,-339.9476051929996,0.11848451771204573
2023-09-05T23:45:00-04:00,1.07314,1.07341,1.07305,1.07332,1.0717636024117758,1.073056,1.0727577777777708,1.0724331111111047,1.0724100000000027,1.0724101999999995,1.0738706000000027,1.0766039000000056,1.072891411780472,1.0726579501177884,1042,-510698,-511267.8,0.020141362526103223,-339.77282836984506,0.16611605726338866
2023-09-06T00:00:00-04:00,1.07332,1.0735999999999999,1.07331,1.07339,1.0718641862670693,1.0731824444444444,1.0729744444444376,1.0725982222222157,1.0724550000000026,1.0724317999999997,1.0738227000000027,1.0765800500000058,1.0729911294243777,1.0727787600942302,1047,-509651,-511009.8,0.033971846570549635,-339.7045449129077,0.18199805868738506
2023-09-06T00:15:00-04:00,1.07339,1.07342,1.07313,1.0732599999999999,1.0720030513657037,1.0732395555555556,1.0731244444444374,1.0727671111111046,1.0724850000000026,1.0724437999999996,1.0737690000000029,1.0765541500000055,1.0730449035395022,1.0728814080753837,-746,-510397,-510651.6,0.047521662916543916,-339.79489418018255,0.12594340942802684
2023-09-06T00:30:00-04:00,1.0732599999999999,1.07334,1.07309,1.07309,1.0721308072564475,1.0732326666666665,1.0731955555555486,1.072922444444438,1.0725150000000028,1.0724507999999995,1.0737114000000028,1.0765264000000057,1.0730539228316018,1.0729531264603067,-728,-511125,-510722.2,0.056613767655115915,-339.91020640648355,0.05967644179217642
2023-09-06T00:45:00-04:00,1.07309,1.0735999999999999,1.07301,1.07358,1.0722483426759317,1.0733095555555554,1.073293333333326,1.0730691111111046,1.0725715000000027,1.0724703999999996,1.0736588000000027,1.0765014500000056,1.0731591382652814,1.073028101168245,1064,-510061,-510386.4,0.0623072046203873,-339.4243571300949,0.08203598396569328
2023-09-06T01:00:00-04:00,1.07358,1.07366,1.07334,1.07354,1.072356475261857,1.073358888888889,1.0733088888888818,1.0731793333333268,1.0726425000000028,1.0724871999999999,1.0736069000000028,1.0764768000000056,1.0732353106122252,1.0730968809345958,-1400,-511461,-510539,0.0652964243683585,-339.4765190556152,0.013042668157260014
2023-09-06T01:15:00-04:00,1.07354,1.07355,1.0732599999999999,1.07346,1.0724868277356714,1.0733891111111111,1.0733477777777707,1.0732539999999935,1.072713500000003,1.0724973999999998,1.0735507000000029,1.0764517000000056,1.07328024848978,1.0731547047476764,-915,-512376,-511084,0.05990328642396506,-339.54470468446914,0.03261548210342579
2023-09-06T01:30:00-04:00,1.07346,1.07377,1.07331,1.07358,1.0726041449621042,1.0734355555555555,1.0733733333333264,1.0733037777777712,1.072808000000003,1.0725189999999998,1.073493000000003,1.0764269000000055,1.073340198791824,1.0732137637981407,2037,-510339,-511072.4,0.05744445208953476,-339.3169924269097,0.021428238691941347
2023-09-06T01:45:00-04:00,1.07358,1.0738699999999999,1.07332,1.0738,1.0727440475666516,1.073520888888889,1.0734466666666596,1.0733539999999935,1.072901500000003,1.0725401999999997,1.0734389000000029,1.0764030000000055,1.0734321590334592,1.073289411038512,2642,-507697,-510386.8,0.05226817979281789,-338.77558889852776,0.061501761186807405
2023-09-06T02:00:00-04:00,1.0738,1.0738,1.07273,1.07313,1.0738699999999999,1.0734575555555557,1.0734255555555485,1.0733804444444381,1.072953000000003,1.07255,1.0733802000000028,1.0763771000000055,1.0733717272267673,1.0733319288308092,-3970,-511667,-510708,0.04684623428200685,-341.25267960443267,-0.01770208325570515
2023-09-06T02:15:00-04:00,1.07313,1.07394,1.07304,1.07382,1.07273,1.0735364444444446,1.0734733333333262,1.0734133333333271,1.073050500000003,1.0725803999999999,1.0733308000000028,1.0763553000000055,1.0734613817814138,1.073377143064647,2537,-509130,-510241.8,0.04386922577163723,-339.62144200973285,0.04005999683245889
2023-09-06T02:30:00-04:00,1.07382,1.07385,1.07292,1.07315,1.07273,1.0734717777777778,1.073461111111104,1.0734359999999936,1.0731310000000032,1.0725961999999998,1.0732784000000029,1.0763297000000054,1.073399105425131,1.0734009144517171,-2626,-511756,-510117.8,0.035949864561420804,-341.25991028188264,-0.010249147457264081
2023-09-06T02:45:00-04:00,1.07315,1.07351,1.07295,1.07313,1.0727541999999999,1.0734055555555555,1.0734655555555486,1.073454444444438,1.073215500000003,1.0726098,1.073223900000003,1.0763019500000055,1.0733452843401048,1.0734019315613732,-1887,-513643,-510778.6,0.027680463264149562,-341.2950777794368,0.003727553140912501
2023-09-06T03:00:00-04:00,1.07313,1.07321,1.07241,1.0726,1.07394,1.0732324444444443,1.0733566666666599,1.0734364444444382,1.073250000000003,1.0726148,1.073169400000003,1.0762711500000055,1.0731962274720839,1.0733547452490984,-4423,-518066,-512852.4,0.01796608319439698,-343.4795195525674,-0.09128336966038683
2023-09-06T03:15:00-04:00,1.0726,1.07479,1.07253,1.07339,1.07241,1.073239111111111,1.0733399999999933,1.0734193333333273,1.073297000000003,1.0726394,1.073135600000003,1.0762440000000055,1.0732349819776672,1.0733273961992782,7458,-510608,-512640.6,0.00962801690822721,-337.98649326131203,-0.013972464929101149
2023-09-06T03:30:00-04:00,1.07339,1.07386,1.07318,1.07325,1.07241,1.0732211111111112,1.0733166666666598,1.073387999999994,1.0733245000000031,1.0726647999999999,1.073101300000003,1.0762158500000054,1.0732379855821337,1.0732827169594221,-4249,-514857,-513786,0.003376341386035098,-338.5406813942368,-0.01956290872506134
2023-09-06T03:45:00-04:00,1.07325,1.07355,1.07274,1.0729,1.0724576000000001,1.0731377777777777,1.0732411111111042,1.073343999999994,1.0732995000000032,1.072674,1.073063800000003,1.0761869500000056,1.073170388465707,1.0732369735675373,-2829,-517686,-514972,-0.002728556540134421,-339.463253022469,-0.06333948098884237
2023-09-06T04:00:00-04:00,1.0729,1.0735,1.07272,1.07339,1.0725042480000002,1.0731675555555555,1.0731955555555488,1.0732899999999943,1.0733135000000031,1.0726904,1.073028900000003,1.0761607000000055,1.0732143107725656,1.0732107788540295,3053,-514633,-515170,-0.004454425986658995,-338.06892922714763,-0.03818215682622662
2023-09-06T04:15:00-04:00,1.07339,1.07339,1.0724,1.07325,1.07479,1.0731784444444445,1.073208888888882,1.0732604444444387,1.073308500000003,1.0727128,1.072999900000003,1.0761317500000056,1.0732214486180525,1.0732158230832234,-2565,-517198,-514996.4,-0.010199862286134042,-338.4034767820905,0.011182242598764365
2023-09-06T04:30:00-04:00,1.07325,1.07362,1.07308,1.07349,1.0747422,1.0732346666666666,1.0731722222222153,1.073226888888883,1.0733260000000029,1.072741,1.072972400000003,1.0761036000000055,1.073275158894442,1.0732238584665783,2443,-514755,-515825.8,-0.007466838452568195,-337.85717349767395,-0.03073140749845798
2023-09-06T04:45:00-04:00,1.07349,1.07375,1.07309,1.0734,1.0746953559999999,1.0732802222222224,1.073199999999993,1.0732035555555497,1.073330000000003,1.0727681999999998,1.0729499000000031,1.0760756000000056,1.0733001271155536,1.073236286773262,-2653,-517408,-516336,-0.012533318662860778,-338.07959755379034,0.02329590457996193
2023-09-06T05:00:00-04:00,1.0734,1.0735,1.07286,1.0731,1.0746494488799998,1.073260222222222,1.0731966666666597,1.073194666666661,1.073315500000003,1.0727863999999998,1.0729275000000031,1.0760437000000056,1.0732601016924428,1.0732542294186094,-2386,-519794,-516757.6,-0.01202323012264494,-338.74645054428777,-0.0027955606496859182
2023-09-06T05:15:00-04:00,1.0731,1.0731,1.07257,1.07274,1.0746044599023998,1.0731688888888888,1.0732122222222151,1.0731979999999939,1.073289500000003,1.0727972,1.072912900000003,1.0760049500000057,1.0731560813539542,1.073242583534887,-2293,-522087,-518248.4,-0.012773386633214106,-339.51569851744944,0.013052396046991328
2023-09-06T05:30:00-04:00,1.07274,1.07292,1.07245,1.07264,1.0745603707043518,1.0730544444444445,1.0731288888888817,1.0731819999999939,1.0732670000000029,1.0728079999999998,1.0728854000000032,1.0759668500000057,1.0730528650831634,1.0732088668279092,-2369,-524456,-519700,-0.009650184151917254,-339.7365348804078,-0.06987208749848875
2023-09-06T05:45:00-04:00,1.07264,1.07346,1.0726,1.07323,1.0745171632902648,1.0730746666666666,1.0731266666666595,1.0731728888888827,1.0732495000000029,1.0728281999999998,1.0728694000000032,1.0759355000000057,1.0730882920665308,1.0731714934623269,1753,-522703,-521289.6,-0.011762059438341549,-338.772306434704,-0.001863498718856839
2023-09-06T06:00:00-04:00,1.07323,1.07441,1.07323,1.07439,1.0744748200244596,1.0733273333333333,1.0732922222222152,1.0731913333333272,1.073292000000003,1.0728685999999996,1.072857800000003,1.0759083500000057,1.0733486336532245,1.0731811947698613,2114,-520589,-521925.8,-0.004733936780632997,-336.48739080618066,0.13887594370397907
2023-09-06T06:15:00-04:00,1.07439,1.0744,1.07355,1.07378,1.0744333236239705,1.0734248888888889,1.0733355555555486,1.073219111111105,1.073308000000003,1.0728989999999998,1.0728466000000032,1.0758806500000058,1.0734349069225797,1.0732161558158888,-2075,-522664,-522499.8,0.002400217927612069,-337.6655011757857,0.03633348549920257
2023-09-06T06:30:00-04:00,1.07378,1.07398,1.07355,1.07384,1.07441,1.0735257777777778,1.073401111111104,1.0732568888888827,1.073321000000003,1.0729237999999997,1.0728378000000032,1.0758527500000057,1.0735159255380637,1.0732881246527106,1843,-520821,-522246.6,0.004906832298346698,-337.562519186924,0.05497321220590434
2023-09-06T06:45:00-04:00,1.07384,1.07412,1.07374,1.07385,1.0744,1.0736155555555555,1.0734411111111042,1.0733193333333273,1.073323500000003,1.0729507999999996,1.0728280000000032,1.0758231000000058,1.073582740430451,1.0733940997221683,1824,-518997,-521154.8,0.009298912568698163,-337.5455334162318,0.03353547774081882
2023-09-06T07:00:00-04:00,1.07385,1.0744799999999999,1.07384,1.0744799999999999,1.0724,1.0738233333333334,1.073561111111104,1.0734062222222163,1.073391000000003,1.0729893999999998,1.072825500000003,1.0757984000000056,1.0737621923443608,1.0735288797777343,2591,-516406,-519895.4,0.015505114026023177,-336.02546078038904,0.10061486864169647
2023-09-06T07:15:00-04:00,1.0744799999999999,1.07488,1.07437,1.07467,1.0724416,1.0740451111111111,1.0737355555555486,1.073494888888883,1.0734335000000028,1.0730303999999997,1.0728262000000033,1.0757728500000057,1.0739437538754886,1.0736479038221869,2331,-514075,-518592.6,0.02050350249705273,-335.6132706977441,0.14630509738142497
2023-09-06T07:30:00-04:00,1.07467,1.07476,1.07408,1.07409,1.072539136,1.074116,1.0738855555555484,1.0736048888888827,1.0734805000000027,1.0730623999999997,1.072823500000003,1.0757448500000055,1.073973003100391,1.0737555230577494,-2186,-516261,-517312,0.02852800633130807,-336.7930561202459,0.12584596453940025
2023-09-06T07:45:00-04:00,1.07409,1.07441,1.07384,1.0744,1.07263277056,1.0742188888888888,1.0740811111111042,1.0737408888888829,1.0735440000000027,1.0730971999999996,1.072828000000003,1.0757196000000055,1.0740584024803128,1.0738640184461992,2338,-513923,-515932.4,0.03844480196759304,-336.1182709532673,0.16408114558472403
2023-09-06T08:00:00-04:00,1.0744,1.07454,1.07394,1.074,1.0727226597376,1.0742026666666666,1.0741666666666596,1.073885999999994,1.0736140000000027,1.0731273999999997,1.072831000000003,1.0756899500000054,1.0740467219842502,1.0739568147569591,-2801,-516724,-515477.8,0.04725241385205361,-337.1610855474593,0.07174603766202581
2023-09-06T08:15:00-04:00,1.074,1.07405,1.0734299999999999,1.07365,1.072808953348096,1.0740993333333333,1.0740844444444373,1.0739906666666605,1.0736270000000028,1.0731513999999998,1.0728344000000032,1.0756571000000057,1.0739673775874001,1.0739978518055668,-2904,-519628,-516122.2,0.04650506765544244,-338.10745426254334,-0.06887629259393357
2023-09-06T08:30:00-04:00,1.07365,1.074,1.07351,1.07372,1.072891795214172,1.0740264444444445,1.0740777777777708,1.074059111111105,1.073650500000003,1.0731833999999998,1.072836400000003,1.0756241000000057,1.07391790206992,1.0739926814444531,3362,-516266,-516560.4,0.03880022673405274,-337.88825806266436,-0.005587736780341316
2023-09-06T08:45:00-04:00,1.07372,1.07389,1.0734,1.07368,1.0729713234056053,1.0739468888888888,1.0740599999999931,1.074093999999994,1.0736895000000028,1.0732161999999998,1.072840700000003,1.0755901000000057,1.073870321655936,1.0739721451555622,-2978,-519244,-517157,0.03596093262492268,-337.99919946265703,-0.014899798852709712
2023-09-06T09:00:00-04:00,1.07368,1.07368,1.07293,1.07333,1.07488,1.073800888888889,1.074002222222215,1.0740782222222163,1.0736865000000029,1.073249,1.0728397000000032,1.0755535500000055,1.0737622573247487,1.0739129161244496,-3297,-522541,-518880.6,0.029303077289038266,-339.07396103034966,-0.04842389532989486
2023-09-06T09:15:00-04:00,1.07333,1.07339,1.07285,1.07294,1.0748410000000002,1.0735884444444446,1.0738311111111039,1.074011111111105,1.073671000000003,1.0732692,1.072844900000003,1.0755151500000055,1.073597805859799,1.0738231328995593,-3504,-526045,-520744.8,0.022823769541343193,-340.3471575309596,-0.1433251433251317
2023-09-06T09:30:00-04:00,1.07294,1.07341,1.07252,1.07302,1.07476136,1.0734262222222222,1.0736477777777707,1.0739237777777717,1.073647500000003,1.0732876,1.072844000000003,1.0754777000000053,1.0734822446878391,1.073726106319647,5494,-520551,-520929.4,0.010245519913797633,-339.9375167309144,-0.15353550392212767
2023-09-06T09:45:00-04:00,1.07302,1.07402,1.07302,1.07375,1.0746268784000002,1.0734466666666667,1.0736099999999928,1.0738302222222162,1.0736650000000028,1.0733252,1.072837500000003,1.0754464000000055,1.0735357957502714,1.0736496850557173,7272,-513279,-520332,0.000523358185655273,-334.9902091318023,-0.03165470305095541
2023-09-06T10:00:00-04:00,1.07375,1.07375,1.07023,1.0720399999999999,1.0745004656960002,1.0731326666666667,1.0733477777777707,1.0736877777777716,1.073612000000003,1.0733351999999998,1.072824000000003,1.0754063500000055,1.073236636600217,1.0735229480445736,-16139,-529418,-522366.8,-0.012539176610123586,-360.69236512714724,-0.21965748324647616
2023-09-06T10:15:00-04:00,1.0720399999999999,1.07248,1.07045,1.0706,1.0741588284403203,1.072583111111111,1.072969999999993,1.0734813333333273,1.0735050000000028,1.0733184,1.072784600000003,1.0753600000000054,1.0727093092801736,1.0733123584356585,-8524,-537942,-525447,-0.036849837908400615,-372.1420871524439,-0.3165735567970269
2023-09-06T10:30:00-04:00,1.0706,1.0711,1.07048,1.07081,1.0738445221650947,1.072151111111111,1.0726544444444377,1.0732459999999941,1.0734135000000027,1.0732964,1.072758800000003,1.0753156500000054,1.072329447424139,1.0730586867485266,6858,-531084,-526454.8,-0.058010080338163926,-370.79687885802923,-0.2645182321985706
2023-09-06T10:45:00-04:00,1.07081,1.0711,1.07051,1.07088,1.0735553603918873,1.0717962222222222,1.072338888888882,1.0729842222222163,1.0732960000000027,1.073265,1.0727385000000031,1.0752714000000052,1.0720395579393112,1.072770149398821,5169,-525915,-527527.6,-0.07601440160764164,-370.45897577531605,-0.2645009872219902
2023-09-06T11:00:00-04:00,1.07088,1.07105,1.0705,1.07062,1.0732893315605363,1.0714524444444444,1.071998888888882,1.0726619999999945,1.0731075000000028,1.0732234,1.0727250000000033,1.0752233000000053,1.0717556463514488,1.0724141195190564,-4193,-530108,-530893.4,-0.09332843462194135,-371.4769983362011,-0.2850011176514476
2023-09-06T11:15:00-04:00,1.07062,1.07161,1.07049,1.07116,1.0730445850356933,1.0712846666666667,1.071757777777771,1.0723439999999944,1.0729765000000027,1.0731785999999999,1.072711600000003,1.0751782000000054,1.071636517081159,1.0720940956152447,3440,-526668,-530343.4,-0.10249270968159334,-369.74192893716133,-0.20217454091472384
2023-09-06T11:30:00-04:00,1.07116,1.07162,1.07107,1.07159,1.0728194182328379,1.0712511111111112,1.071607777777771,1.0720715555555498,1.0728640000000027,1.0731482,1.0727130000000031,1.0751343000000053,1.0716272136649272,1.0718776764921956,3187,-523481,-527451.2,-0.10900035151358467,-368.462558908407,-0.12582250638432366
2023-09-06T11:45:00-04:00,1.07159,1.07186,1.07129,1.07129,1.072612264774211,1.0711875555555557,1.071415555555549,1.0718237777777722,1.0727360000000028,1.073107,1.072717500000003,1.0750929500000053,1.0715597709319418,1.0717237411937561,-2140,-525621,-526358.6,-0.11307419867282407,-369.0616686425403,-0.1612271905463094
2023-09-06T12:00:00-04:00,1.07129,1.0717,1.07111,1.07162,1.072421683592274,1.0712284444444444,1.0711788888888822,1.0715917777777721,1.0725930000000026,1.0730766,1.0727206000000031,1.0750566500000052,1.0715718167455535,1.0716301929550045,2323,-523298,-525835.2,-0.11623725824943405,-368.34609209464026,-0.19837019790453694
2023-09-06T12:15:00-04:00,1.07162,1.07206,1.07155,1.07191,1.0722463489048921,1.0713746666666668,1.071164444444438,1.0714248888888833,1.0724550000000028,1.0730484,1.072729300000003,1.0750208000000052,1.0716394533964428,1.0716069543640034,1905,-521393,-524092.2,-0.12199556290951846,-367.83056420229053,-0.01212641319353415
2023-09-06T12:30:00-04:00,1.07191,1.07192,1.07141,1.07158,1.0720850409925007,1.0714577777777776,1.0712733333333269,1.0713279999999945,1.0723295000000028,1.0730122,1.072722000000003,1.0749839000000052,1.0716275627171543,1.0716051634912023,-2023,-523416,-523441.8,-0.11258097002376834,-368.4533683556242,0.09153745563235391
2023-09-06T12:45:00-04:00,1.07158,1.07212,1.07149,1.07208,1.07023,1.071619111111111,1.071414444444438,1.071289333333328,1.072213500000003,1.0729886,1.072716200000003,1.0749521500000052,1.0717180501737233,1.0716233307929615,2206,-521210,-522987.6,-0.0898632112817831,-367.4240471663524,0.11860180610938283
2023-09-06T13:00:00-04:00,1.07208,1.07279,1.07199,1.07278,1.0702678,1.0718922222222222,1.0716255555555492,1.0713313333333279,1.072152500000003,1.0729824000000001,1.072716600000003,1.0749223500000051,1.0719304401389786,1.0716974646343689,1865,-519345,-521732.4,-0.06430238419309586,-366.20632087726926,0.17742417451068399
2023-09-06T13:15:00-04:00,1.07278,1.0729,1.07258,1.07272,1.070368688,1.072111111111111,1.0718588888888823,1.071467333333328,1.072106000000003,1.0729652,1.0727178000000033,1.074890800000005,1.0720883521111828,1.0718007717074947,-1469,-520814,-521235.6,-0.04145983015437582,-366.28848124565815,0.19614802637723852
2023-09-06T13:30:00-04:00,1.07272,1.07281,1.07249,1.07274,1.07052056672,1.0722873333333334,1.072034444444438,1.0716413333333281,1.0720570000000031,1.0729492000000003,1.072718200000003,1.0748586500000052,1.0722186816889463,1.0719166173659953,1410,-519404,-520837.8,-0.01764612349331281,-366.2621929318389,0.14750364091266824
2023-09-06T13:45:00-04:00,1.07274,1.07291,1.07262,1.07279,1.0706633327168,1.0724384444444444,1.0721677777777714,1.0718202222222168,1.072012500000003,1.0729358000000002,1.072716600000003,1.0748231500000052,1.072332945351157,1.0720576938927961,1289,-518115,-519777.6,0.0016878439261697983,-366.2021131361756,0.11198312787538776
2023-09-06T14:00:00-04:00,1.07279,1.07294,1.0726,1.07272,1.0708430660994561,1.0725488888888888,1.0723266666666602,1.0720026666666613,1.071982000000003,1.0729186000000004,1.0727188000000032,1.074788750000005,1.0724103562809255,1.0721961551142365,-1785,-519900,-519515.6,0.01649271508846101,-366.31858513908395,0.13348393058833932
2023-09-06T14:15:00-04:00,1.07272,1.07273,1.07223,1.0723799999999999,1.0710527594895105,1.0725595555555556,1.0724111111111048,1.0721597777777725,1.071954000000003,1.0728902000000002,1.0727152000000033,1.074753200000005,1.0724042850247404,1.0722909240913887,-1383,-521283,-519903.2,0.030881280311817715,-366.7569287888714,0.07092066217501278
2023-09-06T14:30:00-04:00,1.0723799999999999,1.0726499999999999,1.07234,1.07263,1.0712414835405595,1.0726033333333331,1.0724911111111046,1.072286222222217,1.071934500000003,1.0728802000000002,1.0727151000000033,1.0747187000000051,1.0724494280197923,1.0723631392731108,1193,-520090,-519758.4,0.04168052982225934,-366.478809092495,0.06716981836162121
2023-09-06T14:45:00-04:00,1.07263,1.07293,1.07252,1.07259,1.0714113351865036,1.072623111111111,1.072603333333327,1.0723999999999947,1.0718765000000028,1.0728556000000002,1.0727180000000032,1.074684700000005,1.0724775424158337,1.0724149114184882,-1608,-521698,-520217.2,0.049934965937306924,-366.5387738520114,0.09425334552716133
2023-09-06T15:00:00-04:00,1.07259,1.0726,1.07231,1.0725,1.0715642016678533,1.0726024444444444,1.0726499999999934,1.0724964444444391,1.071899500000003,1.0728426000000002,1.072719400000003,1.0746496500000051,1.072482033932667,1.0724447291347903,-1479,-523177,-521229.6,0.06407365960887469,-366.6628753260135,0.03917618088203184
2023-09-06T15:15:00-04:00,1.0725,1.0728199999999999,1.07248,1.07272,1.0717017815010679,1.0726164444444444,1.0726433333333267,1.0725597777777724,1.0720055000000028,1.0728344000000003,1.072722100000003,1.0746157500000053,1.0725296271461335,1.072468583307832,1563,-521614,-521572.4,0.06702143113234159,-366.34225994139825,-0.0055929454315116825
2023-09-06T15:30:00-04:00,1.07272,1.07273,1.07249,1.07262,1.071825603350961,1.0726117777777777,1.0726322222222155,1.0726039999999943,1.0720960000000028,1.0728348000000003,1.072724800000003,1.0745808500000051,1.0725477017169067,1.072497266646265,-1508,-523122,-521940.2,0.05655022736050026,-366.4828371656506,-0.009322097098962357
2023-09-06T15:45:00-04:00,1.07262,1.07272,1.07251,1.07262,1.0719370430158648,1.0726093333333333,1.0726188888888823,1.07262955555555,1.072183000000003,1.0728194000000002,1.072729400000003,1.0745465000000052,1.0725621613735254,1.072519813317012,0,-523122,-522546.6,0.04757370126174303,-366.4828371656506,-0.0111863079590693
2023-09-06T16:00:00-04:00,1.07262,1.0728,1.07249,1.07254,1.0720373387142783,1.0725935555555557,1.0725911111111046,1.0726271111111054,1.0722790000000029,1.0728052000000001,1.0727350000000029,1.0745115000000052,1.0725577290988204,1.0725358506536093,-788,-523910,-522989,0.03833240067175932,-366.5416091445433,-0.023303722070476186
2023-09-06T16:15:00-04:00,1.07254,1.07255,1.0724,1.07253,1.0721276048428505,1.0725813333333334,1.0725699999999936,1.0726111111111056,1.072347500000003,1.0727978000000002,1.0727359000000032,1.0744764500000052,1.0725521832790563,1.072549880522887,-452,-524362,-523226,0.02742237248177476,-366.5458234395813,-0.01771198448802227
2023-09-06T16:30:00-04:00,1.07253,1.07257,1.07237,1.07251,1.0722088443585656,1.0725693333333333,1.0725844444444381,1.072599333333328,1.0723935000000027,1.0727802000000002,1.072735300000003,1.0744411500000053,1.072543746623245,1.0725527044183094,-410,-524772,-523857.6,0.019467607127597916,-366.5534689133675,0.012122568492529283
2023-09-06T16:45:00-04:00,1.07251,1.0727,1.07242,1.07269,1.072281959922709,1.0725904444444443,1.0725911111111046,1.0725911111111057,1.0724635000000027,1.072769,1.0727409000000032,1.0744069500000053,1.072572997298596,1.0725577635346473,953,-523819,-523997,0.017472922520842062,-366.39352634872955,0.005593727566816981
2023-09-06T17:00:00-04:00,1.07269,1.07272,1.07223,1.07234,1.07294,1.0725402222222222,1.0725633333333269,1.0725799999999945,1.0724995000000028,1.072746,1.0727435000000032,1.0743718500000052,1.0725263978388768,1.0725506108277174,-137,-523956,-524163.8,0.01010584944884643,-366.438227054432,-0.023308067388271517
2023-09-06T17:15:00-04:00,1.07234,1.07246,1.07234,1.07239,1.0729258,1.0725055555555556,1.0725511111111046,1.0725719999999943,1.0725235000000028,1.0727258,1.072747000000003,1.0743371000000053,1.0724991182711014,1.0725388886621736,57,-523899,-524161.6,0.004821870513053564,-366.4355693152821,-0.010256410256415337
2023-09-06T17:30:00-04:00,1.07239,1.07262,1.07224,1.07237,1.072911884,1.0724693333333335,1.0725122222222159,1.072560444444439,1.0725630000000028,1.0727111999999999,1.0727488000000032,1.0743022500000052,1.0724732946168811,1.0725231109297388,-389,-524288,-524146.8,0.0015672979076203038,-366.4428241386206,-0.0326273398463579
2023-09-06T17:45:00-04:00,1.07237,1.07248,1.07234,1.07244,1.07289824632,1.072454888888889,1.0724922222222157,1.0725419999999946,1.0725810000000027,1.0727052000000001,1.0727512000000032,1.0742675500000054,1.0724666356935049,1.0725076887437905,221,-524067,-524005.8,-0.004861545838101922,-366.4283981475914,-0.01678133915084997
2023-09-06T18:00:00-04:00,1.07244,1.0727,1.07244,1.07261,1.0728848813936,1.0724784444444444,1.0724911111111046,1.0725219999999944,1.0725725000000028,1.0727046,1.072756300000003,1.0742334000000053,1.072495308554804,1.0724921509950323,384,-523683,-523978.6,-0.007307685989444724,-366.36752760937947,-0.0009322966194778643
2023-09-06T18:15:00-04:00,1.07261,1.07275,1.0726,1.07262,1.072871783765728,1.0725042222222223,1.0724999999999936,1.0725093333333278,1.0725675000000028,1.0726924,1.0727603000000032,1.0741986000000054,1.072520246843843,1.0724909207960256,513,-523170,-523821.4,-0.006597386706490388,-366.36274488313234,0.0074589292706899474
2023-09-06T18:30:00-04:00,1.07262,1.07262,1.07247,1.07247,1.0728589480904134,1.0724982222222224,1.0724933333333269,1.0724977777777724,1.0725540000000024,1.072654,1.0727613000000031,1.0741629000000055,1.0725101974750744,1.07249313663682,-262,-523432,-523728,-0.006140166277029602,-366.39938414027836,-0.005594249111908197
2023-09-06T18:45:00-04:00,1.07247,1.07262,1.07246,1.07252,1.0728463691286052,1.0725035555555558,1.072494444444438,1.072494222222217,1.0725405000000026,1.0726288,1.072763900000003,1.0741286000000054,1.0725121579800594,1.0725009093094555,186,-523246,-523519.6,-0.005256708518781839,-366.3907125690456,0.0009323922387524094
2023-09-06T19:00:00-04:00,1.07252,1.07254,1.07232,1.07239,1.0728340417460331,1.0724826666666667,1.0724611111111044,1.0724879999999946,1.0725240000000027,1.0725997999999999,1.072761800000003,1.0740948000000055,1.0724877263840475,1.0725051274475643,-447,-523693,-523444.8,-0.0045997016407066495,-366.4448933768627,-0.0279670734322094
2023-09-06T19:15:00-04:00,1.07239,1.07244,1.07225,1.07235,1.0728219609111125,1.0724604444444443,1.0724622222222155,1.072482222222217,1.0725225000000027,1.0725698,1.0727603000000032,1.0740601500000055,1.072460181107238,1.072498101958051,-288,-523981,-523504.4,-0.006127116352343057,-366.4556357373845,0.0009325400525806617
2023-09-06T19:30:00-04:00,1.07235,1.07241,1.0722,1.07224,1.0728101216928903,1.072416,1.072445555555549,1.072471333333328,1.0725030000000026,1.072525,1.0727572000000032,1.0740244500000053,1.0724161448857905,1.0724772815664405,-488,-524469,-523764.2,-0.006437952127146222,-366.5056940205942,-0.013987448596114517
2023-09-06T19:45:00-04:00,1.07224,1.07241,1.07222,1.07237,1.0727857168251747,1.072400888888889,1.072445555555549,1.0724617777777725,1.0724920000000027,1.072479,1.072754700000003,1.0739890500000053,1.0724069159086325,1.072456625253152,408,-524061,-523890,-0.005470102470931075,-366.45622748325184,0
2023-09-06T20:00:00-04:00,1.07237,1.07247,1.07216,1.07224,1.0727622881521677,1.0723597777777778,1.0724233333333268,1.0724475555555502,1.0724790000000026,1.0724420000000001,1.072752200000003,1.0739515000000055,1.072373532726906,1.0724289002025214,-847,-524908,-524222.4,-0.0051283007605970885,-366.5589065958715,-0.01864906195218175
2023-09-06T20:15:00-04:00,1.07224,1.07258,1.07223,1.07244,1.0727261508630377,1.0723631111111112,1.0724044444444378,1.0724362222222168,1.0724650000000027,1.0724028,1.072750000000003,1.0739153500000054,1.0723868261815248,1.072408720162017,1006,-523902,-524264.2,-0.004861908478641017,-366.37126203868286,-0.015849190292837424
2023-09-06T20:30:00-04:00,1.07244,1.07247,1.07201,1.07203,1.0726921818112554,1.0722882222222223,1.0723388888888823,1.0724115555555502,1.0724355000000025,1.0723634000000002,1.072745400000003,1.0738779000000054,1.07231546094522,1.0723797761296132,-962,-524864,-524440.8,-0.007206501569592406,-366.7390401894419,-0.05500550055004274
2023-09-06T20:45:00-04:00,1.07203,1.07226,1.0719,1.0722099999999999,1.0726376072663548,1.0722624444444444,1.0723099999999934,1.0723844444444393,1.0724150000000026,1.0723346000000002,1.0727430000000029,1.0738416500000054,1.072294368756176,1.07235542090369,1204,-523660,-524279,-0.00920921525383292,-366.5368816677589,-0.02424310237117579
2023-09-06T21:00:00-04:00,1.0722099999999999,1.0728199999999999,1.072,1.07257,1.0719,1.0723144444444446,1.0723155555555488,1.0723584444444392,1.0724165000000025,1.0723116000000001,1.0727475000000029,1.0738076500000053,1.0723494950049408,1.072343936722952,1712,-521948,-523856.4,-0.008054750992925554,-365.9620688978722,0.004661917726485802
2023-09-06T21:15:00-04:00,1.07257,1.07284,1.07236,1.07252,1.0719,1.0723553333333333,1.0723299999999933,1.0723397777777723,1.0724160000000027,1.0722884000000001,1.072752300000003,1.0737732000000055,1.0723835960039527,1.0723459493783614,-1826,-523774,-523629.6,-0.007965951551323937,-366.04719154720993,0.012122455449972817
2023-09-06T21:30:00-04:00,1.07252,1.07267,1.07226,1.07263,1.0719376,1.0724153333333333,1.0723611111111042,1.0723311111111058,1.0724220000000027,1.0722744000000002,1.0727617000000031,1.0737392000000054,1.0724328768031621,1.0723551595026888,1638,-522136,-523276.4,-0.006172030930953136,-365.87919468001854,0.02611087797827743
2023-09-06T21:45:00-04:00,1.07263,1.07308,1.07263,1.07308,1.0719736960000001,1.072559111111111,1.0724544444444377,1.0723542222222169,1.0724415000000025,1.0722772000000003,1.0727732000000032,1.0737090000000054,1.0725623014425296,1.0724045276021505,1080,-521056,-522514.8,-0.0018959643929351763,-365.4261027471059,0.07834066999924941
2023-09-06T22:00:00-04:00,1.07308,1.07309,1.0726,1.07286,1.07204007424,1.0726402222222222,1.0725088888888823,1.0723939999999947,1.0724675000000026,1.0722740000000004,1.0727808000000032,1.0736778500000055,1.0726218411540236,1.07247002208172,-1329,-522385,-522259.8,0.0031303157092469913,-365.69857078304,0.04569318425542298
2023-09-06T22:15:00-04:00,1.07286,1.0729,1.07249,1.07259,1.0721240683008,1.0726564444444442,1.072547777777771,1.072440444444439,1.0724775000000026,1.0722508000000002,1.0727880000000032,1.0736460500000053,1.072615472923219,1.0725232176653758,-999,-523384,-522547,0.004071585307720243,-365.94998289645645,0.03264194583300851
2023-09-06T22:30:00-04:00,1.07259,1.07263,1.0723,1.07246,1.072201342836736,1.072638888888889,1.072549999999993,1.072484444444439,1.0724820000000026,1.0722592000000002,1.072797200000003,1.0736128000000056,1.0725843783385751,1.0725633741323002,-1314,-524698,-522731.8,0.00581209226022486,-366.10924225930705,0.0018649061952098931
2023-09-06T22:45:00-04:00,1.07246,1.0728,1.07239,1.07277,1.0722724354097972,1.0726828888888886,1.0726322222222153,1.0725386666666612,1.0724985000000027,1.0723026000000002,1.0728105000000032,1.0735801000000054,1.07262150267086,1.07260109930584,1128,-523570,-523018.6,0.007112915536377873,-365.7831881407385,0.06902791899480079
2023-09-06T23:00:00-04:00,1.07277,1.07284,1.07253,1.07261,1.0723,1.0726784444444446,1.0726766666666596,1.0725831111111055,1.0724985000000027,1.0723386000000001,1.072817500000003,1.0735471000000054,1.072619202136688,1.0726124794446714,-1253,-524823,-523772,0.011765969973490286,-365.9700688327787,0.03730612473304465
2023-09-06T23:15:00-04:00,1.07261,1.07287,1.07246,1.07284,1.0723632,1.0727111111111112,1.0727066666666596,1.0726226666666612,1.0725095000000027,1.0723778000000002,1.0728214000000031,1.0735130000000053,1.0726633617093504,1.0726207835557369,943,-523880,-524071,0.016618707879071153,-365.76786113380143,0.0251731821699276
2023-09-06T23:30:00-04:00,1.07284,1.07317,1.07275,1.0731,1.072421344,1.0727897777777775,1.0727711111111042,1.0726673333333279,1.0725410000000026,1.0724274,1.0728254000000033,1.0734830000000053,1.0727506893674803,1.0726478268445891,846,-523034,-524001,0.019428777945211865,-365.5628352212703,0.0540782456271235
2023-09-06T23:45:00-04:00,1.0731,1.07313,1.07292,1.0729899999999999,1.07246,1.0728335555555555,1.0728111111111043,1.0727195555555502,1.0725645000000026,1.0724640000000003,1.072821300000003,1.0734536000000054,1.0727985514939842,1.0726906614756708,-575,-523609,-523783.2,0.021501690877597693,-365.6217766060434,0.03356236540092259
2023-09-07T00:00:00-04:00,1.0729899999999999,1.07303,1.07287,1.07288,1.072531,1.0728473333333333,1.0727888888888821,1.0727508888888835,1.0725890000000025,1.0724898000000003,1.072819000000003,1.0734247000000052,1.0728148411951874,1.0727293291805364,-517,-524126,-523894.4,0.022233893635411138,-365.6747780319653,-0.018637939389419052
2023-09-07T00:15:00-04:00,1.07288,1.07288,1.07249,1.0725,1.07317,1.0727895555555556,1.072748888888882,1.072765333333328,1.0725965000000026,1.0725140000000002,1.0728105000000032,1.0733941000000053,1.07275187295615,1.0727558633444287,-956,-525082,-523946.2,0.01633792511928792,-366.0133806715895,-0.0335551702924814
2023-09-07T00:30:00-04:00,1.0725,1.07258,1.07198,1.072,1.0731564,1.0726397777777776,1.0726833333333265,1.0727606666666614,1.0725845000000025,1.0725216000000002,1.0727991000000032,1.0733619000000054,1.0726014983649201,1.0727434906755426,-858,-525940,-524358.2,0.009873942957804145,-366.4133806715895,-0.055007039036338995
2023-09-07T00:45:00-04:00,1.072,1.07209,1.07178,1.0719,1.073109344,1.0724831111111113,1.0726211111111044,1.0727306666666614,1.0725610000000025,1.0725214,1.0727849000000031,1.0733277500000054,1.0724611986919361,1.072685592540434,-1093,-527033,-525158,0.0049503653727133844,-366.5153396268134,-0.05221639967923222
2023-09-07T01:00:00-04:00,1.0719,1.07202,1.07171,1.07186,1.0730295833599999,1.072330888888889,1.072519999999993,1.0726724444444389,1.0725420000000025,1.0725270000000002,1.072769600000003,1.0732961500000053,1.0723409589535489,1.0725940740323467,-1185,-528218,-526079.8,0.0016205598881666205,-366.5595601697745,-0.08482712976686209
2023-09-07T01:15:00-04:00,1.07186,1.07196,1.07154,1.07171,1.0729240166912,1.072168888888889,1.072419999999993,1.0725986666666614,1.0725055000000026,1.0725196000000001,1.0727541000000032,1.0732615500000053,1.072214767162839,1.072474059225877,-1217,-529435,-527141.6,-0.005909632789973791,-366.7298715910423,-0.08390747802091374
2023-09-07T01:30:00-04:00,1.07171,1.07215,1.07168,1.07195,1.07278561502208,1.072074888888889,1.0723211111111042,1.0725131111111057,1.0725015000000027,1.0725030000000002,1.0727427000000032,1.0732270500000054,1.0721618137302713,1.0723560473807012,1648,-527787,-527682.6,-0.00988808306139662,-366.3608165295051,-0.08295738413929919
2023-09-07T01:45:00-04:00,1.07195,1.07209,1.07166,1.07192,1.072661053519872,1.0719946666666667,1.072189999999993,1.0724144444444392,1.0724870000000026,1.0724870000000002,1.0727261000000032,1.0731924500000054,1.072113450984217,1.0722584379045608,-1835,-529622,-528419,-0.017978017000921886,-366.41217153673483,-0.10996179293634879
2023-09-07T02:00:00-04:00,1.07192,1.07255,1.07169,1.07242,1.07154,1.0720406666666669,1.0721266666666596,1.0723155555555501,1.0724795000000027,1.0724806000000002,1.0727149000000034,1.0731609000000055,1.0721747607873735,1.0722011503236482,2784,-526838,-528380,-0.02525068643478067,-365.1135671632743,-0.05312258268949007
2023-09-07T02:15:00-04:00,1.07242,1.07248,1.07203,1.07227,1.0715602,1.0720693333333333,1.0720588888888818,1.072223333333328,1.0724670000000027,1.0724702000000004,1.0727030000000033,1.0731268500000055,1.0721938086298988,1.072171720258918,-1942,-528780,-528492.4,-0.03063246108421097,-365.3851958162272,-0.05685631198270071
2023-09-07T02:30:00-04:00,1.07227,1.07227,1.0715,1.07207,1.07255,1.0720715555555553,1.0720111111111041,1.07214155555555,1.0724390000000026,1.0724572000000003,1.0726879000000034,1.0730904500000054,1.0721690469039191,1.072162576207134,-2055,-530835,-528772.4,-0.036187787531663504,-365.76849479875955,-0.040093240093233604
2023-09-07T02:45:00-04:00,1.07207,1.07229,1.07146,1.07167,1.0725289999999998,1.0720033333333334,1.0719744444444375,1.0720722222222168,1.0723685000000027,1.0724430000000003,1.0726666000000034,1.0730527500000056,1.0720692375231353,1.072144060965707,-2392,-533227,-529860.4,-0.039666170080694126,-366.6609738346438,-0.03078358208956749
2023-09-07T03:00:00-04:00,1.07167,1.07196,1.07091,1.0714299999999999,1.07248624,1.0718944444444443,1.0719222222222151,1.0720186666666611,1.0722970000000027,1.0724190000000002,1.0726496000000034,1.0730149000000055,1.0719413900185082,1.0721096487725652,-4107,-537334,-531402.8,-0.03765742401874722,-367.58073458188886,-0.043847373822202856
2023-09-07T03:15:00-04:00,1.0714299999999999,1.07168,1.07091,1.0712,1.0723916655999999,1.07175,1.0718488888888817,1.0719631111111056,1.0722275000000028,1.0723912000000002,1.0726234000000034,1.0729771000000057,1.0717931120148065,1.0720333190180518,-2992,-540326,-534100.4,-0.03681639852990093,-368.22301639217966,-0.06157520571717434
2023-09-07T03:30:00-04:00,1.0712,1.07145,1.07081,1.07139,1.0723027656639998,1.0716582222222222,1.0718133333333264,1.0719139999999945,1.0721740000000026,1.0723690000000003,1.0726058000000034,1.0729421000000054,1.0717124896118453,1.0719370552144412,2742,-537584,-535861.2,-0.035872364200386926,-367.73666463713823,-0.029858823748950367
2023-09-07T03:45:00-04:00,1.07139,1.07168,1.07113,1.07155,1.07218334441088,1.0716055555555557,1.0717688888888819,1.07186555555555,1.0721130000000028,1.0723456000000002,1.0725900000000035,1.0729069500000055,1.0716799916894761,1.0718392441715525,3004,-534580,-536610.2,-0.03332440596319425,-367.28805115371966,-0.037315173282331825
2023-09-07T04:00:00-04:00,1.07155,1.07157,1.07085,1.07088,1.0720734768580096,1.0714277777777779,1.0716533333333262,1.0718013333333278,1.0720265000000029,1.0723108000000001,1.0725728000000034,1.0728711000000055,1.0715199933515809,1.0717293953372415,-2672,-537252,-537415.2,-0.034912944173661455,-368.9587524742365,-0.0970221658332646
2023-09-07T04:15:00-04:00,1.07088,1.07119,1.07074,1.07105,1.0719723987093688,1.0713071111111112,1.0715011111111041,1.0717171111111055,1.0719370000000028,1.0722794000000002,1.0725494000000035,1.0728425000000055,1.0714259946812648,1.0716263162697928,2436,-534816,-536911.6,-0.036101419802310346,-368.5720424787188,-0.1277484567613315
2023-09-07T04:30:00-04:00,1.07105,1.07136,1.07081,1.0711,1.071849158838432,1.0712268888888887,1.0713711111111042,1.07162155555555,1.0718370000000028,1.0722506000000003,1.0725279000000034,1.0728146000000054,1.0713607957450118,1.071539853015834,3089,-531727,-535191.8,-0.04068887206632876,-368.42783819320493,-0.10911430889609103
2023-09-07T04:45:00-04:00,1.0711,1.07168,1.07088,1.07102,1.0717382429545887,1.0711566666666668,1.0712544444444374,1.0715097777777722,1.0717385000000028,1.0722204000000004,1.0725091000000033,1.0727864500000055,1.0712926365960094,1.0714558824126665,-2826,-534553,-534585.6,-0.043114019342384735,-368.6389109221748,-0.09794136576902583
2023-09-07T05:00:00-04:00,1.07102,1.07151,1.07069,1.07136,1.07168,1.0711777777777778,1.071219999999993,1.0713999999999946,1.0716625000000028,1.0721974000000003,1.0724888000000035,1.0727588500000056,1.0713061092768075,1.0713811059301328,2494,-532059,-534081.4,-0.0424995323493263,-367.84717967532595,-0.028926815157633456
2023-09-07T05:15:00-04:00,1.07136,1.07174,1.07118,1.07147,1.07069,1.071227777777778,1.0712244444444374,1.0713142222222167,1.071611000000003,1.0721730000000003,1.0724710000000033,1.0727354500000055,1.071338887421446,1.0713448847441058,2398,-529661,-532563.2,-0.038103117923417563,-367.6009692511925,0.0037333283555659267
2023-09-07T05:30:00-04:00,1.07147,1.07178,1.07132,1.07135,1.07069,1.071252888888889,1.0712411111111042,1.0712622222222168,1.0715785000000029,1.0721532000000003,1.0724496000000032,1.0727110000000055,1.0713411099371568,1.0713279077952842,-2408,-532069,-532013.8,-0.03374131304468389,-367.87065482335015,0.014002987303967
2023-09-07T05:45:00-04:00,1.07135,1.07154,1.07097,1.07146,1.0707335999999998,1.0712966666666668,1.0712488888888823,1.0712377777777724,1.071556500000003,1.0721346000000005,1.0724302000000032,1.0726900500000054,1.0713648879497255,1.071328726236227,2173,-529896,-531647.6,-0.028916105964054573,-367.647543795208,0.006533568541802191
2023-09-07T06:00:00-04:00,1.07146,1.07149,1.07108,1.07122,1.0707754559999998,1.0712908888888888,1.0712122222222156,1.071229333333328,1.0715245000000029,1.0721116000000004,1.0724114000000031,1.0726694500000054,1.0713359103597804,1.0713373809889812,-3024,-532920,-531321,-0.02748157414638826,-368.3248999260949,-0.03079650972889193
2023-09-07T06:15:00-04:00,1.07122,1.07128,1.0707,1.07097,1.07178,1.0712424444444446,1.0712222222222154,1.0712297777777724,1.071487500000003,1.0720822000000003,1.0723937000000032,1.0726533000000054,1.0712627282878242,1.0713287047911846,-1611,-534531,-531815.4,-0.028940344315102312,-368.70087311554255,0.00840430300313046
2023-09-07T06:30:00-04:00,1.07097,1.07103,1.0704,1.07088,1.0717584,1.071174,1.0712033333333268,1.0712255555555503,1.071434000000003,1.0720476000000003,1.0723761000000032,1.0726307500000052,1.0711861826302593,1.0712981638329473,-1665,-536196,-533122.4,-0.025252626259479143,-368.84079300125353,-0.01587227487045455
2023-09-07T06:45:00-04:00,1.07088,1.07117,1.07056,1.07061,1.071704064,1.0710553333333335,1.0711488888888823,1.071207111111106,1.071368500000003,1.0720074000000004,1.0723499000000032,1.0726096500000053,1.0710709461042074,1.0712441310663574,-1738,-537934,-534295.4,-0.023405183007677348,-369.2789933598371,-0.04574736252449626
2023-09-07T07:00:00-04:00,1.07061,1.07135,1.0706,1.07109,1.0716519014399999,1.0710435555555557,1.0711566666666599,1.0711886666666615,1.071302000000003,1.0719798000000003,1.0723169000000032,1.0725873500000054,1.0710747568833658,1.0711861048530853,1628,-536306,-535577.4,-0.019810244789774695,-368.54909171498036,0.006535825661520279
2023-09-07T07:15:00-04:00,1.07109,1.07109,1.07069,1.07069,1.0716018253823998,1.0709502222222222,1.0710822222222154,1.0711626666666612,1.071223000000003,1.0719432000000004,1.0722860000000032,1.0725663000000054,1.0709978055066927,1.0711184838824679,-1541,-537847,-536562.8,-0.015202209387431637,-369.12458023601994,-0.0625373357228355
2023-09-07T07:30:00-04:00,1.07069,1.07071,1.07052,1.07059,1.0715537523671037,1.0708517777777777,1.0709844444444374,1.0711151111111057,1.071149000000003,1.0719072000000003,1.0722535000000033,1.0725456500000055,1.0709162444053542,1.0710491871059737,-1650,-539497,-537556,-0.014923283121956468,-369.2786864665815,-0.08213015763390408
2023-09-07T07:45:00-04:00,1.07059,1.0706499999999999,1.0703,1.07052,1.0715076022724195,1.070758888888889,1.0708922222222155,1.0710528888888835,1.071091500000003,1.0718706000000002,1.0722202000000032,1.0725241000000054,1.0708369955242834,1.0709793496847786,-1826,-541323,-538581.4,-0.01690266076835197,-369.39807857747365,-0.07747234797219475
2023-09-07T08:00:00-04:00,1.07052,1.07107,1.07025,1.07062,1.0714351461360743,1.0707044444444445,1.070798888888882,1.0709828888888835,1.0710510000000029,1.0718382000000002,1.0721816000000033,1.0725035500000053,1.0707935964194266,1.0709238797478224,2788,-538535,-538701.6,-0.019050837058373557,-369.1376443959544,-0.07839770033413976
2023-09-07T08:15:00-04:00,1.07062,1.07067,1.07011,1.07048,1.0713403344451884,1.0706406666666666,1.0707166666666597,1.0708948888888836,1.0710150000000032,1.0718004,1.0721397000000032,1.0724829500000055,1.0707308771355413,1.0708551037982574,-2678,-541213,-539683,-0.023977947224221627,-369.4878340057127,-0.06908011426223959
2023-09-07T08:30:00-04:00,1.07048,1.07052,1.0688199999999999,1.06947,1.0712173010006696,1.0703913333333333,1.070549999999993,1.070788444444439,1.070919000000003,1.0717450000000002,1.0720935000000034,1.0724585000000053,1.070478701708433,1.0707512830386055,-7750,-548963,-541906.2,-0.032628168273544936,-376.799974353969,-0.1400599456567464
2023-09-07T08:45:00-04:00,1.06947,1.06953,1.06858,1.06932,1.0709296248805893,1.0701453333333333,1.0703766666666599,1.0706668888888835,1.0708075000000032,1.0716826000000002,1.0720427000000032,1.0724353500000054,1.0702469613667465,1.0706174264308839,-6015,-554978,-545002.4,-0.03883456289409635,-377.6436165318695,-0.14567458538771905
2023-09-07T09:00:00-04:00,1.06932,1.07027,1.06927,1.06947,1.070600677397307,1.0699639999999997,1.070249999999993,1.070538444444439,1.0707370000000034,1.0716314000000002,1.0719974000000032,1.0724142000000052,1.0700915690933972,1.0704683411447067,5736,-549242,-546586.2,-0.0427562148605803,-376.8389930328241,-0.10648135175275225
2023-09-07T09:15:00-04:00,1.06947,1.06997,1.06935,1.06989,1.0703177825616839,1.069892,1.0701166666666595,1.0704019999999945,1.0706790000000033,1.0715850000000002,1.0719598000000032,1.0723971000000052,1.0700512552747177,1.070319872915765,4559,-544683,-547815.8,-0.045079683321136745,-375.0485921800649,-0.1120354031874156
2023-09-07T09:30:00-04:00,1.06989,1.07042,1.0694299999999999,1.07002,1.06858,1.0698726666666665,1.070042222222215,1.0702671111111057,1.0706250000000033,1.0715340000000002,1.0719228000000032,1.0723796000000052,1.0700450042197742,1.0701826983326115,5369,-539314,-547436,-0.050494582717768584,-374.3962167022122,-0.06257646937955416
2023-09-07T09:45:00-04:00,1.07002,1.0700399999999999,1.0691,1.0691599999999999,1.0686168,1.0696962222222222,1.0698833333333262,1.0701337777777724,1.0705320000000034,1.0714668000000003,1.0718776000000032,1.0723591500000051,1.0698680033758194,1.0700605586660887,-5461,-544775,-546598.4,-0.056161333282033564,-378.7853496156161,-0.133571208399111
2023-09-07T10:00:00-04:00,1.0691599999999999,1.06981,1.06863,1.06937,1.07042,1.0695935555555556,1.0697555555555485,1.0700095555555502,1.0704325000000035,1.0714016000000002,1.0718380000000032,1.072338850000005,1.0697684027006555,1.0699648469328706,4978,-539797,-543562.2,-0.06022239313918993,-377.80759137550217,-0.10742442924933532
2023-09-07T10:15:00-04:00,1.06937,1.06999,1.0693,1.06955,1.0703842,1.0695524444444442,1.0696366666666597,1.0698868888888835,1.0703365000000034,1.0713310000000003,1.0718041000000031,1.072324500000005,1.0697247221605244,1.0698914775462958,3782,-536015,-540916.8,-0.06123710973265788,-377.1709922563944,-0.09994208963029874
2023-09-07T10:30:00-04:00,1.06955,1.07086,1.06936,1.0708,1.06863,1.0697851111111112,1.0696722222222153,1.0697979999999947,1.0703090000000033,1.0712898000000002,1.071781900000003,1.072312950000005,1.0699397777284194,1.0698691820370363,5077,-530938,-538167.8,-0.05657650106543005,-371.2374220633227,0.02989313205289925
2023-09-07T10:45:00-04:00,1.0708,1.07101,1.07015,1.0703,1.0686746,1.0699106666666667,1.0697644444444374,1.069742444444439,1.0702510000000034,1.0712440000000003,1.0717474000000031,1.072292450000005,1.0700118221827355,1.0698625456296285,-5380,-536318,-537568.6,-0.05358935206905925,-373.74956251905644,0.07760853506878253
2023-09-07T11:00:00-04:00,1.0703,1.07055,1.06947,1.06963,1.068768016,1.0698837777777779,1.0697988888888819,1.06972555555555,1.0701715000000034,1.0711874000000001,1.071723300000003,1.072273650000005,1.0699354577461884,1.0698760365037023,-4642,-540960,-536805.6,-0.04395619064114172,-376.6554206896626,0.028990386413798717
2023-09-07T11:15:00-04:00,1.06963,1.07023,1.06946,1.07002,1.06885769536,1.069928,1.069859999999993,1.069746444444439,1.0701240000000032,1.0711324000000004,1.0717175000000032,1.072251050000005,1.0699523661969508,1.0699128292029614,3303,-537657,-536377.6,-0.03207785186489473,-375.4511070484973,0.0514273425154563
2023-09-07T11:30:00-04:00,1.07002,1.07088,1.06983,1.07063,1.0689437875456,1.070082,1.069942222222215,1.06980755555555,1.0701115000000034,1.0710928000000002,1.071715700000003,1.072237250000005,1.0700878929575606,1.0699854633623684,1994,-535663,-536307.2,-0.01972579674076346,-374.31436194092925,0.06916598902690584
2023-09-07T11:45:00-04:00,1.07063,1.07084,1.07011,1.07031,1.069026436043776,1.0701555555555555,1.0699744444444372,1.0698679999999943,1.0700965000000033,1.0710422000000002,1.071710000000003,1.0722242500000052,1.0701323143660484,1.0700239706898944,-2003,-537666,-537652.8,-0.01326507817953705,-374.91303748710277,0.02710229715333578
2023-09-07T12:00:00-04:00,1.07031,1.07096,1.0703,1.07092,1.069105778602025,1.0703446666666667,1.070169999999993,1.0699491111111055,1.0700880000000033,1.0709986000000002,1.0717130000000032,1.0722190000000051,1.0702898514928387,1.0700795765519149,2128,-535538,-537496.8,-0.006234189254699392,-373.70022998273487,0.16461521194210466
2023-09-07T12:15:00-04:00,1.07092,1.07093,1.07042,1.07084,1.069181947457944,1.0704786666666666,1.070333333333326,1.0700559999999943,1.0700955000000034,1.0709556000000002,1.0717098000000032,1.0722107000000052,1.070399881194271,1.0701724612415315,-1541,-537079,-536720.6,0.010577325276418671,-373.8153459577845,0.13746411438511297
2023-09-07T12:30:00-04:00,1.07084,1.07088,1.07049,1.07062,1.0692550695596263,1.070536,1.0704522222222148,1.0701744444444388,1.0700970000000034,1.0709104000000003,1.0717001000000033,1.072206550000005,1.0704439049554169,1.0702707689932247,-1420,-538499,-536889,0.022569777412990284,-374.1070795501047,0.1000420737693333
2023-09-07T12:45:00-04:00,1.07062,1.07081,1.07039,1.0704,1.0693252667772413,1.0705255555555555,1.0704077777777705,1.0702675555555499,1.0700910000000035,1.0708684000000002,1.071691200000003,1.0722043500000051,1.0704351239643335,1.0703402151945793,-1130,-539629,-537682.2,0.0313585501112586,-374.33928145180636,-0.03735524841239783
2023-09-07T13:00:00-04:00,1.0704,1.07093,1.07028,1.07063,1.0693926561061515,1.07057,1.0704444444444374,1.0703615555555497,1.0700915000000033,1.0708410000000002,1.071681300000003,1.0722009500000054,1.0704740991714667,1.070408572155663,1748,-537881,-537725.2,0.029280296541171168,-373.9636835444821,0.030832476875636873
2023-09-07T13:15:00-04:00,1.07063,1.07085,1.07051,1.07067,1.0694573498619055,1.070615111111111,1.0705599999999929,1.0704395555555497,1.0701010000000033,1.0708164,1.071668900000003,1.072199100000005,1.0705132793371734,1.0704532577245298,1356,-536525,-537922.6,0.03251529647378255,-373.91302178458363,0.09722988323064329
2023-09-07T13:30:00-04:00,1.07067,1.07095,1.07037,1.0703799999999999,1.0695194558674292,1.0705791111111111,1.0705999999999927,1.070492888888883,1.0701465000000034,1.0707868,1.071656900000003,1.072189450000005,1.0704866234697388,1.0704706061796234,-1517,-538042,-538115.2,0.039969028675488294,-374.3239140296266,0.03364423094894637
2023-09-07T13:45:00-04:00,1.0703799999999999,1.07044,1.06984,1.06992,1.069579077632732,1.0704431111111112,1.070521111111104,1.0705066666666607,1.0701765000000036,1.0707510000000002,1.0716353000000032,1.0721757500000053,1.070373298775791,1.0704564849436982,-1240,-539282,-538271.8,0.03703135116404063,-374.85680888939595,-0.06631609426225572
2023-09-07T14:00:00-04:00,1.06992,1.07031,1.06974,1.07029,1.0696363145274228,1.0703968888888888,1.0705188888888817,1.070528888888883,1.0702175000000036,1.0707178000000002,1.071610400000003,1.0721635000000052,1.0703566390206327,1.0704407879549582,1592,-537690,-537884,0.029536589685547593,-374.3062630541933,-0.0018686175033523953
2023-09-07T14:15:00-04:00,1.07029,1.07037,1.06996,1.07013,1.069691261946326,1.0703191111111112,1.070431111111104,1.0705262222222163,1.0702295000000035,1.0706820000000001,1.071584500000003,1.0721511500000052,1.0703113112165061,1.0704082303639662,-1191,-538881,-538084,0.024917150474980183,-374.4843082568953,-0.07376834870952717
2023-09-07T14:30:00-04:00,1.07013,1.07013,1.06962,1.06976,1.07101,1.0701848888888887,1.0703111111111039,1.0704764444444386,1.0702165000000035,1.0706288000000002,1.071554700000003,1.072136450000005,1.070201048973205,1.0703457842911723,-1247,-540128,-538804.6,0.014656708648152564,-374.9154614812699,-0.10085540323484087
2023-09-07T14:45:00-04:00,1.06976,1.06999,1.0694,1.06941,1.0709822,1.0700046666666667,1.0701766666666597,1.070391777777772,1.0702290000000034,1.0705716,1.071520900000003,1.0721187500000051,1.070042839178564,1.0702570274329373,-1469,-541597,-539515.6,0.00400912353738771,-375.39608330298705,-0.11301862472211742
2023-09-07T15:00:00-04:00,1.06941,1.06982,1.06939,1.06951,1.070918912,1.0698713333333334,1.0700777777777708,1.0703031111111052,1.0702360000000035,1.0705204000000001,1.0714888000000031,1.0721038000000052,1.069936271342851,1.0701696219463495,1471,-540126,-539684.4,-0.007920231697635165,-375.25853082077725,-0.08314648729447471
2023-09-07T15:15:00-04:00,1.06951,1.06963,1.0695,1.06962,1.07082717728,1.0697797777777778,1.0699655555555485,1.0701924444444386,1.0702395000000036,1.0704794000000002,1.071461200000003,1.072088200000005,1.069873017074281,1.0700728975570792,1044,-539082,-539962.8,-0.016320835227774597,-375.1511545456606,-0.09433697916179777
2023-09-07T15:30:00-04:00,1.06962,1.06974,1.06951,1.06974,1.0707409466432,1.0697346666666667,1.0698622222222152,1.0700786666666608,1.0701865000000033,1.0704456000000002,1.071432300000003,1.072073700000005,1.0698464136594248,1.069979918045663,880,-538202,-539827,-0.025482179159863172,-375.05242789507446,-0.08686149794055101
2023-09-07T15:45:00-04:00,1.06974,1.07015,1.06938,1.0695,1.070659889844608,1.0696622222222223,1.0697644444444372,1.0699693333333276,1.0701465000000034,1.0704116000000001,1.071401400000003,1.072059700000005,1.06977713092754,1.0698951344365297,-2348,-540550,-539911.4,-0.03063200082911856,-375.5792101038355,-0.08221379323230928
2023-09-07T16:00:00-04:00,1.0695,1.06987,1.06948,1.06975,1.0705574986570394,1.0696593333333333,1.0697455555555484,1.0698831111111056,1.0701525000000036,1.0703788000000003,1.071373900000003,1.072046650000005,1.0697717047420319,1.0698409075492232,778,-539772,-539546.4,-0.034072482676446185,-375.39734942127353,-0.015889038432780347
2023-09-07T16:15:00-04:00,1.06975,1.06979,1.0695999999999999,1.06963,1.0704632987644762,1.0696362222222224,1.0696722222222153,1.0698019999999944,1.0701330000000033,1.0703404000000003,1.071343000000003,1.0720325500000047,1.0697433637936256,1.0698023260393783,-437,-540209,-539563,-0.03678243983329855,-375.44637022052564,-0.06166552990309943
2023-09-07T16:30:00-04:00,1.06963,1.0697699999999999,1.06952,1.06963,1.0703766348633181,1.0696277777777778,1.0696166666666598,1.0697322222222165,1.0700830000000034,1.0703154000000004,1.0713131000000031,1.0720189500000048,1.0697206910349004,1.069771860831502,0,-540209,-539788.4,-0.04121520325668803,-375.44637022052564,-0.04672329530056581
2023-09-07T16:45:00-04:00,1.06963,1.06964,1.06955,1.06957,1.0702969040742527,1.0696184444444443,1.0695955555555487,1.0696788888888833,1.0700460000000034,1.0702858000000004,1.071282600000003,1.072006000000005,1.0696905528279204,1.0697406886652012,-720,-540929,-540333.8,-0.04173336305995089,-375.4867580181754,-0.01776099311996471
2023-09-07T17:00:00-04:00,1.06957,1.06978,1.06957,1.06967,1.0702235517483125,1.0696333333333332,1.0696244444444374,1.0696508888888832,1.0699835000000033,1.0702572000000001,1.071253900000003,1.071994450000005,1.0696864422623362,1.0697225509321604,64,-540865,-540396.8,-0.03972748379075128,-375.4807743050944,0.02431247136270719
2023-09-07T17:15:00-04:00,1.06967,1.06968,1.06962,1.06967,1.0701560676084476,1.0696424444444443,1.069642222222215,1.0696302222222165,1.0699250000000031,1.0702302000000001,1.0712253000000032,1.071980600000005,1.069683153809869,1.069704840745728,0,-540865,-540615.4,-0.031736579712332166,-375.4807743050944,0.01496012192498789
2023-09-07T17:30:00-04:00,1.06967,1.06973,1.06965,1.06967,1.0700939821997717,1.069648,1.0696477777777706,1.0696253333333277,1.0698775000000031,1.0701964000000002,1.0711969000000032,1.071966100000005,1.0696805230478952,1.069692272596582,0,-540865,-540746.6,-0.02503541676930044,-375.4807743050944,0.004674557319410956
2023-09-07T17:45:00-04:00,1.06967,1.0698,1.06961,1.06972,1.07003686362379,1.0696624444444442,1.0696455555555484,1.0696311111111054,1.0698435000000033,1.0701614000000002,1.0711672000000032,1.0719540500000049,1.0696884184383162,1.069685818077265,116,-540749,-540854.6,-0.02009589950152519,-375.47535207206926,-0.0018696131770251632
2023-09-07T18:00:00-04:00,1.06972,1.06982,1.06956,1.06979,1.0699843145338868,1.0696913333333333,1.0696777777777706,1.0696475555555498,1.069801500000003,1.0701302000000001,1.0711417000000032,1.0719426000000047,1.0697087347506529,1.0696894544618116,250,-540499,-540768.6,-0.01691395160622436,-375.4589926509123,0.027115474520815662
2023-09-07T18:15:00-04:00,1.06979,1.06983,1.06971,1.06979,1.0699359693711759,1.0697137777777777,1.069682222222215,1.0696591111111053,1.069757500000003,1.0700968,1.0711157000000031,1.071931350000005,1.0697249878005224,1.0696971635694488,0,-540499,-540695.4,-0.010464786061392804,-375.4589926509123,0.00373919139986352
2023-09-07T18:30:00-04:00,1.06979,1.06985,1.06966,1.06967,1.0698914918214817,1.0697113333333332,1.0696866666666593,1.069667999999994,1.069722000000003,1.0700658,1.0710887000000031,1.071918750000005,1.0697139902404178,1.0697033308555586,-142,-540641,-540650.6,-0.006761683378443313,-375.4749210106839,0.003739610893469513
2023-09-07T18:45:00-04:00,1.06967,1.0697,1.06955,1.06956,1.0698505724757632,1.069686,1.0696788888888815,1.0696742222222162,1.069704000000003,1.0700376,1.0710599000000032,1.071905550000005,1.0696831921923342,1.0697038646844466,-118,-540759,-540629.4,-0.003766025640724718,-375.487055594247,-0.006544319063602787
2023-09-07T19:00:00-04:00,1.06956,1.06963,1.06951,1.06956,1.06985,1.0696622222222223,1.0696777777777706,1.0696806666666607,1.069667500000003,1.0700112,1.0710294000000031,1.071892850000005,1.0696585537538674,1.0696978917475566,0,-540759,-540631.4,-0.0028178870384879926,-375.487055594247,-0.0009349551688850162
2023-09-07T19:15:00-04:00,1.06956,1.06959,1.0694,1.06952,1.0698124,1.0696306666666666,1.0696611111111038,1.0696773333333272,1.0696370000000033,1.0699894,1.0709984000000032,1.071879350000005,1.0696308430030939,1.0696823133980449,-278,-541037,-540739,0.00014245730873699343,-375.4974523929306,-0.014023016444312027
2023-09-07T19:30:00-04:00,1.06952,1.06964,1.06948,1.06959,1.069777808,1.0696164444444445,1.0696522222222151,1.0696713333333272,1.0696285000000034,1.0699594000000001,1.070969600000003,1.0718654500000049,1.069622674402475,1.0696618507184354,585,-540452,-540729.6,0.0017985667562646682,-375.45916418887646,-0.007478942103626162
2023-09-07T19:45:00-04:00,1.06959,1.06975,1.06954,1.06974,1.06938,1.069634,1.0696599999999927,1.069665999999994,1.0696450000000033,1.0699404000000001,1.070941800000003,1.071852850000005,1.06964613952198,1.0696482805747478,475,-539977,-540596.8,0.0025420359707579486,-375.3925498787203,0.006544074340685866
2023-09-07T20:00:00-04:00,1.06974,1.07025,1.0697,1.0701,1.0693874,1.069722,1.069702222222215,1.0696706666666604,1.0696745000000032,1.0699306000000002,1.070918900000003,1.071840350000005,1.069736911617584,1.0696590244597979,1153,-538824,-540209.8,0.0034901838581591657,-375.00453035995855,0.035523314512213196
2023-09-07T20:15:00-04:00,1.0701,1.07045,1.07003,1.07034,1.0694219040000001,1.0698495555555556,1.0697633333333263,1.0696877777777718,1.0697105000000033,1.069927,1.070898800000003,1.071829550000005,1.0698575292940673,1.0696988195678376,1180,-537644,-539586.8,0.0055912104038639675,-374.7398821962355,0.05141195935651394
2023-09-07T20:30:00-04:00,1.07034,1.07146,1.07025,1.07098,1.0694835897600001,1.070092888888889,1.0698955555555483,1.0697346666666607,1.0697725000000031,1.0699342000000003,1.070886200000003,1.0718217000000052,1.070082023435254,1.0697890556542697,2877,-534767,-538332.8,0.010660938100538276,-373.01960639602254,0.11123678478954041
2023-09-07T20:45:00-04:00,1.07098,1.0715,1.07086,1.0714,1.0696417025792002,1.0703937777777779,1.0700877777777706,1.0698217777777717,1.069867500000003,1.0699526000000004,1.0708765000000031,1.071815600000005,1.0703456187482032,1.0699336445234153,1934,-532833,-536809,0.018320325279543265,-372.26116086015844,0.1617321229912038
2023-09-07T21:00:00-04:00,1.0714,1.07145,1.07108,1.0712,1.0698275323212803,1.0706162222222222,1.0702699999999927,1.0699437777777718,1.0699400000000032,1.0699872000000004,1.0708661000000033,1.0718091500000049,1.0705164949985626,1.070107715618732,-2247,-535080,-535829.6,0.025052796019606915,-372.68061204552333,0.1533340813044489
2023-09-07T21:15:00-04:00,1.0712,1.0712,1.07048,1.07093,1.0699947790891522,1.0707482222222222,1.0704222222222153,1.070087777777772,1.0700050000000032,1.0700194000000003,1.070851000000003,1.071800500000005,1.0705991959988501,1.0702801724949853,-3012,-538092,-535683.2,0.03260386306408715,-373.4397980051947,0.12809005572383703
2023-09-07T21:30:00-04:00,1.07093,1.07196,1.0709,1.07152,1.0701453011802369,1.0709677777777777,1.0706444444444374,1.070263999999994,1.070099500000003,1.0700604000000005,1.070845900000003,1.071795650000005,1.07078335679908,1.0704653379959876,1723,-536369,-535428.2,0.042506948765014894,-372.4905576253378,0.18699977560026945
2023-09-07T21:45:00-04:00,1.07152,1.07215,1.07152,1.07171,1.0703630650386085,1.0711808888888887,1.070879999999993,1.070460888888883,1.0702065000000032,1.0700968000000004,1.070840900000003,1.0717919500000048,1.0709686854392642,1.0706426703967897,1157,-535212,-535517.2,0.05371167186563505,-372.28540046541553,0.19820678951746928
2023-09-07T22:00:00-04:00,1.07171,1.07198,1.07144,1.07188,1.0706132359332032,1.071380888888889,1.0711177777777707,1.070666888888883,1.0703170000000033,1.0701340000000004,1.070834000000003,1.0717907500000048,1.0711509483514112,1.0708037363174312,1586,-533626,-535675.8,0.06482467306282035,-372.03382121356566,0.20004860994260576
2023-09-07T22:15:00-04:00,1.07188,1.07201,1.07167,1.0718699999999999,1.0708283829025547,1.0715313333333334,1.0713144444444374,1.070875777777772,1.0704270000000031,1.0701882000000003,1.070827500000003,1.0717899000000048,1.071294758681129,1.0709593890539444,-1338,-534964,-535652.6,0.07493034365311463,-372.04630395417104,0.1654051023268692
2023-09-07T22:30:00-04:00,1.0718699999999999,1.07233,1.07176,1.07185,1.071013409296197,1.0716384444444444,1.0714822222222151,1.0710877777777719,1.070536000000003,1.0702378000000003,1.0708197000000028,1.0717907000000049,1.0714058069449033,1.071120711243155,-1456,-536420,-535318.2,0.08157331790091384,-372.07347142783846,0.1410766672272269
2023-09-07T22:45:00-04:00,1.07185,1.07194,1.07172,1.07178,1.0712240638088055,1.0716979999999998,1.071571111111104,1.0712731111111053,1.0706390000000032,1.0702824000000006,1.0708067000000028,1.0717899500000048,1.0714806455559227,1.0712601689945236,-1151,-537571,-535558.6,0.08563104636972654,-372.1486405279924,0.07469794020429063
2023-09-07T23:00:00-04:00,1.07178,1.07185,1.07167,1.07173,1.0714010135993965,1.0717297777777777,1.0716077777777708,1.071418666666661,1.0707360000000032,1.0703010000000004,1.0707954000000028,1.071788100000005,1.0715305164447382,1.0713725351956185,-796,-538367,-536189.6,0.08368872614998023,-372.1857750145474,0.030800821355251404
2023-09-07T23:15:00-04:00,1.07173,1.07174,1.07152,1.07165,1.07233,1.0717382222222223,1.0716577777777707,1.071526666666661,1.0708290000000031,1.0703280000000006,1.0707860000000027,1.0717870000000047,1.0715544131557906,1.0714532281564944,-913,-539280,-537320.4,0.07774487389500173,-372.25392650792736,0.04200896191188028
2023-09-07T23:30:00-04:00,1.07165,1.07166,1.07148,1.07162,1.0723138,1.0717306666666664,1.0717344444444374,1.071610666666661,1.0709265000000032,1.0703678000000005,1.0707776000000029,1.0717874000000047,1.0715675305246324,1.0715077825251953,-609,-539889,-538305.4,0.07352300317528106,-372.2709749845755,0.06442998141802728
2023-09-07T23:45:00-04:00,1.07162,1.07175,1.07156,1.07165,1.072280448,1.0717137777777777,1.071748888888882,1.0716639999999944,1.0710310000000032,1.0704004000000007,1.0707664000000028,1.0717884500000046,1.071584024419706,1.0715434260201557,647,-539242,-538869.8,0.07143562212515603,-372.25286222072265,0.012132298043896846
2023-09-08T00:00:00-04:00,1.07165,1.07169,1.0714299999999999,1.07144,1.0722484300800001,1.071652,1.071718888888882,1.0716935555555498,1.0711250000000032,1.0704166000000006,1.0707547000000028,1.0717861000000048,1.0715552195357647,1.071558340816124,-823,-540065,-539368.6,0.06232421574575023,-372.4141368906242,-0.025193382538185934
2023-09-08T00:15:00-04:00,1.07144,1.07169,1.07142,1.07163,1.0721993242752001,1.0716342222222222,1.071691111111104,1.0717102222222166,1.0712305000000033,1.0704430000000005,1.0707426000000029,1.0717820000000047,1.0715701756286118,1.0715662726528987,695,-539370,-539569.2,0.052369218102953315,-372.29089153857456,-0.02332350636263961
2023-09-08T00:30:00-04:00,1.07163,1.07165,1.07148,1.07153,1.0721369783331842,1.071602,1.0716533333333262,1.0717093333333279,1.071327500000003,1.0704552000000005,1.0707269000000028,1.0717761500000047,1.0715621405028894,1.0715678181223187,-782,-540152,-539743.6,0.040162445646502856,-372.36386448632703,-0.031720264584304526
2023-09-08T00:45:00-04:00,1.07153,1.07153,1.07127,1.07135,1.0720796200665295,1.0715413333333335,1.0715977777777708,1.0716819999999943,1.0714080000000032,1.0704654000000005,1.070710500000003,1.0717659000000048,1.0715197124023115,1.0715582544978544,-798,-540950,-539955.8,0.027482565039695053,-372.4979157961364,-0.04664831832811914
2023-09-08T01:00:00-04:00,1.07135,1.07155,1.07135,1.07146,1.0719986580598766,1.071513777777778,1.071562222222215,1.071644666666661,1.0714760000000034,1.0704822000000005,1.070696300000003,1.0717576500000048,1.0715077699218492,1.071543003598283,788,-540162,-540139.8,0.016195829085375858,-372.4170085296035,-0.029856873612110316
2023-09-08T01:15:00-04:00,1.07146,1.07182,1.0714,1.0718,1.071925792253889,1.0715613333333334,1.071569999999993,1.0716148888888832,1.0715490000000032,1.0705102000000004,1.0706893000000028,1.0717499000000048,1.0715662159374792,1.0715452028786259,854,-539308,-539988.4,0.00882614886619884,-372.1460138121152,0.006531495805847974
2023-09-08T01:30:00-04:00,1.0718,1.07202,1.07177,1.07198,1.07127,1.0716433333333333,1.0716066666666595,1.0715979999999943,1.0715990000000033,1.0705372000000004,1.070689100000003,1.0717441000000045,1.0716489727499834,1.0715609623029003,1040,-538268,-539768,0.0038706019122097396,-371.9713543607252,0.030793635981891613
2023-09-08T01:45:00-04:00,1.07198,1.07262,1.0718699999999999,1.07236,1.071285,1.0717940000000001,1.0716888888888816,1.0716051111111053,1.0716470000000033,1.0705710000000004,1.0706937000000027,1.0717393000000046,1.0717911781999867,1.0716067698423197,1739,-536529,-539043.4,0.004363602754230173,-371.3549062926641,0.06905432895988904
2023-09-08T02:00:00-04:00,1.07236,1.0728,1.07223,1.07259,1.0713384000000001,1.0719742222222222,1.071793333333326,1.0716442222222164,1.071716500000003,1.0706152000000004,1.070701000000003,1.0717353000000045,1.0719509425599894,1.0716930158738553,3064,-533465,-537546.4,0.008126891479841358,-370.6977389234972,0.08771520552418616
2023-09-08T02:15:00-04:00,1.07259,1.0727,1.07197,1.0721,1.0714260960000002,1.0720355555555556,1.0718666666666594,1.0717051111111053,1.0717750000000033,1.0706588000000006,1.0707049000000028,1.0717295000000044,1.0719807540479915,1.0717876126990837,-2199,-535664,-536646.8,0.008326509357826938,-371.70232595115897,0.06159934294035177
2023-09-08T02:30:00-04:00,1.0721,1.07227,1.07181,1.0718699999999999,1.0715085302400003,1.0720362222222222,1.071893333333326,1.0717697777777722,1.0717925000000033,1.0706904000000004,1.070704100000003,1.0717234000000047,1.0719586032383932,1.0718660901592667,-1874,-537538,-536292.8,0.008161771011268441,-372.10435934356667,0.02239578959153774
2023-09-08T02:45:00-04:00,1.0718699999999999,1.07188,1.0714299999999999,1.07154,1.0728,1.0719655555555556,1.0718944444444372,1.0718273333333275,1.0717840000000032,1.0707186000000004,1.070700300000003,1.0717132000000045,1.0718748825907145,1.0719112721274129,-2051,-539589,-536557,0.007233179858068962,-372.73580718705506,0.0009332449861267036
2023-09-08T03:00:00-04:00,1.07154,1.07186,1.07116,1.07177,1.0727726,1.0719406666666667,1.0719411111111037,1.0718777777777722,1.0717785000000033,1.0707588000000003,1.070693800000003,1.0717043500000045,1.0718539060725716,1.07192381770193,3434,-536155,-536482.2,0.009205840733006785,-371.9987185109442,0.03920287487747841
2023-09-08T03:15:00-04:00,1.07177,1.07191,1.07108,1.07113,1.072708096,1.0717784444444445,1.071904444444437,1.0718999999999943,1.0717415000000032,1.0707932000000004,1.070682400000003,1.0716927000000045,1.0717091248580572,1.0718754541615436,-2485,-538640,-537517.2,0.01048576646091501,-373.482618974663,-0.0307990965598495
2023-09-08T03:30:00-04:00,1.07113,1.0715,1.07081,1.07148,1.07261041024,1.0716935555555553,1.0718688888888814,1.0719004444444387,1.0717230000000033,1.0708326000000004,1.070676500000003,1.0716822000000044,1.0716632998864457,1.0718119633292342,3055,-535585,-537501.4,0.012405409860836939,-372.48437413043285,-0.029856316476963796
2023-09-08T03:45:00-04:00,1.07148,1.07148,1.07075,1.07086,1.0724663774208,1.0714917777777777,1.0717444444444368,1.0718706666666609,1.0716770000000033,1.0708574000000004,1.070668400000003,1.0716675000000044,1.0715026399091565,1.071720770663387,-2971,-538556,-537705,0.008033656042462593,-374.2035102785646,-0.10447956118584395
2023-09-08T04:00:00-04:00,1.07086,1.07142,1.07077,1.07107,1.0722947396787201,1.071356888888889,1.0716011111111035,1.0718119999999942,1.0716440000000034,1.0708840000000004,1.0706648000000032,1.0716572000000044,1.071416111927325,1.0716290165307092,2728,-535828,-536952.8,0.0026972251465730785,-373.6685383868139,-0.12029542317878449
2023-09-08T04:15:00-04:00,1.07107,1.07174,1.07101,1.07169,1.072140265710848,1.0713746666666666,1.0715011111111035,1.0717239999999943,1.0716460000000034,1.0709278000000004,1.0706697000000032,1.0716465500000045,1.07147088954186,1.0715524132245668,2219,-533609,-536443.6,-0.003377091852634215,-372.3840471770889,-0.08390904259781472
2023-09-08T04:30:00-04:00,1.07169,1.0717,1.07131,1.07134,1.0720012391397633,1.0713424444444446,1.0714166666666591,1.0716264444444388,1.0716320000000032,1.0709596000000003,1.0706692000000033,1.0716375000000045,1.071444711633488,1.0714995305796529,-2503,-536112,-535938,-0.01366407960065728,-373.2014943866366,-0.070888909616649
2023-09-08T04:45:00-04:00,1.07134,1.07161,1.071,1.07117,1.071876115225787,1.071293111111111,1.0713388888888813,1.0715204444444386,1.0716080000000034,1.0709904000000003,1.070665400000003,1.0716277000000045,1.0713897693067904,1.071444824463722,-3405,-539517,-536724.4,-0.020343221880809514,-373.7417990518223,-0.06530642708536698
2023-09-08T05:00:00-04:00,1.07117,1.07117,1.07031,1.0705,1.0717635037032083,1.0711253333333333,1.0712233333333259,1.0714162222222166,1.0715610000000033,1.0710078000000003,1.070661600000003,1.0716172000000044,1.0712118154454324,1.0713866595709771,-2777,-542294,-537472,-0.028018909764182177,-375.4787689072139,-0.09705657278309068
2023-09-08T05:15:00-04:00,1.0705,1.07064,1.07008,1.07019,1.07161,1.0709186666666666,1.0710477777777703,1.07130555555555,1.0714890000000032,1.0710202000000002,1.0706530000000032,1.0716012000000044,1.071007452356346,1.0713049276567812,-2465,-544759,-539258.2,-0.0350644692929959,-376.19259422248723,-0.14741968892578772
2023-09-08T05:30:00-04:00,1.07019,1.07052,1.06992,1.0704,1.0713958,1.0707891111111112,1.070966666666659,1.0711986666666609,1.0714325000000033,1.0710348000000003,1.0706460000000033,1.0715869500000044,1.0708859618850768,1.0711879421254245,2558,-542201,-540976.6,-0.04238632757574465,-375.6906459703076,-0.06815232511458903
2023-09-08T05:45:00-04:00,1.0704,1.07057,1.0701,1.07033,1.0711596719999998,1.0706617777777778,1.0708388888888816,1.0710831111111054,1.0713815000000033,1.0710480000000002,1.0706391000000033,1.0715741000000043,1.0707747695080614,1.0710539537003394,-2361,-544562,-542666.6,-0.04452201833119247,-375.8450461945229,-0.10732818158061601
2023-09-08T06:00:00-04:00,1.07033,1.07046,1.07001,1.0702,1.0709613244799998,1.0705339999999999,1.0707655555555482,1.0709684444444387,1.0713185000000034,1.0710586000000002,1.0706275000000034,1.0715581500000044,1.070659815606449,1.0709079629602711,-2107,-546669,-544097,-0.05136050899101444,-376.10095792268146,-0.06163270642286414
2023-09-08T06:15:00-04:00,1.0702,1.07024,1.07002,1.07008,1.0707947125631998,1.070396888888889,1.0706555555555481,1.0708548888888834,1.0712325000000034,1.0710658000000002,1.0706136000000033,1.0715423000000044,1.0705438524851592,1.0707743703682167,-1351,-548020,-545242.2,-0.05251050721308133,-376.2524436262884,-0.09243093355243322
2023-09-08T06:30:00-04:00,1.07008,1.07027,1.06968,1.06974,1.070654758553088,1.0702137777777776,1.0704388888888816,1.0707331111111056,1.0711205000000033,1.0710648000000003,1.0705975000000034,1.0715235500000044,1.0703830819881273,1.0706494962945725,-2078,-550098,-546310,-0.055773906293674895,-376.9126933272454,-0.1819556028329198
2023-09-08T06:45:00-04:00,1.06974,1.07017,1.06965,1.07003,1.0704793020135321,1.070132,1.070293333333326,1.070598444444439,1.0710040000000034,1.0710696000000004,1.0705832000000033,1.0715067000000043,1.0703124655905019,1.0705347970356578,1958,-548140,-547497.8,-0.06260770285456493,-376.38189145015355,-0.12227677488004951
2023-09-08T07:00:00-04:00,1.07003,1.07048,1.07003,1.07041,1.06965,1.0701553333333333,1.0702088888888817,1.0704724444444391,1.0708950000000035,1.0710844000000004,1.0705751000000034,1.0714932500000045,1.0703319724724014,1.0704462376285258,2005,-546135,-547812.4,-0.0626264701211033,-375.6698553390164,-0.07095045604337985
2023-09-08T07:15:00-04:00,1.07041,1.07044,1.0697,1.06985,1.06965,1.0700835555555557,1.0701366666666594,1.0703466666666612,1.0707825000000035,1.0710902000000002,1.0705639000000033,1.0714788000000044,1.0702355779779211,1.0703613901028202,-1895,-548030,-548084.6,-0.06277640048444835,-376.66125115930976,-0.06071929005138155
2023-09-08T07:30:00-04:00,1.06985,1.07008,1.0695999999999999,1.06989,1.07048,1.0700342222222223,1.070103333333326,1.0702362222222168,1.0706835000000035,1.0710968000000003,1.0705540000000033,1.0714650500000045,1.0701664623823368,1.0702859120822557,2184,-545846,-547649.8,-0.05865102639269909,-376.57959485235074,-0.028032405460709498
2023-09-08T07:45:00-04:00,1.06989,1.06997,1.06941,1.0699,1.0704624,1.0699935555555555,1.0700477777777708,1.0701579999999946,1.0706015000000035,1.0711044000000003,1.0705469000000032,1.0714484000000042,1.0701131699058695,1.070231929665804,1975,-543871,-546404.4,-0.05260285621875819,-376.56113501068467,-0.04671150971598888
2023-09-08T08:00:00-04:00,1.0699,1.0705,1.06976,1.0703,1.06941,1.0700439999999998,1.070044444444437,1.070108222222217,1.0705280000000035,1.0711186000000006,1.0705390000000032,1.0714279500000043,1.0701505359246957,1.0701995437326428,2896,-540975,-544971.4,-0.04802438181427413,-375.47841699965574,-0.002802873880015929
2023-09-08T08:15:00-04:00,1.0703,1.07058,1.07013,1.07043,1.06941,1.070121111111111,1.0700699999999927,1.070080444444439,1.0704930000000035,1.0711324000000004,1.0705364000000033,1.0714112000000042,1.0702064287397566,1.070174434986114,3281,-537694,-543283.2,-0.041132530195266914,-375.0799025644508,0.02149131003550294
2023-09-08T08:30:00-04:00,1.07043,1.07136,1.0703,1.07044,1.0694568,1.0701951111111112,1.0701099999999926,1.0700751111111058,1.0704410000000035,1.0711392000000004,1.0705349000000033,1.0713942000000043,1.0702531429918052,1.0701779479888907,3501,-534193,-540515.8,-0.0358224756784351,-375.04719608200895,0.033642344497620554
2023-09-08T08:45:00-04:00,1.07044,1.07097,1.07015,1.07023,1.069570992,1.0702191111111112,1.070164444444437,1.0700873333333278,1.0704095000000036,1.0711370000000004,1.0705320000000034,1.0713761000000042,1.0702485143934442,1.0701943583911122,-3695,-537888,-538924.2,-0.028862429684271867,-375.7720849127703,0.045805522837334446
2023-09-08T09:00:00-04:00,1.07023,1.07057,1.06995,1.07017,1.06967833248,1.0702202222222221,1.0701799999999926,1.0701137777777723,1.0703645000000037,1.0711208000000005,1.0705275000000034,1.0713545500000041,1.0702328115147552,1.0702182867128893,-3914,-541802,-538510.4,-0.021776499708793133,-375.99151438120214,0.01308374531555461
2023-09-08T09:15:00-04:00,1.07017,1.07116,1.07014,1.07114,1.0697792325312,1.0704122222222223,1.0702611111111038,1.0701571111111057,1.0703370000000036,1.0711156000000006,1.0705341000000035,1.0713369000000044,1.0704142492118043,1.070271029370311,3419,-538383,-537992,-0.011717900226761899,-372.89253945198556,0.06819816705747306
2023-09-08T09:30:00-04:00,1.07114,1.07191,1.07104,1.07133,1.0698740785793281,1.070626,1.070425555555548,1.0702282222222166,1.0703365000000038,1.0711182000000006,1.0705527000000032,1.0713231000000043,1.0705973993694433,1.0703492234962484,5502,-532881,-537029.4,-0.0015214829384427688,-371.91658859588875,0.13833715006775957
2023-09-08T09:45:00-04:00,1.07133,1.07262,1.07125,1.07262,1.0700369522929818,1.0710648888888887,1.0707288888888813,1.0703519999999944,1.0704090000000037,1.0711520000000008,1.0705857000000032,1.0713142000000042,1.0710019194955547,1.0704989787969983,4820,-528061,-535803,0.018661571620434414,-366.11277464500523,0.2551664189776425
2023-09-08T10:00:00-04:00,1.07262,1.07438,1.07262,1.07386,1.0702952570636837,1.0716911111111111,1.0711688888888815,1.0705528888888831,1.0705770000000037,1.0711988000000008,1.0706296000000033,1.0713135000000045,1.0715735355964437,1.0707639830375981,6155,-521906,-532606.6,0.043777166129322524,-358.99730038571414,0.37012804935040317
2023-09-08T10:15:00-04:00,1.07386,1.07401,1.07262,1.07291,1.0707854262160417,1.0720393333333333,1.0714588888888814,1.070808666666661,1.0707130000000038,1.0712228000000008,1.0706598000000034,1.0713098000000043,1.071840828477155,1.0710855864300781,-3929,-525835,-529413.2,0.06116671744275941,-362.4731259123191,0.24385686256189865
2023-09-08T10:30:00-04:00,1.07291,1.07322,1.07189,1.07215,1.0712167750701167,1.0721775555555555,1.0716499999999924,1.0710864444444388,1.0708005000000038,1.0712282000000009,1.0706811000000034,1.0713019500000043,1.071902662781724,1.071383269144062,-3631,-529466,-527629.8,0.06972211215599616,-365.0451589812628,0.1606830899731831
2023-09-08T10:45:00-04:00,1.07215,1.07222,1.0714299999999999,1.07152,1.07438,1.0721515555555556,1.0717699999999926,1.0713553333333277,1.0708600000000037,1.0712212000000008,1.0707047000000034,1.0712911500000042,1.0718261302253793,1.0716290153152492,-3611,-533077,-527669,0.07491707626429997,-367.16699827613724,0.10089309069167537
2023-09-08T11:00:00-04:00,1.07152,1.07173,1.07102,1.07111,1.0743209999999999,1.0720195555555556,1.07186777777777,1.0715831111111054,1.0709055000000038,1.0712064000000008,1.0707221000000033,1.0712800500000044,1.0716829041803035,1.071765212252199,-3823,-536900,-529436.8,0.0777025930363748,-368.6298081163643,0.08222531605355782
2023-09-08T11:15:00-04:00,1.07111,1.07153,1.07107,1.07133,1.0741889599999999,1.071912,1.0719966666666592,1.0717486666666611,1.0709680000000037,1.0711974000000009,1.0707399000000033,1.0712720000000044,1.0716123233442427,1.0717729698017586,2585,-534315,-531918.6,0.08294559579986333,-368.0988635821897,0.10839399347765567
2023-09-08T11:30:00-04:00,1.07133,1.07161,1.07109,1.0711,1.0740622015999999,1.0717326666666667,1.0719922222222147,1.0718553333333278,1.0710360000000037,1.0711848000000006,1.0707429000000033,1.0712624000000044,1.0715098586753942,1.0717067758414065,-2243,-536558,-534063.2,0.08709025960367475,-368.5804052173534,-0.003734339115338798
2023-09-08T11:45:00-04:00,1.0711,1.07113,1.07067,1.07088,1.0739405135359998,1.0715102222222221,1.0719422222222146,1.071913777777772,1.0710785000000036,1.0711694000000005,1.0707487000000033,1.0712480500000043,1.0713838869403154,1.0716030206731249,-2628,-539186,-536007.2,0.0795897134932928,-369.1201867503566,-0.042003864355505724
2023-09-08T12:00:00-04:00,1.07088,1.07118,1.07078,1.07109,1.07374428272384,1.0713397777777778,1.0717722222222144,1.0719142222222167,1.071112500000004,1.0711588000000005,1.0707633000000034,1.0712433000000043,1.0713251095522522,1.0715028165384994,1795,-537391,-536870,0.07263258325184893,-368.7681865262418,-0.14264138278232827
2023-09-08T12:15:00-04:00,1.07109,1.07134,1.07057,1.0706,1.0735598257604095,1.0711053333333334,1.0714099999999922,1.071822666666661,1.071150000000004,1.0711378000000005,1.0707691000000035,1.0712433000000043,1.0711800876418018,1.0714022532307992,-1357,-538748,-537239.6,0.052927930431477865,-369.3889840315869,-0.3035777475648633
2023-09-08T12:30:00-04:00,1.0706,1.07066,1.07006,1.07022,1.0733206396995767,1.0708673333333332,1.0711111111111034,1.0716455555555497,1.071166500000004,1.0711134000000007,1.0707650000000033,1.0712403500000043,1.0709880701134415,1.0712774025846388,-2070,-540818,-538540.2,0.01729854596209405,-370.1237122213871,-0.25072000447382176
2023-09-08T12:45:00-04:00,1.07022,1.07046,1.07005,1.07045,1.072994575729619,1.0707351111111112,1.0709222222222143,1.0714315555555498,1.071194000000004,1.0710898000000004,1.0707664000000034,1.0712382000000042,1.0708804560907532,1.0711515220677106,1776,-539042,-539037,-0.008157810736761044,-369.7420336880015,-0.15855990299865083
2023-09-08T13:00:00-04:00,1.07045,1.0708,1.07029,1.07079,1.0726412266420648,1.0707086666666668,1.0708411111111031,1.0712113333333275,1.071218500000004,1.0710750000000004,1.0707651000000036,1.0712390500000044,1.0708623648726026,1.071047217654168,1155,-537887,-538777.2,-0.02481032173374448,-369.37517862704584,-0.06812751978498949
2023-09-08T13:15:00-04:00,1.07079,1.07108,1.07069,1.07075,1.0723302794450171,1.0706904444444445,1.070801111111103,1.071017111111105,1.071234500000004,1.0710630000000003,1.0707642000000035,1.0712370000000044,1.0708398918980822,1.0709501741233338,-1490,-539377,-539174.4,-0.033998485004492464,-369.43083846697687,-0.03360999337135457
2023-09-08T13:30:00-04:00,1.07075,1.07095,1.07067,1.0708199999999999,1.072056645911615,1.0706942222222222,1.0707444444444365,1.0708839999999942,1.071253500000004,1.0710502000000002,1.0707662000000036,1.0712331500000045,1.0708359135184657,1.0708813392986667,1436,-537941,-539013,-0.03843878178333511,-369.336960344166,-0.04760437960292445
2023-09-08T13:45:00-04:00,1.0708199999999999,1.07098,1.07052,1.07057,1.071815848402221,1.0706593333333334,1.0706855555555477,1.0707988888888829,1.071270500000004,1.0710256000000005,1.0707679000000034,1.0712295500000044,1.0707827308147726,1.070840271438933,-1335,-539276,-538704.6,-0.046111157539634844,-369.64863737672033,-0.04948184109792918
2023-09-08T14:00:00-04:00,1.07057,1.07087,1.07023,1.0703799999999999,1.0716039465939546,1.0705982222222223,1.0706299999999922,1.0707404444444386,1.0712810000000041,1.0709936000000004,1.0707654000000035,1.0712233500000043,1.070702184651818,1.0708046171511458,-1692,-540968,-539089.8,-0.053498899127129726,-369.9489260080104,-0.04669057223966896
2023-09-08T14:15:00-04:00,1.0703799999999999,1.0703799999999999,1.07002,1.07008,1.07141747300268,1.0704882222222223,1.07051777777777,1.070675777777772,1.0712280000000043,1.0709480000000005,1.0707595000000034,1.0712142000000042,1.0705777477214544,1.0707476937209164,-1341,-542309,-539974.2,-0.060567130606996096,-370.32477383775307,-0.09429646434941763
2023-09-08T14:30:00-04:00,1.07008,1.07024,1.06997,1.0700399999999999,1.0712218267823048,1.0703926666666668,1.0704555555555477,1.0706066666666607,1.0711635000000042,1.0708970000000004,1.0707561000000034,1.0712065000000042,1.0704701981771636,1.0706737549767327,-1497,-543806,-540860,-0.06548238243825007,-370.38073227076745,-0.05230711750421408
2023-09-08T14:45:00-04:00,1.0700399999999999,1.07005,1.06969,1.06979,1.071021534497136,1.0702595555555554,1.0704077777777699,1.0705393333333277,1.0710220000000041,1.0708508000000003,1.0707548000000033,1.0711950500000043,1.070334158541731,1.070573403981386,-1651,-545457,-542363.2,-0.06620264205918826,-370.7664655143843,-0.040178654856004414
2023-09-08T15:00:00-04:00,1.06979,1.07005,1.06972,1.0700399999999999,1.0707818582876516,1.070186,1.0703622222222142,1.070474666666661,1.070831000000004,1.0708142000000003,1.0707523000000034,1.0711813500000043,1.0702753268333847,1.070471923185108,1469,-543988,-543305.6,-0.05641942724191044,-370.42317384031765,-0.03830164883927521
2023-09-08T15:15:00-04:00,1.0700399999999999,1.0700399999999999,1.06983,1.06985,1.0705853237958742,1.0700835555555555,1.07025777777777,1.0704002222222164,1.070678000000004,1.0707804000000005,1.0707495000000034,1.0711670000000042,1.0701902614667078,1.070369538548086,-776,-544764,-544064.8,-0.04419991221369289,-370.56096308184124,-0.08778565358286321
2023-09-08T15:30:00-04:00,1.06985,1.06989,1.0697,1.06983,1.070424165512617,1.069998,1.0701555555555475,1.0703277777777722,1.070562000000004,1.0707416000000005,1.0707502000000035,1.0711524500000043,1.0701182091733663,1.0702776308384685,-1102,-545866,-544776.2,-0.039473584721694,-370.58156410067556,-0.08592108335279307
2023-09-08T15:45:00-04:00,1.06983,1.06994,1.06973,1.06992,1.070292015720346,1.069950888888889,1.0700555555555478,1.0702477777777721,1.0704820000000042,1.0707174000000004,1.0707553000000034,1.0711381000000042,1.070078567338693,1.0701993046707743,979,-544887,-544992.4,-0.03731124194640646,-370.4992052212275,-0.08404773911580854
2023-09-08T16:00:00-04:00,1.06992,1.07015,1.06991,1.07013,1.0701836528906836,1.0699657777777778,1.0700066666666588,1.07016755555555,1.0704330000000042,1.0706904000000004,1.0707615000000035,1.0711251500000043,1.0700888538709543,1.0701502437366188,1196,-543691,-544639.2,-0.037576007227634774,-370.2644586981229,-0.04109960114705213
2023-09-08T16:15:00-04:00,1.07013,1.07017,1.07007,1.07012,1.06969,1.0699884444444443,1.06997777777777,1.0700906666666612,1.0703725000000042,1.0706756000000004,1.0707665000000035,1.0711138500000041,1.0700950830967635,1.0701141949892947,-662,-544353,-544712.2,-0.03737747333243195,-370.27064486242074,-0.02429043890953932
2023-09-08T16:30:00-04:00,1.07012,1.0703,1.0701,1.07024,1.0696996,1.0700408888888888,1.0699955555555478,1.0700382222222167,1.0703295000000042,1.0706590000000005,1.0707715000000035,1.0711019000000044,1.0701240664774108,1.0701009559914352,724,-543629,-544485.2,-0.033837996697902176,-370.1894577058401,0.014952153110062802
2023-09-08T16:45:00-04:00,1.07024,1.07025,1.06975,1.06982,1.069723616,1.0700057777777776,1.0699711111111034,1.0700013333333278,1.070276500000004,1.0706216000000004,1.0707747000000034,1.0710880500000044,1.0700632531819285,1.0700899647931474,-639,-544268,-544165.6,-0.0305742776536111,-370.4402238891261,-0.02055997906619257
2023-09-10T17:00:00-04:00,1.07146,1.07148,1.07094,1.0711,1.0697466713600001,1.0702315555555555,1.070116666666659,1.07001355555555,1.0702770000000041,1.0706168000000005,1.0707882000000035,1.0710810500000043,1.0702706025455428,1.0701283718345178,130,-544138,-544015.8,-0.021649152919973918,-370.28468370479607,0.1224539395582238
2023-09-10T17:15:00-04:00,1.0711,1.07129,1.07105,1.07114,1.06975,1.0704362222222221,1.0702388888888814,1.0700599999999947,1.0703040000000041,1.0706162000000006,1.0708033000000035,1.0710731500000044,1.0704444820364343,1.0701994974676137,75,-544063,-544090.2,-0.009258484793832874,-370.281882845866,0.1027998953310251
2023-09-10T17:30:00-04:00,1.07114,1.07189,1.07112,1.07159,1.0698538,1.0707064444444445,1.070432222222215,1.0701508888888838,1.0703725000000042,1.0706380000000004,1.0708229000000036,1.0710680000000043,1.0706735856291474,1.0703151979740904,163,-543900,-543999.6,0.0008185901832487015,-370.21340440233854,0.16263962237697574
2023-09-10T17:45:00-04:00,1.07159,1.07164,1.07131,1.07153,1.070016696,1.070926,1.0706211111111037,1.070275999999995,1.070426500000004,1.0706648000000005,1.0708425000000035,1.0710625500000044,1.0708448685033178,1.0704593583792719,-283,-544183,-544110.4,0.010685538222982759,-370.2292500149329,0.1589037510632563
2023-09-10T18:00:00-04:00,1.07153,1.07154,1.07072,1.0709899999999999,1.07016656032,1.0709997777777776,1.0707399999999927,1.070429777777773,1.070436500000004,1.0706766000000005,1.0708557000000034,1.0710548000000042,1.0708738948026542,1.0706214867034167,-983,-545166,-544290,0.019119625330240794,-370.7246351184766,0.10000747719454767
2023-09-10T18:15:00-04:00,1.0709899999999999,1.07106,1.07088,1.071,1.0703044354944,1.0710517777777777,1.0708366666666593,1.0705737777777729,1.070449000000004,1.0706900000000006,1.0708690000000036,1.0710471500000043,1.0708991158421233,1.070747189362733,1546,-543620,-544186.4,0.028274360946682935,-370.7101998763174,0.08129853382298659
2023-09-10T18:30:00-04:00,1.071,1.07119,1.07092,1.07104,1.070431280654848,1.0710924444444445,1.0709388888888816,1.0707137777777729,1.0704600000000037,1.0707068000000006,1.0708827000000036,1.071039800000004,1.0709272926736986,1.070843751490186,652,-542968,-543967.4,0.03548484387487137,-370.6858488025545,0.08597166672896796
2023-09-10T18:45:00-04:00,1.07104,1.0712,1.07098,1.07115,1.07054797820246,1.0711346666666666,1.0710399999999927,1.0708353333333283,1.0704890000000038,1.0707282000000005,1.0708970000000035,1.0710321000000043,1.070971834138959,1.0709034011921483,737,-542231,-543633.6,0.04363811061678433,-370.6101560179713,0.08502765734788144
2023-09-10T19:00:00-04:00,1.07115,1.07116,1.0708199999999999,1.07091,1.0706553399462633,1.0711086666666667,1.0711611111111037,1.0709433333333283,1.070515500000004,1.0707516000000006,1.0709082000000034,1.0710249500000042,1.070959467311167,1.0709263209537183,-1118,-543349,-543466.8,0.04838374622862052,-370.8606531472249,0.10188629862967932
2023-09-10T19:15:00-04:00,1.07091,1.0712,1.0708199999999999,1.07113,1.0707541127505622,1.0711024444444444,1.0711644444444373,1.0710282222222172,1.0705680000000037,1.0707736000000005,1.0709216000000035,1.071018650000004,1.0709935738489336,1.070950256762974,586,-542763,-542986.2,0.05728280750718573,-370.7402695482297,0.0028008589300695073
2023-09-10T19:30:00-04:00,1.07113,1.07165,1.07103,1.07164,1.0708199999999999,1.0711975555555555,1.0712199999999927,1.0711048888888839,1.0706480000000038,1.0707982000000005,1.0709413000000034,1.0710150000000043,1.0711228590791468,1.070995005410379,1161,-541602,-542582.6,0.05538406796263487,-370.1874795040707,0.04667923894168315
2023-09-10T19:45:00-04:00,1.07164,1.07205,1.07158,1.07162,1.0708199999999999,1.0712775555555556,1.071223333333326,1.0711617777777729,1.0707395000000037,1.0708336000000005,1.0709619000000035,1.0710109000000043,1.0712222872633175,1.0710540043283026,-1358,-542960,-542581,0.052836210416370606,-370.2128238361224,0.0027995781968826222
2023-09-10T20:00:00-04:00,1.07162,1.07211,1.07132,1.07133,1.070943,1.0712988888888888,1.0712011111111037,1.0711939999999953,1.0708040000000036,1.0708624000000004,1.0709796000000034,1.0710045000000044,1.071243829810654,1.0711084034626417,-2183,-545143,-543163.4,0.04355575795219172,-370.8035836203746,-0.018664899722844904
2023-09-10T20:15:00-04:00,1.07133,1.07134,1.0709899999999999,1.07125,1.07211,1.0713086666666667,1.0712299999999928,1.071207777777773,1.0708740000000037,1.0708894000000004,1.0709969000000035,1.0709976500000042,1.0712450638485231,1.071165522770113,-1628,-546771,-543847.8,0.03555780077065258,-370.9251521380113,0.02427660388987283
2023-09-10T20:30:00-04:00,1.07125,1.07157,1.07118,1.07135,1.07211,1.0713326666666667,1.0712688888888817,1.0712286666666617,1.0709500000000036,1.0709104000000005,1.0710145000000033,1.0709920500000043,1.0712660510788186,1.0712200182160898,1808,-544963,-544287.8,0.03224712001486564,-370.75637734221203,0.03267973856209827
2023-09-10T20:45:00-04:00,1.07135,1.07154,1.07129,1.07133,1.0720876,1.071344888888889,1.071301111111104,1.071244888888884,1.0710205000000035,1.0709284000000006,1.0710304000000035,1.0709861000000043,1.071278840863055,1.0712512145728714,-1504,-546467,-545260.8,0.02865676048345912,-370.78445406783874,0.02707648640572728
2023-09-10T21:00:00-04:00,1.07133,1.07169,1.07102,1.0715999999999999,1.072065648,1.0714046666666666,1.071351111111104,1.0712704444444396,1.0710940000000038,1.0709516000000006,1.0710454000000034,1.0709821500000043,1.0713430726904438,1.0712753716582966,1674,-544793,-545627.4,0.02641382428710928,-370.36256725425187,0.042010922839923394
2023-09-10T21:15:00-04:00,1.0715999999999999,1.07191,1.07135,1.0715999999999999,1.0720441350399998,1.0714544444444445,1.0714277777777705,1.071315777777773,1.0711680000000037,1.0709790000000006,1.0710580000000034,1.0709784000000042,1.0713944581523551,1.071305497326637,0,-544793,-545557.4,0.02407808840626233,-370.36256725425187,0.06443118469337829
2023-09-10T21:30:00-04:00,1.0715999999999999,1.07206,1.07159,1.0719,1.0709899999999999,1.0715488888888889,1.0715133333333262,1.07137244444444,1.0712510000000037,1.0710136000000003,1.0710672000000034,1.0709767000000043,1.0714955665218842,1.071355597861309,3137,-541656,-544534.4,0.02540535206101833,-369.4843477693689,0.07188669909349561
2023-09-10T21:45:00-04:00,1.0719,1.07209,1.07181,1.07195,1.0710114,1.0716362222222222,1.0715477777777707,1.0714282222222176,1.0713575000000035,1.0710298000000003,1.0710727000000035,1.0709746000000044,1.0715864532175072,1.0714196782890468,1780,-539876,-543517,0.025456761510747633,-369.40131763596116,0.028927624948679828
2023-09-10T22:00:00-04:00,1.07195,1.07225,1.07188,1.07208,1.0710545439999999,1.0717426666666665,1.0715988888888817,1.0714877777777732,1.0714065000000035,1.0710448000000004,1.0710815000000036,1.0709738000000044,1.0716851625740058,1.071500942631237,1824,-538052,-541834,0.019516223444284764,-369.18011328874354,0.04292566394803241
2023-09-10T22:15:00-04:00,1.07208,1.07246,1.07193,1.07244,1.0711262713599998,1.0719108888888889,1.071722222222215,1.0715619999999952,1.0714715000000035,1.0710412000000005,1.0710966000000035,1.0709738000000046,1.0718361300592048,1.0715995541049892,1786,-536266,-540128.6,0.021212795942693846,-368.5803819254122,0.10360953207696662
2023-09-10T22:30:00-04:00,1.07244,1.07281,1.0723799999999999,1.07239,1.0712329696511997,1.0720444444444446,1.0718488888888817,1.0716462222222174,1.0715115000000037,1.0710118000000004,1.0711053000000035,1.0709756000000046,1.0719469040473637,1.071710043283991,-1616,-537882,-538746.4,0.025549044477478654,-368.6557241356992,0.10641773628937398
2023-09-10T22:45:00-04:00,1.07239,1.07254,1.07226,1.0724,1.0713906726860798,1.0721546666666666,1.0719655555555483,1.071736666666662,1.0715550000000038,1.0710016000000004,1.0711122000000035,1.0709765500000046,1.072037523237891,1.0718184346271922,1185,-536697,-537754.6,0.03268062444276976,-368.6446740513082,0.09800718719372711
2023-09-10T23:00:00-04:00,1.0724,1.07252,1.07229,1.07244,1.0715326054174719,1.0722495555555556,1.0720888888888818,1.071844888888884,1.0716275000000037,1.0710074000000005,1.0711178000000035,1.0709759000000045,1.0721180185903127,1.0719247477017533,947,-535750,-536929.4,0.03880722766305929,-368.6093514105025,0.10360953207696662
2023-09-10T23:15:00-04:00,1.07244,1.07245,1.07203,1.07205,1.0716603448757247,1.0722417777777777,1.0721388888888819,1.0719528888888843,1.0716800000000037,1.0710180000000005,1.0711196000000036,1.0709735500000046,1.0721044148722503,1.072008598161402,-1357,-537107,-536740.4,0.04081387805180945,-369.1028335633503,0.041993281075033737
2023-09-10T23:30:00-04:00,1.07205,1.0724,1.07194,1.07225,1.0717753103881522,1.072264,1.072211111111104,1.072050666666662,1.0717405000000038,1.0710408000000005,1.0711236000000037,1.0709716500000048,1.0721335318978003,1.0720680785291212,1536,-535571,-536601.4,0.04132258946026447,-368.81627976455366,0.0606569615528219
2023-09-10T23:45:00-04:00,1.07225,1.07227,1.07208,1.07225,1.071878779349337,1.0722717777777777,1.0722499999999928,1.0721308888888843,1.0717955000000037,1.0710592000000003,1.0711283000000038,1.0709675000000047,1.07215682551824,1.0721100628232965,0,-535571,-536139.2,0.04200904071898009,-368.81627976455366,0.03265229965480459
2023-09-11T00:00:00-04:00,1.07225,1.07268,1.07217,1.07242,1.07194,1.0723057777777778,1.0723022222222152,1.0721982222222177,1.0718710000000038,1.0710856000000004,1.0711352000000036,1.0709653000000048,1.072209460414592,1.0721444502586368,1709,-533862,-535572.2,0.04121585208696386,-368.54532616231535,0.043845328606741965
2023-09-11T00:15:00-04:00,1.07242,1.07314,1.07242,1.07314,1.0720269999999998,1.0724733333333334,1.0724199999999928,1.0722644444444398,1.0719715000000036,1.0711308000000002,1.0711501000000037,1.0709680500000047,1.0723955683316735,1.0721999602069086,1818,-532044,-534831,0.04240676375907134,-367.32475959324717,0.09887321841654177
2023-09-11T00:30:00-04:00,1.07314,1.07331,1.07289,1.07318,1.07216056,1.0726253333333333,1.072502222222215,1.0723371111111066,1.0720485000000035,1.0711726000000001,1.0711657000000039,1.0709716500000048,1.0725524546653389,1.0722895681655262,2035,-530009,-533411.4,0.04355781048950957,-367.2489074211167,0.06900152922307662
2023-09-11T00:45:00-04:00,1.07318,1.07376,1.07318,1.07353,1.0723214816,1.072830888888889,1.0726288888888815,1.072420666666662,1.0721440000000038,1.0712312000000004,1.0711845000000038,1.0709754500000046,1.0727479637322712,1.0724124545324205,2714,-527295,-531756.2,0.04532634524438411,-366.3637809744813,0.10630460933057385
2023-09-11T01:00:00-04:00,1.07353,1.07386,1.0734,1.07375,1.072551644544,1.073055111111111,1.0727788888888816,1.07252644444444,1.0722650000000036,1.0713018000000003,1.0712076000000037,1.0709811500000046,1.072948370985817,1.072570763625936,3282,-524013,-529444.6,0.04854634108233375,-365.69119613754185,0.1258858634837712
2023-09-11T01:15:00-04:00,1.07375,1.07394,1.07369,1.07384,1.07278714852608,1.0732673333333334,1.0729344444444373,1.0726528888888844,1.0723945000000037,1.0713696000000001,1.0712297000000037,1.0709861500000046,1.0731266967886535,1.0727542109007484,2183,-521830,-527038.2,0.050823432866670994,-365.50822058457345,0.13054343366527224
2023-09-11T01:30:00-04:00,1.07384,1.07414,1.07322,1.07323,1.073017718820864,1.0733264444444444,1.0730655555555484,1.0727819999999955,1.0724885000000035,1.0714184000000002,1.0712467000000039,1.0709868000000047,1.0731473574309227,1.072904568720598,-2419,-524249,-525479.2,0.04939363584068387,-366.88234522139084,0.11006949302737362
2023-09-11T01:45:00-04:00,1.07323,1.07339,1.07284,1.07287,1.07414,1.0732873333333333,1.0731344444444373,1.07290844444444,1.0725655000000036,1.0714608000000003,1.0712619000000039,1.0709862000000046,1.0730918859447383,1.073012454976478,-1678,-525927,-524662.8,0.05028717770229871,-367.44520686335,0.05782233620891256
2023-09-11T02:00:00-04:00,1.07287,1.0733,1.07266,1.07312,1.07414,1.0732844444444443,1.0732311111111041,1.0730288888888846,1.0726415000000036,1.0715068000000003,1.0712785000000038,1.0709874000000048,1.0730975087557906,1.073082363981182,3635,-522292,-523662.2,0.05044744750498984,-366.59817973051906,0.08113779435767297
2023-09-11T02:15:00-04:00,1.07312,1.07331,1.07242,1.07253,1.0740808000000002,1.073144222222222,1.0732433333333262,1.0731217777777735,1.0726880000000034,1.071546,1.0712858000000036,1.0709875500000046,1.0729840070046324,1.0730894911849451,-2387,-524679,-523795.4,0.048927075971466574,-367.91054926980655,0.010257175360404927
2023-09-11T02:30:00-04:00,1.07253,1.0732599999999999,1.0725,1.07325,1.0739811520000002,1.0731455555555556,1.0732555555555487,1.0731859999999958,1.0727555000000035,1.0716034,1.0712985000000037,1.0709938000000045,1.0730372056037059,1.0730715929479555,1903,-522776,-523984.6,0.049336330032454453,-366.63304654261003,0.010250293531138016
2023-09-11T02:45:00-04:00,1.07325,1.07355,1.07298,1.0733,1.0738874828800002,1.0731544444444445,1.073268888888882,1.0732266666666626,1.0728230000000034,1.0716678000000002,1.0713079000000036,1.0710008000000046,1.0730897644829647,1.0730600743583638,2083,-520693,-523273.4,0.04461033867922552,-366.5360048468264,0.011181721612394748
2023-09-11T03:00:00-04:00,1.0733,1.07374,1.07301,1.07359,1.0737994339072001,1.0732186666666665,1.0732755555555487,1.0732548888888849,1.0728985000000033,1.0717388,1.0713179000000037,1.0710094500000047,1.0731898115863718,1.0730796594866905,3394,-517299,-521547.8,0.04114948701864491,-365.61896394493465,0.005589038033399065
2023-09-11T03:15:00-04:00,1.07359,1.07364,1.07293,1.07306,1.07374,1.0731755555555555,1.073198888888882,1.0732484444444403,1.0729295000000032,1.0718042000000003,1.0713275000000038,1.0710162000000047,1.0731638492690974,1.073092927589352,-3242,-520541,-521197.6,0.032417514867471124,-367.21944457534335,-0.06426076833528098
2023-09-11T03:30:00-04:00,1.07306,1.07328,1.07261,1.07293,1.07374,1.0731217777777777,1.0730977777777708,1.0732193333333293,1.0729565000000032,1.0718620000000003,1.0713381000000037,1.0710211000000047,1.0731170794152778,1.0731195420714807,-2951,-523492,-520960.2,0.022599451790414535,-367.5769548729967,-0.08474260597481621
2023-09-11T03:45:00-04:00,1.07293,1.07308,1.07249,1.07259,1.0736607999999999,1.073020222222222,1.0730266666666597,1.0731735555555515,1.0729660000000032,1.0719168000000001,1.0713486000000039,1.0710244500000046,1.0730116635322222,1.0731144336571843,-2739,-526231,-521651.2,0.010061371258130435,-368.4449145721383,-0.05963307026452615
2023-09-11T04:00:00-04:00,1.07259,1.0728,1.07222,1.07231,1.073586352,1.0728768888888889,1.0729644444444375,1.0731126666666626,1.0729595000000034,1.0719664000000002,1.0713540000000037,1.0710239000000046,1.0728713308257778,1.073070746925747,-3116,-529347,-523382,0.001886237258674799,-369.25834747753504,-0.05219644504925051
2023-09-11T04:15:00-04:00,1.07231,1.07323,1.0723,1.07314,1.0734770438399999,1.0729119999999999,1.0729666666666597,1.0730508888888848,1.0730140000000032,1.0720308,1.0713741000000037,1.0710282500000046,1.0729250646606223,1.0730177975405968,2111,-527236,-525369.4,0.0012959156911283034,-367.6243703627084,0.0018637244669663204
2023-09-11T04:30:00-04:00,1.07314,1.07332,1.07244,1.07277,1.0733764803327999,1.0728726666666668,1.0729933333333261,1.0730097777777736,1.0730400000000033,1.0720836,1.0713870000000039,1.0710317500000046,1.072894051728498,1.0729638380324773,-2518,-529754,-527212,-0.0051613075014555285,-368.49253295100067,0.02237699644765349
2023-09-11T04:45:00-04:00,1.07277,1.07295,1.07242,1.07284,1.07332,1.072842,1.0729477777777707,1.0729797777777736,1.0730695000000032,1.072138,1.0714068000000037,1.0710376000000048,1.0728832413827984,1.0729170704259812,2735,-527019,-527917.4,-0.004890465987546585,-368.3140697202988,-0.03820172373631693
2023-09-11T05:00:00-04:00,1.07284,1.07295,1.07236,1.07242,1.07332,1.0727364444444445,1.0728499999999928,1.0729444444444403,1.0730695000000032,1.0721816000000002,1.0714203000000038,1.0710425500000047,1.0727905931062387,1.0728728563407846,-2626,-529645,-528600.2,-0.01337989447837035,-369.3421074519272,-0.08199012391689108
2023-09-11T05:15:00-04:00,1.07242,1.07281,1.0724,1.07255,1.073232,1.0726764444444443,1.072734444444437,1.0728984444444403,1.0730400000000033,1.0722362,1.0714289000000037,1.0710493000000048,1.072742474484991,1.072847085072627,1763,-527882,-528307.2,-0.020946181626247555,-369.12839454094086,-0.09687124507494964
2023-09-11T05:30:00-04:00,1.07255,1.07284,1.07234,1.07284,1.07315104,1.0726975555555556,1.0727099999999927,1.0728471111111069,1.0730230000000034,1.072271,1.0714439000000038,1.0710565500000049,1.0727619795879928,1.0728144680581013,1956,-525926,-528045.2,-0.026604667510220305,-368.59952409201054,-0.020502115445537712
2023-09-11T05:45:00-04:00,1.07284,1.0734299999999999,1.07274,1.0732599999999999,1.07222,1.0728075555555554,1.0727466666666594,1.0727977777777735,1.0730095000000033,1.0723134,1.0714648000000038,1.0710651000000049,1.0728615836703943,1.0728079744464805,2313,-523613,-526817,-0.025095723209269376,-367.69402094149444,0.030756899331731005
2023-09-11T06:00:00-04:00,1.0732599999999999,1.07335,1.07267,1.07273,1.0722441999999999,1.072804222222222,1.072762222222215,1.0727606666666623,1.0729585000000033,1.0723362,1.0714871000000037,1.0710743500000048,1.0728352669363155,1.072798379557184,-2318,-525931,-526599.4,-0.023410192731129768,-368.8387016339639,0.013052517737441986
2023-09-11T06:15:00-04:00,1.07273,1.07302,1.07263,1.07287,1.072267916,1.0728257777777779,1.072824444444437,1.0727555555555512,1.0729100000000034,1.072363,1.0715139000000038,1.0710834500000048,1.0728422135490523,1.0728087036457468,2134,-523797,-525429.8,-0.016895940180959784,-368.5601972572801,0.052223703966193906
2023-09-11T06:30:00-04:00,1.07287,1.07332,1.07287,1.07318,1.0722911576799998,1.072896888888889,1.0728288888888815,1.07277444444444,1.0729075000000032,1.0724068000000002,1.0715417000000038,1.071093850000005,1.0729097708392419,1.0728421629165967,2248,-521549,-524163.2,-0.0058584960173264766,-367.910649781817,0.00372737946587025
2023-09-11T06:45:00-04:00,1.07318,1.0734,1.07314,1.07321,1.0723139345264,1.072973111111111,1.0728777777777703,1.0728079999999955,1.0729245000000032,1.072451,1.0715705000000038,1.071104800000005,1.0729698166713935,1.072883730333277,1802,-519747,-522927.4,-0.005117312048419016,-367.8602761259532,0.041015315491670715
2023-09-11T07:00:00-04:00,1.07321,1.07322,1.07243,1.07243,1.072336255835872,1.0728835555555556,1.0728322222222149,1.0728251111111065,1.0728900000000032,1.0724787999999998,1.071592800000004,1.0711101500000049,1.0728618533371148,1.072883784266621,-1800,-521547,-522514.2,-0.006333518560042507,-369.16850098408906,-0.038216323030463205
2023-09-11T07:15:00-04:00,1.07243,1.07266,1.07231,1.0726499999999999,1.0734299999999999,1.072847111111111,1.0728577777777704,1.0728442222222176,1.0728960000000032,1.0725088,1.0716185000000038,1.0711160500000048,1.0728194826696917,1.0728806274132965,1758,-519789,-521285.8,-0.006018521600558622,-368.80786206126913,0.021446821208104334
2023-09-11T07:30:00-04:00,1.0726499999999999,1.07286,1.07207,1.0721,1.0734076,1.0726955555555555,1.0728077777777703,1.072840888888884,1.0728385000000031,1.0725326,1.0716421000000038,1.0711198000000048,1.0726755861357533,1.0728473019306368,-2016,-521805,-520887.4,-0.007092758905479196,-369.84156364146736,-0.04195608596334338
2023-09-11T07:45:00-04:00,1.0721,1.0723,1.07182,1.07197,1.0733540959999999,1.0725280000000001,1.0727111111111036,1.0728173333333286,1.0727720000000032,1.0725494,1.0716615000000038,1.0711223500000049,1.0725344689086027,1.072772241544509,-2590,-524395,-521456.6,-0.006817957861609546,-370.1556201660452,-0.08109317325975228
2023-09-11T08:00:00-04:00,1.07197,1.07258,1.07154,1.07254,1.0732620502399999,1.0724937777777777,1.0726311111111038,1.0727679999999953,1.0727195000000032,1.0725673999999998,1.0716828000000038,1.071128950000005,1.0725355751268821,1.0726853932356066,3271,-521124,-521732,-0.006241127699684492,-368.41632708881366,-0.06708532881126959
2023-09-11T08:15:00-04:00,1.07254,1.0726,1.07193,1.07212,1.0731242862208,1.0723915555555557,1.072563333333326,1.0727142222222175,1.0726725000000035,1.0725774,1.071705500000004,1.0711347000000049,1.0724524601015057,1.072603514588485,-3089,-524213,-522265.2,-0.010343368768412468,-369.62596029596705,-0.05686426220950281
2023-09-11T08:30:00-04:00,1.07212,1.07268,1.07191,1.07241,1.072997543323136,1.072360888888889,1.072512222222215,1.0726451111111064,1.0726465000000034,1.072599,1.071730700000004,1.071142350000005,1.0724439680812046,1.0725284116707874,3229,-520984,-522504.2,-0.010441332761370188,-368.75254127570776,-0.042875651290455036
2023-09-11T08:45:00-04:00,1.07241,1.07278,1.07228,1.07275,1.0728809398572852,1.0724084444444444,1.0724644444444371,1.0725764444444397,1.0726545000000034,1.072629,1.0717592000000038,1.0711530500000048,1.0725051744649636,1.0724943293366294,3178,-517806,-521704.4,-0.010761051386484784,-367.74497886953844,-0.04006783577777544
2023-09-11T09:00:00-04:00,1.07275,1.07316,1.07257,1.07293,1.07154,1.0725015555555555,1.072433333333326,1.0725208888888844,1.0726855000000033,1.0726605999999999,1.0717855000000038,1.0711622500000049,1.0725901395719708,1.072505463469303,3254,-514552,-519735.8,-0.014600892656410042,-367.19898026781436,-0.02608995443576355
2023-09-11T09:15:00-04:00,1.07293,1.07356,1.07286,1.0735,1.0715724,1.0727148888888889,1.0725522222222148,1.0725051111111066,1.0727035000000034,1.0727039999999999,1.0718162000000038,1.0711763000000047,1.0727721116575766,1.0725527707754419,2624,-511928,-517896.6,-0.01717922459089873,-365.80496574682985,0.09977341178444321
2023-09-11T09:30:00-04:00,1.0735,1.07368,1.07266,1.07331,1.0716519039999999,1.0728664444444445,1.072625555555548,1.0725175555555508,1.0727305000000034,1.0727382,1.0718449000000039,1.0711899000000047,1.0728796893260613,1.0726382166203527,-4965,-516893,-516432.6,-0.009730381428981109,-366.6837268087763,0.0615298559642106
2023-09-11T09:45:00-04:00,1.07331,1.0737,1.07222,1.07357,1.0717735897599998,1.0730553333333332,1.0727888888888812,1.0725728888888841,1.0727670000000031,1.0727776,1.0718783000000038,1.0712051500000046,1.073017751460849,1.0727529732962817,5909,-510984,-514432.6,-0.00470521808663781,-365.2523230204956,0.1371140751795411
2023-09-11T10:00:00-04:00,1.07357,1.07514,1.07345,1.07494,1.0719277025791998,1.0734855555555556,1.0731188888888812,1.072703777777773,1.0728930000000032,1.0728384,1.071926000000004,1.0712267500000048,1.0734022011686792,1.0729323786370248,5348,-505636,-511998.6,0.012445473380908768,-358.4276539257924,0.2770599923505244
2023-09-11T10:15:00-04:00,1.07494,1.07593,1.0748,1.07529,1.07222,1.0739197777777778,1.073424444444437,1.0729019999999951,1.0730300000000033,1.0729052000000001,1.071967500000004,1.0712508000000047,1.0737797609349433,1.0731703029096191,5334,-500302,-509148.6,0.030648178350758927,-356.69090582822383,0.256400693680425
2023-09-11T10:30:00-04:00,1.07529,1.07547,1.07463,1.0754,1.0726651999999999,1.0743148888888887,1.0737888888888811,1.0731493333333284,1.0731580000000034,1.0729716,1.072008200000004,1.0712804500000046,1.0741038087479546,1.0734366423276946,4057,-496245,-506012,0.04464856230053036,-356.27588290417606,0.3059359026974546
2023-09-11T10:45:00-04:00,1.0754,1.07557,1.0744799999999999,1.07455,1.073056976,1.074467111111111,1.074026666666659,1.0734295555555506,1.0732225000000033,1.0730138,1.072027500000004,1.0713066000000047,1.0741930469983636,1.0736993138621553,-4920,-501165,-502866.4,0.05969994289591754,-360.1646684723368,0.19955054503406428
2023-09-11T11:00:00-04:00,1.07455,1.07485,1.07431,1.07452,1.07340173888,1.0745657777777777,1.0742233333333255,1.0737164444444394,1.0733120000000032,1.0730564,1.072034100000004,1.0713318500000049,1.0742584375986908,1.0739474510897238,-3630,-504795,-501628.6,0.07376557136394322,-360.2660132213014,0.16499650431133323
2023-09-11T11:15:00-04:00,1.07452,1.07497,1.07426,1.07427,1.0737051302143998,1.074575111111111,1.0743722222222145,1.0739671111111062,1.0733820000000034,1.0730938,1.072047700000004,1.0713537500000048,1.0742607500789527,1.0741191608717784,-2575,-507370,-501975.4,0.08108955831097367,-360.8651179378257,0.12489165183191066
2023-09-11T11:30:00-04:00,1.07427,1.07467,1.07409,1.07433,1.0739721145886718,1.0745666666666667,1.0744644444444367,1.074175111111106,1.0734395000000034,1.0731316000000002,1.072069500000004,1.0713753000000048,1.0742746000631622,1.0742181286974222,2014,-505356,-502986.2,0.08764983717059875,-360.75263224987026,0.07731718677225044
2023-09-11T11:45:00-04:00,1.07433,1.07439,1.0741,1.07426,1.07593,1.074525777777778,1.0745699999999923,1.0743313333333284,1.0734920000000034,1.0731758000000002,1.072096900000004,1.0714008000000048,1.0742716800505299,1.074251702957937,-1670,-507026,-505142.4,0.08993459181452407,-360.8614442536308,0.0885112409275984
2023-09-11T12:00:00-04:00,1.07426,1.07563,1.07426,1.07555,1.0758934,1.0747217777777778,1.0747899999999921,1.074483999999995,1.0736480000000035,1.0732418000000004,1.0721413000000042,1.0714317000000049,1.074527344040424,1.0743185623663494,2450,-504576,-505824.6,0.10041077133748745,-357.9194190455806,0.18443138314223506
2023-09-11T12:15:00-04:00,1.07555,1.07577,1.07542,1.07577,1.075857532,1.0749177777777779,1.0748822222222145,1.074615777777773,1.0738040000000035,1.0733122000000002,1.0721857000000041,1.0714628000000048,1.074775875232339,1.0744220498930788,1830,-502746,-505414.8,0.10607249277472607,-357.5450989302909,0.07721361192251534
2023-09-11T12:30:00-04:00,1.07577,1.07579,1.07485,1.07488,1.0758223813599999,1.0749173333333335,1.074836666666659,1.0747086666666616,1.0739430000000036,1.0733614000000002,1.072223500000004,1.0714832000000047,1.0747967001858714,1.0745292399144626,-1354,-504100,-504760.8,0.0956145547685874,-358.6652826126764,-0.03812924885379957
2023-09-11T12:45:00-04:00,1.07488,1.07527,1.07484,1.0751,1.07579,1.07497,1.0748033333333256,1.0747764444444396,1.0740995000000035,1.0734006000000003,1.072265700000004,1.071507200000005,1.074857360148697,1.0746457919315695,1743,-502357,-504161,0.08053131246151642,-358.3085358130338,-0.027896596615209875
2023-09-11T13:00:00-04:00,1.0751,1.07524,1.07441,1.07442,1.07579,1.0748933333333333,1.0747888888888812,1.0748202222222172,1.0741935000000034,1.0734254000000003,1.072299000000004,1.0715311500000049,1.0747698881189576,1.0747454335452553,-2342,-504699,-503695.6,0.060537115613877146,-359.78984917923236,-0.012098087571538178
2023-09-11T13:15:00-04:00,1.07442,1.07474,1.07442,1.07472,1.0757562,1.0748795555555555,1.0748111111111034,1.0748244444444395,1.0743235000000033,1.0734492000000002,1.0723402000000042,1.0715546500000048,1.074759910495166,1.0747919468362035,1383,-503316,-503443.6,0.05245008664126817,-359.40368734307896,0.018612962066781258
2023-09-11T13:30:00-04:00,1.07472,1.0748,1.07464,1.07467,1.075723076,1.0748513333333332,1.074855555555548,1.0748191111111063,1.0744365000000033,1.0734676,1.0723847000000042,1.0715748500000049,1.0747419283961328,1.0747851574689622,-1218,-504534,-503801.2,0.04253774410355657,-359.46035326536554,0.03723458720805346
2023-09-11T13:45:00-04:00,1.07467,1.07469,1.07442,1.07457,1.07569061448,1.0747942222222222,1.0748822222222147,1.0748282222222176,1.0745275000000034,1.0734822000000002,1.0724259000000043,1.0715961500000049,1.0747075427169062,1.0747673259751693,-1011,-505545,-504090.2,0.035752748933195855,-359.5544286559506,0.02233950462148669
2023-09-11T14:00:00-04:00,1.07457,1.0750899999999999,1.07454,1.07499,1.0756588021904,1.0748157777777778,1.074963333333326,1.0748602222222174,1.0746305000000034,1.0735174000000003,1.0724679000000041,1.0716165000000049,1.074764034173525,1.0747486607801346,1250,-504295,-504477.8,0.03196466825099531,-359.0658611359195,0.06795375421219234
2023-09-11T14:15:00-04:00,1.07499,1.07506,1.0748,1.07499,1.075627626146592,1.074821111111111,1.0749011111111035,1.074882666666662,1.0747050000000034,1.0735598000000002,1.0725103000000042,1.0716372500000049,1.07480922733882,1.0747565286241074,0,-504295,-504397,0.02962654424951075,-359.0658611359195,-0.052066384640427316
2023-09-11T14:30:00-04:00,1.07499,1.07515,1.07469,1.07471,1.0755970736236602,1.0747828888888888,1.0747833333333259,1.0748771111111066,1.0747750000000034,1.0735916,1.0725492000000043,1.071657700000005,1.0747893818710559,1.0747624228992854,-1041,-505336,-504801,0.01644747773609342,-359.33700784426077,-0.09853407326843461
2023-09-11T14:45:00-04:00,1.07471,1.07473,1.07444,1.07452,1.075567132151187,1.074730222222222,1.0747433333333258,1.074854666666662,1.0748225000000036,1.0736314000000002,1.0725887000000043,1.071678300000005,1.0747355054968446,1.0747611383194278,-1074,-506410,-505176.2,-0.0005449707175680257,-359.526882322027,-0.03349211074725904
2023-09-11T15:00:00-04:00,1.07452,1.07477,1.07452,1.07456,1.0755377895081633,1.0746935555555555,1.0746833333333257,1.0748148888888842,1.0748035000000034,1.0736576,1.0726305000000043,1.071697950000005,1.0747004043974757,1.0747597106555418,1506,-504904,-505048,-0.007908374503183834,-359.4708200802818,-0.05022788577806576
2023-09-11T15:15:00-04:00,1.07456,1.07491,1.07444,1.07487,1.075509033718,1.074730888888889,1.0747333333333258,1.0747688888888842,1.0747825000000033,1.0736890000000001,1.0726784000000043,1.0717189500000048,1.0747343235179805,1.0747537685244328,1072,-503832,-504955.4,-0.009738185471907003,-359.1615586151239,0.04188306248953496
2023-09-11T15:30:00-04:00,1.07487,1.07503,1.07478,1.07478,1.07548085304364,1.0747402222222222,1.0747399999999923,1.074736666666662,1.0747515000000034,1.0737128,1.0727258000000044,1.071740950000005,1.0747434588143845,1.0747406148195457,-1104,-504936,-505083.6,-0.004129296605991785,-359.2539977007807,0.005582849486393761
2023-09-11T15:45:00-04:00,1.07478,1.07497,1.07464,1.07489,1.075453235982767,1.0747702222222222,1.0747644444444369,1.074732888888884,1.0747685000000033,1.0737494,1.0727768000000044,1.071765800000005,1.0747727670515075,1.0747372918556362,1286,-503650,-504746.4,-0.0002879939315120969,-359.1223800674048,0.020471400522940712
2023-09-11T16:00:00-04:00,1.07489,1.07499,1.07485,1.07493,1.0754261712631117,1.074803333333333,1.0748044444444367,1.0747451111111064,1.074789000000003,1.0737894000000001,1.0728257000000043,1.071789000000005,1.074804213641206,1.0747510334845085,637,-503013,-504067,0.00044749072916514,-359.0986753162209,0.03350177280213629
2023-09-11T16:15:00-04:00,1.07493,1.07508,1.07492,1.07499,1.0753996478378494,1.0748404444444444,1.0748044444444367,1.0747693333333284,1.074825000000003,1.0738374000000004,1.0728771000000044,1.071813300000005,1.0748413709129647,1.0747792267876064,424,-502589,-503604,0.0022728511257808022,-359.0750086588572,0
2023-09-11T16:30:00-04:00,1.07499,1.07501,1.07478,1.0748,1.0753736548810924,1.0748395555555554,1.0747833333333254,1.0747793333333284,1.074848500000003,1.0738872000000002,1.0729268000000043,1.0718385000000048,1.0748330967303719,1.0747989814300847,-507,-503096,-503456.8,-0.0018430484728551928,-359.1646187947654,-0.01767458301936878
2023-09-11T16:45:00-04:00,1.0748,1.07503,1.07479,1.07502,1.0753481817834705,1.0748868888888887,1.0748177777777699,1.0747948888888839,1.074886500000003,1.0739248000000001,1.0729778000000043,1.0718665500000049,1.0748704773842974,1.074824385144067,665,-502431,-502955.8,-0.004620771141356805,-359.02850044716575,0.028844990741691477
2023-09-11T17:00:00-04:00,1.07502,1.07502,1.07416,1.07468,1.075323218147801,1.0748593333333334,1.0748355555555478,1.0748091111111058,1.074843000000003,1.073963,1.0730233000000045,1.0718924000000047,1.074832381907438,1.0748363081152532,-125,-502556,-502737,-0.006760465541550557,-359.06803459536764,0.01489036965344154
2023-09-11T17:15:00-04:00,1.07468,1.07532,1.07468,1.07491,1.0741,1.074874222222222,1.0748744444444367,1.074823111111106,1.074800000000003,1.0740044000000002,1.0730712000000042,1.071918850000005,1.0748479055259503,1.074845046492202,373,-502183,-502571,-0.00029683095276126923,-358.9882061813281,0.03257147111376493
2023-09-11T17:30:00-04:00,1.07491,1.07518,1.07481,1.07508,1.0741244,1.0749153333333332,1.07489777777777,1.0748417777777726,1.0748100000000034,1.0740576000000004,1.0731196000000043,1.071945550000005,1.0748943244207603,1.074855637193761,328,-501855,-502424.2,0.007598218605636947,-358.93633207093745,0.019537246364680703
2023-09-11T17:45:00-04:00,1.07508,1.07529,1.07463,1.07496,1.0741483120000002,1.074927777777778,1.0749177777777699,1.0748686666666614,1.0748030000000033,1.0741058000000003,1.0731710000000043,1.0719728500000048,1.0749074595366082,1.0748705097550082,-587,-502442,-502293.4,0.008081108813422888,-359.00185277637337,0.016747613465066983
2023-09-11T18:00:00-04:00,1.07496,1.07524,1.07491,1.07511,1.0741717457600002,1.0749662222222223,1.0749422222222145,1.0748935555555506,1.0748375000000032,1.0741512000000002,1.0732111000000044,1.0719996500000049,1.0749479676292866,1.0748860078040061,371,-502071,-502221.4,0.011107089264963505,-358.9500834082108,0.02046721059830392
2023-09-11T18:15:00-04:00,1.07511,1.07513,1.075,1.07501,1.0741947108448002,1.0749797777777776,1.0749511111111032,1.0749166666666614,1.074852000000003,1.0741862000000004,1.0732498000000041,1.0720265500000048,1.0749603741034293,1.0749116062432045,-252,-502323,-502174.8,0.00960935257176243,-358.9735228702193,0.007442345082943076
2023-09-11T18:30:00-04:00,1.07501,1.0750899999999999,1.07497,1.07503,1.0742172166279043,1.0749955555555555,1.0749555555555477,1.0749328888888836,1.074870000000003,1.0742322000000004,1.0732842000000042,1.0720535500000048,1.0749742992827434,1.0749368849945633,189,-502134,-502165,0.009166195214056075,-358.9700066238588,0.0037209648461883375
2023-09-11T18:45:00-04:00,1.07503,1.07506,1.07498,1.07498,1.0742392722953462,1.0750004444444443,1.0749755555555476,1.074948444444439,1.0748905000000033,1.0742744000000004,1.0733187000000044,1.072080600000005,1.0749754394261948,1.07495310799565,-89,-502223,-502238.6,0.007699675444283764,-358.9741460432238,0.016747301823601506
2023-09-11T19:00:00-04:00,1.07498,1.07508,1.07497,1.07499,1.0742608868494392,1.0750033333333333,1.0749722222222142,1.074959333333328,1.0748905000000033,1.0743106000000002,1.0733587000000042,1.0721072000000047,1.074978351540956,1.0749672863965194,229,-501994,-502149,0.0076064998584881366,-358.9720157710327,-0.0027906457554460876
2023-09-11T19:15:00-04:00,1.07499,1.07508,1.0749,1.07493,1.0742820691124504,1.074994888888889,1.074999999999992,1.0749708888888836,1.0748875000000033,1.0743450000000003,1.0733980000000043,1.072133500000005,1.0749686812327648,1.0749714291172152,-235,-502229,-502180.6,0.007035034293799082,-358.9851321721155,0.02326273867568592
2023-09-11T19:30:00-04:00,1.07493,1.07498,1.07483,1.07485,1.0743028277302014,1.074964888888889,1.0749933333333255,1.074979333333328,1.0748945000000032,1.0743934000000004,1.0734361000000043,1.0721594000000048,1.0749449449862118,1.0749683432937718,-396,-502625,-502241,0.00923686239092657,-359.0146038586439,-0.005581862667567422
2023-09-11T19:45:00-04:00,1.07485,1.07489,1.07475,1.07475,1.0743231711755974,1.0749162222222224,1.0749566666666586,1.0749795555555504,1.0749060000000035,1.0744354000000005,1.0734721000000043,1.072184550000005,1.0749059559889695,1.074954674635017,-341,-502966,-502407.4,0.007571112639246871,-359.0463292156705,-0.030695390110497957
2023-09-11T20:00:00-04:00,1.07475,1.07478,1.07444,1.07458,1.0743431077520855,1.074840888888889,1.0749144444444363,1.074967333333328,1.0749070000000036,1.0744850000000004,1.0735088000000041,1.0722085000000048,1.0748407647911757,1.0749277397080133,-1043,-504009,-502764.6,0.002653647990949617,-359.2113071175081,-0.035350152563800044
2023-09-11T20:15:00-04:00,1.07458,1.07466,1.07439,1.0744,1.0743626455970439,1.0747380000000002,1.0748355555555476,1.074939999999995,1.0748835000000034,1.0745336000000003,1.0735415000000041,1.0722315500000048,1.0747526118329407,1.0748825917664102,-875,-504884,-503342.6,-0.001847377388424332,-359.3578760095404,-0.06603975407167531
2023-09-11T20:30:00-04:00,1.0744,1.07444,1.0742099999999999,1.07439,1.07532,1.074648888888889,1.0747666666666587,1.074893333333328,1.0748640000000034,1.0745706000000004,1.0735690000000042,1.0722551500000048,1.0746800894663526,1.0748248734131276,-1051,-505935,-504083.8,-0.006419440671125,-359.3676582135613,-0.05767388210342833
2023-09-11T20:45:00-04:00,1.07439,1.07475,1.07431,1.07439,1.0752978,1.0745735555555558,1.0746955555555475,1.0748337777777723,1.0748390000000034,1.0746160000000002,1.0735967000000044,1.0722793000000048,1.074622071573082,1.0747602987305018,0,-505935,-504745.8,-0.010460014699625606,-359.3676582135613,-0.05953322232867678
2023-09-11T21:00:00-04:00,1.07439,1.07679,1.07423,1.07538,1.0742099999999999,1.0747104444444444,1.074739999999992,1.0747904444444392,1.0748615000000035,1.0746754000000005,1.0736372000000043,1.072308400000005,1.0747736572584656,1.074733838984401,2089,-503846,-504921.8,-0.009374379766709868,-357.4427426800957,0.03720999460454668
2023-09-11T21:15:00-04:00,1.07538,1.07552,1.07427,1.07442,1.07423,1.0746464444444443,1.0746766666666587,1.0747428888888835,1.0748330000000035,1.0747088000000005,1.0736689000000044,1.0723329000000048,1.0747029258067724,1.0747062711875204,-2632,-506478,-505415.6,-0.01232519554376046,-359.7923493307682,-0.053023749058127005
2023-09-11T21:30:00-04:00,1.07442,1.07444,1.07382,1.07394,1.07679,1.074499111111111,1.0745666666666587,1.0746891111111057,1.0747900000000035,1.0747290000000003,1.0736948000000044,1.0723546500000047,1.074550340645418,1.0746658169500158,-2127,-508605,-506159.8,-0.017443045377400018,-360.74259225253076,-0.09209902040133278
2023-09-11T21:45:00-04:00,1.07394,1.07422,1.07375,1.07409,1.0767305999999999,1.0744037777777777,1.0744822222222143,1.0746322222222169,1.0747435000000034,1.0747408000000003,1.0737224000000045,1.072376400000005,1.0744582725163343,1.0746214535600123,2122,-506483,-506269.4,-0.0221135326753781,-360.4462069796103,-0.0707075405870674
2023-09-11T22:00:00-04:00,1.07409,1.07455,1.07389,1.07432,1.0766113759999998,1.0743713333333333,1.0744344444444363,1.0745799999999945,1.0747255000000036,1.0747610000000003,1.0737496000000042,1.072397500000005,1.0744306180130674,1.0745831628480094,1958,-504525,-505987.4,-0.023944146865477522,-360.0269311274937,-0.040009304489430325
2023-09-11T22:15:00-04:00,1.07432,1.07452,1.07422,1.07442,1.0764969209599997,1.0743684444444446,1.0744166666666584,1.0745153333333277,1.0747010000000035,1.0747780000000002,1.0737778000000044,1.072417900000005,1.0744284944104538,1.074514130278407,1741,-502784,-505775,-0.025862989516758552,-359.8648751292809,-0.014889538238210277
2023-09-11T22:30:00-04:00,1.07442,1.07474,1.07439,1.07461,1.0763870441215997,1.0744071111111109,1.0744399999999918,1.0744679999999944,1.0746775000000035,1.0747714000000004,1.0738049000000043,1.072436050000005,1.074464795528363,1.074466504222725,1304,-501480,-504775.4,-0.024254906035255413,-359.6342762945606,0.01954579300074865
2023-09-11T22:45:00-04:00,1.07461,1.07512,1.0744,1.0750899999999999,1.0762815623567357,1.0745371111111113,1.0745177777777697,1.0744582222222165,1.0746840000000035,1.0747674000000003,1.0738363000000044,1.072454500000005,1.0745898364226905,1.0744744033781797,1733,-499747,-503003.8,-0.017878791101063943,-358.86019081238595,0.06515324975101433
2023-09-11T23:00:00-04:00,1.0750899999999999,1.07512,1.07462,1.0748199999999999,1.0761802998624663,1.0745975555555554,1.0745655555555473,1.0744748888888833,1.0746695000000035,1.0747558000000001,1.0738637000000044,1.072472600000005,1.0746358691381523,1.0745099227025432,-1159,-500906,-501888.4,-0.013257416310101506,-359.1512641178766,0.040022710561335315
2023-09-11T23:15:00-04:00,1.0748199999999999,1.0748199999999999,1.07451,1.07453,1.0760830878679677,1.0745904444444443,1.074471111111103,1.0744822222222166,1.0746455000000035,1.0747554000000001,1.0738846000000044,1.0724906000000052,1.0746146953105218,1.074546738162034,-896,-501802,-501343.8,-0.009385003136967546,-359.3930162252061,-0.07904182707508206
2023-09-11T23:30:00-04:00,1.07453,1.07483,1.07444,1.07474,1.075989764353249,1.0746442222222221,1.0745066666666585,1.0745002222222166,1.0746310000000034,1.0747598000000003,1.0739081000000044,1.0725067000000053,1.0746397562484173,1.0745889905296266,882,-500920,-500971,-0.014144139952308878,-359.220643187692,0.029783511103674356
2023-09-11T23:45:00-04:00,1.07474,1.07478,1.07459,1.07463,1.075900173779119,1.074668888888889,1.074583333333325,1.0745288888888833,1.0746135000000037,1.0747670000000002,1.0739304000000045,1.0725213000000051,1.074637804998734,1.0746235924237009,-671,-501591,-500993.2,-0.010417751387284324,-359.28932026307774,0.06424939940779555
2023-09-12T00:00:00-04:00,1.07463,1.07466,1.0742099999999999,1.07424,1.0758141668279542,1.0746002222222222,1.074599999999992,1.0745453333333277,1.0745760000000035,1.0747652000000003,1.0739484000000044,1.0725331000000053,1.0745582439989871,1.0746172739389603,-701,-502292,-501502.2,-0.00434714982489511,-359.5437241043998,0.013965310169547664
2023-09-12T00:15:00-04:00,1.07424,1.07428,1.07396,1.0740399999999999,1.075731600154836,1.074488222222222,1.0745688888888807,1.0745459999999945,1.0745315000000035,1.0747608000000002,1.0739683000000044,1.0725439500000054,1.0744545951991897,1.0745810191511678,-906,-503198,-501960.6,-0.0006026883443046272,-359.71240149492724,-0.026062997989431267
2023-09-12T00:30:00-04:00,1.0740399999999999,1.07411,1.07386,1.0738699999999999,1.0756523361486425,1.0743484444444444,1.0745077777777694,1.0745533333333277,1.0744825000000036,1.0747272000000003,1.0739845000000043,1.0725540500000053,1.0743376761593517,1.074525615320934,-745,-503943,-502388.8,-0.00009306654234297272,-359.83032075305545,-0.05119040970942932
2023-09-12T00:45:00-04:00,1.0738699999999999,1.07402,1.07385,1.07389,1.075576242702697,1.074224888888889,1.0744277777777693,1.0745375555555499,1.0744395000000035,1.0746896000000001,1.0740009000000044,1.0725646000000053,1.0742481409274813,1.0744472922567465,804,-503139,-502832.6,-0.0007711555897067457,-359.8153468735355,-0.06700105154428619
2023-09-12T01:00:00-04:00,1.07389,1.07405,1.07381,1.07398,1.075503192994589,1.0741353333333332,1.074304444444436,1.074481777777772,1.0744095000000038,1.0746716000000003,1.0740165000000044,1.0725758500000053,1.074194512741985,1.074358633805397,1329,-501810,-502876.4,-0.0032221221062325553,-359.70396675080417,-0.10324717000436656
2023-09-12T01:15:00-04:00,1.07398,1.07408,1.07386,1.07389,1.0754330652748054,1.0740524444444444,1.074201111111103,1.0744019999999943,1.0743840000000038,1.0746474000000001,1.0740240000000043,1.0725870500000054,1.0741336101935879,1.074273707044317,-1170,-502980,-503014,-0.011333174955260063,-359.8020132693612,-0.08652611600080716
2023-09-12T01:30:00-04:00,1.07389,1.07395,1.0737,1.07394,1.0753657426638132,1.074000222222222,1.0741355555555474,1.0743153333333277,1.0743615000000037,1.0746378,1.0740316000000043,1.0725986500000053,1.0740948881548702,1.074201765635453,1047,-501933,-502761,-0.01748544652353233,-359.7532652597887,-0.054907727099298344
2023-09-12T01:45:00-04:00,1.07394,1.07401,1.07354,1.07362,1.0752657981039844,1.073897111111111,1.0740111111111028,1.0742159999999943,1.0743230000000037,1.0746158000000003,1.0740325000000042,1.0726085000000054,1.0739999105238962,1.074134212508362,-1616,-503549,-502682.2,-0.02254347686343166,-360.2347819180748,-0.10421125109328859
2023-09-12T02:00:00-04:00,1.07362,1.07409,1.07355,1.07374,1.0751277342556655,1.0738428888888887,1.073912222222214,1.0741128888888831,1.0742410000000038,1.0745972000000001,1.0740324000000043,1.0726200000000052,1.073947928419117,1.0740741700066891,3239,-500310,-502116.4,-0.028971374367004837,-359.872754385056,-0.08281920288844137
2023-09-12T02:15:00-04:00,1.07374,1.07394,1.07358,1.0738,1.0750007155152124,1.0738204444444444,1.0738633333333252,1.074024666666661,1.0742100000000037,1.0745818000000003,1.0740320000000043,1.0726308500000052,1.0739183427352936,1.0740189360053507,1786,-498524,-501459.2,-0.029695965444463467,-359.7729536884252,-0.04095918975275505
2023-09-12T02:30:00-04:00,1.0738,1.07393,1.07337,1.07344,1.0748838582739955,1.0737357777777778,1.0737966666666585,1.073943777777772,1.0741850000000037,1.0745508000000001,1.0740341000000044,1.0726404000000052,1.0738226741882348,1.0739567488042803,-2039,-500563,-500975.8,-0.03280041706465341,-360.4565446737114,-0.055863841197714606
2023-09-12T02:45:00-04:00,1.07344,1.07344,1.07303,1.07324,1.0747324724465959,1.0736244444444445,1.0737266666666585,1.0738619999999943,1.0741425000000038,1.0745158000000004,1.0740378000000044,1.0726498500000052,1.0737061393505878,1.0738789990434237,-1747,-502310,-501051.2,-0.03714599586621608,-360.7820402766328,-0.05866631901439732
2023-09-12T03:00:00-04:00,1.07324,1.07348,1.07229,1.07237,1.0745281757530043,1.0733531111111112,1.0735577777777694,1.0737713333333274,1.074045000000004,1.0744690000000003,1.0740303000000044,1.0726544000000053,1.0734389114804703,1.0737667992347384,-3530,-505840,-501509.4,-0.04348882431622579,-363.6435623965685,-0.14154149866373333
2023-09-12T03:15:00-04:00,1.07237,1.07279,1.07227,1.07269,1.0742148311475836,1.0731795555555554,1.0734144444444362,1.073671777777772,1.0739585000000038,1.0744324000000003,1.0740319000000043,1.0726588500000052,1.0732891291843762,1.0736350393877905,3300,-502540,-501955.4,-0.047438124041166214,-362.658827650166,-0.12011396860276853
2023-09-12T03:30:00-04:00,1.07269,1.07269,1.07205,1.07212,1.0739036581639703,1.0729206666666666,1.0732177777777696,1.0735426666666608,1.0738340000000037,1.0743836000000002,1.0740206000000043,1.0726595500000051,1.073055303347501,1.073462431510232,-2549,-505089,-503268.4,-0.054564506065681334,-364.0133009835614,-0.16482135041764512
2023-09-12T03:45:00-04:00,1.07212,1.07219,1.07121,1.07135,1.0735699996944557,1.0725471111111111,1.0729299999999917,1.0733693333333276,1.0736470000000038,1.0743132000000004,1.0740011000000045,1.0726545000000052,1.0727142426780008,1.0732407452081851,-3110,-508199,-504795.6,-0.06377053782498449,-366.2469128926759,-0.2411680354582072
2023-09-12T04:00:00-04:00,1.07135,1.07205,1.07121,1.0719,1.0730979997555645,1.0723411111111112,1.0727388888888807,1.073171777777772,1.0735010000000038,1.0742556000000005,1.0739842000000044,1.072651050000005,1.0725513941424005,1.0730097961665475,3457,-504742,-505282,-0.06863211271375871,-364.47218941295387,-0.16020565935805442
2023-09-12T04:15:00-04:00,1.0719,1.0722099999999999,1.07146,1.07202,1.0727203998044517,1.0721973333333332,1.0725477777777697,1.0729697777777722,1.0733755000000038,1.0741982000000005,1.0739738000000045,1.072650650000005,1.0724451153139205,1.0728110369332378,2681,-502061,-504526.2,-0.07112488488149353,-364.17204947452706,-0.16018775494998266
2023-09-12T04:30:00-04:00,1.07202,1.07236,1.07188,1.07192,1.0724183198435613,1.0720717777777777,1.0723388888888807,1.0727546666666612,1.0732345000000039,1.0741380000000005,1.0739637000000046,1.072650900000005,1.0723400922511364,1.0726212295465896,-2521,-504582,-504934.6,-0.0765103642813554,-364.40721299759565,-0.17507915813001523
2023-09-12T04:45:00-04:00,1.07192,1.0721,1.07139,1.07144,1.07236,1.071892,1.0721166666666584,1.0725344444444391,1.0730750000000038,1.0740670000000005,1.0739522000000046,1.072650400000005,1.0721600738009092,1.072442183637271,-2418,-507000,-505316.8,-0.08386976823414706,-365.48998036829505,-0.186316887762707
2023-09-12T05:00:00-04:00,1.07144,1.07233,1.07131,1.07201,1.07121,1.0718706666666666,1.071979999999992,1.0723444444444392,1.0729635000000037,1.0740112000000006,1.0739492000000046,1.072651600000005,1.0721300590407272,1.0723253469098164,2527,-504473,-504571.6,-0.08557921069527268,-364.14563070802484,-0.11460623905184902
2023-09-12T05:15:00-04:00,1.07201,1.07226,1.07163,1.07224,1.0712324,1.0719226666666666,1.0719655555555474,1.0721897777777725,1.0728735000000038,1.0739556000000006,1.0739402000000047,1.072657150000005,1.0721520472325818,1.0722454775278527,2173,-502300,-504083.2,-0.08603062999303489,-363.6794130421445,-0.012122681537152612
2023-09-12T05:30:00-04:00,1.07224,1.07246,1.07184,1.07246,1.071254352,1.0720215555555552,1.0719399999999917,1.0720682222222169,1.0728030000000037,1.0739112000000006,1.0739371000000046,1.072662050000005,1.0722136377860654,1.0721991820222816,1908,-500392,-503749.4,-0.07818488561634321,-363.28793352263415,-0.0214414229646918
2023-09-12T05:45:00-04:00,1.07246,1.0726,1.07214,1.07223,1.07130257792,1.0720795555555556,1.0719522222222142,1.0719908888888834,1.072720000000004,1.0738576000000006,1.0739310000000046,1.072668900000005,1.0722169102288523,1.0721745456178249,-1939,-502331,-503299.2,-0.07519878339608808,-363.7037718755796,0.010260045517297924
2023-09-12T06:00:00-04:00,1.07223,1.07243,1.07202,1.07227,1.0713804232448,1.072143111111111,1.0720544444444362,1.0719784444444391,1.0726345000000037,1.0738014000000007,1.0739295000000046,1.072674900000005,1.072227528183082,1.0721880364942593,1650,-500681,-502035.4,-0.0666143730961562,-363.64221791793983,0.08587296401736425
2023-09-12T06:15:00-04:00,1.07227,1.07228,1.07193,1.072,1.071453597850112,1.072132222222222,1.0720655555555474,1.0719955555555503,1.0725400000000038,1.0737422000000008,1.0739240000000048,1.072676450000005,1.0721820225464656,1.072198429195407,-1034,-501715,-501483.8,-0.051769857875723434,-363.90258144578263,0.009329228472804272
2023-09-12T06:30:00-04:00,1.072,1.0722,1.07132,1.07136,1.0726,1.0719911111111111,1.071992222222214,1.0720008888888835,1.0724110000000038,1.0736672000000007,1.0739092000000048,1.072676550000005,1.0720176180371725,1.072171543356325,-2152,-503867,-501797.2,-0.04557733361251913,-365.18735756518555,-0.061566015559400285
2023-09-12T06:45:00-04:00,1.07136,1.07172,1.07121,1.0715999999999999,1.0725744,1.0719126666666667,1.0719566666666585,1.0720042222222168,1.0723100000000039,1.0735990000000006,1.0738926000000049,1.072678700000005,1.071934094429738,1.0721156346850598,2017,-501850,-502088.8,-0.03910777261962148,-364.7355206476232,-0.02985297410255411
2023-09-12T07:00:00-04:00,1.0715999999999999,1.07168,1.07123,1.07157,1.072519824,1.0718353333333333,1.071971111111103,1.0720079999999945,1.0722015000000038,1.0735298000000006,1.0738810000000047,1.072684050000005,1.0718612755437904,1.0720445077480474,-1800,-503650,-502352.6,-0.03327150068566037,-364.7859125849132,0.012133203912488191
2023-09-12T07:15:00-04:00,1.07157,1.07174,1.071,1.07131,1.07246743104,1.0717031111111113,1.0718933333333254,1.0719757777777723,1.0720770000000037,1.0734564000000004,1.0738654000000047,1.0726896500000052,1.0717510204350322,1.0719492061984375,-2256,-505906,-503397.6,-0.02369495641612794,-365.3332963302587,-0.06529789834049336
2023-09-12T07:30:00-04:00,1.07131,1.07142,1.07085,1.07132,1.0723793851776,1.0715884444444443,1.0717911111111031,1.0719208888888834,1.0719710000000036,1.0733830000000004,1.0738468000000048,1.0726942500000052,1.0716648163480258,1.0718457649587496,2698,-503208,-503696.2,-0.01911796191132293,-365.30811220988255,-0.085801686189662
2023-09-12T07:45:00-04:00,1.07132,1.07185,1.07108,1.0718,1.072257034363392,1.0715902222222222,1.0717177777777698,1.0718659999999947,1.0718990000000037,1.0733204000000005,1.0738327000000047,1.0727016000000054,1.0716918530784207,1.071780611966999,2187,-501021,-503127,-0.015938718558783704,-364.3282369158527,-0.06154075676481015
2023-09-12T08:00:00-04:00,1.0718,1.07189,1.07119,1.07134,1.0721444716143205,1.0715146666666666,1.071618888888881,1.0717984444444393,1.0718475000000036,1.0732502000000006,1.0738218000000046,1.0727073000000054,1.0716214824627366,1.071718089573599,-2875,-503896,-503536.2,-0.017948121044701483,-365.5621424952522,-0.08300457924139945
2023-09-12T08:15:00-04:00,1.07134,1.07138,1.0706,1.07108,1.0720409138851748,1.071406888888889,1.071486666666659,1.0717015555555502,1.0717670000000035,1.0731768000000006,1.0738061000000045,1.0727123000000054,1.0715131859701892,1.0716484716588786,-3357,-507253,-504256.8,-0.022947365895368197,-366.3768418437314,-0.11097951075755401
2023-09-12T08:30:00-04:00,1.07108,1.0721,1.07095,1.07161,1.0706,1.0714315555555556,1.0714433333333253,1.0716115555555503,1.0717415000000037,1.0731174000000006,1.0738012000000046,1.0727216500000054,1.0715325487761513,1.0716047773271025,4060,-503193,-503714.2,-0.02430804706966534,-364.36784158231336,-0.036380597014935866
2023-09-12T08:45:00-04:00,1.07161,1.07163,1.07056,1.07071,1.0721,1.0712848888888888,1.071371111111103,1.0715275555555503,1.0717095000000036,1.0730436000000005,1.0737886000000045,1.0727250500000054,1.071368039020921,1.0715454218616816,-3334,-506527,-504378,-0.030081482159250984,-367.1679274344421,-0.06067054958184358
2023-09-12T09:00:00-04:00,1.07071,1.07109,1.07055,1.07088,1.0721,1.0711866666666667,1.0712911111111032,1.0714422222222173,1.0716585000000038,1.0729734000000009,1.0737720000000046,1.0727274000000053,1.071270431216737,1.071461137489345,3571,-502956,-504765,-0.03247268282189015,-366.6009485139127,-0.06718924972002911
2023-09-12T09:15:00-04:00,1.07088,1.07154,1.07075,1.07128,1.072038,1.0711844444444445,1.071258888888881,1.0713702222222172,1.0716215000000036,1.0729112000000007,1.0737636000000046,1.0727345500000054,1.0712723449733896,1.0713913099914756,3440,-499516,-503889,-0.032704642859278765,-365.3160239658776,-0.027063094338204828
2023-09-12T09:30:00-04:00,1.07128,1.07188,1.0712,1.07155,1.07197848,1.0712426666666668,1.0712855555555474,1.071329999999995,1.0716030000000036,1.0728346000000006,1.0737550000000047,1.0727428500000054,1.0713278759787117,1.07135424799318,4966,-494550,-501348.4,-0.0308034401023571,-364.0644184099072,0.022402479207700665
2023-09-12T09:45:00-04:00,1.07155,1.07176,1.07114,1.07175,1.0719213408000001,1.0713355555555555,1.0713333333333255,1.071307999999995,1.0716185000000036,1.0727812000000005,1.0737450000000046,1.0727521000000053,1.0714123007829695,1.0713301983945436,4089,-490461,-498802,-0.02594227377476692,-363.3012249051712,0.04013740058991995
2023-09-12T10:00:00-04:00,1.07175,1.07179,1.07107,1.07137,1.07188,1.071342888888889,1.0712855555555476,1.0712908888888841,1.0715865000000036,1.0727298000000005,1.0737294000000046,1.0727574500000052,1.0714038406263755,1.0713373587156347,-3274,-493735,-496243.6,-0.025164705955310396,-364.46205532271273,-0.04011942526592204
2023-09-12T10:15:00-04:00,1.07137,1.07152,1.07107,1.07134,1.0718268,1.0713537777777777,1.0712855555555476,1.071289777777773,1.0715415000000035,1.0726748000000006,1.0737078000000044,1.0727620000000053,1.0713910725011004,1.0713614869725074,-3253,-496988,-495050,-0.026480831281890174,-364.55314430224354,0
2023-09-12T10:30:00-04:00,1.07134,1.07166,1.07104,1.07164,1.07179,1.0714246666666667,1.0713477777777698,1.0713075555555507,1.0715005000000037,1.0726212000000006,1.0736911000000045,1.0727680000000053,1.0714408580008803,1.0713951895780056,3310,-493678,-493882.4,-0.021015470745876237,-363.6262676804429,0.0522836762893429
2023-09-12T10:45:00-04:00,1.07164,1.07176,1.07116,1.07138,1.07055,1.071431111111111,1.0713222222222145,1.071314888888884,1.0714580000000038,1.0725604000000006,1.0736692000000045,1.0727737500000054,1.0714286864007043,1.0714153516624039,-2789,-496467,-494265.8,-0.013416948908245388,-364.30293148545184,-0.021463032259866226
2023-09-12T11:00:00-04:00,1.07138,1.0723799999999999,1.07136,1.07205,1.0705741999999998,1.0715766666666664,1.0714711111111033,1.0713424444444395,1.0714470000000036,1.0725092000000007,1.0736403000000045,1.0727831500000053,1.0715529491205635,1.0714434813299227,3408,-493059,-494785.4,-0.008510653426850954,-362.1716988695734,0.12515060100306308
2023-09-12T11:15:00-04:00,1.07205,1.07302,1.07203,1.07298,1.0706464319999998,1.0718784444444442,1.0717044444444366,1.0714262222222175,1.0714960000000038,1.0724670000000007,1.0736172000000044,1.0727923500000054,1.0718383592964509,1.0715303850639377,2182,-490877,-494213.8,0.009519187696215558,-360.278820738889,0.19610040340654328
2023-09-12T11:30:00-04:00,1.07298,1.07302,1.0725,1.07251,1.0707888460799997,1.0720395555555557,1.0718411111111033,1.0715373333333287,1.0715535000000036,1.0724208000000006,1.0735883000000046,1.0727982500000053,1.0719726874371607,1.07164670805115,-1809,-492686,-493353.4,0.022464240528925532,-361.07122134281445,0.1148159211410709
2023-09-12T11:45:00-04:00,1.07251,1.07284,1.07242,1.07254,1.0709227153151997,1.0721793333333334,1.0719511111111033,1.0716579999999953,1.0716005000000037,1.0723810000000007,1.0735682000000044,1.0727978500000053,1.0720861499497285,1.0717757664409195,1257,-491429,-492903.6,0.028977572931878515,-361.0360608314906,0.0923895291866965
2023-09-12T12:00:00-04:00,1.07254,1.07346,1.07254,1.07342,1.0710485523962876,1.0724731111111112,1.072136666666659,1.0718208888888843,1.0716930000000038,1.0723546000000008,1.0735572000000044,1.0727956500000055,1.0723529199597828,1.071960613152735,2194,-489235,-491457.2,0.0383374145708462,-359.2359228412991,0.15581992069046516
2023-09-12T12:15:00-04:00,1.07342,1.07375,1.07325,1.0732599999999999,1.0712414682045845,1.0726977777777778,1.0723466666666588,1.0719959999999953,1.0717905000000036,1.0723272000000008,1.0735471000000045,1.0727974000000053,1.072534335967826,1.0721568905221877,-1644,-490879,-491021.2,0.04491467588945528,-359.48097137775295,0.1764096437271855
2023-09-12T12:30:00-04:00,1.0732599999999999,1.0732599999999999,1.07233,1.0725,1.071492321384126,1.0727284444444445,1.0724755555555479,1.0721502222222175,1.071849500000004,1.072292400000001,1.0735288000000045,1.0727991500000054,1.072527468774261,1.0722947124177495,-1643,-492522,-491350.2,0.05016813790128294,-360.64441732747605,0.10827561745104727
2023-09-12T12:45:00-04:00,1.0725,1.07256,1.07214,1.07232,1.0717180892457134,1.0726973333333334,1.0725511111111032,1.0722922222222175,1.0718755000000038,1.0722580000000008,1.0735094000000045,1.0728031500000055,1.0724859750194087,1.0723973699341993,-1342,-493864,-491585.8,0.05486618648039823,-360.8696480967069,0.06345414504871169
2023-09-12T13:00:00-04:00,1.07232,1.07274,1.07231,1.0727,1.071921280321142,1.0727271111111112,1.07269777777777,1.0724415555555509,1.0719435000000037,1.072234600000001,1.0734809000000043,1.0728111000000053,1.072528780015527,1.0724858959473589,1548,-492316,-491763.2,0.06075465311097684,-360.32108050494315,0.1232055853198667
2023-09-12T13:15:00-04:00,1.0727,1.0734,1.0727,1.07324,1.0721041522890278,1.0728355555555555,1.072829999999992,1.0725802222222174,1.0720515000000037,1.0722216000000009,1.0734556000000044,1.0728206500000055,1.0726710240124215,1.0725495167578867,1448,-490868,-492089.8,0.06966028506455285,-359.59215349832436,0.11100228534117107
2023-09-12T13:30:00-04:00,1.07324,1.07332,1.07292,1.07292,1.072268737060125,1.0728535555555556,1.0728233333333252,1.0726755555555507,1.0721170000000038,1.0722004000000007,1.0734360000000045,1.0728297500000052,1.0727208192099373,1.072586813406309,-1573,-492441,-492402.2,0.06959684995324182,-360.06116322587815,-0.005591902924560474
2023-09-12T13:45:00-04:00,1.07292,1.07335,1.07257,1.0726,1.0724168633541125,1.0728088888888887,1.0728333333333253,1.0727471111111062,1.0722115000000039,1.0721746000000008,1.0734110000000046,1.0728383500000056,1.0726966553679498,1.0726206507250469,-1675,-494116,-492721,0.06165239614250404,-360.5607344893462,0.008391530148895905
2023-09-12T14:00:00-04:00,1.0726,1.07295,1.07245,1.07268,1.07375,1.0727782222222224,1.0728488888888807,1.0728066666666618,1.072301500000004,1.072149400000001,1.0733936000000044,1.0728463000000055,1.07269332429436,1.072662120580037,1564,-492552,-492458.6,0.05448349706976721,-360.44408336124616,0.013053126223733285
2023-09-12T14:15:00-04:00,1.07268,1.07338,1.0726499999999999,1.07332,1.073724,1.0728724444444444,1.0728377777777696,1.072834666666662,1.072403500000004,1.0721434000000007,1.0733796000000044,1.0728599000000054,1.072818659435488,1.072720096464029,1469,-491083,-492212,0.05091621205785216,-359.56762439864787,-0.009316017961281602
2023-09-12T14:30:00-04:00,1.07332,1.0734299999999999,1.07312,1.07334,1.07369852,1.072972888888889,1.0728466666666587,1.072837999999995,1.072493000000004,1.0721354000000007,1.0733663000000044,1.0728755000000054,1.0729229275483905,1.072770477171223,1491,-489592,-491956.8,0.04101874616221745,-359.53984144482246,0.007453925423483594
2023-09-12T14:45:00-04:00,1.07334,1.07339,1.07301,1.07323,1.0736735496,1.0730495555555555,1.0729277777777697,1.072858888888884,1.0725670000000038,1.0721240000000005,1.0733529000000046,1.0728894000000053,1.0729843420387124,1.072823181736978,-1412,-491004,-491669.4,0.033276961553903556,-359.6845486205544,0.06806526806525849
2023-09-12T15:00:00-04:00,1.07323,1.07339,1.07308,1.07318,1.073649078608,1.0731,1.0730233333333252,1.072896888888884,1.072657500000004,1.0721188000000006,1.0733348000000045,1.0729013500000053,1.0730234736309698,1.072888545389582,-1193,-492197,-491285.6,0.03326596970791008,-359.74012850557426,0.08019994031633122
2023-09-12T15:15:00-04:00,1.07318,1.07321,1.07306,1.07309,1.0736250970358399,1.0731133333333331,1.0730666666666586,1.0729404444444395,1.0727450000000038,1.0721158000000006,1.0733158000000045,1.0729130500000053,1.073036778904776,1.0729572363116653,-1157,-493354,-491446,0.032806185142549626,-359.8371578948658,0.03635685653026126
2023-09-12T15:30:00-04:00,1.07309,1.07315,1.07274,1.07276,1.073601595095123,1.0730520000000001,1.0730133333333252,1.0729755555555507,1.072801000000004,1.0721236000000005,1.0732963000000044,1.0729227500000054,1.0729814231238206,1.0729897890493316,-1347,-494701,-492169.6,0.02706006749061104,-360.25139155653466,-0.044724385971454284
2023-09-12T15:45:00-04:00,1.07276,1.073,1.07275,1.0728199999999999,1.0735785631932204,1.0730133333333334,1.073002222222214,1.0730066666666616,1.0728730000000037,1.0721262000000005,1.0732793000000045,1.0729340000000054,1.0729491384990564,1.0729950312394647,1404,-493297,-492910.6,0.017905937456428885,-360.17286513869664,-0.009320359393077864
2023-09-12T16:00:00-04:00,1.0728199999999999,1.07292,1.07276,1.07283,1.073555991929356,1.072978888888889,1.0730277777777697,1.0730266666666615,1.0729120000000036,1.0721404000000008,1.0732620000000046,1.0729462500000055,1.0729253107992451,1.0729832249915714,863,-492434,-493196.6,0.010630133922174658,-360.16482091879016,0.021443222077191168
2023-09-12T16:15:00-04:00,1.07283,1.07417,1.07276,1.07414,1.07245,1.0732013333333332,1.0731899999999919,1.0730599999999948,1.0729700000000038,1.0721962000000007,1.0732547000000046,1.0729665500000056,1.073168248639396,1.0730121799932566,1060,-491374,-493032,0.015706285798740987,-358.87048724057445,0.13610769288138277
2023-09-12T16:30:00-04:00,1.07414,1.07513,1.0741,1.07496,1.0724844,1.0735553333333334,1.073372222222214,1.0731211111111059,1.0730925000000036,1.0722574000000007,1.0732565000000045,1.0729911500000056,1.0735265989115168,1.073110143994605,1370,-490004,-492362,0.028165876466222397,-357.8246272968057,0.15279692915438672
2023-09-12T16:45:00-04:00,1.07496,1.07649,1.07492,1.07538,1.072590224,1.0739568888888888,1.0735988888888806,1.073238222222217,1.0732345000000039,1.0723246000000004,1.0732614000000045,1.0730191000000056,1.0738972791292134,1.0732933151956836,2328,-487676,-490957,0.03462271095450585,-356.9150492659951,0.19006093129856727
2023-09-12T17:00:00-04:00,1.07538,1.07547,1.0748199999999999,1.07529,1.07282421056,1.074295111111111,1.0738277777777696,1.0734033333333282,1.0733280000000038,1.0723920000000005,1.0732650000000046,1.0730453500000054,1.0741758233033707,1.0735386521565462,-104,-487780,-489853.6,0.04058566156694753,-356.9237531660118,0.19194394491396746
2023-09-12T17:15:00-04:00,1.07529,1.07547,1.07519,1.07534,1.0730441579264,1.0745975555555558,1.0740677777777696,1.0736113333333281,1.073432000000004,1.0724700000000005,1.0732685000000044,1.0730728000000056,1.0744086586426966,1.0738353217252365,305,-487475,-488861.8,0.051721460924146825,-356.9095709454016,0.201270989023271
2023-09-12T17:30:00-04:00,1.07534,1.07589,1.07533,1.07588,1.0732509084508162,1.07496,1.0743777777777697,1.0738488888888837,1.0736010000000038,1.0725474000000006,1.0732793000000043,1.0731030500000056,1.0747029269141573,1.0741422573801889,489,-486986,-487984.2,0.06524423673715055,-356.6640114014434,0.259996831579816
2023-09-12T17:45:00-04:00,1.07588,1.07635,1.07585,1.07586,1.073445253943767,1.0752564444444446,1.0747222222222141,1.0741188888888837,1.073778000000004,1.0726198000000007,1.0732877000000045,1.0731327500000054,1.0749343415313257,1.0744238059041504,-441,-487427,-487468.8,0.07613132587213206,-356.6722093417341,0.28897423468437516
2023-09-12T18:00:00-04:00,1.07586,1.0760399999999999,1.07556,1.07563,1.073627938707141,1.075438,1.0750344444444364,1.0744059999999949,1.0739245000000037,1.0726832000000006,1.0732972000000045,1.0731602500000055,1.0750734732250606,1.07465904472332,-529,-487956,-487524.8,0.08816829621875404,-356.78530026434487,0.2619265114371657
2023-09-12T18:15:00-04:00,1.07563,1.07565,1.07544,1.07545,1.0737996623847126,1.0755211111111111,1.0753255555555474,1.0747055555555503,1.0740350000000036,1.0727476000000007,1.0733026000000045,1.0731869000000054,1.0751487785800484,1.0748536357786553,-332,-488288,-487626.4,0.10045251517051693,-356.84085840236634,0.24421390155011202
2023-09-12T18:30:00-04:00,1.07545,1.07564,1.07544,1.07555,1.07396108264163,1.075566,1.075482222222214,1.0749884444444393,1.0741665000000036,1.0728132000000006,1.0733073000000044,1.0732134500000055,1.0752290228640387,1.0750177086229238,218,-488070,-487745.4,0.11552452202848074,-356.8205878179598,0.13126780494161946
2023-09-12T18:45:00-04:00,1.07555,1.07563,1.07555,1.0756,1.074112817683132,1.0755895555555557,1.0755533333333251,1.0752235555555503,1.0743165000000037,1.0728852000000006,1.0733137000000044,1.0732423500000055,1.075303218291231,1.0751377668983384,194,-487876,-487923.4,0.1172218717822662,-356.8115691763346,0.05953709905484613
2023-09-12T19:00:00-04:00,1.0756,1.07569,1.07546,1.07559,1.074255448622144,1.075596888888889,1.0755766666666584,1.0753944444444392,1.0744620000000036,1.0729698000000005,1.0733185000000045,1.0732648000000056,1.0753605746329848,1.0752230135186702,-394,-488270,-488092,0.10981778146561694,-356.81523224810843,0.019527980806788622
2023-09-12T19:15:00-04:00,1.07559,1.0758,1.07558,1.07561,1.0743895217048154,1.0756035555555556,1.0756122222222142,1.0755099999999946,1.0745765000000036,1.0730500000000005,1.0733245000000045,1.0732871500000056,1.0754104597063878,1.0752904108149357,368,-487902,-488081.2,0.09895922197598629,-356.8083894920397,0.02975941373953779
2023-09-12T19:30:00-04:00,1.07561,1.07567,1.07537,1.07547,1.0745155504025266,1.0755751111111111,1.0756266666666585,1.075570222222217,1.0746830000000034,1.0731280000000005,1.0733289000000044,1.0733065500000056,1.0754223677651102,1.0753451286519482,-536,-488438,-488111.2,0.09109762041941091,-356.878154555585,0.012089199694976797
2023-09-12T19:45:00-04:00,1.07547,1.07568,1.07525,1.0753,1.074634017378375,1.0755097777777778,1.075562222222214,1.075586222222217,1.0747865000000034,1.0732078000000005,1.0733321000000047,1.0733254000000056,1.075397894212088,1.0753789029215581,-633,-489071,-488311.4,0.08203302234596481,-356.97821313462487,-0.05390935792096005
2023-09-12T20:00:00-04:00,1.0753,1.07642,1.0753,1.07613,1.0747453763356725,1.0756233333333332,1.0755922222222138,1.0755939999999946,1.0749340000000036,1.0733040000000005,1.0733435000000044,1.0733511000000058,1.0755443153696704,1.075427122337246,1674,-487397,-488215.6,0.07150053207864848,-355.6860900061954,0.025096202108080275
2023-09-12T20:15:00-04:00,1.07613,1.0762,1.07568,1.07575,1.074850053755532,1.075654888888889,1.0756055555555473,1.0755997777777724,1.0750670000000035,1.0733830000000004,1.0733517000000043,1.0733748500000058,1.0755854522957364,1.0754720978697963,-1341,-488738,-488309.2,0.05908454831441205,-356.15962015589855,0.01115625261473722
2023-09-12T20:30:00-04:00,1.07575,1.07623,1.07575,1.07612,1.0749484505302003,1.0757577777777778,1.0756799999999918,1.0756133333333278,1.0752350000000035,1.0734786000000005,1.0733644000000044,1.0734002500000057,1.0756923618365892,1.0755284782958365,853,-487885,-488305.8,0.05021379730072624,-355.8662341461379,0.06229950253381825
2023-09-12T20:45:00-04:00,1.07612,1.07629,1.07586,1.07594,1.0750409434983883,1.0758097777777775,1.075723333333325,1.0756326666666611,1.0753910000000035,1.0735758000000004,1.0733763000000045,1.0734242000000058,1.0757418894692714,1.0755923826366687,-1498,-489383,-488494.8,0.04068086644156962,-356.1168009974185,0.03626051787456561
2023-09-12T21:00:00-04:00,1.07594,1.07616,1.07577,1.07613,1.075127886888485,1.075891111111111,1.0757822222222138,1.075676666666661,1.0755560000000035,1.0736662000000003,1.0733918000000044,1.0734503000000055,1.0758195115754172,1.0756767061093346,1697,-487686,-488217.8,0.031411688389552446,-355.81712815320765,0.04927482335442
2023-09-12T21:15:00-04:00,1.07613,1.07649,1.07595,1.07609,1.0752096136751759,1.0759526666666666,1.0758377777777695,1.0757257777777722,1.0756535000000036,1.0737738000000006,1.0734087000000045,1.0734751000000058,1.0758736092603338,1.0757425648874672,-1793,-489479,-488634.2,0.021529883505096784,-355.8837743762477,0.04648611459756458
2023-09-12T21:30:00-04:00,1.07609,1.07614,1.07563,1.07565,1.0752864368546653,1.0759151111111112,1.0758422222222137,1.0757731111111055,1.0756880000000035,1.0738692000000005,1.0734213000000046,1.0734951500000058,1.075828887408267,1.0757912519099735,-2393,-491872,-489261,0.01540149242654135,-356.86224271997355,0.003718820018411878
2023-09-12T21:45:00-04:00,1.07565,1.07584,1.07555,1.07575,1.0753586506433854,1.0758966666666667,1.0758733333333248,1.0758117777777723,1.0757065000000037,1.0739586000000003,1.0734349000000045,1.0735158000000056,1.0758131099266137,1.0758154015279784,1625,-490247,-489733.4,0.013205244381343005,-356.7111712748009,0.026035128827401787
2023-09-12T22:00:00-04:00,1.07575,1.07599,1.07504,1.07512,1.07649,1.0757459999999999,1.075853333333325,1.0758377777777723,1.0756980000000036,1.0740300000000005,1.0734323000000046,1.0735347500000056,1.075674487941291,1.0758019212223826,-1713,-491960,-490248.8,0.011102626249456992,-357.71436904379914,-0.016739514554063698
2023-09-12T22:15:00-04:00,1.07512,1.07535,1.0748199999999999,1.07503,1.076461,1.0755813333333333,1.0757311111111028,1.0758275555555499,1.0756825000000036,1.0740956000000006,1.0734384000000046,1.0735536500000056,1.0755455903530327,1.0757471369779057,-1570,-493530,-491417.6,0.009743684866184156,-357.8457962333224,-0.10221813349689172
2023-09-12T22:30:00-04:00,1.07503,1.07505,1.07453,1.07462,1.0763953599999998,1.0753591111111112,1.075605555555547,1.0757811111111055,1.0756195000000037,1.0741606000000004,1.0734452000000045,1.0735700000000055,1.0753604722824261,1.075644509582324,-1581,-495111,-492544,-0.0011067691325764117,-358.44876545278606,-0.10504299326052292
2023-09-12T22:45:00-04:00,1.07462,1.07485,1.07451,1.07466,1.0762834383999997,1.0751700000000002,1.0754433333333249,1.0757013333333276,1.0755595000000038,1.0742270000000007,1.0734509000000045,1.0735866500000057,1.0752203778259408,1.075522807665859,1655,-493456,-492860.8,-0.005839629344888145,-358.3871622814324,-0.13567260156859987
2023-09-12T23:00:00-04:00,1.07466,1.07489,1.07456,1.07488,1.0761415633279998,1.0750573333333333,1.0753255555555472,1.0755917777777722,1.0755220000000036,1.0742918000000006,1.0734565000000045,1.0736030500000056,1.0751523022607528,1.0753906461326868,1135,-492321,-493275.6,-0.01303015531227172,-358.1548097234139,-0.0985185047493205
2023-09-12T23:15:00-04:00,1.07488,1.07488,1.07443,1.07464,1.0760110382617598,1.074920222222222,1.0751599999999917,1.0754531111111054,1.0754815000000038,1.0743570000000005,1.0734587000000044,1.0736182500000055,1.0750498418086023,1.075265716906149,-1397,-493718,-493627.2,-0.020734927659926308,-358.46673291483995,-0.13845910810032164
2023-09-12T23:30:00-04:00,1.07464,1.07502,1.07461,1.07476,1.0758529344355838,1.0748402222222222,1.075012222222214,1.0753093333333277,1.0754420000000038,1.0744112000000006,1.0734602000000044,1.0736325500000057,1.0749918734468817,1.0751549735249188,1233,-492485,-493418.2,-0.030419240900204744,-358.3290495976362,-0.12359561003262305
2023-09-12T23:45:00-04:00,1.07476,1.07487,1.07466,1.07472,1.0757106409920254,1.0747817777777777,1.0749088888888805,1.0751699999999944,1.0753980000000039,1.0744460000000005,1.0734565000000047,1.0736464000000057,1.0749374987575053,1.0750703788199347,-754,-493239,-493043.8,-0.039484474546712015,-358.35711167661196,-0.0864593501603772
2023-09-13T00:00:00-04:00,1.07472,1.07478,1.07463,1.07467,1.0755825768928229,1.074734,1.0747888888888804,1.0750391111111057,1.0753520000000036,1.0744892000000006,1.0734550000000045,1.0736593500000056,1.0748839990060042,1.0750031030559473,-830,-494069,-493166.4,-0.044481090111912994,-358.3957263855593,-0.10039507320473808
2023-09-13T00:15:00-04:00,1.07467,1.0748199999999999,1.07462,1.0748,1.0754673192035407,1.074736222222222,1.074753333333325,1.0749246666666612,1.0753115000000038,1.0745344000000006,1.0734577000000045,1.0736711500000056,1.0748671992048033,1.0749460824447576,657,-493412,-493384.6,-0.04981879244536522,-358.31625082562005,-0.029764119354127722
2023-09-13T00:30:00-04:00,1.0748,1.075,1.07472,1.07498,1.0753635872831866,1.0747815555555553,1.0747477777777692,1.0748422222222165,1.0752870000000037,1.0745656000000006,1.0734601000000046,1.0736841000000057,1.0748897593638427,1.0749140659558054,842,-492570,-493155,-0.048332219575190176,-358.1752385442653,-0.004651032994417223
2023-09-13T00:45:00-04:00,1.07498,1.07537,1.07496,1.07523,1.07443,1.074878,1.0748155555555472,1.0748028888888832,1.0752835000000038,1.0746050000000005,1.0734661000000048,1.0736982500000056,1.0749578074910742,1.0749072527646442,1328,-491242,-492906.4,-0.04540991817418445,-357.8663955890477,0.05676425154938485
2023-09-13T01:00:00-04:00,1.07523,1.07545,1.07495,1.07502,1.0744488,1.0749188888888888,1.0748555555555472,1.0747922222222166,1.0752280000000038,1.0746554000000006,1.0734739000000046,1.0737111500000056,1.0749702459928594,1.0749138022117148,-1499,-492741,-492806.8,-0.040450491105163154,-358.1591608578737,0.033498967115193456
2023-09-13T01:15:00-04:00,1.07502,1.07505,1.07459,1.07466,1.074488848,1.0748797777777779,1.0748311111111029,1.074800666666661,1.0751735000000038,1.0747022000000006,1.0734801000000047,1.0737242000000056,1.0749081967942875,1.0749186417693717,-909,-493650,-492723,-0.0339427136984308,-358.4635644968759,-0.02046740101221615
2023-09-13T01:30:00-04:00,1.07466,1.07483,1.07435,1.07435,1.07545,1.0747835555555554,1.0747988888888806,1.0748097777777723,1.0750850000000036,1.0747352000000006,1.0734849000000046,1.0737347000000057,1.07479655743543,1.0749045134154969,-1723,-495373,-493115.2,-0.03267365936986244,-358.9605868109102,-0.026985781284906897
2023-09-13T01:45:00-04:00,1.07435,1.07449,1.07418,1.07443,1.075428,1.0747097777777779,1.074762222222214,1.0748126666666613,1.0750095000000037,1.0747590000000007,1.0734903000000047,1.0737456000000056,1.074723245948344,1.0748712107323972,1579,-493794,-493360,-0.027143713293358778,-358.84300874044885,-0.030704529383298734
2023-09-13T02:00:00-04:00,1.07443,1.07447,1.07384,1.074,1.0753780800000001,1.0745573333333334,1.0746822222222139,1.0747859999999947,1.0749030000000037,1.0747806000000006,1.0734905000000046,1.0737535000000056,1.0745785967586752,1.0747953685859173,-3862,-497656,-494642.8,-0.025622181792282116,-360.38862827825005,-0.06699419383651853
2023-09-13T02:15:00-04:00,1.074,1.0740399999999999,1.07356,1.07382,1.0752857952000001,1.074384888888889,1.0745877777777695,1.074732444444439,1.0747895000000036,1.0748050000000007,1.0734898000000046,1.0737569000000058,1.07442687740694,1.0746866948687335,-2869,-500525,-496199.6,-0.02376408168013362,-360.86946626707703,-0.07909404747504047
2023-09-13T02:30:00-04:00,1.07382,1.07422,1.07348,1.0742099999999999,1.0751477315840001,1.0743093333333333,1.074522222222214,1.0746706666666612,1.0747175000000038,1.0748356000000008,1.0734925000000046,1.0737620500000056,1.074383501925552,1.0745817558949864,2845,-497680,-497005.6,-0.01971643774899076,-359.8361925340494,-0.05489393375512565
2023-09-13T02:45:00-04:00,1.0742099999999999,1.07472,1.07376,1.07383,1.0749809584256,1.074170888888889,1.074394444444436,1.0745897777777722,1.074621500000004,1.0748458000000005,1.0734946000000045,1.0737635500000058,1.0742728015404417,1.0744770047159888,-2535,-500215,-497974,-0.02067955856407077,-360.73294456577463,-0.10697873448808204
2023-09-13T03:00:00-04:00,1.07383,1.07383,1.0731,1.07357,1.07483086258304,1.074006,1.0742099999999914,1.0744793333333278,1.0745440000000037,1.0748504000000005,1.0734929000000046,1.0737626500000057,1.0741322412323533,1.0743588037727907,-3839,-504054,-500026,-0.02414251528821899,-361.6624585484354,-0.15438557331919636
2023-09-13T03:15:00-04:00,1.07357,1.07444,1.0735,1.07433,1.07472,1.07403,1.074133333333325,1.0743695555555501,1.074509000000004,1.0748724000000005,1.0734982000000046,1.0737651000000057,1.0741717929858827,1.074277443018232,3519,-500535,-500601.8,-0.02901812125807253,-359.1712935568649,-0.06418485237484692
2023-09-13T03:30:00-04:00,1.07433,1.07464,1.07405,1.07432,1.0731,1.0740673333333333,1.0740955555555471,1.0742711111111056,1.0744940000000036,1.0748952000000005,1.0735070000000047,1.0737705500000059,1.074201434388706,1.0742323544145853,-2928,-503463,-501189.4,-0.032387156816856964,-359.19854775250326,-0.03163791338656012
2023-09-13T03:45:00-04:00,1.07432,1.07488,1.07424,1.07436,1.0731308,1.0741202222222224,1.074096666666658,1.0741859999999943,1.0744790000000037,1.0749206000000004,1.0735182000000045,1.0737780000000057,1.0742331475109648,1.0742022835316678,3037,-500426,-501738.6,-0.034027292742570193,-359.08547157408333,0.000930795364645182
2023-09-13T04:00:00-04:00,1.07436,1.07447,1.07384,1.07407,1.073200768,1.074114888888889,1.0740566666666582,1.074118444444439,1.0744385000000036,1.0749468000000006,1.0735352000000047,1.0737827500000057,1.074200518008772,1.074187826825334,-3284,-503710,-502437.6,-0.034019318682668075,-359.97191559657085,-0.03350613813835391
2023-09-13T04:15:00-04:00,1.07407,1.07447,1.07376,1.07427,1.07326793728,1.0741575555555554,1.0740866666666582,1.0740937777777722,1.0744200000000037,1.0749758000000005,1.0735510000000046,1.0737914500000059,1.0742144144070176,1.0742042614602667,2409,-501301,-501887,-0.03280586303945233,-359.5233414812898,0.02513966480446857
2023-09-13T04:30:00-04:00,1.07427,1.07435,1.07375,1.07402,1.0733324197888001,1.0741442222222222,1.0741088888888806,1.0740888888888833,1.0743830000000036,1.0749996000000006,1.0735700000000046,1.0737953000000058,1.074175531525614,1.0742050091682132,-3216,-504517,-502683.4,-0.029872682096759,-360.271756684172,0.01862509545361215
2023-09-13T04:45:00-04:00,1.07402,1.07406,1.07315,1.07351,1.07488,1.0740244444444447,1.0740311111111025,1.0740759999999945,1.0743225000000036,1.0749870000000006,1.0735916000000045,1.0737963500000058,1.0740424252204912,1.07417320733457,-2833,-507350,-503460.8,-0.027219333039635984,-361.61701096249084,-0.06516416715539075
2023-09-13T05:00:00-04:00,1.07351,1.07398,1.07332,1.07358,1.0748454,1.0739342222222221,1.0740033333333248,1.0740573333333276,1.0742680000000036,1.0749594000000005,1.0736084000000046,1.073796300000006,1.073949940176393,1.0741165658676557,2919,-504431,-504261.8,-0.028031877616918235,-361.42667272623777,-0.023281152510181636
2023-09-13T05:15:00-04:00,1.07358,1.07365,1.0731,1.07317,1.074811492,1.0737675555555555,1.0739588888888802,1.074037777777772,1.0741865000000037,1.0749152000000004,1.0736199000000046,1.073796850000006,1.0737939521411144,1.0740352526941241,-2700,-507131,-504946,-0.02752838948255682,-362.4578022182179,-0.03725886528125376
2023-09-13T05:30:00-04:00,1.07317,1.0734299999999999,1.07297,1.0729899999999999,1.07474303232,1.0735737777777778,1.0738099999999913,1.0739824444444388,1.0740870000000036,1.0748692000000006,1.0736306000000047,1.0737971500000059,1.0736331617128916,1.073919002155299,-2260,-509391,-506564,-0.024906103369366703,-362.8368661130344,-0.12472890080330241
2023-09-13T05:45:00-04:00,1.0729899999999999,1.07327,1.07288,1.0729899999999999,1.0746366503808,1.0734097777777776,1.0736622222222134,1.0738931111111054,1.0739750000000037,1.0748222000000005,1.0736461000000046,1.0737991500000057,1.0735045293703132,1.0737848017242386,0,-509391,-507538.8,-0.028561636516789207,-362.8368661130344,-0.12379924044977786
2023-09-13T06:00:00-04:00,1.0729899999999999,1.07324,1.07286,1.07316,1.074496118350336,1.0733093333333332,1.07352888888888,1.073792666666661,1.0738820000000036,1.0747678000000005,1.0736576000000047,1.0738034000000056,1.0734356234962505,1.0736634413793904,2580,-506811,-507431,-0.030187126485043205,-362.42810181886574,-0.11169440411036244
2023-09-13T06:15:00-04:00,1.07316,1.07372,1.07315,1.07369,1.0743325065153024,1.0733415555555554,1.0734866666666578,1.0736893333333275,1.0738335000000034,1.0747244000000005,1.0736721000000045,1.0738061500000058,1.0734864987970005,1.073570753103512,1871,-504940,-507532.8,-0.03053035009439878,-361.5040737149481,-0.03537944454272505
2023-09-13T06:30:00-04:00,1.07369,1.07379,1.07322,1.07329,1.0741852558637721,1.0733022222222222,1.0733777777777689,1.073573111111105,1.0737805000000038,1.0746776000000005,1.0736804000000044,1.0738087500000058,1.0734471990376004,1.0735014024828093,-2043,-506983,-507503.2,-0.031720677109591346,-362.26518725796325,-0.09122473865973925
2023-09-13T06:45:00-04:00,1.07329,1.07381,1.0731,1.07376,1.074052730277395,1.0733786666666667,1.07334888888888,1.073480888888883,1.0737470000000038,1.0746438000000005,1.0736957000000045,1.0738133500000058,1.0735097592300804,1.0734767219862469,1942,-505041,-506633.2,-0.03385460436342695,-361.41477404252294,-0.024208115305108562
2023-09-13T07:00:00-04:00,1.07376,1.0738699999999999,1.07302,1.07315,1.0739334572496555,1.0733388888888888,1.0733088888888802,1.0734102222222162,1.0737045000000036,1.0745958000000007,1.0737045000000045,1.0738170000000058,1.0734378073840642,1.0734633775889972,-2471,-507512,-506257.4,-0.036282452305035476,-362.81854210987507,-0.03353485295897718
2023-09-13T07:15:00-04:00,1.07315,1.07362,1.07302,1.07359,1.0738699999999999,1.073395111111111,1.0733099999999913,1.0733664444444386,1.0736930000000036,1.0745556000000005,1.0737204000000045,1.0738222000000057,1.0734682459072513,1.0734699020711973,1663,-505849,-506065,-0.033719655414426744,-362.1366989379047,0.0009314629557243533
2023-09-13T07:30:00-04:00,1.07359,1.07396,1.07353,1.07367,1.07286,1.0734671111111111,1.0733655555555468,1.0733422222222164,1.0736660000000036,1.0745172000000007,1.0737435000000044,1.0738263500000058,1.0735085967258011,1.0734743216569576,1937,-503912,-505859.4,-0.032216389112017414,-361.99236078274333,0.04659094085745455
2023-09-13T07:45:00-04:00,1.07367,1.07408,1.0735999999999999,1.07365,1.072882,1.073524,1.0734388888888802,1.0733544444444387,1.0736570000000039,1.0744780000000005,1.0737640000000044,1.0738283000000057,1.0735368773806409,1.0734922573255656,-2653,-506565,-505775.8,-0.025262818019202517,-362.0417800642728,0.06151035890363424
2023-09-13T08:00:00-04:00,1.07365,1.07373,1.073,1.07316,1.07292992,1.0734682222222223,1.0734577777777692,1.0733762222222165,1.0736365000000037,1.0744318000000006,1.0737799000000043,1.0738304500000058,1.0734615019045126,1.0734826058604523,-2962,-509527,-506673,-0.020708497624638424,-363.39359862711945,0.01584357729335814
2023-09-13T08:15:00-04:00,1.07316,1.07432,1.07288,1.07379,1.07432,1.0735346666666667,1.0735277777777692,1.0734199999999945,1.0736095000000039,1.0744016000000005,1.0738047000000044,1.0738350500000058,1.0735272015236101,1.0735004846883613,4018,-505509,-506272.4,-0.014232795127332065,-361.0348264030331,0.058705132505882676
2023-09-13T08:30:00-04:00,1.07379,1.07605,1.07107,1.07428,1.07107,1.073685111111111,1.0735933333333247,1.073476666666661,1.0736075000000036,1.0743646000000004,1.0738343000000043,1.0738405500000057,1.0736777612188881,1.0735423877506887,22449,-483060,-501714.6,-0.0035792742719530034,-350.7907283950452,0.05495068408943628
2023-09-13T08:45:00-04:00,1.07428,1.07617,1.0732599999999999,1.07477,1.07107,1.0739204444444446,1.073757777777769,1.0735551111111055,1.0736280000000038,1.0743450000000005,1.0738640000000044,1.0738483500000056,1.0738962089751105,1.0736199102005508,12036,-471024,-495137,0.004483982734895588,-345.3008747256097,0.13789376589737404
2023-09-13T09:00:00-04:00,1.07477,1.07536,1.07292,1.07342,1.07107,1.073852888888889,1.0737199999999913,1.073611333333328,1.0735955000000037,1.0742910000000006,1.0738848000000045,1.0738533000000057,1.0738009671800883,1.0736727281604401,-10324,-481348,-490093.6,0.009864286227749123,-358.2686724869908,-0.031664431530324
2023-09-13T09:15:00-04:00,1.07342,1.07519,1.0729899999999999,1.0744799999999999,1.071274,1.074004888888889,1.0738677777777692,1.073693333333328,1.0736060000000038,1.0742618000000006,1.0739188000000042,1.0738624500000058,1.0739367737440706,1.0737677825283518,6487,-474861,-483160.4,0.014751807274042069,-351.8627735844187,0.12393421236545042
2023-09-13T09:30:00-04:00,1.0744799999999999,1.07558,1.07437,1.07461,1.07146984,1.074153333333333,1.0739811111111024,1.0737839999999945,1.0736355000000037,1.0742314000000006,1.0739488000000044,1.0738750000000057,1.0740714189952565,1.0738766260226809,8223,-466638,-475386.2,0.02684202986444256,-350.8678830327085,0.09500833651580406
2023-09-13T09:45:00-04:00,1.07461,1.07472,1.07348,1.07386,1.0716578464,1.074129111111111,1.0740022222222136,1.0738657777777723,1.0736530000000037,1.0741868000000006,1.0739803000000046,1.0738844500000058,1.0740291351962052,1.0739469008181444,-7322,-473960,-473566.2,0.030066657589423108,-355.97810906820064,0.017696312647287764
2023-09-13T10:00:00-04:00,1.07386,1.07392,1.0727,1.07337,1.071838332544,1.0740026666666667,1.0739711111111023,1.0739084444444391,1.0736425000000036,1.0741412000000006,1.0740052000000044,1.0738886000000059,1.0738973081569643,1.0739471206545153,-6885,-480845,-475530.4,0.027893551218780017,-359.11971970645953,-0.026079262329442368
2023-09-13T10:15:00-04:00,1.07337,1.07366,1.0729899999999999,1.07311,1.0720115992422399,1.0738304444444444,1.073965555555547,1.07395755555555,1.0736395000000036,1.0740884000000006,1.0740235000000045,1.0738935500000057,1.0737398465255714,1.0739348965236117,-5024,-485869,-476434.6,0.024949037433140246,-360.33667192237726,-0.004659137500455056
2023-09-13T10:30:00-04:00,1.07311,1.07429,1.07303,1.07402,1.0721779352725502,1.0738413333333334,1.0739911111111025,1.0739822222222168,1.0736910000000035,1.0740664000000004,1.0740482000000044,1.0739016000000057,1.0737958772204572,1.0739067172188892,5384,-480485,-477559.4,0.02918816453439118,-355.7710262756124,0.021419458180831675
2023-09-13T10:45:00-04:00,1.07402,1.07409,1.07322,1.0738,1.0723376178616482,1.073803111111111,1.0739377777777692,1.07397355555555,1.0737315000000036,1.0740418000000005,1.0740687000000044,1.0739068500000057,1.0737967017763659,1.073851773775111,-5275,-485760,-481383.8,0.025687855303806763,-356.85154619144214,-0.04468108872917805
2023-09-13T11:00:00-04:00,1.0738,1.07427,1.07356,1.07406,1.0724909131471823,1.0738275555555554,1.0738588888888803,1.0739448888888836,1.0737765000000035,1.0740306000000006,1.0740956000000046,1.0739125000000058,1.0738493614210927,1.0738158190200884,3778,-481982,-482988.2,0.018892450071650333,-355.93677621565547,-0.0660606455334619
2023-09-13T11:15:00-04:00,1.07406,1.0744799999999999,1.07405,1.07432,1.072638076621295,1.0739197777777778,1.0739588888888805,1.0739424444444392,1.0738080000000036,1.0740238000000004,1.0741254000000044,1.0739166000000058,1.0739434891368742,1.0738250552160704,3138,-478844,-482588,0.009556604589671665,-355.1771538481902,0.08384416165153442
2023-09-13T11:30:00-04:00,1.07432,1.07437,1.07323,1.07337,1.0727793535564432,1.0738020000000001,1.073835555555547,1.0739164444444391,1.0738120000000035,1.0739936000000005,1.0741427000000043,1.0739169000000057,1.0738287913094993,1.0738428441728562,-2513,-481357,-481685.6,0.0105101968868449,-357.3993502142636,-0.10330578512396178
2023-09-13T11:45:00-04:00,1.07337,1.0737,1.07313,1.07357,1.0729149794141855,1.0737488888888886,1.0737199999999916,1.0738622222222172,1.0738025000000035,1.0739722000000007,1.0741646000000045,1.0739169000000057,1.0737770330475993,1.0738390753382845,2153,-479204,-481429.4,0.0007937982628663349,-356.998183794483,-0.09677929667508695
2023-09-13T12:00:00-04:00,1.07357,1.07393,1.07347,1.07372,1.073045180237618,1.0737488888888889,1.073704444444436,1.0738155555555502,1.0738310000000035,1.0739514000000006,1.0741813000000044,1.0739108000000057,1.0737656264380795,1.073832860270627,2441,-476763,-479630,-0.007317147802141052,-356.65712545641446,-0.01303708118376967
2023-09-13T12:15:00-04:00,1.07372,1.07458,1.07367,1.07443,1.07313,1.0738939999999997,1.0738222222222138,1.073808222222217,1.0738730000000036,1.0739456000000005,1.0741958000000045,1.0739065000000059,1.0738985011504636,1.0738426882165015,2746,-474017,-478037,-0.007684786295720781,-354.8413261791355,0.09875439037797414
2023-09-13T12:30:00-04:00,1.07443,1.07464,1.0739,1.07399,1.0732515999999999,1.0739275555555556,1.0739199999999918,1.0738004444444393,1.0738890000000034,1.0739320000000006,1.0742106000000045,1.0738994500000056,1.0739168009203708,1.0738373505732006,-2287,-476304,-477529,-0.0036849071786527947,-355.7778971981874,0.08200464071716711
2023-09-13T12:45:00-04:00,1.07399,1.07432,1.07389,1.07407,1.073368336,1.0739575555555556,1.0739255555555474,1.0738184444444392,1.0739100000000037,1.0739174000000005,1.0742259000000045,1.0738970500000058,1.0739474407362966,1.0738610804585602,2550,-473754,-476008.4,0.0034808674235289063,-355.5879512955252,0.004655406789455086
2023-09-13T13:00:00-04:00,1.07407,1.07433,1.07372,1.07422,1.07348040256,1.0740164444444444,1.073972222222214,1.0738688888888839,1.0739630000000036,1.0739022000000005,1.0742339000000045,1.0738955500000058,1.0740019525890372,1.0739060643668477,2714,-471040,-474375.6,0.0028156623548934007,-355.2089257199113,0.03911342894392483
2023-09-13T13:15:00-04:00,1.07422,1.07468,1.07416,1.07434,1.0735879864576,1.0740900000000002,1.074003333333325,1.0739286666666614,1.0739905000000036,1.0738844000000005,1.0742447000000046,1.0738959000000057,1.0740695620712297,1.073966851493478,2199,-468841,-472791.2,0.0026115564701379023,-354.9632777148469,0.026069307115064146
2023-09-13T13:30:00-04:00,1.07434,1.07487,1.07433,1.07476,1.073691266999296,1.0742413333333334,1.074052222222214,1.0739746666666616,1.0740145000000036,1.0738792000000006,1.0742673000000047,1.0738980500000057,1.0742076496569837,1.074028681194782,1623,-467218,-471431.4,0.004828289788063488,-354.3287858407663,0.04095613969766885
2023-09-13T13:45:00-04:00,1.07476,1.07492,1.07432,1.07447,1.0737904163193241,1.074324888888889,1.0741744444444363,1.0740255555555502,1.0739995000000035,1.0738754000000008,1.0742888000000046,1.0738991000000058,1.074260119725587,1.074097344955825,-2061,-469279,-470026.4,0.005382455854334595,-354.8849006943148,0.1024809711469578
2023-09-13T14:00:00-04:00,1.07447,1.07462,1.07395,1.0740399999999999,1.0738855996665513,1.074298,1.0742266666666584,1.0740857777777726,1.0740305000000034,1.0738692000000007,1.0743022000000046,1.0738915500000057,1.0742160957804696,1.0741510759646598,-1827,-471106,-469496.8,0.014857655151007267,-355.616061173435,0.043779166705475235
2023-09-13T14:15:00-04:00,1.0740399999999999,1.07429,1.07383,1.07393,1.07617,1.0742386666666668,1.0742499999999917,1.0741413333333283,1.0740030000000036,1.0738592000000007,1.0743091000000045,1.0738823500000056,1.0741588766243757,1.0741824607717274,-1374,-472480,-469784.8,0.015948008693820133,-355.75678218941187,0.019558171590362803
2023-09-13T14:30:00-04:00,1.07393,1.07396,1.07361,1.07361,1.0761232,1.0741106666666664,1.0741588888888804,1.0741724444444394,1.0739530000000035,1.0738514000000006,1.0743160000000045,1.0738760000000056,1.0740491012995006,1.0741783686173816,-1215,-473695,-470755.6,0.018781865656678175,-356.1188169589035,-0.07631953687071684
2023-09-13T14:45:00-04:00,1.07361,1.07368,1.07319,1.07319,1.0760226720000001,1.073916888888889,1.0740699999999916,1.0741759999999947,1.0739195000000037,1.0738388000000005,1.0743219000000044,1.0738664500000055,1.0738772810396005,1.0741122948939048,-1988,-475683,-472448.6,0.013533017770103772,-356.89652953609607,-0.07448858927922158
2023-09-13T15:00:00-04:00,1.07319,1.07322,1.07284,1.0729,1.07585271168,1.073682888888889,1.0739399999999917,1.0741291111111058,1.0738960000000035,1.0738126000000008,1.0743241000000046,1.0738588500000055,1.0736818248316804,1.0739966359151236,-1715,-477398,-474072.4,0.007640361150309593,-357.35996098812245,-0.10893144767101914
2023-09-13T15:15:00-04:00,1.0729,1.07306,1.07278,1.07293,1.0756116947456,1.073480888888889,1.0737966666666583,1.0740431111111057,1.0738870000000036,1.0737946000000007,1.0743202000000045,1.0738499000000055,1.0735314598653443,1.0738597087320985,1405,-475993,-475049.8,-0.0010243516317287053,-357.3206749409606,-0.12008713298951923
2023-09-13T15:30:00-04:00,1.07293,1.07323,1.07288,1.07313,1.07532852527104,1.0733475555555556,1.0736622222222136,1.0739255555555502,1.0738425000000036,1.0737858000000007,1.0743181000000044,1.0738422000000056,1.0734511678922753,1.0737181669856783,1289,-474704,-475494.6,-0.011263423539494036,-357.0803983152721,-0.11262728745091455
2023-09-13T15:45:00-04:00,1.07313,1.07325,1.07298,1.07318,1.075073672743936,1.0732511111111112,1.0734866666666583,1.0737911111111056,1.0738115000000035,1.0737628000000008,1.0743176000000043,1.0738352500000055,1.0733969343138203,1.0735877335885422,1044,-473660,-475487.6,-0.018341439013340392,-357.0317555599674,-0.1470095649261151
2023-09-13T16:00:00-04:00,1.07318,1.07321,1.07312,1.07316,1.0748443054695425,1.0731857777777778,1.0733411111111026,1.073645333333328,1.0737665000000036,1.0737396000000006,1.0743174000000044,1.0738261000000053,1.0733495474510562,1.0734821868708333,-766,-474426,-475236.2,-0.030404370140122608,-357.046030891226,-0.12192057479502864
2023-09-13T16:15:00-04:00,1.07316,1.07319,1.07306,1.07313,1.0746378749225882,1.0731435555555555,1.0732399999999918,1.0735053333333278,1.0737070000000035,1.0737150000000006,1.0743178000000044,1.0738168000000055,1.073305637960845,1.073406949496666,-523,-474949,-474746.4,-0.038760961945679136,-357.06065126470247,-0.08472682581654002
2023-09-13T16:30:00-04:00,1.07313,1.07314,1.0729899999999999,1.07304,1.0744520874303294,1.0731035555555555,1.0731411111111027,1.0733742222222167,1.0736905000000037,1.0736944000000006,1.0743206000000045,1.0738084500000056,1.073252510368676,1.0733511595973326,-332,-475281,-474604,-0.04239998083990425,-357.0884950487733,-0.08287318540315079
2023-09-13T16:45:00-04:00,1.07304,1.07307,1.07287,1.07292,1.0742848786872965,1.0730593333333334,1.0730644444444362,1.0732546666666614,1.0736580000000036,1.0736674000000008,1.0743216000000044,1.0738004500000053,1.073186008294941,1.0732981276778655,-503,-475784,-474820,-0.04981210135543298,-357.14474644667087,-0.06426914801462891
2023-09-13T17:00:00-04:00,1.07292,1.07294,1.07273,1.07293,1.0741343908185668,1.0730324444444443,1.073035555555547,1.0731644444444393,1.0736185000000036,1.0736456000000008,1.0743226000000043,1.0737923000000054,1.0731348066359527,1.073245702142292,101,-475683,-475224.6,-0.053308578116829604,-357.14380509037215,-0.02422683774542709
2023-09-13T17:15:00-04:00,1.07293,1.07296,1.07285,1.07296,1.0739658639203387,1.073017333333333,1.073042222222214,1.0731046666666613,1.0735450000000035,1.0736346000000008,1.0743108000000043,1.0737827500000054,1.0730998453087621,1.0731957617138332,4014,-471669,-474673.2,-0.05208173932221277,-357.031570368629,0.005592319880692421
2023-09-13T17:30:00-04:00,1.07296,1.07312,1.07291,1.0731,1.073817560249898,1.0730288888888888,1.0730611111111028,1.0730688888888835,1.0735005000000037,1.0736250000000007,1.0742922000000044,1.0737743500000052,1.0730998762470096,1.0731546093710662,427,-471242,-473931.8,-0.0443222143361005,-356.97585533731376,0.015844463292106988
2023-09-13T17:45:00-04:00,1.0731,1.07311,1.07294,1.073,1.0736870530199103,1.0730166666666665,1.0730466666666585,1.0730499999999947,1.0734470000000036,1.073621600000001,1.0742684000000042,1.0737649000000054,1.0730799009976077,1.0731200874968525,-1106,-472348,-473345.2,-0.03928046875699726,-357.07892122120154,-0.012114096148645876
2023-09-13T18:00:00-04:00,1.073,1.0734,1.07296,1.07329,1.073572206657521,1.073065333333333,1.0730588888888808,1.0730488888888838,1.0734005000000038,1.073627600000001,1.0742484000000043,1.0737567000000054,1.0731219207980862,1.0731072699974817,515,-471833,-472555,-0.034331119857869664,-356.9397320320123,0.010249911478042313
2023-09-13T18:15:00-04:00,1.07329,1.07338,1.07324,1.07336,1.0734711418586185,1.0731255555555554,1.0730811111111032,1.073057999999995,1.0733515000000038,1.0736350000000008,1.0742286000000043,1.0737485500000055,1.073169536638469,1.0731142159979847,322,-471511,-471720.6,-0.028840305624459092,-356.91873118415197,0.018636550001882295
2023-09-13T18:30:00-04:00,1.07336,1.07342,1.07318,1.07334,1.07273,1.0731773333333334,1.0731044444444364,1.0730704444444394,1.0732805000000039,1.0736386000000009,1.0742032000000041,1.0737412500000054,1.0732036293107752,1.0731349727983877,-349,-471860,-471758.8,-0.022728109609304093,-356.92523412817826,0.01956892454782212
2023-09-13T18:45:00-04:00,1.07334,1.07335,1.07314,1.0733,1.0727438,1.0732164444444443,1.0731333333333253,1.073084888888884,1.0732220000000037,1.0736308000000008,1.074177600000004,1.0737326500000053,1.07322290344862,1.0731595782387096,-403,-472263,-471963,-0.014667967527902571,-356.9402526684358,0.02423022440914849
2023-09-13T19:00:00-04:00,1.0733,1.07332,1.07304,1.07324,1.0727573240000001,1.0732377777777777,1.0731688888888806,1.0731093333333284,1.0731820000000039,1.0736298000000009,1.074153700000004,1.0737254500000053,1.073226322758896,1.0731888625909671,-504,-472767,-472046.8,-0.007347695059717956,-356.9684274564727,0.02982515005777466
2023-09-13T19:15:00-04:00,1.07324,1.07336,1.07324,1.07328,1.07277057752,1.07326,1.0732077777777695,1.073139111111106,1.073149500000004,1.0736202000000008,1.074132000000004,1.0737173000000053,1.073237058207117,1.0732118900727734,250,-472517,-472183.6,-0.0006212028970254094,-356.959109876062,0.03262095383669694
2023-09-13T19:30:00-04:00,1.07328,1.07341,1.07328,1.07333,1.0727835659696001,1.0732844444444445,1.0732488888888807,1.0731726666666614,1.073135500000004,1.0736238000000007,1.074109800000004,1.0737085500000052,1.0732556465656935,1.0732291120582182,324,-472193,-472320,0.005768466191716941,-356.9440159583518,0.034484044139574774
2023-09-13T19:45:00-04:00,1.07333,1.07346,1.07322,1.07329,1.072796294650208,1.0732926666666667,1.073269999999992,1.0732057777777724,1.073140500000004,1.0736178000000007,1.074086700000004,1.0737002000000053,1.0732625172525547,1.0732408896465742,-682,-472875,-472523,0.010263578275027432,-356.96943218635244,0.01770571242196762
2023-09-13T20:00:00-04:00,1.07329,1.07338,1.07301,1.07312,1.0728228428641997,1.0732626666666667,1.0732833333333252,1.0732357777777726,1.073151500000004,1.073606800000001,1.074062000000004,1.0736902500000052,1.0732340138020438,1.0732431117172587,-945,-473820,-472834.4,0.01076059430456985,-357.1191121423755,0.011183597390505126
2023-09-13T20:15:00-04:00,1.07312,1.07348,1.07312,1.07347,1.0728483291496318,1.0733000000000001,1.0733033333333253,1.0732626666666614,1.073178500000004,1.0736032000000009,1.074040600000004,1.0736825500000051,1.073281211041635,1.0732540893738067,1049,-472771,-472835.2,0.01261065382852785,-356.7769789233508,0.016770863419937478
2023-09-13T20:30:00-04:00,1.07347,1.07367,1.07331,1.07367,1.0728862294006538,1.073373333333333,1.0733377777777695,1.0732886666666612,1.0732055000000043,1.0736134000000006,1.074022600000004,1.0736757500000051,1.073358968833308,1.0732784714990449,1385,-471386,-472609,0.012867591595328284,-356.5189372454278,0.028881270030540585
2023-09-13T20:45:00-04:00,1.07367,1.07424,1.07367,1.074,1.0729489310486016,1.073505777777778,1.0734111111111029,1.0733211111111056,1.0732465000000042,1.0736176000000008,1.0740096000000041,1.0736708500000052,1.0734871750666464,1.0733247771992356,1425,-469961,-472162.6,0.014970199364814838,-356.0809535074075,0.061490301302486165
2023-09-13T21:00:00-04:00,1.074,1.07417,1.0738,1.07392,1.0730780379437415,1.0736075555555558,1.073479999999992,1.0733631111111055,1.0732845000000042,1.0736104000000006,1.073987500000004,1.073665500000005,1.0735737400533172,1.073387021759388,-2216,-472177,-472023,0.017090490420147746,-356.2460186843164,0.05776576912327075
2023-09-13T21:15:00-04:00,1.07392,1.07401,1.07353,1.07364,1.0731942341493674,1.0736395555555556,1.0735244444444363,1.0734113333333277,1.0733100000000042,1.0735878000000008,1.073966400000004,1.0736590500000052,1.0735869920426537,1.0734576174075101,-2186,-474363,-472131.6,0.018128311711393105,-356.81596802877425,0.037270321642871675
2023-09-13T21:30:00-04:00,1.07364,1.07408,1.07355,1.07403,1.0732988107344308,1.0737406666666667,1.0736077777777695,1.0734722222222168,1.0733595000000042,1.0736000000000008,1.073945500000004,1.0736549500000052,1.073675593634123,1.0735364939260077,2422,-471941,-471965.6,0.021494900451597198,-355.9361759196872,0.06987924865832107
2023-09-13T21:45:00-04:00,1.07403,1.07432,1.07367,1.07371,1.0733929296609876,1.0737611111111112,1.073649999999992,1.0735346666666612,1.0733990000000042,1.0735846000000007,1.0739232000000039,1.0736497500000053,1.0736824749072984,1.0736011951408058,-2104,-474045,-472497.4,0.022527938103889558,-356.5630485396328,0.0354038366578822
2023-09-13T22:00:00-04:00,1.07371,1.0738,1.07324,1.07327,1.07432,1.073685111111111,1.0736477777777698,1.0735819999999945,1.0734160000000041,1.0735578000000006,1.073894600000004,1.0736432000000051,1.0735999799258387,1.0736237561126443,-1454,-475499,-473605,0.02041590417593695,-357.1588891297363,-0.001863429268895734
2023-09-13T22:15:00-04:00,1.07327,1.07374,1.07315,1.07373,1.07432,1.0737015555555556,1.0737155555555475,1.0736291111111056,1.0734545000000044,1.0735552000000006,1.073871000000004,1.0736398500000053,1.073625983940671,1.073634204890115,1221,-474278,-474025.2,0.020965262698194712,-356.635572536521,0.056843596242731415
2023-09-13T22:30:00-04:00,1.07373,1.0738699999999999,1.07366,1.07379,1.0742732,1.0737164444444445,1.073751111111103,1.073674444444439,1.0734890000000044,1.0735636000000006,1.073852400000004,1.0736368500000053,1.0736587871525367,1.0736485639120914,1275,-473003,-473753.2,0.023524057263590314,-356.5643255749944,0.02980986892974168
2023-09-13T22:45:00-04:00,1.07379,1.07405,1.07359,1.07405,1.074228272,1.0737762222222222,1.0737933333333254,1.07371155555555,1.0735415000000041,1.0735824000000005,1.0738354000000039,1.0736351500000052,1.0737370297220294,1.0736608511296728,941,-472062,-473777.4,0.024711861294470693,-356.33647841679783,0.03539262529455484
2023-09-13T23:00:00-04:00,1.07405,1.0744,1.07405,1.07431,1.07315,1.0738795555555556,1.0738277777777698,1.0737471111111057,1.0735925000000042,1.0735882000000005,1.073827300000004,1.0736298000000053,1.0738516237776237,1.073694680903738,987,-471075,-473183.4,0.024861233951341016,-356.09755099256233,0.028864059590319596
2023-09-13T23:15:00-04:00,1.07431,1.07449,1.07414,1.07437,1.073175,1.073988,1.0738777777777697,1.0737931111111056,1.0736430000000043,1.0735996000000005,1.0738207000000042,1.0736295500000053,1.0739552990220989,1.07376574472299,978,-470097,-472103,0.02351613707334671,-356.0429298869225,0.04190256257449917
2023-09-13T23:30:00-04:00,1.07437,1.07454,1.07435,1.0745,1.0732276,1.0741124444444443,1.0739733333333252,1.0738446666666612,1.0737010000000045,1.0736084000000006,1.073819500000004,1.0736323500000053,1.0740642392176791,1.0738533957783916,962,-469135,-471074.4,0.023860886596319412,-355.9265267855701,0.0801013375060619
2023-09-13T23:45:00-04:00,1.0745,1.0746499999999999,1.07443,1.07446,1.0733063440000001,1.0742097777777777,1.0740211111111033,1.0738986666666615,1.0737590000000043,1.0736112000000004,1.073817500000004,1.0736342000000052,1.0741433913741434,1.0739503166227131,-1063,-470198,-470513.4,0.026529504428077184,-355.96609867947427,0.0400361256203207
2023-09-14T00:00:00-04:00,1.07446,1.0748,1.07441,1.07479,1.07341383648,1.0743635555555557,1.0741411111111032,1.0739682222222169,1.0738365000000043,1.0736396000000004,1.073816600000004,1.0736365500000054,1.0742727130993146,1.07405745329817,791,-469407,-469982.4,0.026997818622680754,-355.72315803952495,0.10058581926218159
2023-09-14T00:15:00-04:00,1.07479,1.07489,1.07466,1.0748199999999999,1.0735524528320002,1.0744993333333333,1.0743133333333255,1.074065333333328,1.0739135000000044,1.0736646000000005,1.0738184000000042,1.0736385500000054,1.0743821704794516,1.0741635626385357,945,-468462,-469459.8,0.030326075148117602,-355.69678079373745,0.14441845947431126
2023-09-14T00:30:00-04:00,1.0748199999999999,1.07485,1.07452,1.07461,1.07371295849216,1.0745586666666667,1.0744111111111032,1.074171999999995,1.0739775000000042,1.0736824000000005,1.073816900000004,1.0736385500000054,1.0744277363835613,1.074258050110828,-652,-469114,-469263.2,0.03690437762300386,-355.8241695658108,0.08195728907639648
2023-09-14T00:45:00-04:00,1.07461,1.07486,1.07461,1.07472,1.073854203473101,1.0746204444444445,1.0745144444444366,1.0742802222222172,1.0740490000000043,1.0736882000000003,1.073816900000004,1.0736367000000053,1.074486189106849,1.074342440088662,827,-468287,-469093.6,0.03995695715298533,-355.73951559832506,0.08660911351380395
2023-09-14T01:00:00-04:00,1.07472,1.07504,1.07472,1.07494,1.0739784990563288,1.0747055555555556,1.0746133333333256,1.0743986666666618,1.0741400000000043,1.0737072000000005,1.073819600000004,1.0736373000000055,1.074576951285479,1.0744291520709293,1135,-467152,-468484.4,0.0433456050565305,-355.5071760122002,0.08286392626042154
2023-09-14T01:15:00-04:00,1.07494,1.0752,1.07492,1.07517,1.0741271091884428,1.074816888888889,1.074708888888881,1.0745122222222174,1.0742250000000042,1.0737292000000003,1.0738233000000041,1.0736405000000055,1.0746955610283833,1.0745137216567429,906,-466246,-467852.2,0.044680438887284145,-355.31332333205063,0.0800513818171534
2023-09-14T01:30:00-04:00,1.07517,1.07521,1.07496,1.07497,1.074298771718292,1.0748691111111108,1.0747755555555478,1.0746046666666618,1.0742900000000044,1.0737442000000004,1.073823200000004,1.0736416500000054,1.0747504488227066,1.0745873773253938,-1873,-468119,-467783.6,0.04417213702303559,-355.66173335093134,0.05584668224167967
2023-09-14T01:45:00-04:00,1.07497,1.07502,1.07462,1.07477,1.0744627928089994,1.074868,1.0748055555555478,1.0746835555555507,1.0743285000000042,1.0737528000000003,1.073818600000004,1.0736423500000054,1.0747543590581654,1.0746527018603147,-1810,-469929,-467946.6,0.04301753014244871,-355.99848693475224,0.02512796649604397
2023-09-14T02:00:00-04:00,1.07477,1.07487,1.07435,1.07443,1.07521,1.074792888888889,1.0748022222222144,1.0747411111111063,1.0743540000000043,1.0737462000000004,1.073812700000004,1.0736433000000054,1.0746894872465322,1.0746933614882512,-1912,-471841,-468657.4,0.040459199503828994,-356.60334192698315,-0.002792100217781443
2023-09-14T02:15:00-04:00,1.07443,1.07467,1.07432,1.0745,1.0751928,1.0747324444444444,1.0747699999999922,1.0747724444444393,1.0743970000000043,1.0737468000000003,1.0738111000000041,1.0736456000000054,1.0746515897972257,1.0747082891906008,1376,-470465,-469320,0.03825973180982363,-356.51369439294183,-0.026982015091311
2023-09-14T02:30:00-04:00,1.0745,1.07461,1.07415,1.07443,1.075157888,1.0746644444444444,1.0747266666666588,1.074775999999995,1.0744170000000044,1.0737546000000002,1.073811900000004,1.0736484000000055,1.0746072718377806,1.0746906313524802,-1432,-471897,-470450.2,0.03140627513889959,-356.606984295222,-0.03628514541968799
2023-09-14T02:45:00-04:00,1.07443,1.07462,1.07405,1.07426,1.0750974147199999,1.0745711111111111,1.07468777777777,1.0747584444444394,1.0744445000000042,1.0737612000000003,1.0738102000000038,1.0736502500000056,1.0745378174702245,1.0746481050819838,-1591,-473488,-471524,0.02517440365943871,-356.85871777250765,-0.03256995561181009
2023-09-14T03:00:00-04:00,1.07426,1.07432,1.07362,1.07367,1.0750136215423998,1.0743675555555554,1.0745711111111034,1.0747115555555504,1.0744645000000044,1.0737624000000003,1.073806900000004,1.0736487000000055,1.0743642539761795,1.0745700840655865,-3391,-476879,-472914,0.016602725932080883,-358.7211067658615,-0.0976998660116119
2023-09-14T03:15:00-04:00,1.07367,1.07394,1.07356,1.07393,1.0748742593881597,1.0742393333333333,1.074458888888881,1.0746428888888837,1.0744745000000042,1.0737772000000003,1.073808000000004,1.0736489000000056,1.0742774031809437,1.074487667252469,2461,-474418,-473429.4,0.006324451918013374,-358.12515083899353,-0.09395873258041894
2023-09-14T03:30:00-04:00,1.07393,1.07405,1.07359,1.07383,1.0747165482615806,1.0741135555555557,1.074309999999992,1.0745508888888837,1.0744765000000043,1.0737958000000003,1.073804200000004,1.0736483500000056,1.074187922544755,1.0743949338019747,-2494,-476912,-474718.8,-0.004449699777948598,-358.3573819899996,-0.12463145363057906
2023-09-14T03:45:00-04:00,1.07383,1.07384,1.07329,1.07336,1.0745777624701909,1.0739235555555555,1.074131111111103,1.0744317777777728,1.0744420000000043,1.0738044000000004,1.073799500000004,1.0736470500000055,1.074022338035804,1.0742779470415793,-2314,-479226,-476184.6,-0.019390246550597297,-359.37018662388016,-0.1497716215336139
2023-09-14T04:00:00-04:00,1.07336,1.0738,1.07323,1.07354,1.0743974757243642,1.0738053333333333,1.0739944444444365,1.0742931111111058,1.0744035000000043,1.0738126000000003,1.073799200000004,1.0736460500000056,1.0739258704286432,1.0741555576332633,2528,-476698,-476826.6,-0.030440051093647044,-358.9462468459868,-0.11444309014952635
2023-09-14T04:15:00-04:00,1.07354,1.07393,1.07338,1.07384,1.0742106796084658,1.0737744444444444,1.073928888888881,1.0741646666666615,1.0743770000000041,1.0738258000000003,1.0737943000000039,1.0736462500000057,1.0739086963429145,1.0740644461066102,2597,-474101,-476271,-0.03701371027517435,-358.2205170175688,-0.05491283750454571
2023-09-14T04:30:00-04:00,1.07384,1.07402,1.07369,1.07381,1.0740537708711113,1.0737506666666667,1.0738522222222142,1.0740433333333281,1.0743425000000042,1.0738388000000005,1.073789200000004,1.0736481000000055,1.0738889570743315,1.0739867568852879,-2441,-476542,-476695.8,-0.04030343928859485,-358.28871153444277,-0.06421591437878822
2023-09-14T04:45:00-04:00,1.07381,1.07396,1.0732,1.0734,1.0732,1.0736602222222222,1.0737377777777697,1.0739288888888836,1.0742895000000043,1.0738442000000004,1.073779600000004,1.0736489000000056,1.0737911656594652,1.0739074055082298,-2527,-479069,-477127.2,-0.04566882015910279,-359.2535656520241,-0.09586478411809857
2023-09-14T05:00:00-04:00,1.0734,1.07374,1.07314,1.07363,1.07402,1.0736386666666666,1.0736677777777697,1.073836222222217,1.0742315000000042,1.0738560000000004,1.073775200000004,1.0736552000000055,1.0737589325275723,1.0738547244065837,1771,-477298,-476741.6,-0.049438327758179176,-358.8740892219884,-0.05864502075846708
2023-09-14T05:15:00-04:00,1.07363,1.07366,1.07302,1.07303,1.0740024,1.0735111111111109,1.0735966666666588,1.0737566666666614,1.0741420000000041,1.0738582000000003,1.073762800000004,1.0736569000000058,1.0736131460220577,1.0737921795252665,-1561,-478859,-477173.8,-0.053090613121860544,-359.74645679741036,-0.05960863207502994
2023-09-14T05:30:00-04:00,1.07303,1.07304,1.07245,1.07264,1.073963104,1.0733197777777777,1.0734533333333252,1.0736615555555502,1.0740435000000041,1.0738524000000005,1.073749000000004,1.0736595000000058,1.0734185168176462,1.073694143620213,-2306,-481165,-478586.6,-0.053020374649283934,-360.58458807053387,-0.12011956086523454
2023-09-14T05:45:00-04:00,1.07264,1.07288,1.07246,1.07285,1.07387231776,1.073199111111111,1.0733444444444364,1.0735599999999947,1.0739500000000042,1.0738502000000003,1.073742400000004,1.0736670000000057,1.073304813454117,1.0735773148961703,1966,-479199,-479118,-0.055276912189841446,-360.19968726504453,-0.09126211783987977
2023-09-14T06:00:00-04:00,1.07285,1.07323,1.07273,1.07312,1.0737869786944,1.0731542222222221,1.0733177777777698,1.0734759999999948,1.0738590000000041,1.0738506000000003,1.0737378000000042,1.0736731000000055,1.0732678507632936,1.0734726519169357,1787,-477412,-478786.6,-0.05479750905876753,-359.7499599033444,-0.02235969292688548
2023-09-14T06:15:00-04:00,1.07312,1.07353,1.07288,1.0732,1.0737067599727361,1.0731306666666665,1.0732799999999922,1.073398444444439,1.0737605000000043,1.0738546000000002,1.0737381000000041,1.0736790000000056,1.0732542806106349,1.0733717215335483,3141,-474271,-478181.2,-0.04857567810361388,-359.5158015613141,-0.03167092050599018
2023-09-14T06:30:00-04:00,1.0732,1.07362,1.07304,1.07361,1.0736313543743718,1.0731966666666666,1.0732544444444363,1.0733299999999946,1.0736925000000042,1.0738610000000002,1.073744300000004,1.0736874500000055,1.073325424488508,1.0733141772268382,1943,-472328,-476875,-0.04100879779937456,-358.7735074875161,-0.02141846085077409
2023-09-14T06:45:00-04:00,1.07361,1.07373,1.07332,1.07351,1.07245,1.0732477777777778,1.0732211111111032,1.0732835555555504,1.0736295000000042,1.0738640000000002,1.0737495000000041,1.0736978000000055,1.0733623395908063,1.0733029417814703,-2315,-474643,-475570.6,-0.03760972459723724,-358.98913513628986,-0.027937903353476592
2023-09-14T07:00:00-04:00,1.07351,1.07375,1.07327,1.07335,1.0724756,1.0732735555555557,1.0732155555555476,1.0732577777777723,1.0735755000000045,1.0738642000000003,1.0737514000000041,1.0737045000000056,1.0733598716726451,1.0733139534251759,-2074,-476717,-475074.2,-0.03559842703364237,-359.29825195867613,-0.004658095770438185
2023-09-14T07:15:00-04:00,1.07335,1.07365,1.07327,1.0733,1.072526576,1.0732904444444444,1.073178888888881,1.0732299999999948,1.0735155000000043,1.0738642000000003,1.073747500000004,1.0737098000000056,1.073347897338116,1.0733299627401405,-1927,-478644,-475320.6,-0.03151944948723644,-359.38801764554455,-0.03073684602704502
2023-09-14T07:30:00-04:00,1.0733,1.0734,1.07314,1.07323,1.07257551296,1.0733006666666667,1.0732011111111033,1.073214222222217,1.0734555000000043,1.0738640000000004,1.0737469000000042,1.0737136500000055,1.0733243178704928,1.0733439701921121,-1859,-480503,-476567,-0.02961380510754424,-359.50926054128666,0.018638807861847104
2023-09-14T07:45:00-04:00,1.07323,1.07337,1.07288,1.07303,1.0726224924416001,1.0732664444444444,1.0732444444444367,1.073212222222217,1.0733940000000044,1.0738590000000003,1.0737396000000041,1.0737176500000056,1.0732654542963942,1.0733319761536895,-2722,-483225,-478746.4,-0.023405053823378943,-360.01651434522427,0.03635889021478692
2023-09-14T08:00:00-04:00,1.07303,1.07329,1.07275,1.07306,1.0726675927439362,1.0732295555555553,1.07326777777777,1.0732215555555504,1.0733635000000046,1.0738536000000003,1.0737387000000043,1.0737216000000056,1.0732243634371152,1.0733043809229512,3348,-479877,-479793.2,-0.014169772866335015,-359.9229102521421,0.019574031784482585
2023-09-14T08:15:00-04:00,1.07306,1.07469,1.06911,1.06995,1.07469,1.072566,1.0729155555555476,1.0731615555555503,1.0731645000000045,1.0737868000000004,1.0737023000000043,1.0737113500000057,1.072569490749692,1.0731463047383607,-16578,-496455,-483740.8,-0.024688049368749652,-407.9701583090999,-0.2954003280155171
2023-09-14T08:30:00-04:00,1.06995,1.07,1.06548,1.06806,1.07469,1.0715948888888887,1.0723444444444368,1.0729946666666614,1.0728760000000044,1.0736856000000004,1.0736462000000042,1.0736948500000056,1.0716675925997536,1.0728102437906881,-19647,-516102,-491232.4,-0.04580284803147482,-442.675359486724,-0.4789414834140815
2023-09-14T08:45:00-04:00,1.06806,1.06885,1.06696,1.06768,1.07469,1.070662,1.0716855555555478,1.0726915555555503,1.0725920000000044,1.0735698000000005,1.0735865000000042,1.0736752500000055,1.070870074079803,1.0723193950325502,-13108,-529210,-500973.8,-0.0699749613763384,-447.3389926159495,-0.5523420981548226
2023-09-14T09:00:00-04:00,1.06768,1.06948,1.06714,1.06933,1.0743216,1.070190888888889,1.0712211111111034,1.0722868888888837,1.0723815000000045,1.0734830000000004,1.0735482000000043,1.0736640500000056,1.0705620592638423,1.07177871602604,15330,-513880,-507104.8,-0.09200232492337007,-423.6479053988068,-0.389376903801555
2023-09-14T09:15:00-04:00,1.06933,1.06973,1.06663,1.06678,1.073967936,1.0693026666666665,1.0704911111111035,1.0717315555555502,1.0720285000000043,1.0733386000000003,1.0734781000000044,1.0736414000000056,1.0698056474110738,1.0710949728208314,-10183,-524063,-515942,-0.12477786448742507,-447.93100790224196,-0.6121022965481869
2023-09-14T09:30:00-04:00,1.06678,1.06842,1.06652,1.0679,1.07362841856,1.0687844444444445,1.0698911111111036,1.0711266666666615,1.0717330000000043,1.0732182000000001,1.0734143000000043,1.0736243000000056,1.069424517928859,1.070465978256665,9110,-514953,-519641.6,-0.14926825323951992,-438.3665241286428,-0.5031212149445495
2023-09-14T09:45:00-04:00,1.0679,1.06796,1.06606,1.06643,1.0733024818176,1.0680922222222222,1.069135555555548,1.0704848888888836,1.0713845000000046,1.073074,1.0733309000000042,1.0735974500000056,1.0688256143430872,1.0698975826053316,-8616,-523569,-521135,-0.18063569364834844,-450.22673575894595,-0.6336013715606085
2023-09-14T10:00:00-04:00,1.06643,1.06666,1.06561,1.06588,1.072989582544896,1.067441111111111,1.0683411111111034,1.0698159999999948,1.0709970000000044,1.0729110000000002,1.0732555000000041,1.0735701500000057,1.0682364914744698,1.0693708660842651,-7916,-531485,-521590,-0.21588391704803517,-454.3093290843404,-0.6663373810611064
2023-09-14T10:15:00-04:00,1.06588,1.0667,1.06538,1.06608,1.0726891992431002,1.0669888888888888,1.0675655555555479,1.0690848888888835,1.0706495000000045,1.0727584000000001,1.0731715000000042,1.0735451500000055,1.0678051931795758,1.0688194928674117,6697,-524788,-523771.6,-0.24728698097724972,-453.05271483132896,-0.6504762082269385
2023-09-14T10:30:00-04:00,1.06608,1.06725,1.06584,1.06694,1.0722506472885143,1.0668637777777776,1.0672311111111035,1.0684328888888834,1.0703645000000044,1.0726318000000001,1.0730948000000042,1.0735218000000057,1.0676321545436607,1.068384794293929,6182,-518606,-522680.2,-0.27743413791741867,-448.0657344921419,-0.28132155708210266
2023-09-14T10:45:00-04:00,1.06694,1.06738,1.06635,1.06639,1.0718384084512034,1.0666955555555555,1.067045555555548,1.0678637777777726,1.0700415000000045,1.0724850000000001,1.0730201000000041,1.0735002000000056,1.0673837236349286,1.067976635435143,-5674,-524280,-524545.6,-0.2829665635531758,-450.9906412347894,-0.15635825702676445
2023-09-14T11:00:00-04:00,1.06639,1.06731,1.06631,1.06723,1.0714509039441311,1.0667324444444444,1.0669955555555481,1.0674357777777728,1.0697470000000044,1.0723538000000001,1.0729587000000043,1.0734819500000057,1.0673529789079428,1.067682108348114,5058,-519222,-523676.2,-0.26578173638460856,-447.0064328307348,-0.04214745991308833
2023-09-14T11:15:00-04:00,1.06723,1.06756,1.06643,1.06654,1.0710866497074834,1.0666413333333333,1.0666855555555483,1.0671046666666617,1.0694140000000045,1.0722036000000001,1.0728930000000043,1.0734582500000056,1.0671903831263543,1.067472886678491,-3353,-522575,-521894.2,-0.2472232461972145,-449.17425982210455,-0.2609110377525973
2023-09-14T11:30:00-04:00,1.06654,1.06678,1.06605,1.06614,1.0707442507250344,1.0665322222222222,1.0666144444444372,1.0669144444444396,1.0690405000000045,1.0720402000000002,1.0728142000000043,1.0734312000000057,1.0669803065010834,1.0673079093427924,-2921,-525496,-522035.8,-0.2456932755329994,-450.26976491333403,-0.05999362567726934
2023-09-14T11:45:00-04:00,1.06614,1.06625,1.06561,1.06587,1.0704223956815324,1.0663833333333332,1.0663888888888815,1.0667459999999953,1.0686585000000046,1.0718702000000002,1.0727349000000042,1.0734018000000056,1.0667582452008668,1.0671331274742335,-2733,-528229,-523960.4,-0.21980978924247235,-450.9618972786894,-0.19009270530948366
2023-09-14T12:00:00-04:00,1.06587,1.06631,1.06531,1.06565,1.0701198519406405,1.0662355555555558,1.066302222222215,1.0665973333333285,1.0682735000000045,1.0716932000000001,1.0726508000000043,1.0733732000000056,1.0665365961606934,1.0669637019793865,-2772,-531001,-525304.6,-0.2059154625774958,-451.53404960495834,-0.07314122821000937
2023-09-14T12:15:00-04:00,1.06565,1.06586,1.0645,1.06498,1.0697350637853893,1.065971111111111,1.0662022222222147,1.0664386666666619,1.0678575000000046,1.0715036000000002,1.0725574000000042,1.0733414000000057,1.0662252769285547,1.066738161583509,-3337,-534338,-528327.8,-0.18225225084620267,-453.6321024365633,-0.08443727248845094
2023-09-14T12:30:00-04:00,1.06498,1.06551,1.06478,1.06541,1.0692115574068504,1.0658126666666667,1.0661277777777702,1.0663271111111061,1.0674665000000045,1.0713160000000002,1.0724778000000041,1.0733102500000056,1.0660622215428437,1.066512529266807,2188,-532150,-530242.8,-0.1515304229308715,-452.7486680058699,-0.0628470658862326
2023-09-14T12:45:00-04:00,1.06541,1.06541,1.0648,1.06485,1.0687404016661652,1.0655571111111113,1.0658955555555483,1.0661833333333284,1.0670575000000044,1.0711166,1.0723906000000043,1.0732776000000055,1.065819777234275,1.066280423413445,-2531,-534681,-532079.8,-0.12572398365648352,-454.0790103154031,-0.19588730387837416
2023-09-14T13:00:00-04:00,1.06485,1.06507,1.06462,1.06475,1.0683163614995488,1.065328,1.065713333333326,1.0660482222222174,1.0666420000000045,1.0709194000000002,1.0723009000000043,1.0732411000000055,1.06560582178742,1.0660499387307556,-2312,-536993,-533832.6,-0.10934173588176567,-454.296130097532,-0.1537898892525121
2023-09-14T13:15:00-04:00,1.06475,1.06486,1.0639,1.06423,1.0679347253495939,1.0650313333333334,1.0653799999999929,1.0658637777777729,1.0663560000000045,1.0707096000000003,1.0721989000000043,1.0731973500000054,1.065330657429936,1.0658087509846044,-1897,-538890,-535410.4,-0.09021269299926815,-455.22258231636283,-0.2811015432474623
2023-09-14T13:30:00-04:00,1.06423,1.06427,1.0634,1.06354,1.0674505583076426,1.0646633333333333,1.0650466666666594,1.0656326666666618,1.0661300000000042,1.0704816000000001,1.0720944000000043,1.0731525000000055,1.0649725259439486,1.0655582007876832,-1932,-540822,-536707.2,-0.09621869118610392,-456.47520627922813,-0.28128340240404615
2023-09-14T13:45:00-04:00,1.06354,1.0637,1.06318,1.06367,1.0668834801445726,1.064388,1.0647722222222147,1.0653615555555507,1.0659295000000044,1.0702516000000002,1.0719904000000042,1.0731081500000057,1.0647120207551588,1.065288160630146,1854,-538968,-538070.8,-0.1035500777929128,-456.24858574779546,-0.23167689046468512
2023-09-14T14:00:00-04:00,1.06367,1.0639,1.0633299999999999,1.0637699999999999,1.066290923321441,1.0641875555555556,1.0645388888888816,1.0650902222222176,1.0656515000000044,1.0700276000000002,1.0718859000000043,1.0730599000000056,1.064523616604127,1.0650289285041166,1512,-537456,-538625.8,-0.10833531405952763,-456.106436396963,-0.19702215091898756
2023-09-14T14:15:00-04:00,1.0637699999999999,1.06404,1.06364,1.06387,1.0657931755900105,1.0640537777777777,1.0643411111111039,1.0648157777777731,1.0655060000000045,1.0698096000000001,1.0717812000000042,1.0730129500000056,1.0643928932833016,1.0647863428032927,1680,-535776,-538382.4,-0.10273094128292937,-455.94850752135983,-0.16703420447613126
2023-09-14T14:30:00-04:00,1.06387,1.06399,1.06373,1.06398,1.0653750674956088,1.0639815555555554,1.0642299999999927,1.0645857777777732,1.0653100000000044,1.0696006000000002,1.0716734000000043,1.0729703500000056,1.0643103146266413,1.0645822742426339,1172,-534604,-537525.2,-0.10590370115419491,-455.82732730197233,-0.0938984769667141
2023-09-14T14:45:00-04:00,1.06398,1.06399,1.0634,1.06348,1.0650238566963115,1.0638315555555555,1.0640155555555484,1.0643795555555509,1.0651625000000045,1.0693802000000003,1.071563500000004,1.0729261500000056,1.064144251701313,1.0644166193941067,-1629,-536233,-536607.4,-0.10024729902232725,-456.5928492102788,-0.18115091842576916
2023-09-14T15:00:00-04:00,1.06348,1.0639399999999999,1.06343,1.06386,1.0647288396249017,1.0638004444444442,1.063905555555548,1.0642062222222175,1.0650615000000045,1.0691688000000001,1.0714617000000042,1.0728819500000055,1.0640874013610504,1.0642916955152848,2056,-534177,-535649.2,-0.10332134996403596,-455.8582044590845,-0.09297084096352035
2023-09-14T15:15:00-04:00,1.06386,1.06402,1.06369,1.06397,1.0644810252849175,1.0638133333333333,1.0638188888888813,1.0640622222222176,1.0649560000000045,1.0689630000000003,1.0713621000000044,1.0728356000000057,1.0640639210888403,1.0641997564122276,1474,-532703,-534698.6,-0.10305295727262094,-455.70579718745097,-0.0732566330124445
2023-09-14T15:30:00-04:00,1.06397,1.06427,1.06382,1.06416,1.0642728612393306,1.0638815555555559,1.0638111111111037,1.0639562222222174,1.0648170000000046,1.0687728,1.0712676000000043,1.0727918000000056,1.0640831368710721,1.0641378051297816,1763,-530940,-533731.4,-0.1000166344111431,-455.39096688208537,-0.006577525534895135
2023-09-14T15:45:00-04:00,1.06416,1.06443,1.06407,1.06426,1.06318,1.0639713333333334,1.0638911111111036,1.0638884444444394,1.0647105000000043,1.0685794000000002,1.0711783000000041,1.0727501000000057,1.0641185094968577,1.0640994441038252,1694,-529246,-532659.8,-0.0877615090826658,-455.23178029360247,0.06769844105534856
2023-09-14T16:00:00-04:00,1.06426,1.06468,1.06422,1.06466,1.063205,1.0641251111111112,1.0640011111111036,1.0638855555555504,1.0645820000000046,1.0683960000000001,1.0710959000000044,1.0727100000000056,1.0642268075974861,1.0641159552830597,1028,-528218,-531056.8,-0.06951156297228887,-454.8454085423387,0.09307397971175707
2023-09-14T16:15:00-04:00,1.06466,1.06468,1.0643,1.06442,1.063264,1.0642088888888888,1.0640733333333259,1.063919111111106,1.0644760000000044,1.0682172,1.0710108000000043,1.0726655000000056,1.0642654460779888,1.0641515642264474,-794,-529012,-530023.8,-0.04990593154581856,-455.0243952611034,0.06110343401299524
2023-09-14T16:30:00-04:00,1.06442,1.06445,1.0643,1.06432,1.06332064,1.064258222222222,1.0641233333333258,1.063979999999995,1.0643850000000044,1.0680328000000001,1.0709227000000043,1.0726204000000055,1.064276356862391,1.0641940513811574,-243,-529255,-529334.2,-0.03481281068461614,-455.04722459538874,0.042298401120422546
2023-09-14T16:45:00-04:00,1.06432,1.06453,1.06415,1.06429,1.0633750144,1.0642915555555554,1.0641577777777702,1.0640493333333283,1.0643060000000042,1.0678418000000003,1.0708338000000044,1.0725757000000053,1.0642790854899127,1.0642332411049256,-1721,-530976,-529341.4,-0.022593066657348265,-455.09573444205137,0.029135886012898033
2023-09-14T17:00:00-04:00,1.06429,1.06429,1.06395,1.06415,1.063427213824,1.06429,1.064232222222215,1.0641175555555507,1.0642310000000044,1.0676486000000003,1.0707437000000044,1.0725305500000055,1.0642532683919301,1.0642601928839401,-39,-531015,-529695.2,-0.013301852729033118,-455.10086462273523,0.06300071463496713
2023-09-14T17:15:00-04:00,1.06415,1.0644,1.06414,1.06425,1.0634773252710399,1.0642935555555553,1.064275555555548,1.0641724444444396,1.0641945000000044,1.0674656000000002,1.0706549000000043,1.0724863500000055,1.064252614713544,1.0642653543071519,202,-530813,-530214.2,0.00019687796322934078,-455.0818823364034,0.03665895888555735
2023-09-14T17:30:00-04:00,1.06425,1.06433,1.06423,1.0643,1.0635254322601984,1.0642984444444443,1.0643122222222148,1.0642202222222172,1.0641390000000044,1.067279,1.0705675000000043,1.0724440500000056,1.0642620917708352,1.0642646834457212,82,-530731,-530558,0.007374198984638808,-455.0780298581323,0.031015912102779347
2023-09-14T17:45:00-04:00,1.0643,1.06432,1.06426,1.0643,1.0635716149697905,1.0642960000000001,1.0643277777777707,1.0642611111111062,1.0641115000000043,1.0671044,1.0704813000000042,1.0724014500000054,1.0642696734166681,1.0642633467565765,0,-530731,-530853.2,0.015442733458053776,-455.0780298581323,0.013155916403551062
2023-09-14T18:00:00-04:00,1.0643,1.06433,1.06391,1.06393,1.0636159503709988,1.0642164444444444,1.064291111111104,1.064287777777773,1.0640705000000044,1.0669302000000003,1.0703913000000043,1.0723569500000054,1.0642017387333345,1.0642478774052608,-390,-531121,-530882.2,0.017398962506562695,-455.21361193085613,-0.031007460582934757
2023-09-14T18:15:00-04:00,1.06393,1.06437,1.06393,1.0642,1.0636585123561588,1.0641982222222222,1.0642399999999927,1.0642893333333288,1.0640690000000044,1.0667572,1.0703037000000044,1.0723072500000057,1.0642013909866677,1.0642375019242085,435,-530686,-530816.4,0.01929685517673116,-455.10321932983913,-0.04320628181766056
2023-09-14T18:30:00-04:00,1.0642,1.06435,1.0642,1.06429,1.0636993718619125,1.0642082222222222,1.0642255555555482,1.0642793333333287,1.0641065000000043,1.0665806,1.0702156000000043,1.0722539000000055,1.0642191127893341,1.0642308015393664,237,-530449,-530743.6,0.01555111124461579,-455.08317610488143,-0.012213224103264076
2023-09-14T18:45:00-04:00,1.06429,1.06437,1.06424,1.06424,1.063738596987436,1.064211111111111,1.0642166666666595,1.0642602222222177,1.0641350000000043,1.0664014,1.0701280000000042,1.0721982000000054,1.0642232902314672,1.0642230412314928,-223,-530672,-530731.8,0.010726574383502097,-455.0936525727614,-0.0075165363800227345
2023-09-14T19:00:00-04:00,1.06424,1.06425,1.06385,1.06401,1.0637762531079387,1.0641697777777777,1.0641855555555484,1.0642317777777732,1.0641470000000044,1.0662094,1.0700352000000044,1.0721418000000056,1.0641806321851737,1.064205232985194,-530,-531202,-530826,0.006291753909444858,-455.20819440543085,-0.026308618891473
2023-09-14T19:15:00-04:00,1.06401,1.06402,1.06391,1.06393,1.0638124029836211,1.0641186666666667,1.0641611111111038,1.0642057777777731,1.0641500000000044,1.0660178,1.0699409000000042,1.0720847500000057,1.064130505748139,1.0641909863881547,-427,-531629,-530927.6,0.002192700812482921,-455.2402993668503,-0.020673777193054264
2023-09-14T19:30:00-04:00,1.06393,1.06398,1.0638,1.06381,1.06468,1.0640484444444445,1.064112222222215,1.0641802222222176,1.0641415000000043,1.065827,1.0698456000000043,1.0720244000000059,1.064066404598511,1.0641639891105235,-310,-531939,-531178.2,-0.0007338855073348508,-455.275264073175,-0.041343669250645615
2023-09-14T19:45:00-04:00,1.06381,1.06382,1.06348,1.06351,1.0646624,1.0639280000000002,1.0640244444444373,1.0641399999999954,1.0641430000000043,1.0656312,1.0697477000000042,1.071962650000006,1.063955123678809,1.0641111912884185,-635,-532574,-531603.2,-0.005584807176208555,-455.4543374039389,-0.07422719158132748
2023-09-14T20:00:00-04:00,1.06351,1.06437,1.0634,1.06415,1.064615104,1.063953111111111,1.0640077777777706,1.0640982222222177,1.0641575000000043,1.0654496,1.0696568000000042,1.0719052500000057,1.0639940989430472,1.0640653530307345,1516,-531058,-531680.4,-0.009992388243186675,-454.5420375666078,-0.01409377055342427
2023-09-14T20:15:00-04:00,1.06415,1.06422,1.06381,1.06388,1.06454219776,1.0639275555555554,1.064002222222215,1.064061555555551,1.0641530000000043,1.0652666000000002,1.0695628000000041,1.0718474000000058,1.0639712791544378,1.0640234824245873,-1048,-532106,-531861.2,-0.014028709855155681,-454.8079399299964,-0.004699557301712097
2023-09-14T20:30:00-04:00,1.06388,1.06419,1.06383,1.06399,1.0644736658944,1.063925111111111,1.0639788888888817,1.0640251111111065,1.0641445000000043,1.0650852,1.0694694000000042,1.0717896000000058,1.0639750233235503,1.0639923859396696,1501,-530605,-531656.4,-0.013554361761168018,-454.65274385525106,-0.01973313286976541
2023-09-14T20:45:00-04:00,1.06399,1.06427,1.06376,1.06423,1.0644092459407362,1.0639753333333333,1.063972222222215,1.0639971111111066,1.0641430000000045,1.0649708000000002,1.0693788000000042,1.0717327500000058,1.0640260186588402,1.0639843087517353,2580,-528025,-530873.6,-0.013585643250429644,-454.07078349848075,-0.005637561191023968
2023-09-14T21:00:00-04:00,1.06423,1.06435,1.06389,1.06389,1.0634,1.063958888888889,1.063933333333326,1.0639788888888844,1.0641045000000044,1.0648874000000002,1.0692865000000042,1.0716742500000058,1.063998814927072,1.0639930470013879,-1679,-529704,-530299.6,-0.01568908230478777,-454.6071901023164,-0.032887318649935396
2023-09-14T21:15:00-04:00,1.06389,1.06412,1.06346,1.06347,1.063419,1.0638662222222224,1.0638733333333261,1.0639519999999956,1.0640570000000045,1.0648032,1.069186500000004,1.071613550000006,1.0638930519416576,1.06397283760111,-1624,-531328,-530353.6,-0.01760081197313573,-455.2483090149861,-0.050751402712379115
2023-09-14T21:30:00-04:00,1.06347,1.06378,1.0633299999999999,1.06376,1.06435,1.0638435555555557,1.063854444444437,1.0639224444444397,1.0640290000000046,1.0646918,1.0690874000000041,1.0715550000000058,1.063866441553326,1.0639518700808874,2020,-529308,-529794,-0.016997167138586455,-454.697470721475,-0.015978494825787736
2023-09-14T21:45:00-04:00,1.06376,1.06397,1.06369,1.06393,1.0643296,1.0638586666666667,1.0638677777777705,1.0639002222222178,1.0640110000000045,1.0646348,1.0689867000000042,1.0714981500000058,1.0638791532426608,1.0639326960647097,1226,-528082,-529289.4,-0.015252068628694257,-454.50154306862095,0.011280209811913784
2023-09-14T22:00:00-04:00,1.06393,1.06484,1.06393,1.06419,1.0633299999999999,1.063923111111111,1.0639433333333261,1.0638944444444398,1.0640130000000045,1.0645606,1.0688894000000042,1.0714384500000058,1.0639413225941285,1.0639157568517672,3165,-524917,-528667.8,-0.01123323462086116,-453.72808992790704,0.06393922012957226
2023-09-14T22:15:00-04:00,1.06419,1.06436,1.06399,1.06433,1.0633602,1.0640004444444444,1.0639633333333263,1.06390044444444,1.0640170000000047,1.0645186000000002,1.068796300000004,1.0713813500000058,1.0640190580753028,1.0639198054814134,1512,-523405,-527408,-0.004332144827662778,-453.52917807945886,0.01691490861251412
2023-09-14T22:30:00-04:00,1.06433,1.06456,1.06423,1.06431,1.063389796,1.0640697777777777,1.0640111111111041,1.0639279999999958,1.0640175000000045,1.0644872,1.0686991000000041,1.0713223000000058,1.0640772464602424,1.0639566443851303,-1242,-524647,-526071.8,-0.0030969381930059992,-453.5525167056367,0.04041809226605938
2023-09-14T22:45:00-04:00,1.06431,1.06459,1.06404,1.0643,1.06341880008,1.0641275555555556,1.0640455555555486,1.0639662222222177,1.0640175000000045,1.0644516000000002,1.0686050000000042,1.0712641000000058,1.064121797168194,1.0640077155081038,-1425,-526072,-525424.6,0.0008503154001034081,-453.56590566186196,0.029135612176809225
2023-09-14T23:00:00-04:00,1.0643,1.06436,1.06415,1.06425,1.0634472240784,1.0641684444444444,1.0640477777777706,1.0640022222222179,1.0640335000000045,1.0643978,1.0685148000000042,1.071204700000006,1.0641474377345552,1.0640613724064827,-1128,-527200,-525248.2,0.0035176284205038987,-453.61889823914294,0.0018792930099610966
2023-09-14T23:15:00-04:00,1.06425,1.06463,1.06425,1.0646,1.0634750795968322,1.064278888888889,1.0641266666666596,1.0640388888888848,1.0640535000000046,1.064362,1.0684235000000042,1.0711472500000059,1.0642379501876442,1.0641206979251858,1178,-526022,-525469.2,0.003996371491828974,-453.23148926568734,0.0667362227297924
2023-09-14T23:30:00-04:00,1.0646,1.06474,1.06445,1.06453,1.0635023780048956,1.0643595555555556,1.0642444444444374,1.0640951111111068,1.0640655000000045,1.064308,1.068330900000004,1.071091650000006,1.0642963601501154,1.0641761583401483,-1038,-527060,-526200.2,0.008534118573923834,-453.2997402519733,0.09967370964860889
2023-09-14T23:45:00-04:00,1.06453,1.06478,1.06443,1.06474,1.0635291304447976,1.0644586666666669,1.0643533333333262,1.064163555555551,1.0640905000000047,1.064272,1.0682378000000041,1.0710366000000058,1.0643850881200922,1.0642377266721184,995,-526065,-526483.8,0.018455163217004907,-453.10345644597436,0.09212604346844973
2023-09-15T00:00:00-04:00,1.06474,1.0649899999999999,1.06464,1.06469,1.0635553478359017,1.064526,1.0644377777777705,1.0642419999999955,1.0641245000000046,1.064243,1.0681416000000041,1.0709844500000059,1.0644460704960739,1.0643025813376943,-667,-526732,-526615.8,0.025180677063768867,-453.1347786466995,0.07143327098586108
2023-09-15T00:15:00-04:00,1.06469,1.06487,1.06443,1.06476,1.0636127339224657,1.0645904444444443,1.0645011111111038,1.0643326666666622,1.0641660000000046,1.0642208000000002,1.0680455000000042,1.070933100000006,1.064508856396859,1.064374865070155,723,-526009,-526377.6,0.02962333173007875,-453.0872436834707,0.05356186395286175
2023-09-15T00:30:00-04:00,1.06476,1.0651599999999999,1.06469,1.06514,1.063667824565567,1.064718222222222,1.0645911111111037,1.064425555555551,1.0642325000000048,1.0642106,1.067951900000004,1.070885700000006,1.0646350851174873,1.0644542920561235,879,-525130,-526199.2,0.03313427412920845,-452.7735391866827,0.07610421579772979
2023-09-15T00:45:00-04:00,1.06514,1.06536,1.06514,1.06534,1.063757355091633,1.0648680000000001,1.0647055555555485,1.0645177777777732,1.0643240000000047,1.0642178000000002,1.067860700000004,1.070839100000006,1.0647760680939897,1.0645502336448984,1193,-523937,-525574.6,0.035776302361020466,-452.549531075073,0.0967763151713189
2023-09-15T01:00:00-04:00,1.06534,1.06537,1.06486,1.06511,1.0638855666843023,1.064948888888889,1.0647955555555484,1.0646062222222177,1.0643720000000045,1.0642118,1.067763900000004,1.070790250000006,1.0648428544751918,1.0646417869159184,-2030,-525967,-525555,0.03613165774807534,-452.9877949157247,0.07610636098844098
2023-09-15T01:15:00-04:00,1.06511,1.06529,1.06492,1.06521,1.064034010015872,1.0650317777777778,1.0649022222222149,1.0646991111111066,1.0644385000000045,1.064219,1.0676678000000042,1.0707431000000058,1.0649162835801533,1.0647358295327343,1384,-524583,-525125.2,0.039937099180870024,-452.85785528507625,0.09020436927414348
2023-09-15T01:30:00-04:00,1.06521,1.06521,1.06493,1.0649899999999999,1.0641676090142849,1.0650493333333333,1.0649455555555483,1.0647879999999954,1.0644885000000044,1.0642238,1.0675716000000042,1.0706942500000058,1.0649310268641226,1.064820263626187,-1710,-526293,-525182,0.04192135909152131,-453.21102508258116,0.03663347736237934
2023-09-15T01:45:00-04:00,1.0649899999999999,1.06563,1.06493,1.06562,1.0642878481128564,1.0651842222222223,1.0650666666666593,1.0648831111111066,1.0645580000000046,1.0642516,1.067480600000004,1.070648750000006,1.065068821491298,1.064907010900949,1766,-524527,-525061.4,0.04420857788682346,-452.166339216986,0.10239260518726907
2023-09-15T02:00:00-04:00,1.06562,1.06585,1.06518,1.0657,1.0644489063393137,1.065310888888889,1.065173333333326,1.0649766666666618,1.0646485000000045,1.0642948,1.0673882000000041,1.070603900000006,1.0651950571930384,1.064990808720759,3552,-520975,-524469,0.048620423440730115,-451.89967755523014,0.09016285665984859
2023-09-15T02:15:00-04:00,1.0657,1.06662,1.06565,1.06641,1.0646450594518098,1.0655582222222222,1.0653644444444368,1.0650904444444396,1.0647955000000044,1.0643496000000001,1.067300600000004,1.0705619500000059,1.0654380457544308,1.0651098469766065,3176,-517799,-522835.4,0.0530291984842571,-449.7837349822734,0.16154937117848067
2023-09-15T02:30:00-04:00,1.06641,1.06675,1.06603,1.06667,1.0649610499395201,1.0658193333333335,1.065576666666659,1.0652253333333284,1.0649410000000046,1.0644076,1.067217600000004,1.070520400000006,1.0656844366035447,1.065263477581285,2530,-515269,-520972.6,0.05730555240067993,-449.16689905612884,0.17938314737594185
2023-09-15T02:45:00-04:00,1.06667,1.06674,1.06604,1.06605,1.0652830609504065,1.0659140000000003,1.0656777777777702,1.0653717777777727,1.0650470000000045,1.0644512000000002,1.0671304000000041,1.0704745000000058,1.0657575492828357,1.0654287820650274,-2600,-517869,-519287.8,0.05917315861906305,-450.6781443334875,0.08543477852676327
2023-09-15T03:00:00-04:00,1.06605,1.06626,1.06567,1.0658,1.0655471099793332,1.0659384444444444,1.0657288888888814,1.065504222222217,1.0651275000000044,1.0644876,1.0670441000000042,1.0704284000000057,1.0657660394262687,1.0655682256520218,-3963,-521832,-518748.8,0.057004284039808846,-451.6075097478672,0.043178703512505585
2023-09-15T03:15:00-04:00,1.0658,1.06585,1.06496,1.06551,1.06675,1.0658946666666667,1.065773333333326,1.0656242222222172,1.0651865000000045,1.0645282000000003,1.066954200000004,1.0703826500000058,1.065714831541015,1.065672180521617,-3101,-524933,-519540.4,0.05269567409978409,-452.45127968594227,0.037554806545798645
2023-09-15T03:30:00-04:00,1.06551,1.0659399999999999,1.06545,1.06575,1.0667142,1.06589,1.0658333333333259,1.0657179999999948,1.0652585000000045,1.0645660000000001,1.066867400000004,1.0703396500000057,1.065721865232812,1.0657289444172933,3092,-521841,-520348.8,0.052352580390971085,-451.7548244673145,0.050694229306895815
2023-09-15T03:45:00-04:00,1.06575,1.0665499999999999,1.0657,1.06636,1.066679116,1.0659953333333334,1.065985555555548,1.0657997777777726,1.0653615000000045,1.0646138000000003,1.066788400000004,1.0702993000000058,1.0658494921862496,1.065761955533834,2809,-519032,-521101.4,0.05397932103902263,-450.14704590761477,0.12863970553714998
2023-09-15T04:00:00-04:00,1.06636,1.06672,1.0662099999999999,1.06667,1.06496,1.0661322222222225,1.0661022222222145,1.0658846666666615,1.0654825000000048,1.0646640000000003,1.066718400000004,1.0702626500000059,1.0660135937489996,1.0658131644270668,3108,-515924,-520712.4,0.05914927661265098,-449.24352364496417,0.09853418667067015
2023-09-15T04:15:00-04:00,1.06667,1.06688,1.06645,1.06667,1.0649951999999998,1.0662457777777778,1.0662099999999923,1.0659808888888835,1.0655860000000046,1.0647122000000002,1.066645800000004,1.0702269000000058,1.0661448749991997,1.0658889315416529,0,-515924,-519530.8,0.0581820424450662,-449.24352364496417,0.09101998686308672
2023-09-15T04:30:00-04:00,1.06667,1.06669,1.06616,1.06643,1.0650705919999999,1.0662897777777778,1.0662122222222148,1.0660686666666614,1.0656810000000045,1.0647476000000002,1.0665718000000042,1.070188000000006,1.0662018999993599,1.0659863452333218,-2801,-518725,-518289.2,0.05685009708146992,-449.8737466755172,0.0018754512804558263
2023-09-15T04:45:00-04:00,1.06643,1.06687,1.0663,1.06654,1.0651429683199998,1.0663553333333333,1.0661977777777703,1.0661415555555502,1.0657710000000047,1.0647900000000003,1.066503600000004,1.0701515500000058,1.0662695199994878,1.0660958761866568,1975,-516750,-517271,0.04908365266395463,-449.67002960079117,-0.012187461914178094
2023-09-15T05:00:00-04:00,1.06654,1.06669,1.06618,1.0663,1.0652124495871997,1.0663757777777776,1.0662255555555482,1.0661895555555503,1.0658515000000046,1.0648296000000002,1.066431200000004,1.0701152000000058,1.0662756159995903,1.0661811009493252,-2099,-518849,-517234.4,0.03863867477584857,-450.14236069010803,0.02345105764270752
2023-09-15T05:15:00-04:00,1.0663,1.06663,1.06606,1.06658,1.0652791516037117,1.0664466666666665,1.0663122222222148,1.0662315555555502,1.0659425000000045,1.0648754000000002,1.066358600000004,1.0700764500000057,1.0663364927996724,1.0662456807594596,1654,-517195,-517488.6,0.03516412232005632,-449.7080363911302,0.0731844623756805
2023-09-15T05:30:00-04:00,1.06658,1.06693,1.06654,1.06662,1.0653431855395632,1.0665082222222222,1.0664355555555483,1.0662766666666612,1.0660165000000046,1.0649248000000002,1.066286700000004,1.070037950000006,1.0663931942397378,1.0662953446075671,1687,-515508,-517405.4,0.034544729237502673,-449.6447687506347,0.10417546527014711
2023-09-15T05:45:00-04:00,1.06662,1.06677,1.06627,1.06627,1.0654383944071895,1.066475111111111,1.066493333333326,1.0663328888888834,1.0660630000000044,1.0649652000000003,1.0662154000000041,1.0699975000000057,1.0663685553917903,1.0663286756860533,-1799,-517307,-517121.8,0.03662458792330939,-450.2350914522526,0.048791930565336705
2023-09-15T06:00:00-04:00,1.06627,1.0668199999999999,1.06627,1.06678,1.065527890742758,1.0665324444444444,1.0665399999999927,1.066401333333328,1.0661465000000043,1.0650148000000002,1.0661469000000041,1.0699610500000059,1.0664508443134322,1.066364940548842,1916,-515391,-516850,0.03985163506962371,-449.3186631554797,0.03938632356803396
2023-09-15T06:15:00-04:00,1.06678,1.06685,1.06604,1.06605,1.0656120172981927,1.0664344444444445,1.0664711111111038,1.0664504444444391,1.0661885000000044,1.0650498000000002,1.066077100000004,1.0699199500000058,1.0663706754507458,1.0663839524390732,-1369,-516760,-516432.2,0.032743787345557905,-450.2554729944345,-0.05812481835994871
2023-09-15T06:30:00-04:00,1.06605,1.06653,1.06605,1.06607,1.065691096260301,1.0663542222222222,1.0664044444444372,1.0664688888888838,1.0662425000000044,1.0650926000000003,1.066011400000004,1.0698802000000058,1.0663105403605966,1.0663787619512584,1427,-515333,-516059.8,0.023273949255737985,-450.2287012670294,-0.05624982421929312
2023-09-15T06:45:00-04:00,1.06607,1.06623,1.0654,1.06561,1.06693,1.0661953333333334,1.066313333333326,1.0664444444444392,1.0662420000000044,1.0651208000000003,1.0659390000000042,1.0698407000000056,1.0661704322884773,1.066334209561006,-2138,-517471,-516452.4,0.010562534222352447,-451.1512298064314,-0.07689206042591103
2023-09-15T07:00:00-04:00,1.06561,1.06576,1.06534,1.06571,1.0668993999999998,1.0660746666666665,1.066221111111104,1.0663899999999948,1.0662425000000044,1.0651492000000002,1.065864900000004,1.0698013500000056,1.0660783458307819,1.0662761676488044,1950,-515521,-516095.2,0.003407687618398693,-450.96823602821985,-0.07782174133179331
2023-09-15T07:15:00-04:00,1.06571,1.06592,1.06543,1.06571,1.0668370239999998,1.0659724444444443,1.0661555555555482,1.0663131111111057,1.0662075000000044,1.0651786000000003,1.0657900000000042,1.0697640500000056,1.0660046766646254,1.066186934119043,0,-515521,-516121.2,-0.0044215062060046235,-450.96823602821985,-0.05533152021008069
2023-09-15T07:30:00-04:00,1.06571,1.06595,1.0654,1.06582,1.0667771430399997,1.0659053333333333,1.0660711111111039,1.0662331111111059,1.0661650000000045,1.0652148000000004,1.065712100000004,1.069728200000006,1.0659677413317004,1.066106347295234,1497,-514024,-515574,-0.006288530087190793,-450.81371932104804,-0.07125578953290836
2023-09-15T07:45:00-04:00,1.06582,1.06591,1.06529,1.06545,1.0667196573183997,1.065781111111111,1.065941111111104,1.0661404444444393,1.0661350000000043,1.0652452000000003,1.0656315000000043,1.0696905000000059,1.0658641930653603,1.0660170778361866,-2094,-516118,-515731,-0.011438780637428548,-451.5406525743178,-0.10969229903807293
2023-09-15T08:00:00-04:00,1.06545,1.06585,1.0653,1.06557,1.0666338778792956,1.065706888888889,1.065863333333326,1.0660504444444392,1.0661235000000044,1.0652804,1.0655537000000042,1.0696525500000056,1.0658053544522883,1.0659440622689487,2317,-513801,-514997,-0.019143953507613262,-451.27969241663817,-0.06564941337561264
2023-09-15T08:15:00-04:00,1.06557,1.0662,1.06544,1.06565,1.0665532452065378,1.0656642222222221,1.0657377777777706,1.0659537777777726,1.0661305000000045,1.0653232000000001,1.0654772000000041,1.0696123500000057,1.0657742835618307,1.0658832498151587,2707,-511094,-514111.6,-0.02428966791301847,-451.07645846673324,-0.10592624533644006
2023-09-15T08:30:00-04:00,1.06565,1.06566,1.06451,1.06488,1.0664774504941457,1.0654926666666666,1.0656077777777706,1.0658442222222169,1.0660870000000044,1.0653378,1.0653937000000042,1.0695703000000056,1.0655954268494645,1.0658013998521265,-5814,-516908,-514389,-0.039298733354932155,-455.27744378086044,-0.10975094976782453
2023-09-15T08:45:00-04:00,1.06488,1.06527,1.06479,1.06503,1.066320054454614,1.0653771111111112,1.065492222222215,1.065728444444439,1.0660205000000043,1.0653607999999999,1.0653137000000041,1.0695266500000056,1.0654823414795715,1.0657043198817007,3698,-513210,-514226.2,-0.04565196319060031,-454.7565400170565,-0.09755456958737717
2023-09-15T09:00:00-04:00,1.06503,1.0666,1.06496,1.06646,1.06451,1.0655706666666667,1.0655866666666594,1.0656575555555503,1.0660100000000043,1.0654102,1.0652477000000042,1.0694932000000057,1.0656778731836571,1.06566705590536,3762,-509448,-512892.2,-0.042440055264360066,-449.7053583602016,0.07976651870759635
2023-09-15T09:15:00-04:00,1.06646,1.06675,1.06601,1.06657,1.0645518,1.0657673333333333,1.0656822222222149,1.065621333333328,1.0660050000000043,1.0654569999999999,1.0652139000000043,1.0694581000000056,1.0658562985469258,1.0656772447242875,4677,-504771,-511086.2,-0.03298823367535574,-449.22294926843983,0.08069737545862223
2023-09-15T09:30:00-04:00,1.06657,1.06677,1.066,1.06616,1.064639728,1.065862888888889,1.065732222222215,1.0656202222222169,1.0659915000000042,1.0655024,1.0651949000000043,1.0694205500000056,1.0659170388375405,1.0657057957794294,-5137,-509908,-510849,-0.0264894627327904,-451.19766260183576,0.04222537087951333
2023-09-15T09:45:00-04:00,1.06616,1.06648,1.06574,1.06619,1.06476754432,1.0659544444444444,1.0657733333333261,1.0656533333333278,1.0659740000000042,1.0655568,1.0651800000000042,1.0693832500000056,1.0659716310700325,1.0657810366235432,3901,-506007,-508668.8,-0.020914838814383527,-451.08789483714764,0.034715055074964016
2023-09-15T10:00:00-04:00,1.06619,1.06878,1.06619,1.0675,1.0648876916607999,1.0662997777777778,1.0660011111111036,1.0657551111111059,1.0660340000000041,1.0656316,1.0651617000000042,1.0693549500000055,1.066277304856026,1.065940029298834,11313,-494694,-504965.6,-0.009442988737044562,-437.18790515425894,0.1924069641935225
2023-09-15T10:15:00-04:00,1.0675,1.06793,1.06688,1.06721,1.065199076327936,1.0665415555555555,1.066183333333326,1.065874444444439,1.0660655000000043,1.0656971999999998,1.0651660000000043,1.0693220500000056,1.0664638438848206,1.0660972234390667,-5788,-500482,-503172.4,0.0030016227524909114,-438.7602892291999,0.15390823690607713
2023-09-15T10:30:00-04:00,1.06721,1.06728,1.0663799999999999,1.06706,1.065485550221701,1.0667168888888887,1.0663399999999925,1.066005999999995,1.0660875000000043,1.0657546,1.0651576000000043,1.0692859500000056,1.0665830751078564,1.0662425787512528,-5278,-505760,-503370.2,0.014833594406550684,-439.5021301040047,0.13231361141086767
2023-09-15T10:45:00-04:00,1.06706,1.06746,1.06615,1.06642,1.065749106203965,1.0667328888888887,1.0665111111111036,1.0661617777777725,1.0660950000000045,1.0657963999999998,1.0651575000000042,1.0692442000000055,1.0665504600862852,1.0663692630010018,-5418,-511178,-503624.2,0.022949620268371117,-442.75173181337425,0.14461723386671502
2023-09-15T11:00:00-04:00,1.06642,1.067,1.06617,1.06691,1.0659915777076479,1.0668126666666666,1.0667199999999928,1.0663511111111057,1.0661015000000043,1.0658484,1.0651678000000042,1.0692116500000055,1.066622368069028,1.066499410400801,4854,-506324,-503687.6,0.039131155251384636,-440.52140980140854,0.17652084917796718
2023-09-15T11:15:00-04:00,1.06691,1.06759,1.0668,1.06752,1.06615,1.0669726666666668,1.0668377777777704,1.066518444444439,1.0661750000000043,1.0659127999999998,1.0651822000000042,1.0691768500000054,1.0668018944552224,1.0666043283206403,3273,-503051,-505359,0.05917939395849471,-438.650089821279,0.09939425763742296
2023-09-15T11:30:00-04:00,1.06752,1.06766,1.06667,1.06731,1.06617,1.0670671111111112,1.066919999999993,1.0666657777777726,1.0662370000000043,1.065974,1.0651859000000041,1.0691403500000056,1.066903515564178,1.0666922626565118,-3786,-506837,-506630,0.061520775711253556,-439.3948627529338,0.06938128767919245
2023-09-15T11:45:00-04:00,1.06731,1.06749,1.06695,1.06722,1.0663788,1.0671271111111111,1.0670377777777706,1.066805333333328,1.0663175000000042,1.0660264,1.0651942000000043,1.0691071500000056,1.0669668124513423,1.066769010125209,-2724,-509561,-507390.2,0.06247778220413192,-439.62456171574667,0.09942222555714535
2023-09-15T12:00:00-04:00,1.06722,1.06798,1.0671,1.06784,1.066570896,1.0672875555555557,1.0672211111111038,1.0669473333333281,1.0664240000000045,1.0660926,1.065200300000004,1.0690795000000055,1.0671414499610739,1.0668872081001666,2573,-506988,-506552.2,0.0682677069366381,-438.12978088330385,0.1547566568810371
2023-09-15T12:15:00-04:00,1.06784,1.06803,1.06723,1.06726,1.06674762432,1.0672953333333333,1.0671944444444372,1.067042222222217,1.0665015000000042,1.0661429999999998,1.065207500000004,1.0690502500000054,1.0671651599688592,1.0669957664801328,-1819,-508807,-507048.8,0.07137518117300617,-439.1177753394018,-0.022482435597170582
2023-09-15T12:30:00-04:00,1.06726,1.06742,1.067,1.06725,1.0669102143744,1.0673064444444444,1.0671988888888817,1.0671144444444394,1.0665730000000044,1.0661942,1.0652186000000043,1.0690164000000055,1.0671821279750873,1.0670718131841057,-1939,-510746,-508587.8,0.06215040397778604,-439.13594335844135,0.003748090816244226
2023-09-15T12:45:00-04:00,1.06725,1.06736,1.06703,1.06723,1.06878,1.0673126666666664,1.0672177777777707,1.067173999999995,1.0666620000000044,1.0662435999999997,1.0652322000000043,1.0689835500000056,1.0671917023800699,1.0671294505472841,-1695,-512441,-509708.6,0.05603899156617276,-439.16770723757014,0.01593162521320296
2023-09-15T13:00:00-04:00,1.06723,1.06727,1.06685,1.06717,1.068745,1.067303111111111,1.067301111111104,1.0672266666666617,1.0667420000000045,1.0662842,1.0652474000000043,1.0689491000000055,1.067187361904056,1.0671735604378267,-1834,-514275,-510651.4,0.049387488889862066,-439.2708152836332,0.0703287635265682
2023-09-15T13:15:00-04:00,1.06717,1.06763,1.06694,1.06694,1.0686692,1.0672308888888888,1.0673044444444375,1.0672433333333282,1.0668065000000044,1.0663162,1.0652670000000042,1.0689122000000055,1.0671378895232448,1.0671728483502612,-2244,-516519,-512557.6,0.048143495740228366,-439.75444956870484,0.0028118585447670834
2023-09-15T13:30:00-04:00,1.06694,1.06718,1.06681,1.06715,1.068596432,1.0672,1.0672633333333263,1.0672571111111062,1.0669200000000045,1.066357,1.0652844000000041,1.0688811000000056,1.0671403116185958,1.0671678786802083,1516,-515003,-513796.8,0.04369449473486621,-439.45606353012715,-0.03465977218225246
2023-09-15T13:45:00-04:00,1.06715,1.06721,1.06685,1.0671599999999999,1.0684892460800002,1.0671793333333333,1.0672466666666596,1.067266666666662,1.0670265000000043,1.0663960000000001,1.0653075000000043,1.0688490500000056,1.0671442492948766,1.0671603029441663,1601,-513402,-514328,0.030139840289802926,-439.44106095317005,-0.01405402366698471
2023-09-15T14:00:00-04:00,1.0671599999999999,1.06717,1.06694,1.06696,1.0683884913152002,1.0671220000000001,1.0672177777777707,1.067266666666662,1.0670515000000045,1.0664354000000003,1.0653296000000043,1.0688152500000057,1.0671073994359013,1.0671434423553325,-1544,-514946,-514829,0.018243899696175268,-439.73042712131723,-0.024362362024713646
2023-09-15T14:15:00-04:00,1.06696,1.06701,1.06624,1.06631,1.068293781836288,1.0669404444444446,1.0670477777777707,1.067215999999995,1.0670385000000044,1.0664492,1.0653504000000042,1.0687746500000057,1.066947919548721,1.0670955538842655,-1125,-516071,-515188.2,0.010384989918613701,-440.41578552275666,-0.1432798921186516
2023-09-15T14:30:00-04:00,1.06631,1.0665,1.0663,1.06645,1.068129479289385,1.0668208888888888,1.0669577777777708,1.0671466666666616,1.0670530000000045,1.0664642000000002,1.0653795000000041,1.0687369500000057,1.0668483356389769,1.0670376431074122,821,-515250,-514934.4,-0.002106463898579922,-440.3079932297088,-0.0758952832487116
2023-09-15T14:45:00-04:00,1.06645,1.06645,1.06605,1.06607,1.0679783209462341,1.0666433333333334,1.0668266666666597,1.0670593333333283,1.0670470000000045,1.0664574000000002,1.0654035000000042,1.0686969500000056,1.0666926685111815,1.0669481144859292,-1305,-516555,-515244.8,-0.012857514549926917,-440.7729939329765,-0.11056453501990712
2023-09-15T15:00:00-04:00,1.06607,1.06632,1.06602,1.06605,1.0677854888516107,1.0664879999999999,1.0666955555555486,1.066949111111106,1.0669745000000044,1.066445,1.0654263000000044,1.0686561000000057,1.0665641348089452,1.0668320915887428,-1871,-518426,-516249.6,-0.023479280349426566,-440.808094817534,-0.11056660701066864
2023-09-15T15:15:00-04:00,1.06605,1.06635,1.06599,1.06631,1.0675736301894174,1.0664108888888888,1.066599999999993,1.0668255555555506,1.0669295000000045,1.0664502,1.0654507000000042,1.0686159500000054,1.0665133078471563,1.0667132732709939,1633,-516793,-516619,-0.026792169884466373,-440.4098208153763,-0.08058697302209217
2023-09-15T15:30:00-04:00,1.06631,1.06636,1.0661,1.06616,1.067351921962899,1.0663228888888887,1.0665133333333265,1.0667186666666617,1.0668845000000045,1.0664574000000002,1.0654725000000043,1.0685729500000054,1.066442646277725,1.0666122186167946,-1427,-518220,-517048.8,-0.03157366183498702,-440.6105598124786,-0.07310626651920472
2023-09-15T15:45:00-04:00,1.06616,1.06619,1.06596,1.06598,1.0671612528880932,1.0662162222222222,1.0663833333333266,1.0666037777777728,1.0668625000000045,1.0664668,1.0654975000000042,1.0685305000000056,1.06635011702218,1.0665125748934352,-941,-519161,-517831,-0.03575307081373656,-440.7694290253548,-0.10963782036265898
2023-09-15T16:00:00-04:00,1.06598,1.06617,1.06569,1.06586,1.0669690524259983,1.0661115555555556,1.066238888888882,1.0664862222222173,1.0668100000000045,1.0664690000000001,1.0655175000000041,1.0684896000000057,1.066252093617744,1.0664244599147477,-1329,-520490,-518618,-0.04534638271192321,-440.9190378360265,-0.1218186588702591
2023-09-15T16:15:00-04:00,1.06586,1.06604,1.06576,1.06603,1.0667388229893187,1.066069777777778,1.0661355555555485,1.0663742222222172,1.0667355000000045,1.0664624,1.0655381000000042,1.0684501000000057,1.066207674894195,1.0663531679317977,761,-519729,-518878.6,-0.052012679094762725,-440.7976616703012,-0.08716353002923029
2023-09-15T16:30:00-04:00,1.06603,1.06623,1.06602,1.0662099999999999,1.0665500348512413,1.0660846666666666,1.0661244444444375,1.0662791111111063,1.0666805000000046,1.0664532,1.0655586000000041,1.0684131000000057,1.066208139915356,1.0662921343454375,652,-519077,-519335.4,-0.053198707910081675,-440.6875709599085,-0.009378135814182651
2023-09-15T16:45:00-04:00,1.0662099999999999,1.06628,1.0657699999999999,1.06596,1.0663952285780178,1.0660517777777778,1.0660699999999932,1.0661904444444397,1.0666175000000044,1.066439,1.0655756000000043,1.0683769500000055,1.0661585119322847,1.0662353074763495,-1516,-520593,-519810,-0.0504563257239895,-441.04303564322583,-0.045946832950431754
2023-09-17T17:00:00-04:00,1.06598,1.06613,1.06581,1.06613,1.06628,1.0660637777777777,1.06607666666666,1.0661291111111062,1.0665320000000045,1.066433,1.0655903000000042,1.0683431000000057,1.0661528095458277,1.066195845981079,65,-520528,-520083.4,-0.048592583067999406,-441.03266940059007,0.005628148245419999
2023-09-17T17:15:00-04:00,1.06613,1.06617,1.06604,1.06613,1.06628,1.0660744444444443,1.0660855555555486,1.0660984444444395,1.0664755000000048,1.0664247999999998,1.0656074000000042,1.0683091000000056,1.0661482476366622,1.0661750767848628,0,-520528,-520091,-0.040398682488458806,-441.03266940059007,0.0075043384456714044
2023-09-17T17:30:00-04:00,1.06613,1.06632,1.06598,1.06601,1.06569,1.0660593333333332,1.0660522222222155,1.066081777777773,1.0664135000000046,1.066419,1.065624300000004,1.0682735000000054,1.0661205981093298,1.0661576614278896,-117,-520645,-520274.2,-0.03519453890766226,-441.04583852630645,-0.028134407442506306
2023-09-17T17:45:00-04:00,1.06601,1.06623,1.06597,1.06618,1.0657026,1.0660848888888887,1.0660544444444375,1.066067777777773,1.0663610000000046,1.066411,1.0656432000000042,1.0682385000000054,1.0661324784874637,1.0661425291423112,200,-520445,-520547.8,-0.03163730299236251,-441.0139438911717,0.0018758910482393806
2023-09-17T18:00:00-04:00,1.06618,1.06653,1.06615,1.06649,1.065714948,1.066172,1.0661111111111041,1.0660759999999954,1.0663270000000047,1.0664084,1.0656666000000041,1.0682051500000056,1.066203982789971,1.0661516233138486,261,-520184,-520466,-0.025239230122997326,-440.9380561423863,0.04784329912381194
2023-09-17T18:15:00-04:00,1.06649,1.0669,1.06649,1.06668,1.06574755008,1.0662857777777779,1.0662022222222152,1.0661011111111063,1.0663140000000049,1.0664166,1.065690900000004,1.0681729000000055,1.0662991862319768,1.0661808986510786,452,-519732,-520306.8,-0.01648713315893451,-440.85753030529446,0.07693318071792195
2023-09-17T18:30:00-04:00,1.06668,1.06669,1.0663799999999999,1.06649,1.0658166970752,1.0663433333333334,1.0662533333333262,1.0661346666666618,1.0662810000000047,1.0664107999999999,1.0657128000000042,1.0681401500000056,1.0663373489855814,1.0662187189208623,-317,-520049,-520211,-0.008569730319109525,-440.913995224483,0.04315075560724416
2023-09-17T18:45:00-04:00,1.06649,1.06654,1.0664,1.0664,1.065881695250688,1.0663726666666666,1.0662744444444374,1.066179111111106,1.0662430000000047,1.0664177999999997,1.0657338000000043,1.0681075500000055,1.0663498791884651,1.0662645751366893,-183,-520232,-520128.4,-0.0017506236595694461,-440.92943840726014,0.017820129242844703
2023-09-17T19:00:00-04:00,1.0664,1.0665,1.06624,1.06645,1.0659427935356467,1.0664077777777776,1.0663288888888818,1.066233999999995,1.0662175000000045,1.0664254,1.0657590000000041,1.0680751500000054,1.066369903350772,1.066312060109351,328,-519904,-520020.2,0.0036710670346172896,-440.91405956254897,0.04596795376936089
2023-09-17T19:15:00-04:00,1.06645,1.06651,1.0663799999999999,1.06645,1.066000225923508,1.066432,1.0663644444444373,1.0662846666666617,1.0662245000000046,1.0664422,1.0657815000000042,1.0680426000000056,1.0663859226806176,1.0663484480874803,0,-519904,-519964.2,0.01054450935221124,-440.91405956254897,0.03001510134785401
2023-09-17T19:30:00-04:00,1.06645,1.06676,1.0663799999999999,1.06671,1.0660542123680974,1.066501111111111,1.0664288888888818,1.066329999999995,1.0662375000000046,1.0664622,1.0658057000000043,1.0680106500000057,1.066450738144494,1.0663787584699838,740,-519164,-519850.6,0.014197541891585447,-440.73364791643326,0.05440237119300882
2023-09-17T19:45:00-04:00,1.06671,1.06685,1.06663,1.0668,1.0661049596260115,1.0665753333333332,1.0665166666666595,1.0663826666666616,1.0662740000000046,1.066484,1.0658313000000041,1.0679796500000058,1.0665205905155952,1.0664154067759868,614,-518550,-519550.8,0.018917850707196284,-440.6818437709767,0.07410812281311324
2023-09-17T20:00:00-04:00,1.0668,1.06718,1.06675,1.06702,1.0661526620484507,1.066676,1.0666099999999927,1.0664497777777728,1.0663225000000045,1.0665079999999998,1.0658614000000042,1.0679483000000056,1.0666204724124762,1.0664695254207888,1066,-517484,-519001.2,0.024146477615390655,-440.46200875035413,0.07878594608791893
2023-09-17T20:15:00-04:00,1.06702,1.0671599999999999,1.0669,1.06711,1.0662348490845746,1.066776,1.0666788888888816,1.0665197777777728,1.0663625000000045,1.0665411999999999,1.065893200000004,1.0679170500000057,1.066718377929981,1.0665392203366306,1125,-516359,-518292.2,0.028133088262997354,-440.3671183078133,0.05813462854785933
2023-09-17T20:30:00-04:00,1.06711,1.06711,1.0669,1.067,1.0663104611578087,1.0668402222222222,1.0667144444444372,1.0665897777777729,1.0664045000000046,1.0665698,1.065925100000004,1.0678853500000056,1.0667747023439846,1.0666169762693039,-902,-517261,-517763.6,0.029833551023263717,-440.46009841295717,0.02999962500467581
2023-09-17T20:45:00-04:00,1.067,1.06719,1.06694,1.06715,1.066380024265184,1.0669273333333333,1.0667877777777706,1.0666615555555505,1.0664630000000046,1.0665998,1.0659615000000042,1.0678546000000058,1.0668497618751878,1.0666967810154429,656,-516605,-517251.8,0.029818836502864675,-440.3678772320761,0.06188524974449878
2023-09-17T21:00:00-04:00,1.06715,1.06738,1.06705,1.0671599999999999,1.0664610218386656,1.0670017777777778,1.066872222222215,1.0667326666666617,1.0665280000000046,1.0666454,1.0659916000000043,1.0678242000000058,1.0669118095001502,1.0667750248123538,1231,-515374,-516616.6,0.030830820283020973,-440.3563418340535,0.07126781695422654
2023-09-17T21:15:00-04:00,1.0671599999999999,1.06723,1.0665,1.06651,1.06738,1.0669293333333334,1.0668788888888816,1.0667864444444395,1.0665520000000046,1.066675,1.0660179000000043,1.0677903500000057,1.0668314476001202,1.0668172198498826,-1681,-517055,-516530.8,0.028959145102563085,-441.3802276618579,0.005626142810274372
2023-09-17T21:30:00-04:00,1.06651,1.0665499999999999,1.06608,1.06642,1.06738,1.0668375555555556,1.0668755555555485,1.0668257777777725,1.0665625000000047,1.0666742,1.0660422000000043,1.0677558000000056,1.066749158080096,1.0668233758799057,-2144,-519199,-517098.8,0.026936090074644998,-441.56115423544867,-0.0028130714051267753
2023-09-17T21:45:00-04:00,1.06642,1.06646,1.06619,1.06623,1.067328,1.0667084444444443,1.066822222222215,1.0668473333333284,1.0665760000000046,1.0666674,1.0660622000000042,1.0677205000000056,1.066645326464077,1.0667975007039243,-1583,-520782,-517803,0.024784038204431147,-441.843191331527,-0.04499817194926793
2023-09-17T22:00:00-04:00,1.06623,1.06647,1.06619,1.06645,1.0672780800000001,1.0666339999999999,1.0667833333333263,1.0668464444444394,1.0665920000000046,1.0666732,1.0660878000000042,1.0676871500000056,1.0666062611712614,1.0667488005631391,1300,-519482,-518378.4,0.020158076825844348,-441.57495652290237,-0.032808398950138026
2023-09-17T22:15:00-04:00,1.06645,1.06681,1.06645,1.06679,1.0672301568000002,1.0666353333333334,1.0667577777777708,1.0668235555555508,1.0666250000000046,1.0666852,1.0661210000000043,1.0676537500000056,1.0666430089370091,1.066695040450511,1190,-518292,-518962,0.017117118323883976,-441.1955669593973,-0.021555359787086885
2023-09-17T22:30:00-04:00,1.06679,1.06684,1.06645,1.06653,1.0671841505280002,1.0665897777777777,1.0666933333333264,1.0667864444444397,1.0666510000000047,1.0666658,1.0661487000000043,1.0676180500000056,1.0666204071496073,1.0666528323604083,-1166,-519458,-519442.6,0.01073707209656135,-441.4797466011261,-0.05435240977968765
2023-09-17T22:45:00-04:00,1.06653,1.06672,1.0664,1.06653,1.06713998450688,1.0665571111111112,1.066641111111104,1.0667395555555508,1.0666685000000047,1.0666521999999998,1.0661747000000044,1.0675807000000055,1.0666023257196857,1.0666234658883262,0,-519458,-519494.4,0.002977738392205558,-441.4797466011261,-0.04404873477038149
2023-09-17T23:00:00-04:00,1.06653,1.0668199999999999,1.06635,1.06681,1.067097585126605,1.0665908888888889,1.0666033333333265,1.0666957777777732,1.0666845000000047,1.0666472,1.0662009000000043,1.0675451500000057,1.0666438605757487,1.0666231727106605,865,-518593,-519056.6,-0.001616058442244653,-441.2526550050153,-0.03186056318230867
2023-09-17T23:15:00-04:00,1.06681,1.06686,1.06657,1.06664,1.0670568817215407,1.0665982222222223,1.0665455555555488,1.0666482222222176,1.0666825000000046,1.0666516,1.0662240000000043,1.0675101500000057,1.0666430884605989,1.066630538168528,-728,-519321,-519024.4,-0.007066860175581344,-441.3686644162507,-0.04872746354809532
2023-09-17T23:30:00-04:00,1.06664,1.06665,1.06645,1.06648,1.067017806452679,1.066585111111111,1.0665422222222154,1.0666051111111066,1.0666820000000046,1.066643,1.066245700000004,1.0674724000000055,1.0666104707684791,1.0666240305348222,-435,-519756,-519317.2,-0.01254903431350881,-441.43391604754146,-0.0028129131466160177
2023-09-17T23:45:00-04:00,1.06648,1.06653,1.06641,1.06641,1.0669802941945719,1.0665586666666667,1.0665411111111043,1.066574666666662,1.0666825000000046,1.0666208,1.0662668000000042,1.0674359000000058,1.0665703766147834,1.0666140244278572,-551,-520307,-519487,-0.013129434978794404,-441.4700817515397,-0.0009377168470061953
2023-09-18T00:00:00-04:00,1.06641,1.06659,1.06631,1.06657,1.066944282426789,1.0665644444444444,1.066578888888882,1.0665622222222175,1.0666885000000046,1.066606,1.0662900000000044,1.0674024000000057,1.0665703012918266,1.0666076195422856,527,-519780,-519551.4,-0.01248202026573467,-441.39101272555536,0.03188805417217739
2023-09-18T00:15:00-04:00,1.06657,1.06683,1.06657,1.06672,1.0669097111297174,1.0665926666666667,1.066608888888882,1.0665633333333286,1.0667020000000045,1.0665959999999999,1.0663112000000041,1.0673673500000056,1.0666002410334612,1.066598895633828,493,-519287,-519690.2,-0.009093551078446527,-441.3216783171247,0.0253176426461618
2023-09-18T00:30:00-04:00,1.06672,1.0668,1.06671,1.06676,1.0668765226845287,1.066622888888889,1.066605555555549,1.0665753333333288,1.0667045000000046,1.0665744,1.0663335000000043,1.0673322000000056,1.066632192826769,1.066596716507062,641,-518646,-519555.2,-0.0075711581727673895,-441.29764201893954,-0.00281217484228147
2023-09-18T00:45:00-04:00,1.06676,1.06694,1.06665,1.06686,1.06608,1.0666737777777777,1.0666422222222154,1.066595333333329,1.0667075000000046,1.0665664,1.0663547000000042,1.0672962500000056,1.0666777542614152,1.0666101732056492,453,-518193,-519242.6,-0.0075844997643776755,-441.25517698463005,0.030941464375117574
2023-09-18T01:00:00-04:00,1.06686,1.06718,1.0668199999999999,1.06691,1.0660972,1.0667273333333334,1.0666844444444377,1.0666239999999956,1.0667020000000047,1.0665596,1.0663769000000043,1.0672592500000055,1.0667242034091322,1.0666409385645192,696,-517497,-518680.6,-0.004513179286903327,-441.22255789683965,0.0356295650380249
2023-09-18T01:15:00-04:00,1.06691,1.06702,1.06683,1.06688,1.066140512,1.0667664444444445,1.0666922222222153,1.066646666666662,1.0666905000000046,1.0665526,1.0663981000000042,1.0672218000000055,1.0667553627273059,1.066677950851615,-760,-518257,-518376,-0.000607117921789457,-441.2439280217799,0.006561618282544642
2023-09-18T01:30:00-04:00,1.06688,1.06731,1.06688,1.06702,1.06618209152,1.066832,1.0667344444444375,1.0666717777777732,1.0666915000000046,1.0665495999999999,1.0664169000000043,1.0671844000000055,1.0668082901818448,1.0667195606812918,668,-517589,-518036.4,0.001763327519714945,-441.15627055327354,0.035625890647270585
2023-09-18T01:45:00-04:00,1.06702,1.0671,1.0668199999999999,1.06687,1.0662497660288,1.066859111111111,1.0667777777777707,1.0667062222222177,1.0666775000000046,1.0665482,1.0664322000000042,1.0671464500000056,1.0668206321454758,1.066757248545033,-1032,-518621,-518031.4,0.004499859379544596,-441.30134749653615,0.03656889955741227
2023-09-18T02:00:00-04:00,1.06687,1.06758,1.06687,1.06757,1.0663133800670719,1.0670175555555554,1.0669066666666596,1.0667591111111066,1.0666980000000046,1.0665566,1.0664568000000043,1.0671103500000056,1.0669705057163807,1.0668157988360263,2682,-515939,-517580.6,0.012843107844737675,-439.54162044450567,0.10877617426691683
2023-09-18T02:15:00-04:00,1.06757,1.06778,1.06693,1.06695,1.066414709661706,1.0670262222222222,1.0669488888888818,1.0668119999999952,1.0667200000000046,1.0665524,1.0664742000000045,1.0670710000000057,1.0669664045731047,1.0668642390688208,-2379,-518318,-517744.8,0.018842984503911243,-440.923244131945,0.035628228808240146
2023-09-18T02:30:00-04:00,1.06695,1.06695,1.0664,1.06666,1.06778,1.0669684444444445,1.0669422222222151,1.0668619999999953,1.0667320000000045,1.0665463999999998,1.0664909000000045,1.0670312500000056,1.0669051236584837,1.0668941912550562,-2175,-520493,-518192,0.019016957233401296,-441.5144152271231,-0.005624718764057015
2023-09-18T02:45:00-04:00,1.06666,1.06669,1.06584,1.06585,1.06778,1.0667499999999999,1.066841111111104,1.0668833333333283,1.0667130000000045,1.0665371999999997,1.0664932000000045,1.0669869000000056,1.066694098926787,1.0668713530040448,-1944,-522437,-519161.6,0.01340595674484229,-442.99064945358697,-0.08530503580936354
2023-09-18T03:00:00-04:00,1.06585,1.06641,1.06579,1.06602,1.0677024,1.0665857777777779,1.0667477777777707,1.0668773333333283,1.0666915000000043,1.0665285999999998,1.0664964000000046,1.0669423000000058,1.0665592791414296,1.0668190824032355,3416,-519021,-519241.6,0.007406157423172308,-442.4458073088199,-0.07873572914908722
2023-09-18T03:15:00-04:00,1.06602,1.06639,1.06578,1.06637,1.067587656,1.0665102222222222,1.0666877777777708,1.0668335555555506,1.0666705000000045,1.0665345999999998,1.0664960000000046,1.0668983000000059,1.0665214233131437,1.066729265922588,2171,-516850,-519423.8,0.0031696145571555668,-441.7330158039699,-0.050613453805849126
2023-09-18T03:30:00-04:00,1.06637,1.06659,1.06601,1.06622,1.06744304352,1.0664166666666666,1.0666144444444374,1.0667666666666615,1.0666550000000043,1.0665379999999998,1.0664915000000044,1.066854550000006,1.066461138650515,1.06662821273807,-2709,-519559,-519672,-0.0007544767479061073,-442.1140749110343,-0.06186262747451493
2023-09-18T03:45:00-04:00,1.06622,1.0663,1.06592,1.06622,1.0673100000384,1.0663377777777776,1.0665255555555486,1.0666833333333283,1.0666395000000044,1.0665361999999998,1.0664932000000045,1.0668118000000057,1.066412910920412,1.0665297701904557,0,-519559,-519485.2,-0.0055582044453560105,-442.1140749110343,-0.07497516447677961
2023-09-18T04:00:00-04:00,1.06622,1.0664,1.06597,1.06623,1.067187600035328,1.0662786666666666,1.0664544444444375,1.066605999999995,1.0666105000000043,1.0665375999999998,1.0664975000000045,1.0667708000000058,1.0663763287363295,1.0664662161523641,2243,-517316,-518461,-0.011625508615857422,-442.093037976818,-0.05998856467985546
2023-09-18T04:15:00-04:00,1.06623,1.06645,1.06589,1.06592,1.0670749920325018,1.0661717777777777,1.066271111111104,1.0665106666666617,1.0665745000000044,1.0665363999999997,1.0665016000000045,1.0667279000000058,1.0662850629890637,1.066411372921891,-2108,-519424,-518541.6,-0.01655941812985668,-442.7059263780073,-0.1545566098710089
2023-09-18T04:30:00-04:00,1.06592,1.06652,1.06562,1.0664,1.0669713926699016,1.0661975555555556,1.0662099999999932,1.0664151111111062,1.0665705000000045,1.0665471999999998,1.0665081000000045,1.066687750000006,1.066308050391251,1.0663686983375125,2079,-517345,-518640.6,-0.02645784937765267,-441.7697210342666,-0.0515488073480529
2023-09-18T04:45:00-04:00,1.0664,1.06656,1.06615,1.06639,1.0668362534029114,1.0662335555555555,1.066179999999993,1.0663282222222175,1.0665695000000046,1.0665543999999998,1.0665084000000045,1.0666484000000058,1.0663244403130008,1.0663413586700097,-1795,-519140,-518556.8,-0.03130664618830832,-441.78655336734994,-0.025312658204113072
2023-09-18T05:00:00-04:00,1.06639,1.0666,1.0662,1.06659,1.0667146280626203,1.0663155555555557,1.0662622222222151,1.0662755555555505,1.0665705000000045,1.0665619999999998,1.0665076000000044,1.0666130000000058,1.0663775522504007,1.0663342869360075,1522,-517618,-518168.6,-0.03276634767941275,-441.50110432900567,0.06942815593188187
2023-09-18T05:15:00-04:00,1.06659,1.06707,1.06652,1.0669899999999999,1.06562,1.0664611111111113,1.066369999999993,1.0662586666666616,1.0665840000000046,1.0665825999999998,1.0665108000000043,1.066578300000006,1.0665000418003205,1.0663590295488057,2059,-515559,-517817.2,-0.02395260375725287,-440.7289238285323,0.0909926643027256
2023-09-18T05:30:00-04:00,1.0669899999999999,1.06728,1.06693,1.06725,1.065649,1.066637111111111,1.0664677777777707,1.0662979999999949,1.0666085000000045,1.0666049999999998,1.0665190000000044,1.0665454000000059,1.0666500334402564,1.0664320236390443,1530,-514029,-516738.2,-0.014786420601177547,-440.35609934095487,0.08252295169593966
2023-09-18T05:45:00-04:00,1.06725,1.06741,1.06714,1.06728,1.0657142400000001,1.0667995555555554,1.0665855555555483,1.066373111111106,1.0666295000000046,1.0666279999999997,1.0665264000000043,1.0665150000000059,1.066776026752205,1.066525618911235,2005,-512024,-515674,-0.008576103430968544,-440.2997395377223,0.09941663071411726
2023-09-18T06:00:00-04:00,1.06728,1.06733,1.06686,1.06688,1.0658159856000002,1.0668584444444444,1.066658888888882,1.0664688888888838,1.0666280000000046,1.0666453999999996,1.0665322000000044,1.066481700000006,1.066796821401764,1.0666200951289877,-1779,-513803,-514606.6,-0.0024777371963012208,-440.9664811612887,0.06190092101068306
2023-09-18T06:15:00-04:00,1.06688,1.06748,1.06668,1.06731,1.0659116264640003,1.0669886666666668,1.0667788888888818,1.0665722222222171,1.0666495000000047,1.0666679999999997,1.0665395000000042,1.0664490500000061,1.0668994571214112,1.0667244761031898,1739,-512064,-513495.8,0.005955391705552678,-440.265586965128,0.10129146619397034
2023-09-18T06:30:00-04:00,1.06731,1.06737,1.06702,1.06706,1.0660370963468802,1.067044888888889,1.0669055555555484,1.0666793333333282,1.0666515000000047,1.0666793999999995,1.066543900000004,1.066415300000006,1.066931565697129,1.0668107808825513,-1712,-513776,-513139.2,0.012933006846133044,-440.6665951070925,0.1069498649054262
2023-09-18T06:45:00-04:00,1.06706,1.06728,1.06677,1.06678,1.0661525286391298,1.0670197777777777,1.066947777777771,1.0667753333333283,1.0666470000000046,1.0666813999999996,1.0665490000000042,1.066382200000006,1.0669012525577033,1.0668610247060406,-1445,-515221,-513377.6,0.022067151462633387,-441.04576778716654,0.03563390847712369
2023-09-18T07:00:00-04:00,1.06678,1.06704,1.06661,1.06689,1.0662587263479995,1.0670082222222221,1.0670033333333264,1.066858888888884,1.0666130000000047,1.0666893999999996,1.0665501000000044,1.0663485000000061,1.0668990020461626,1.0668856197648322,1419,-513802,-513733.2,0.026571630231291558,-440.8994489585423,0.04688716135747193
2023-09-18T07:15:00-04:00,1.06689,1.06698,1.06649,1.06657,1.0663564282401594,1.0669215555555556,1.0670011111111044,1.0669273333333285,1.0665940000000045,1.0666927999999996,1.0665553000000043,1.0663162000000062,1.0668332016369302,1.0668928958118653,-1434,-515236,-514019.8,0.032724923578776266,-441.32955890427223,-0.001875134775303442
2023-09-18T07:30:00-04:00,1.06657,1.06668,1.06637,1.06654,1.06748,1.0668293333333334,1.0669511111111045,1.0669617777777731,1.0665880000000045,1.0666945999999995,1.0665600000000044,1.066285700000006,1.066774561309544,1.066867916649492,-1432,-516668,-514940.6,0.03408722579558146,-441.36983755452485,-0.04217471578926133
2023-09-18T07:45:00-04:00,1.06654,1.06669,1.06622,1.06632,1.0674578,1.066703111111111,1.0668477777777712,1.0669502222222176,1.0666115000000045,1.0666919999999995,1.0665671000000045,1.066253050000006,1.0666836490476352,1.0668183333195933,-1833,-518501,-515885.6,0.029323942052313225,-441.7479387040365,-0.08713984539705762
2023-09-18T08:00:00-04:00,1.06632,1.06671,1.06611,1.0663799999999999,1.067408288,1.0666095555555555,1.0667477777777712,1.0669102222222178,1.0666295000000046,1.0666853999999995,1.0665738000000045,1.0662193500000061,1.0666229192381083,1.0667626666556742,2183,-516318,-516105,0.018800273767147633,-441.6251050330936,-0.08432651225546463
2023-09-18T08:15:00-04:00,1.0663799999999999,1.0669,1.06618,1.06678,1.06733039072,1.066616,1.06673666666666,1.0668568888888843,1.0666500000000048,1.0666849999999994,1.0665845000000045,1.066187250000006,1.0666543353904867,1.0667137333245391,2931,-513387,-516022,0.01071905147348865,-440.525684563842,-0.009373125374923982
2023-09-18T08:30:00-04:00,1.06678,1.06688,1.06584,1.06586,1.0672571672768,1.0664406666666666,1.0665755555555492,1.0667717777777734,1.0666320000000047,1.0666617999999994,1.0665849000000045,1.066148500000006,1.0664954683123893,1.0666461866596308,-2908,-516295,-516233.8,0.003433210440344776,-443.03356810121625,-0.13585556211409539
2023-09-18T08:45:00-04:00,1.06586,1.06607,1.0655999999999999,1.06568,1.067143793894656,1.0662615555555555,1.066422222222216,1.0666659999999957,1.066605000000005,1.0666331999999994,1.0665872000000045,1.0661093500000058,1.0663323746499114,1.0665577493277043,-3023,-519318,-516763.8,-0.009438207865410242,-443.5440854299463,-0.12932731055422722
2023-09-18T09:00:00-04:00,1.06568,1.06641,1.06545,1.06641,1.0669894145051904,1.0662591111111113,1.0663811111111046,1.0665726666666626,1.0666140000000048,1.0666213999999994,1.0665956000000045,1.066074650000006,1.0663478997199292,1.066490599462163,3920,-515398,-516143.2,-0.01638055388486682,-440.8588515886426,-0.034683814844671014
2023-09-18T09:15:00-04:00,1.06641,1.06712,1.06632,1.06692,1.06545,1.0663668888888889,1.066384444444438,1.0664999999999958,1.0666640000000047,1.0666167999999994,1.0666083000000046,1.066042750000006,1.0664623197759433,1.06645847956973,3414,-511984,-515276.4,-0.018147969570157317,-439.2261399674087,0.00281191125609918
2023-09-18T09:30:00-04:00,1.06692,1.06703,1.06652,1.0668199999999999,1.06545,1.066454,1.0664122222222157,1.066435111111107,1.0666850000000048,1.0666099999999994,1.0666277000000044,1.0660107000000059,1.0665338558207547,1.0664343836557835,-4163,-516147,-515828.4,-0.022821326690317494,-439.6163285476217,0.023439624215931577
2023-09-18T09:45:00-04:00,1.0668199999999999,1.06715,1.06593,1.06622,1.0654834,1.0664155555555554,1.06637666666666,1.0663953333333291,1.0666765000000047,1.0666041999999996,1.0666396000000047,1.0659766500000059,1.0664710846566037,1.0664295069246263,-3939,-520086,-516586.6,-0.02529919749695287,-441.8316975883219,-0.030003562923106304
2023-09-18T10:00:00-04:00,1.06622,1.06665,1.0659399999999999,1.06652,1.065550064,1.0664442222222223,1.0663988888888822,1.0663906666666623,1.0666730000000046,1.0666061999999996,1.0666402000000046,1.0659439500000059,1.0664808677252828,1.0664592055397006,4325,-515761,-515875.2,-0.026066906100507957,-440.61478175481676,0.018756095731110548
2023-09-18T10:15:00-04:00,1.06652,1.06712,1.0665,1.0669,1.06561406144,1.0665444444444445,1.0664566666666597,1.0664057777777736,1.0666685000000047,1.0666195999999994,1.0666435000000047,1.065928700000006,1.0665646941802263,1.0665025644317603,3371,-512390,-515273.6,-0.02201303907599915,-439.41369785578047,0.04876310508449858
2023-09-18T10:30:00-04:00,1.0669,1.0675,1.0668,1.06734,1.0656754989824,1.066721111111111,1.066518888888882,1.0664326666666624,1.0666730000000046,1.0666373999999994,1.0666553000000045,1.0659251000000058,1.066719755344181,1.066554051545408,3261,-509129,-514702.6,-0.014575430867861332,-438.0688295457233,0.05249442246760287
2023-09-18T10:45:00-04:00,1.06734,1.06756,1.0668199999999999,1.0675,1.065784969043456,1.0669173333333333,1.066701111111104,1.0664904444444399,1.0666840000000046,1.0666515999999995,1.0666684000000046,1.0659242000000058,1.0668758042753448,1.0666224412363259,3697,-505432,-512559.6,-0.008941581074907341,-437.51462938457524,0.15386636143582308
2023-09-18T11:00:00-04:00,1.0675,1.06788,1.0674,1.06762,1.0659269715199795,1.067101111111111,1.0669166666666596,1.0665984444444399,1.0667210000000047,1.0666733999999995,1.0666696000000047,1.065915650000006,1.067024643420276,1.0667331529890602,2760,-502672,-509076.8,0.006039828045886776,-437.2043717733337,0.18204339013588064
2023-09-18T11:15:00-04:00,1.06762,1.06859,1.06749,1.06849,1.0661222743679815,1.0674157777777777,1.067147777777771,1.0667482222222175,1.0667800000000047,1.0667125999999996,1.0666824000000046,1.065924200000006,1.0673177147362207,1.0669005223912478,2802,-499870,-505898.6,0.025193155710760327,-434.9210312589187,0.19504693316828045
2023-09-18T11:30:00-04:00,1.06849,1.06952,1.0683799999999999,1.06952,1.0664184014438236,1.0678902222222222,1.0674366666666597,1.0669442222222174,1.0669030000000048,1.0667667999999995,1.0667070000000047,1.065932300000006,1.0677581717889766,1.0671392179129977,2408,-497462,-502913,0.04447644109936755,-432.59977415777576,0.24369212312075278
2023-09-18T11:45:00-04:00,1.06952,1.06986,1.06938,1.06939,1.0668526252416883,1.0682808888888888,1.0677222222222151,1.0671848888888842,1.0670335000000049,1.0668217999999994,1.0667367000000048,1.065947100000006,1.0680845374311814,1.067412174330398,-2397,-499859,-501059,0.05722203999134341,-432.8911291581497,0.24090287021242418
2023-09-18T12:00:00-04:00,1.06939,1.06951,1.06842,1.06848,1.0673338052030181,1.0684324444444446,1.0679733333333263,1.0674393333333287,1.0671130000000049,1.0668617999999994,1.0667524000000048,1.065960100000006,1.068163629944945,1.0676697394643182,-2516,-502375,-500447.6,0.0651876577203603,-435.0321254270506,0.21196375982444063
2023-09-18T12:15:00-04:00,1.06848,1.06891,1.06846,1.06873,1.0677379963705351,1.0685837777777778,1.068218888888882,1.0676997777777733,1.0672210000000049,1.0669081999999994,1.0667645000000048,1.065973350000006,1.068276903955956,1.0679201915714542,1639,-500736,-500060.4,0.08049175873105445,-434.64863673283094,0.2072159921989316
2023-09-18T12:30:00-04:00,1.06873,1.06898,1.06861,1.06898,1.0680775169512495,1.0687360000000001,1.068449999999993,1.0679602222222175,1.0673430000000046,1.0669563999999996,1.0667812000000048,1.065983550000006,1.0684175231647648,1.068140153257163,1195,-499541,-499994.6,0.09277931951439886,-434.36909933797904,0.19495735307902165
2023-09-18T12:45:00-04:00,1.06898,1.06925,1.06887,1.06922,1.0683627142390497,1.06889,1.068658888888882,1.0682046666666623,1.0674880000000047,1.0670063999999997,1.0668012000000047,1.065997700000006,1.068578018531812,1.06830412260573,1470,-498071,-500116.4,0.10254692167423377,-434.0390650997332,0.17613881237469822
2023-09-18T13:00:00-04:00,1.06922,1.06968,1.06921,1.06957,1.0686022799608017,1.0690722222222222,1.068888888888882,1.0684379999999956,1.0676475000000045,1.0670625999999996,1.0668185000000048,1.066009400000006,1.0687764148254495,1.0684424980845837,1316,-496755,-499495.6,0.1089238616856051,-433.6082837825115,0.19391100702576267
2023-09-18T13:15:00-04:00,1.06957,1.06981,1.06938,1.06941,1.0688035151670734,1.0691764444444445,1.0690877777777708,1.0686608888888842,1.0677790000000047,1.0671135999999997,1.066840000000005,1.066023750000006,1.0689031318603597,1.0685903984676666,-1329,-498084,-498637.4,0.1132842394825549,-433.8070926496262,0.1676626515052133
2023-09-18T13:30:00-04:00,1.06941,1.06967,1.06914,1.0693,1.0689725527403418,1.069218888888889,1.0691777777777707,1.068852666666662,1.0679510000000048,1.0671613999999996,1.0668605000000049,1.0660395500000062,1.0689825054882878,1.068731518774133,-1334,-499418,-498373.8,0.11776651647650707,-433.9443084976172,0.0758079158438523
2023-09-18T13:45:00-04:00,1.0693,1.06932,1.06869,1.0687,1.06986,1.0691233333333332,1.0690866666666596,1.0689799999999954,1.0681020000000045,1.0671977999999995,1.0668752000000048,1.066053700000006,1.0689260043906301,1.068833215019306,-1254,-500672,-498600,0.10705501941363643,-434.64794639156645,-0.07666990799611441
2023-09-18T14:00:00-04:00,1.0687,1.06875,1.06827,1.06844,1.0698366000000001,1.068994,1.0689811111111043,1.0690444444444398,1.0682035000000047,1.0672261999999997,1.0668879000000049,1.0660676500000061,1.0688288035125042,1.0688833720154445,-1450,-502122,-499410.2,0.08462591973080377,-435.0007114332057,-0.08883569137545763
2023-09-18T14:15:00-04:00,1.06844,1.06844,1.0681,1.06815,1.069773936,1.0688277777777777,1.0689444444444376,1.069055555555551,1.0682650000000047,1.0672517999999998,1.0669000000000048,1.0660835000000062,1.0686930428100034,1.068866697612355,-1256,-503378,-500734.8,0.06525435289079866,-435.3416196732568,-0.030884995507652314
2023-09-18T14:30:00-04:00,1.06815,1.06823,1.06803,1.0680399999999999,1.06967349984,1.0686468888888887,1.068867777777771,1.069011555555551,1.0683260000000048,1.0672611999999997,1.0669089000000047,1.0660966500000062,1.0685624342480027,1.0687985580898838,-916,-504294,-501976.8,0.05613965642226727,-435.43595099376427,-0.06456261169800412
2023-09-18T14:45:00-04:00,1.0680399999999999,1.06822,1.06779,1.06782,1.0695420198527998,1.0684373333333332,1.068738888888882,1.0689237777777731,1.0684060000000046,1.0672785999999994,1.0669155000000048,1.066111500000006,1.0684139473984022,1.0686848464719068,-1623,-505917,-503276.6,0.04316151043461573,-435.7702643153625,-0.10851465883365917
2023-09-18T15:00:00-04:00,1.06782,1.0684,1.06781,1.0682099999999999,1.06936681786752,1.0683315555555555,1.0686266666666597,1.0688317777777734,1.0684905000000047,1.0673095999999995,1.0669280000000048,1.0661288000000062,1.0683731579187217,1.068574277177525,1530,-504387,-504019.6,0.027081077876987592,-435.21146227007415,-0.09446138306430645
2023-09-18T15:15:00-04:00,1.0682099999999999,1.06858,1.0682099999999999,1.06854,1.069209136080768,1.0683142222222222,1.0685122222222152,1.0687379999999955,1.0685725000000048,1.0673633999999996,1.0669503000000047,1.0661503500000062,1.0684065263349773,1.0684898217420198,1312,-503075,-504210.2,0.011712091129868854,-434.8061487081339,-0.09630038239665141
2023-09-18T15:30:00-04:00,1.06854,1.06854,1.06826,1.0684,1.0690672224726914,1.0682917777777778,1.0683999999999931,1.0686291111111066,1.0686255000000047,1.0674109999999997,1.0669698000000047,1.0661746500000062,1.068405221067982,1.0684322573936154,-927,-504002,-504335,-0.005922499481781775,-434.9276041520106,-0.09444460029361568
2023-09-18T15:45:00-04:00,1.0684,1.06868,1.06834,1.06866,1.0689395002254223,1.0683437777777778,1.0683288888888818,1.0685213333333288,1.0686835000000048,1.0674567999999995,1.0669957000000048,1.0661996000000062,1.0684561768543857,1.0684110059148921,1701,-502301,-503936.4,-0.01882254802206651,-434.51365806440305,-0.059852239783033195
2023-09-18T16:00:00-04:00,1.06866,1.06904,1.06862,1.06897,1.06779,1.068472,1.0683588888888818,1.0684453333333288,1.0687510000000047,1.0675117999999995,1.0670249000000047,1.066225600000006,1.0685589414835086,1.0684400047319134,606,-501695,-503092,-0.028459218701356724,-434.33786782241776,0.02526433985215612
2023-09-18T16:15:00-04:00,1.06897,1.06913,1.06897,1.06907,1.067815,1.0686142222222221,1.068428888888882,1.0684057777777731,1.068780000000005,1.0675687999999994,1.0670525000000046,1.0662516000000062,1.0686611531868069,1.0684976037855303,232,-501463,-502507.2,-0.03145594229908028,-434.31616468762445,0.058964471566012915
2023-09-18T16:30:00-04:00,1.06907,1.06917,1.06904,1.06917,1.0678676,1.0687624444444443,1.0685422222222154,1.0684117777777733,1.068762500000005,1.0676275999999993,1.0670826000000047,1.0662775500000061,1.0687629225494455,1.0685688830284241,276,-501187,-502129.6,-0.027654549366979423,-434.29034785617284,0.09549220615082347
2023-09-18T16:45:00-04:00,1.06917,1.06923,1.06902,1.06915,1.067945744,1.068884,1.0686655555555487,1.0684648888888844,1.068750500000005,1.0676921999999995,1.0671143000000045,1.0663059000000061,1.0688403380395564,1.0686559064227388,-824,-502011,-501731.4,-0.016650032970178724,-434.30576168185064,0.10392869180931112
2023-09-18T17:00:00-04:00,1.06915,1.06917,1.06831,1.06912,1.06804848448,1.0689748888888888,1.068809999999993,1.0685611111111066,1.068782500000005,1.0677465999999995,1.0671469000000047,1.066332200000006,1.0688962704316451,1.0687439251381907,-353,-502364,-501744,-0.0053421540507759815,-434.31566674662173,0.12174336498661562
2023-09-18T17:15:00-04:00,1.06912,1.06935,1.06891,1.06932,1.0681430057216,1.0690768888888889,1.0689333333333264,1.0686759999999955,1.068812000000005,1.0678051999999996,1.0671798000000046,1.066358950000006,1.0689810163453162,1.0688283401105523,227,-502137,-501832.4,0.0049498840944974,-434.2732019157328,0.10391215210493877
2023-09-18T17:30:00-04:00,1.06932,1.06937,1.06896,1.06918,1.06826370514944,1.0691262222222222,1.0690044444444375,1.0687911111111066,1.0688220000000048,1.0678569999999996,1.0672095000000048,1.0663840500000061,1.0690208130762529,1.0689002720884413,-1367,-503504,-502240.6,0.012020269614199183,-434.45217546901904,0.05989480974039099
2023-09-18T17:45:00-04:00,1.06918,1.06921,1.06915,1.0692,1.068396460531507,1.0691653333333333,1.0690933333333266,1.0689013333333288,1.0688210000000047,1.0679011999999997,1.0672419000000046,1.0664087500000061,1.0690566504610022,1.0689590176707529,164,-503340,-502671.2,0.017214924591308144,-434.4491076974558,0.0748783227255627
2023-09-18T18:00:00-04:00,1.0692,1.06928,1.06908,1.06925,1.0685132852677262,1.0691966666666666,1.0691588888888819,1.0689999999999955,1.068805000000005,1.0679411999999995,1.0672731000000046,1.0664317000000059,1.0690953203688018,1.069010014136602,199,-503141,-502897.2,0.025033781571415177,-434.4398016742609,0.0552093275691137
2023-09-18T18:15:00-04:00,1.06925,1.06928,1.06902,1.06903,1.068616091035599,1.069170888888889,1.0691655555555488,1.0690711111111066,1.068786000000005,1.0679761999999995,1.0673021000000045,1.066454750000006,1.0690822562950415,1.069047211309281,-436,-503577,-503139.8,0.030902026408589432,-434.52950941333035,0.005612879687919117
2023-09-18T18:30:00-04:00,1.06903,1.06927,1.06888,1.0691,1.0687065601113273,1.0691577777777777,1.0691688888888822,1.0691182222222178,1.0687760000000046,1.0680205999999997,1.0673330000000045,1.0664786500000059,1.0690858050360332,1.0690681690474242,343,-503234,-503359.2,0.0334999345062177,-434.50704980041024,0.0028061773316971285
2023-09-18T18:45:00-04:00,1.0691,1.06919,1.06905,1.06914,1.068786172897968,1.069152,1.0691655555555488,1.06915044444444,1.0687980000000048,1.0680571999999997,1.0673626000000045,1.066502900000006,1.0690966440288265,1.0690833352379392,168,-503066,-503271.6,0.034867981961164606,-434.500764139574,-0.0028059148685405026
2023-09-18T19:00:00-04:00,1.06914,1.0693,1.06912,1.0693,1.0688562321502117,1.069178888888889,1.0691822222222154,1.0691682222222176,1.0688410000000048,1.0681019999999997,1.0673907000000045,1.066528650000006,1.0691373152230612,1.0690994681903507,310,-502756,-503154.8,0.03341017212562615,-434.4543717120154,0.014029836786220124
2023-09-18T19:15:00-04:00,1.0693,1.06938,1.06927,1.06929,1.0689178842921863,1.0692004444444443,1.0692011111111044,1.0691766666666622,1.0688980000000048,1.0681521999999997,1.0674168000000046,1.066553850000006,1.069167852178449,1.0691139745522804,-195,-502951,-503116.8,0.03093186302679265,-434.4561953349463,0.015900927865908736
2023-09-18T19:30:00-04:00,1.06929,1.06938,1.06924,1.06931,1.0689825804912803,1.069222222222222,1.069199999999993,1.0691835555555511,1.0689615000000048,1.0682005999999997,1.0674450000000046,1.0665789000000059,1.0691962817427592,1.0691367796418239,399,-502552,-502911.8,0.02754009730378239,-434.44873243900605,-0.0009351737552898582
2023-09-18T19:45:00-04:00,1.06931,1.06936,1.06918,1.06919,1.069038219222501,1.069220222222222,1.0692011111111042,1.0691899999999954,1.0690300000000046,1.0682529999999997,1.0674729000000047,1.066603350000006,1.0691950253942073,1.0691586237134587,-390,-502942,-502853.4,0.0211997102693242,-434.4924989800465,0.0009352962083152988
2023-09-18T20:00:00-04:00,1.06919,1.06964,1.06918,1.06942,1.0690860685313508,1.069264,1.0692255555555485,1.0692019999999953,1.0690905000000046,1.0683105999999996,1.0675026000000047,1.066630800000006,1.0692400203153658,1.0691872989707665,1357,-501585,-502557.2,0.01631624381646152,-434.20058641071836,0.020576131687252995
2023-09-18T20:15:00-04:00,1.06942,1.06965,1.06928,1.06931,1.0691746975663348,1.069280888888889,1.0692322222222153,1.0692119999999952,1.0691290000000049,1.0683703999999996,1.0675312000000048,1.066656350000006,1.0692540162522925,1.0692106391766127,-908,-502493,-502504.6,0.012444813443805082,-434.29398283120804,0.005611409866724244
2023-09-18T20:30:00-04:00,1.06931,1.06941,1.06881,1.06881,1.06965,1.0691964444444444,1.0692077777777709,1.0692133333333282,1.0691495000000049,1.0684189999999996,1.0675522000000048,1.066678950000006,1.069165213001834,1.06921011134129,-1185,-503678,-502650,0.007126507534938589,-434.84807846297053,-0.020579403758536896
2023-09-18T20:45:00-04:00,1.06881,1.0689899999999999,1.06879,1.06885,1.06965,1.069124888888889,1.0691799999999931,1.0692093333333283,1.0691590000000049,1.0684603999999995,1.0675727000000048,1.0667020000000058,1.0691021704014674,1.0691912890730315,1400,-502278,-502595.2,0.0034384709673949076,-434.7956837436097,-0.023384154896629077
2023-09-18T21:00:00-04:00,1.06885,1.06895,1.06839,1.06845,1.0696155999999999,1.0689788888888891,1.0691033333333264,1.069189777777773,1.0691330000000048,1.0685121999999996,1.067587000000005,1.066724200000006,1.068971736321174,1.069146631258425,-1536,-503814,-502769.6,-0.0017058895053601092,-435.370507151946,-0.06453785285370292
2023-09-18T21:15:00-04:00,1.06845,1.0686,1.06823,1.06827,1.069542064,1.0688122222222223,1.0689888888888817,1.0691424444444393,1.0690930000000047,1.0685639999999996,1.0675986000000048,1.066745900000006,1.0688313890569392,1.0690649050067396,-1214,-505028,-503458.2,-0.0067257792882340845,-435.5750277191226,-0.09632469840081029
2023-09-18T21:30:00-04:00,1.06827,1.06837,1.06808,1.06822,1.06943709888,1.0686584444444445,1.0688699999999929,1.069069999999995,1.0690455000000048,1.0686001999999997,1.0676108000000049,1.0667679500000058,1.0687091112455513,1.0689559240053914,-1274,-506302,-504220,-0.013042269782359917,-435.63465683910175,-0.10006639919948063
2023-09-18T21:45:00-04:00,1.06822,1.06843,1.06818,1.06837,1.069301388992,1.0685584444444445,1.0687655555555482,1.0689815555555504,1.0690065000000049,1.0686291999999995,1.0676230000000049,1.0667922500000058,1.0686412889964412,1.0688511392043127,1058,-505244,-504533.2,-0.018085212532214765,-435.4860919367407,-0.08790715508130859
2023-09-18T22:00:00-04:00,1.06837,1.06862,1.06822,1.06862,1.0691792500928,1.0685293333333332,1.068702222222215,1.068885999999995,1.068981500000005,1.0686651999999996,1.067637600000005,1.0668146000000056,1.068637031197153,1.0687581113634497,1038,-504206,-504918.8,-0.022179408652834593,-435.24319855710644,-0.05331138525427487
2023-09-18T22:15:00-04:00,1.06862,1.06877,1.06845,1.0685,1.06906932508352,1.0684888888888888,1.0685999999999929,1.0687853333333281,1.068940500000005,1.0687107999999996,1.0676575000000048,1.0668377000000058,1.0686096249577224,1.0686856890907594,-770,-504976,-505151.2,-0.025872979174436837,-435.32966521503903,-0.08602794037889995
2023-09-18T22:30:00-04:00,1.0685,1.06851,1.06836,1.06841,1.068970392575168,1.068450888888889,1.068499999999993,1.0686875555555504,1.068902000000005,1.0687485999999997,1.0676774000000049,1.0668598000000058,1.068569699966178,1.0686333512726072,-751,-505727,-505291,-0.031268905458923524,-435.3929221172383,-0.08416642507784468
2023-09-18T22:45:00-04:00,1.06841,1.0685499999999999,1.0682099999999999,1.06844,1.068881353317651,1.068438888888889,1.0684588888888817,1.068605333333328,1.068864000000005,1.0687793999999997,1.0676995000000047,1.0668808500000058,1.0685437599729424,1.0686002810180855,949,-504778,-504986.2,-0.03611256642446077,-435.36627504354936,-0.0346179395776594
2023-09-18T23:00:00-04:00,1.06844,1.06856,1.06836,1.0683799999999999,1.068801217985886,1.068423111111111,1.0684066666666596,1.0685335555555504,1.068820500000005,1.0688001999999996,1.0677188000000049,1.066903300000006,1.068511007978354,1.0685742248144678,-696,-505474,-505032.2,-0.0364836676664958,-435.4053600647018,-0.04397249380176755
2023-09-18T23:15:00-04:00,1.0683799999999999,1.06853,1.06832,1.06845,1.0687290961872973,1.0684317777777779,1.0684066666666596,1.0684744444444392,1.068791500000005,1.0688191999999996,1.0677354000000048,1.066928200000006,1.0684988063826832,1.068546579851574,619,-504855,-505162,-0.03666318257255265,-435.3648033339506,0
2023-09-18T23:30:00-04:00,1.06845,1.0685499999999999,1.06834,1.0684,1.0686641865685675,1.0684304444444443,1.068421111111104,1.0684386666666614,1.068756500000005,1.0688347999999996,1.0677541000000048,1.066951400000006,1.0684790451061466,1.0685204638812589,-748,-505603,-505287.4,-0.03432508043247821,-435.39980731167526,0.012169208158982604
2023-09-18T23:45:00-04:00,1.0684,1.06844,1.06824,1.06827,1.0686057679117107,1.068400222222222,1.0684266666666595,1.0684239999999947,1.068713000000005,1.0688303999999995,1.0677715000000048,1.0669731000000062,1.0684372360849173,1.0684939711050068,-784,-506387,-505419.4,-0.030628157943776907,-435.4952022948276,0.0046806837542927035
2023-09-19T00:00:00-04:00,1.06827,1.06849,1.06825,1.06847,1.0685531911205397,1.068408888888889,1.0684377777777707,1.0684197777777726,1.068671500000005,1.0688093999999995,1.0677881000000047,1.066994500000006,1.068443788867934,1.068473976884005,659,-505728,-505609.4,-0.025304408153344657,-435.3718252459542,0.009360053165100947
2023-09-19T00:15:00-04:00,1.06847,1.06852,1.06833,1.06834,1.06808,1.0683893333333332,1.0684066666666596,1.0684197777777726,1.0686240000000051,1.0687883999999994,1.0678051000000048,1.0670145500000061,1.0684230310943472,1.0684563815072037,-375,-506103,-505735.2,-0.02130847967853834,-435.4174512345173,-0.02620201755533641
2023-09-19T00:30:00-04:00,1.06834,1.06848,1.06806,1.06809,1.06852,1.0683259999999999,1.068361111111104,1.0684106666666613,1.068563000000005,1.0687805999999995,1.0678212000000047,1.067033450000006,1.0683564248754778,1.0684279052057626,-630,-506733,-506110.8,-0.020921928453460917,-435.56487621158453,-0.03837154890032957
2023-09-19T00:45:00-04:00,1.06809,1.06814,1.06787,1.068,1.06852,1.0682537777777779,1.0683155555555484,1.0683895555555503,1.0685035000000052,1.0687659999999994,1.0678371000000049,1.067051950000006,1.0682851399003823,1.0683891241646097,-629,-507362,-506462.6,-0.019764466385904792,-435.61787736317285,-0.03837478121695056
2023-09-19T01:00:00-04:00,1.068,1.0682099999999999,1.06789,1.068,1.0684939999999998,1.0681906666666667,1.0682666666666596,1.0683575555555502,1.068432500000005,1.0687463999999993,1.0678514000000048,1.0670707000000061,1.0682281119203059,1.0683472993316876,0,-507362,-506657.6,-0.018299256575770934,-435.61787736317285,-0.04118153569690352
2023-09-19T01:15:00-04:00,1.068,1.0680399999999999,1.06761,1.06781,1.0684690399999999,1.068099333333333,1.0682033333333263,1.0683106666666615,1.0683575000000052,1.0687181999999995,1.067862300000005,1.067086750000006,1.0681444895362446,1.0682874394653499,-1211,-508573,-507226.6,-0.017021401771706735,-435.83331743807935,-0.05335180366535872
2023-09-19T01:30:00-04:00,1.06781,1.06805,1.06767,1.06774,1.0684174975999998,1.0680066666666665,1.0681244444444373,1.068254222222217,1.0683040000000052,1.0686815999999995,1.0678721000000049,1.067102800000006,1.0680635916289958,1.0682155515722793,-1089,-509662,-507938.4,-0.01601523341523251,-435.90470654288265,-0.06645140156301076
2023-09-19T01:45:00-04:00,1.06774,1.06798,1.06769,1.06796,1.0683690477439998,1.0679737777777778,1.0680755555555483,1.068197111111106,1.0682595000000052,1.0686525999999994,1.0678831000000049,1.067118900000006,1.0680428733031966,1.0681528412578234,1154,-508508,-508293.4,-0.016813734842006597,-435.66693330220596,-0.04118307749906364
2023-09-19T02:00:00-04:00,1.06796,1.0682099999999999,1.06781,1.06786,1.0683235048793598,1.0679306666666666,1.068029999999993,1.0681399999999948,1.0682300000000051,1.0686237999999997,1.0678926000000046,1.067134750000006,1.0680062986425574,1.0680970730062582,-2467,-510975,-509016,-0.01745638689321563,-435.8979344632981,-0.03837981034757331
2023-09-19T02:15:00-04:00,1.06786,1.0680399999999999,1.06773,1.06788,1.0682806945865981,1.0679006666666666,1.0679644444444374,1.0680795555555505,1.068210500000005,1.0686073999999997,1.0679026000000045,1.0671503500000061,1.0679810389140458,1.0680476584050063,1601,-509374,-509418.4,-0.018566828099045092,-435.8679492592453,-0.05521914513276839
2023-09-19T02:30:00-04:00,1.06788,1.0683799999999999,1.06787,1.06819,1.06761,1.0679457777777777,1.0679477777777708,1.0680284444444392,1.068209000000005,1.0686023999999994,1.0679143000000046,1.067165600000006,1.0680228311312367,1.068023326724005,2112,-507262,-509156.2,-0.020831475900731665,-435.25484666344795,-0.014040474006411301
2023-09-19T02:45:00-04:00,1.06819,1.0682,1.06762,1.06787,1.0683799999999999,1.0679302222222222,1.0679233333333265,1.067988222222217,1.0681840000000051,1.0685967999999995,1.0679243000000045,1.0671782500000062,1.0679922649049893,1.0680090613792035,-1669,-508931,-509010,-0.0236714878932428,-435.75483262100215,-0.02059751519065687
2023-09-19T03:00:00-04:00,1.06787,1.06839,1.06764,1.0678,1.06762,1.0679055555555557,1.067901111111104,1.0679533333333284,1.068143000000005,1.0685919999999995,1.0679266000000045,1.067191700000006,1.0679538119239915,1.0679912491033625,-3212,-512143,-509737,-0.023845952206248966,-435.96538259431355,-0.018726591760297562
2023-09-19T03:15:00-04:00,1.0678,1.06839,1.0675,1.06827,1.06839,1.0679793333333334,1.067931111111104,1.0679335555555505,1.0681315000000051,1.0686009999999997,1.0679398000000044,1.067207000000006,1.0680170495391932,1.0679933992826895,3008,-509135,-509369,-0.019758255602623155,-434.64138933714935,0.02528089887640379
2023-09-19T03:30:00-04:00,1.06827,1.06888,1.06803,1.06875,1.0675,1.068143111111111,1.0680355555555485,1.0679477777777726,1.0681485000000053,1.0686117999999996,1.0679607000000046,1.067225800000006,1.0681636396313545,1.0680299194261516,2858,-506277,-508749.6,-0.013851131762533856,-433.3572196047782,0.0880306421554549
2023-09-19T03:45:00-04:00,1.06875,1.06953,1.06872,1.06942,1.0675,1.0684200000000001,1.0682222222222153,1.0680026666666615,1.068197500000005,1.0686293999999996,1.0679964000000046,1.067244800000006,1.0684149117050836,1.0681083355409207,3182,-503095,-507916.2,-0.00328097006138443,-431.36242194395965,0.15734167493960383
2023-09-19T04:00:00-04:00,1.06942,1.0694299999999999,1.06874,1.06925,1.0675812,1.0686255555555555,1.0683655555555487,1.0680911111111058,1.0682410000000053,1.0686463999999993,1.0680287000000046,1.0672625500000061,1.0685819293640668,1.0682262684327364,-2714,-505809,-507291.8,0.007243728046151588,-431.7938520649598,0.12079104086295492
2023-09-19T04:15:00-04:00,1.06925,1.06935,1.06878,1.06879,1.067659152,1.0687104444444446,1.068468888888882,1.0682046666666616,1.0682580000000053,1.0686489999999993,1.0680529000000047,1.0672744500000062,1.0686235434912534,1.0683602147461886,-2334,-508143,-506491.8,0.013185572897284118,-432.79795774651257,0.0870900679864285
2023-09-19T04:30:00-04:00,1.06879,1.0689,1.0685,1.06858,1.0677339859200001,1.0687326666666668,1.0685466666666599,1.0683277777777724,1.0682670000000054,1.0686411999999994,1.0680765000000045,1.0672840000000061,1.0686148347930027,1.0684797717969505,-1728,-509871,-506639,0.019345860298115296,-433.1374818812815,0.06555043637863289
2023-09-19T04:45:00-04:00,1.06858,1.06897,1.06837,1.06864,1.0678058264832002,1.0687513333333334,1.0685966666666598,1.068439999999995,1.0682855000000053,1.0686325999999995,1.0681007000000047,1.0672969500000062,1.068619867834402,1.06857101743756,1902,-507969,-506977.4,0.025390055621169756,-433.0306859464896,0.04212733689699973
2023-09-19T05:00:00-04:00,1.06864,1.06876,1.06826,1.06859,1.0678747934238721,1.06875,1.0686766666666596,1.0685308888888838,1.0682915000000053,1.0686209999999994,1.0681243000000047,1.0673109000000063,1.0686138942675216,1.0686108139500476,-2175,-510144,-508387.2,0.027707572779375803,-433.1324508064988,0.06742393737063798
2023-09-19T05:15:00-04:00,1.06859,1.06891,1.06858,1.06877,1.0679410016869173,1.0687686666666667,1.0687844444444374,1.0686146666666614,1.0683130000000052,1.0686133999999994,1.0681528000000045,1.0673272000000062,1.0686451154140173,1.0686234511600374,1525,-508619,-508949.2,0.03479446925751262,-432.8755702442625,0.09084098145719378
2023-09-19T05:30:00-04:00,1.06877,1.06909,1.06819,1.06827,1.0680045616194407,1.0686657777777777,1.0687844444444374,1.0686777777777725,1.0683220000000053,1.0685963999999992,1.0681715000000045,1.067339800000006,1.0685700923312138,1.0686127609280296,-1453,-510072,-509335,0.039506064981299445,-433.55532360560306,0
2023-09-19T05:45:00-04:00,1.06827,1.06898,1.06822,1.06889,1.0680655791546632,1.068686888888889,1.0687999999999929,1.0687284444444392,1.0683665000000053,1.0685877999999993,1.0681965000000044,1.0673524500000062,1.0686340738649711,1.0686166087424234,1831,-508241,-509009,0.04174219857718166,-432.49265218358454,0.013099415204660297
2023-09-19T06:00:00-04:00,1.06889,1.0689899999999999,1.06866,1.06895,1.0681241559884767,1.0687168888888887,1.0687477777777707,1.0687586666666613,1.0684140000000053,1.0685831999999993,1.0682201000000044,1.0673638500000062,1.068697259091977,1.0686320869939383,1429,-506812,-508777.6,0.03937818568873808,-432.4124381297528,-0.04394905649791199
2023-09-19T06:15:00-04:00,1.06895,1.06947,1.06891,1.06946,1.0681803897489377,1.0688593333333334,1.068771111111104,1.0687775555555503,1.0684965000000053,1.0685883999999992,1.0682448000000047,1.0673778000000063,1.0688498072735817,1.0686792695951504,1822,-504990,-507746.8,0.033243098458410045,-431.5431551885488,0.01963993453355562
2023-09-19T06:30:00-04:00,1.06946,1.07095,1.06946,1.0706,1.0682343741589801,1.0692251111111113,1.0689722222222153,1.0688151111111057,1.0686395000000053,1.0686153999999994,1.0682783000000047,1.0673986500000063,1.0691998458188654,1.06879021567612,2975,-502015,-506426,0.03343949541319365,-428.3719285882087,0.16935038688611323
2023-09-19T06:45:00-04:00,1.0706,1.0706,1.06981,1.07003,1.0683973117094414,1.0694366666666668,1.0691333333333264,1.0688848888888836,1.0687430000000053,1.0686353999999993,1.0683058000000047,1.0674161000000064,1.0693658766550924,1.0689493725408954,-1970,-503985,-505208.6,0.03483519450781857,-429.42077969973485,0.13569409871043359
2023-09-19T07:00:00-04:00,1.07003,1.07042,1.06998,1.07018,1.068550473006875,1.0696459999999999,1.0693044444444375,1.0689857777777725,1.0688590000000053,1.0686569999999993,1.0683388000000047,1.0674355000000062,1.069528701324074,1.0691282980327164,2690,-501295,-503819.4,0.03991082216846608,-429.04368746867624,0.14410839946098544
2023-09-19T07:15:00-04:00,1.07018,1.07046,1.06993,1.07044,1.0686944446264623,1.0698731111111113,1.069509999999993,1.069138222222217,1.0689870000000052,1.0686829999999994,1.0683701000000048,1.0674548000000064,1.0697109610592592,1.0693310384261725,2010,-499285,-502314,0.04525201335396925,-428.55535840253754,0.17312533338325545
2023-09-19T07:30:00-04:00,1.07044,1.07081,1.07039,1.07064,1.0688297779488747,1.0700991111111111,1.0697177777777709,1.0693275555555506,1.0691095000000053,1.0687097999999993,1.0684059000000046,1.0674749000000063,1.0698967688474075,1.0695404307409377,2080,-497205,-500757,0.05212829359701885,-428.1667331643178,0.17496748598856987
2023-09-19T07:45:00-04:00,1.07064,1.07098,1.07042,1.07087,1.068956991271942,1.0703295555555556,1.0700066666666597,1.0695344444444392,1.0692595000000051,1.0687413999999995,1.0684468000000047,1.0674979000000062,1.070091415077926,1.0697187445927496,2249,-494956,-499345.2,0.05982703471172782,-427.6835922392637,0.24338416317971445
2023-09-19T08:00:00-04:00,1.07087,1.07167,1.07075,1.07154,1.0691188319701868,1.070636222222222,1.070301111111104,1.0697679999999947,1.0694465000000053,1.0687859999999996,1.0684933000000045,1.0675217000000061,1.0703811320623406,1.0699217956741995,2634,-492322,-497012.6,0.07405352426662726,-426.0356050886293,0.24792074020713464
2023-09-19T08:15:00-04:00,1.07154,1.07179,1.07121,1.0714,1.0693739487731682,1.070856,1.0705733333333263,1.0700217777777725,1.0696030000000052,1.0688301999999994,1.0685416000000045,1.067548450000006,1.0705849056498724,1.070133036539359,-3057,-495379,-495829.4,0.08148143860772622,-426.4350115503574,0.22919687543849956
2023-09-19T08:30:00-04:00,1.0714,1.07175,1.06946,1.06967,1.07179,1.0706753333333332,1.0705966666666593,1.0702391111111058,1.0696490000000052,1.0688351999999994,1.0685729000000048,1.0675664500000062,1.070401924519898,1.0702712292314869,-5018,-500397,-496051.8,0.08197498589841351,-434.5376249533815,0.019636078020666636
2023-09-19T08:45:00-04:00,1.06967,1.07017,1.06941,1.06997,1.07179,1.0705500000000001,1.0705266666666595,1.0704008888888834,1.0696765000000052,1.0688483999999996,1.0686094000000046,1.0675882500000062,1.0703155396159183,1.0703549833851889,3503,-496894,-495989.6,0.08130721922115694,-433.55517242129156,-0.0588455071922201
2023-09-19T09:00:00-04:00,1.06997,1.07014,1.06851,1.06853,1.07175,1.0701506666666667,1.0703599999999927,1.07047155555555,1.069640500000005,1.0688427999999994,1.0686309000000047,1.0676023500000063,1.0699584316927346,1.0703283867081508,-5349,-502243,-497447,0.06592004473338575,-440.75402846398487,-0.14018298552377567
2023-09-19T09:15:00-04:00,1.06853,1.06901,1.06829,1.06896,1.0715556,1.0698706666666666,1.070224444444437,1.0704562222222165,1.0696490000000054,1.0688449999999994,1.0686527000000046,1.067618600000006,1.0697587453541877,1.07020390936652,4032,-498211,-498624.8,0.05720831439390066,-439.131462883234,-0.1139995141004316
2023-09-19T09:30:00-04:00,1.06896,1.06967,1.06895,1.0694,1.071294352,1.0697057777777779,1.0701088888888814,1.0703633333333276,1.0696900000000054,1.0688639999999994,1.0686881000000046,1.067636500000006,1.0696869962833502,1.0700243274932155,4608,-493603,-498269.6,0.047198916588706945,-437.2347408356364,-0.09715630955496356
2023-09-19T09:45:00-04:00,1.0694,1.06964,1.06872,1.0691599999999999,1.07105400384,1.069516,1.069944444444437,1.070232888888883,1.0697160000000052,1.0688817999999993,1.0687229000000047,1.0676550500000062,1.0695815970266802,1.069860261994572,-5133,-498736,-497937.4,0.03264930356479247,-438.38671390464714,-0.1382350743480673
2023-09-19T10:00:00-04:00,1.0691599999999999,1.06933,1.06851,1.0687,1.0708328835328,1.069267111111111,1.069703333333326,1.0700682222222162,1.0697215000000053,1.0688913999999994,1.0687458000000047,1.067670700000006,1.069405277621344,1.0696782095956572,-4079,-502815,-499121.6,0.014245635716086325,-440.14168042041615,-0.20263897578604362
2023-09-19T10:15:00-04:00,1.0687,1.06875,1.06823,1.0686,1.070629452850176,1.0690464444444445,1.0693766666666593,1.0698715555555496,1.0697130000000052,1.0688959999999994,1.0687626000000048,1.0676854500000061,1.0692442220970753,1.0695353676765254,-3603,-506418,-499956.6,-0.007020424225772892,-440.4788189999988,-0.27437146536759643
2023-09-19T10:30:00-04:00,1.0686,1.06908,1.06848,1.06895,1.0703895075651584,1.0689611111111113,1.069104444444437,1.0696475555555496,1.0697470000000053,1.0689025999999995,1.0687839000000046,1.0677058000000061,1.0691853776776603,1.0694206941412199,4001,-502417,-500797.8,-0.03203460235630318,-439.16836607093245,-0.2286727646070414
2023-09-19T10:45:00-04:00,1.06895,1.06928,1.06858,1.06896,1.0701735568086426,1.0689322222222222,1.0690255555555481,1.069430888888883,1.0697505000000054,1.0689117999999993,1.0688113000000046,1.067725450000006,1.0691403021421282,1.0693113553129754,3679,-498738,-501824.8,-0.057915143852868965,-439.1339491197192,-0.06637561116979895
2023-09-19T11:00:00-04:00,1.06896,1.06928,1.06872,1.06907,1.0699792011277782,1.0689411111111111,1.0689255555555484,1.0692271111111051,1.0697565000000053,1.0689249999999995,1.0688368000000046,1.0677385000000061,1.0691262417137026,1.06922028425038,2508,-496230,-501323.6,-0.06432491337264679,-438.87586649735715,-0.08411450788341009
2023-09-19T11:15:00-04:00,1.06907,1.0691,1.06803,1.06834,1.0698042810150004,1.068824,1.0689044444444373,1.0690673333333274,1.0697005000000053,1.0689229999999994,1.0688512000000048,1.067747350000006,1.068968993370962,1.0691330274003037,-2678,-498908,-500542.2,-0.0768492134116601,-440.70450260163443,-0.017781438050397506
2023-09-19T11:30:00-04:00,1.06834,1.06835,1.0680399999999999,1.06815,1.0695913672932003,1.068673111111111,1.0688144444444374,1.0689548888888831,1.0695780000000052,1.0689183999999994,1.0688593000000046,1.0677573000000062,1.0688051946967696,1.0690452219202424,-2086,-500994,-499457.4,-0.07457430629983326,-441.07548936614785,-0.07577458464301541
2023-09-19T11:45:00-04:00,1.06815,1.06856,1.06799,1.06831,1.0694040032180163,1.0685722222222223,1.0686933333333262,1.0688726666666608,1.0694920000000052,1.0689155999999995,1.0688674000000047,1.0677679000000062,1.0687061557574158,1.0689493775361933,1683,-499311,-498836.2,-0.07046345326110925,-440.82338994190945,-0.10192631382081667
2023-09-19T12:00:00-04:00,1.06831,1.0686,1.068,1.06858,1.069206042767494,1.0685495555555558,1.0686288888888817,1.0687933333333277,1.0694120000000051,1.0689191999999994,1.0688770000000047,1.0677733000000063,1.0686809246059326,1.0688575020289541,1722,-497589,-498606.4,-0.07167912969815901,-440.3881791884765,-0.05424819484453243
2023-09-19T12:15:00-04:00,1.06858,1.06862,1.06815,1.0682099999999999,1.069035796780045,1.0684657777777777,1.0685744444444372,1.0687231111111053,1.069300500000005,1.0689179999999994,1.0688742000000047,1.0677783000000063,1.068586739684746,1.0687496016231628,-1689,-499278,-499216,-0.07179674436501812,-440.9730020374914,-0.04585009825022003
2023-09-19T12:30:00-04:00,1.0682099999999999,1.0682099999999999,1.06783,1.06803,1.0688893852308388,1.068356888888889,1.068511111111104,1.0686444444444387,1.0691700000000053,1.0689091999999993,1.0688593000000046,1.0677831500000061,1.0684753917477967,1.0686508812985298,-1453,-500731,-499580.6,-0.06733754816484905,-441.21784153534276,-0.05334081976417363
2023-09-19T12:45:00-04:00,1.06803,1.06848,1.06793,1.06846,1.0687198835939045,1.0683466666666668,1.0684566666666595,1.0685728888888832,1.069049500000005,1.0689115999999992,1.0688500000000047,1.067793350000006,1.0684723133982374,1.0685843050388235,1784,-498947,-499171.2,-0.058943891508136254,-440.4995845575426,-0.045839375087712374
2023-09-19T13:00:00-04:00,1.06846,1.06856,1.0682099999999999,1.06839,1.0685775022188797,1.0683333333333334,1.0683933333333262,1.068512888888883,1.068892000000005,1.0689175999999994,1.0688491000000047,1.0678007500000062,1.06845585071859,1.0685342440310583,-1846,-500793,-499467.6,-0.053141779416424395,-440.62052497646334,-0.05332285585989742
2023-09-19T13:15:00-04:00,1.06839,1.06889,1.06835,1.06888,1.06783,1.0684306666666668,1.068372222222215,1.0684615555555497,1.068766000000005,1.0689351999999994,1.0688506000000046,1.0678075500000062,1.068540680574872,1.0685061952248462,1543,-499250,-499799.8,-0.042046232144189864,-439.91285268450986,-0.017772456434088736
2023-09-19T13:30:00-04:00,1.06888,1.06918,1.06881,1.0688199999999999,1.0678512,1.0685202222222223,1.0684255555555484,1.068431777777772,1.0687235000000053,1.0689515999999992,1.0688490000000046,1.0678151000000062,1.0685965444598977,1.0685081561798766,-1469,-500719,-500088,-0.032895000654743274,-439.9953128297088,0.04492951682047044
2023-09-19T13:45:00-04:00,1.0688199999999999,1.06889,1.06844,1.06847,1.067904352,1.068529111111111,1.068461111111104,1.0684217777777723,1.068648500000005,1.0689647999999994,1.0688415000000047,1.067821350000006,1.0685712355679182,1.068527324943901,-1797,-502516,-500445,-0.026333448291323575,-440.58376551584837,0.02995833918458063
2023-09-19T14:00:00-04:00,1.06847,1.06854,1.06813,1.06814,1.06795537792,1.0684648888888888,1.068442222222215,1.0684188888888833,1.0686290000000052,1.0689727999999994,1.0688272000000048,1.0678228500000062,1.0684849884543346,1.0685298599551203,-1745,-504261,-501507.8,-0.01827449711689419,-441.1227137315212,-0.01591298405893453
2023-09-19T14:15:00-04:00,1.06814,1.06818,1.06782,1.06793,1.06918,1.0683624444444444,1.0683699999999927,1.0684142222222166,1.0685775000000053,1.0689721999999993,1.0688124000000048,1.0678262000000063,1.0683739907634677,1.0685134879640958,-1237,-505498,-502448.8,-0.019157318616855944,-441.3659121886523,-0.06082838907709665
2023-09-19T14:30:00-04:00,1.06793,1.06825,1.0679,1.06802,1.0691528000000001,1.0682924444444444,1.068348888888882,1.06840955555555,1.0685085000000052,1.0689753999999994,1.0687996000000046,1.0678300500000062,1.0683031926107742,1.0684659903712763,1163,-504335,-503465.8,-0.020209834680226767,-441.2679001466646,-0.017786764774708388
2023-09-19T14:45:00-04:00,1.06802,1.06805,1.06771,1.06776,1.0691261440000002,1.0681746666666665,1.0683188888888817,1.0683882222222165,1.0684385000000052,1.0689729999999993,1.0687902000000047,1.0678327000000063,1.0681945540886193,1.0683855922970207,-1558,-505893,-504500.6,-0.017113878151623373,-441.6471814335318,-0.025280188758742026
2023-09-19T15:00:00-04:00,1.06776,1.06803,1.06765,1.0679,1.0690694982400002,1.068090888888889,1.0682566666666595,1.0683473333333275,1.0683985000000054,1.0689671999999995,1.0687848000000046,1.0678363500000063,1.0681356432708955,1.068298473837616,1569,-504324,-504862.2,-0.012715790712028456,-441.441461046928,-0.052411882522499106
2023-09-19T15:15:00-04:00,1.0679,1.0679,1.0675999999999999,1.06779,1.0689843283456002,1.0679975555555556,1.068189999999993,1.068296888888883,1.0683580000000052,1.0689655999999994,1.0687812000000048,1.0678406000000062,1.0680665146167163,1.0682147790700924,-1549,-505873,-505184.6,-0.014931520037401617,-441.6010171851433,-0.05615926768314323
2023-09-19T15:30:00-04:00,1.06779,1.06811,1.06775,1.068,1.0688735820779522,1.0679595555555557,1.068092222222215,1.0682413333333276,1.0683105000000053,1.0689695999999993,1.0687808000000047,1.0678448500000064,1.068053211693373,1.0681506232560734,1308,-504565,-504998,-0.015908065732311693,-441.3437755926953,-0.08232916697851882
2023-09-19T15:45:00-04:00,1.068,1.06811,1.06789,1.06805,1.0687716955117161,1.067951111111111,1.0680066666666594,1.068172888888883,1.0682650000000051,1.0689651999999994,1.0687831000000048,1.0678493000000062,1.0680525693546983,1.0681004986048583,1128,-503437,-504818.4,-0.019666349591867797,-441.2909666039314,-0.07204206508111165
2023-09-19T16:00:00-04:00,1.06805,1.06813,1.068,1.06805,1.0686779598707787,1.0679597777777776,1.067959999999993,1.0681011111111054,1.0682140000000053,1.0689511999999994,1.0687815000000047,1.0678547500000064,1.0680520554837587,1.0680719988838863,0,-503437,-504327.2,-0.02281870518645141,-441.2909666039314,-0.03930854399282029
2023-09-19T16:15:00-04:00,1.06805,1.06807,1.06784,1.06791,1.0685917230811164,1.0679497777777778,1.0679344444444372,1.068036666666661,1.0681925000000052,1.0689209999999993,1.0687752000000048,1.0678627500000062,1.068023644387007,1.0680495991071086,-384,-503821,-504226.6,-0.022891211245760507,-441.3413013260886,-0.021532757878197098
2023-09-19T16:30:00-04:00,1.06791,1.06802,1.06788,1.06795,1.068512385234627,1.067952888888889,1.0679366666666597,1.067985999999994,1.0681825000000054,1.0688949999999995,1.0687707000000048,1.0678702500000063,1.0680089155096055,1.0680380792856865,413,-503408,-503733.6,-0.02293173084616611,-441.3258318576877,0.0018727819239003473
2023-09-19T16:45:00-04:00,1.06795,1.06811,1.06788,1.06792,1.0684393944158568,1.0679495555555556,1.0679255555555482,1.0679526666666608,1.0681630000000053,1.0688775999999995,1.0687633000000047,1.0678795000000063,1.0679911324076845,1.0680256634285485,-696,-504104,-503641.4,-0.022000243406739034,-441.3453833348168,-0.009363120540812812
2023-09-19T17:00:00-04:00,1.06792,1.06792,1.06737,1.06779,1.0683722428625881,1.0679224444444444,1.0679288888888818,1.0679371111111053,1.0681235000000053,1.0688617999999992,1.0687515000000047,1.0678882000000065,1.0679509059261476,1.0680053307428385,-32,-504136,-503781.2,-0.021835803495353755,-441.34927875769495,0.00280962013935477
2023-09-19T17:15:00-04:00,1.06779,1.06791,1.06771,1.06787,1.0682720185763293,1.0679106666666667,1.0679255555555482,1.0679302222222162,1.0681065000000056,1.0688463999999993,1.0687395000000048,1.0678960000000064,1.067934724740918,1.0679818645942702,56,-504080,-503909.8,-0.01764128408196328,-441.3450831761667,-0.0028092518026008513
2023-09-19T17:30:00-04:00,1.06787,1.06791,1.06779,1.06781,1.0681818167186963,1.0678875555555556,1.0679277777777707,1.0679288888888832,1.0680955000000056,1.0688307999999993,1.0687259000000047,1.0679042500000062,1.0679097797927344,1.0679590916754158,-119,-504199,-503985.4,-0.016700891754277514,-441.3517693832893,0.0018730274679392932
2023-09-19T17:45:00-04:00,1.06781,1.06807,1.0678,1.06796,1.0681006350468267,1.0678940000000001,1.0679233333333262,1.0679262222222163,1.0680705000000055,1.0688145999999992,1.0687140000000048,1.0679141500000062,1.0679198238341876,1.0679412733403324,638,-503561,-504016,-0.014797232440269729,-441.2621466976055,-0.0037453183520636704
2023-09-19T18:00:00-04:00,1.06796,1.0681,1.06779,1.06805,1.06737,1.0679193333333334,1.0679233333333262,1.067925777777772,1.0680535000000053,1.0688101999999993,1.0687033000000046,1.0679251000000063,1.06794585906735,1.0679322186722655,173,-503388,-503872.8,-0.012501415548775088,-441.24756749988273,0
2023-09-19T18:15:00-04:00,1.06805,1.06815,1.06793,1.06815,1.0673846,1.0679646666666665,1.0679344444444372,1.067926888888883,1.0680170000000053,1.0687953999999993,1.0686916000000046,1.0679357000000063,1.0679866872538801,1.0679393749378119,229,-503159,-503677.4,-0.010495237908204856,-441.2261265561067,0.009362857544121436
2023-09-19T18:30:00-04:00,1.06815,1.06829,1.06812,1.06823,1.0674152160000001,1.0680237777777777,1.0679699999999928,1.0679357777777718,1.0679875000000052,1.068780999999999,1.0686821000000046,1.0679458000000062,1.068035349803104,1.0679594999502493,408,-502751,-503411.6,-0.005912102287173003,-441.1955690501384,0.029965071963002313
2023-09-19T18:45:00-04:00,1.06823,1.06825,1.06813,1.06822,1.0674677030400002,1.0680737777777778,1.0679999999999927,1.0679502222222166,1.0679750000000054,1.068756199999999,1.0686723000000047,1.0679571000000063,1.0680722798424833,1.0679919999601992,-334,-503085,-503188.8,-0.0003344038713766662,-441.1986957176164,0.025282082494498103
2023-09-19T19:00:00-04:00,1.06822,1.06835,1.06813,1.06828,1.0675170408576002,1.0681297777777778,1.0680399999999928,1.0679735555555498,1.0679820000000053,1.0687097999999993,1.0686626000000046,1.0679678500000065,1.0681138238739867,1.068030799968159,534,-502551,-502986.8,0.003602674897160229,-441.16870189611893,0.033710390291399724
2023-09-19T19:15:00-04:00,1.06828,1.0683,1.06809,1.06811,1.0675836775889922,1.0681437777777776,1.0680755555555483,1.0680039999999944,1.0679910000000052,1.0686713999999993,1.0686534000000045,1.0679777500000063,1.0681130590991894,1.0680642399745268,-311,-502862,-502881.6,0.005515488624819695,-441.218192666329,0.02996843948715346
2023-09-19T19:30:00-04:00,1.06811,1.06819,1.0681,1.06812,1.0676449833818729,1.0681526666666665,1.068103333333326,1.0680377777777719,1.0679960000000053,1.0686301999999992,1.0686436000000046,1.067988300000006,1.0681144472793516,1.0680897919796213,297,-502565,-502762.8,0.007758180198669006,-441.2154120538452,0.023411089364797345
2023-09-19T19:45:00-04:00,1.06812,1.06815,1.06806,1.06813,1.067701384711323,1.068158,1.0681388888888819,1.0680715555555498,1.0680145000000052,1.068583999999999,1.0686335000000047,1.0679980500000061,1.0681175578234812,1.0681062335836966,411,-502154,-502643.4,0.009702136387462831,-441.21156417158477,0.029967878180584374
2023-09-19T20:00:00-04:00,1.06813,1.06836,1.06793,1.06797,1.067753273934417,1.068124222222222,1.068139999999993,1.0680995555555497,1.0680180000000052,1.0685305999999992,1.0686202000000045,1.0680054500000062,1.068088046258785,1.0681093868669571,-1156,-503310,-502688.4,0.01026383678471705,-441.3847266143585,0.0009363646578584884
2023-09-19T20:15:00-04:00,1.06797,1.06836,1.06797,1.06834,1.0678139465409755,1.068164222222222,1.068172222222215,1.0681259999999941,1.0680455000000053,1.0684799999999992,1.0686107000000045,1.0680137500000064,1.068138437007028,1.0681143094935652,1011,-502299,-502638,0.01185980462558859,-441.03446396653135,0.027152286877966714
2023-09-19T20:30:00-04:00,1.06834,1.06857,1.06823,1.06835,1.067868551886878,1.0681997777777779,1.0681944444444373,1.068149777777772,1.0680630000000053,1.068416199999999,1.0686011000000044,1.0680230500000063,1.0681807496056224,1.068127847594852,798,-501501,-502365.8,0.012171600846640433,-441.02699443436006,0.018723961990355097
2023-09-19T20:45:00-04:00,1.06835,1.0686,1.06832,1.06849,1.0679527256604526,1.068258888888889,1.068223333333326,1.068173777777772,1.0680850000000055,1.068357999999999,1.0685941000000045,1.0680335000000063,1.068242599684498,1.0681534780758812,1559,-499942,-501841.2,0.013170008582591658,-440.8226980895292,0.0243393276728726
2023-09-19T21:00:00-04:00,1.06849,1.06861,1.06832,1.06849,1.0680433440679893,1.068312222222222,1.0682533333333264,1.0681966666666607,1.0681070000000055,1.0683343999999992,1.0685848000000044,1.0680437000000063,1.0682920797475983,1.0681883824607048,0,-499942,-501398.8,0.013642327595325826,-440.8226980895292,0.025275692273126555
2023-09-19T21:15:00-04:00,1.06849,1.06861,1.06799,1.06849,1.06861,1.0683595555555556,1.0682766666666597,1.0682239999999943,1.0681360000000055,1.068304799999999,1.0685766000000045,1.0680539000000062,1.0683316637980786,1.0682371059685634,0,-499942,-500725.2,0.014208250058301742,-440.8226980895292,0.019657767626469043
2023-09-19T21:30:00-04:00,1.06849,1.06875,1.06833,1.06853,1.06799,1.0684102222222225,1.068323333333326,1.0682542222222164,1.0681650000000054,1.068304799999999,1.0685738000000047,1.0680630000000062,1.0683713310384628,1.0682836847748505,1679,-498263,-499918,0.013784341042321862,-440.75984303239244,0.03932179269926197
2023-09-19T21:45:00-04:00,1.06853,1.06871,1.06837,1.06861,1.06799,1.0684675555555556,1.0683777777777705,1.0682908888888831,1.0681995000000055,1.0682977999999992,1.0685714000000046,1.0680720500000063,1.0684190648307703,1.0683313478198802,1200,-497063,-499030.4,0.01552253018158379,-440.6699999769798,0.04587499531888753
2023-09-19T22:00:00-04:00,1.06861,1.06895,1.0685499999999999,1.06895,1.0680052,1.0685820000000001,1.0684688888888818,1.0683399999999943,1.0682575000000056,1.0682887999999993,1.0685764000000046,1.0680817000000062,1.0685252518646162,1.0683878782559038,1179,-495884,-498218.8,0.018700179290157482,-440.29487715387313,0.07676968159306853
2023-09-19T22:15:00-04:00,1.06895,1.06897,1.06853,1.06857,1.068042992,1.0686022222222225,1.0685355555555485,1.0683964444444387,1.0682925000000059,1.0682769999999993,1.0685794000000046,1.0680890000000063,1.068534201491693,1.0684363026047228,-1091,-496975,-497625.4,0.019341419969814484,-440.6827156870132,0.05618135340879742
2023-09-19T22:30:00-04:00,1.06857,1.06868,1.06837,1.06854,1.06809861248,1.0686031111111112,1.0685577777777706,1.0684526666666607,1.0683290000000056,1.0682737999999992,1.0685826000000045,1.0680967000000061,1.0685353611933543,1.068477042083778,-1169,-498144,-497265.8,0.021689914457467534,-440.71553524960615,0.018720632008534546
2023-09-19T22:45:00-04:00,1.06854,1.06859,1.06827,1.06829,1.0681508957312,1.0685495555555553,1.0685511111111041,1.0684982222222164,1.0683455000000057,1.0682675999999993,1.0685818000000045,1.0681024000000061,1.0684862889546836,1.0685000336670218,-983,-499127,-497438.6,0.01908190241374322,-440.9455219604453,-0.005616137033738849
2023-09-19T23:00:00-04:00,1.06829,1.06842,1.06812,1.06819,1.06897,1.0684773333333333,1.0685177777777708,1.0685262222222165,1.0683525000000056,1.0682523999999993,1.0685775000000044,1.0681075500000063,1.068427031163747,1.0685016269336174,-913,-500040,-498034,0.01655887426423019,-441.03098564539977,-0.028077005868091136
2023-09-19T23:15:00-04:00,1.06819,1.06834,1.06812,1.06826,1.068953,1.068425777777778,1.0684922222222153,1.0685308888888831,1.0683580000000057,1.0682383999999991,1.0685751000000046,1.0681163000000062,1.0683936249309975,1.0684753015468935,718,-499322,-498721.6,0.013469838393386871,-440.983934090901,-0.021525704498867794
2023-09-19T23:30:00-04:00,1.06826,1.06828,1.06787,1.06799,1.06893634,1.0683253333333336,1.0684366666666596,1.0685111111111056,1.0683460000000058,1.0682167999999992,1.0685709000000043,1.0681241500000063,1.068312899944798,1.0684310412375146,-739,-500061,-499338.8,0.009502945155515025,-441.1707144627206,-0.04679500978015189
2023-09-19T23:45:00-04:00,1.06799,1.06799,1.06781,1.06796,1.0688936864,1.06823,1.0683733333333263,1.0684742222222166,1.0683330000000058,1.0682091999999992,1.0685661000000044,1.0681328000000063,1.0682423199558384,1.0683724329900115,-660,-500721,-499854.2,0.005745517694094834,-441.18925396215405,-0.053344314151213296
2023-09-20T00:00:00-04:00,1.06796,1.0680399999999999,1.06784,1.0679,1.068828665216,1.0681353333333334,1.0682944444444376,1.0684228888888834,1.0683140000000058,1.0682041999999992,1.0685613000000045,1.0681400500000062,1.0681738559646707,1.068309946392009,-538,-501259,-500280.6,0.0012748188511384577,-441.2194798133095,-0.06644145197967344
2023-09-20T00:15:00-04:00,1.0679,1.06798,1.06788,1.06789,1.0687675453030399,1.0680544444444444,1.0681766666666597,1.0683546666666612,1.068303000000006,1.0681957999999991,1.0685557000000045,1.0681455500000063,1.0681170847717365,1.0682479571136068,-417,-501676,-500607.8,-0.0037264583443544007,-441.22338467331514,-0.09916272978156704
2023-09-20T00:30:00-04:00,1.06789,1.06811,1.06782,1.06783,1.0687100925848574,1.0679851111111112,1.0680944444444376,1.0682751111111055,1.068288500000006,1.068180799999999,1.0685500000000046,1.0681520500000063,1.0680596678173893,1.0681811656908853,-607,-502283,-501200,-0.012962531241582115,-441.2574893095604,-0.06925142948051723
2023-09-20T00:45:00-04:00,1.06783,1.06795,1.06783,1.06785,1.0686560870297659,1.0679362222222222,1.0680177777777708,1.068191333333328,1.0682745000000058,1.0681735999999993,1.0685458000000045,1.0681586500000064,1.0680177342539114,1.068122132552708,538,-501745,-501536.8,-0.01849902066608617,-441.2474127992545,-0.0645740917513691
2023-09-20T01:00:00-04:00,1.06785,1.06813,1.06784,1.06794,1.0686053218079798,1.0679206666666667,1.067978888888882,1.068112444444439,1.0682730000000058,1.0681717999999991,1.0685405000000046,1.0681643000000063,1.0680021874031291,1.068074106042166,720,-501025,-501597.6,-0.02326884475513666,-441.18673011910283,-0.03276263935823348
2023-09-20T01:15:00-04:00,1.06794,1.06816,1.0679,1.06811,1.0685576024995012,1.0679468888888888,1.0679699999999932,1.06804755555555,1.068261500000006,1.0681647999999992,1.0685382000000045,1.0681716500000065,1.0680237499225034,1.0680440848337327,636,-500389,-501423.6,-0.025577739075656317,-441.0854884763139,-0.007489304337250865
2023-09-20T01:30:00-04:00,1.06811,1.06839,1.06807,1.06816,1.0685127463495312,1.067984888888889,1.0679588888888822,1.0680039999999944,1.068252000000006,1.0681601999999992,1.0685389000000045,1.0681800500000065,1.0680509999380028,1.0680308678669859,1193,-499196,-500927.6,-0.025056400303079544,-441.02964216834926,-0.009361016980883773
2023-09-20T01:45:00-04:00,1.06816,1.06816,1.06791,1.06809,1.0684705815685593,1.0680111111111112,1.0679699999999932,1.0679791111111057,1.0682320000000058,1.068144399999999,1.0685398000000044,1.0681884500000063,1.0680587999504023,1.0680306942935887,-1395,-500591,-500589.2,-0.02548908689940242,-441.1210610569053,0.009363383552279421
2023-09-20T02:00:00-04:00,1.06809,1.06877,1.06725,1.06864,1.06725,1.068145111111111,1.0680455555555488,1.0679846666666613,1.068239500000006,1.0681407999999992,1.0685462000000046,1.0681988000000062,1.0681750399603218,1.0680621554348704,5755,-494836,-499207.4,-0.02007285604223704,-438.1575935588478,0.06367279673396138
2023-09-20T02:15:00-04:00,1.06864,1.0691599999999999,1.06859,1.06904,1.06725,1.068344,1.0681722222222154,1.0680233333333278,1.0682670000000059,1.0681521999999992,1.0685585000000044,1.0682104000000063,1.0683480319682574,1.068131324347896,2811,-492025,-497407.4,-0.012414286815722621,-437.1054150890171,0.10675156849891551
2023-09-20T02:30:00-04:00,1.06904,1.06928,1.06878,1.06923,1.06725,1.0685555555555555,1.0683211111111044,1.06809355555555,1.0683020000000059,1.068173999999999,1.0685734000000044,1.0682227500000063,1.068524425574606,1.0682314594783169,2635,-489390,-495207.6,-0.003262821618400087,-436.637097720163,0.12548108887618545
2023-09-20T02:45:00-04:00,1.06923,1.0693,1.06812,1.06817,1.0673718,1.0685253333333333,1.068358888888882,1.06817355555555,1.068280000000006,1.068178799999999,1.0685755000000043,1.0682293000000065,1.0684535404596849,1.0683119675826531,-2246,-491636,-493695.6,0.0009628152720755912,-438.86370939398404,0.03184027420095024
2023-09-20T03:00:00-04:00,1.06817,1.0684,1.06766,1.06767,1.0675260560000002,1.0683875555555555,1.068338888888882,1.0682473333333278,1.0682160000000058,1.068171799999999,1.0685736000000046,1.0682331000000063,1.068296832367748,1.0683595740661223,-4045,-495681,-492713.6,0.00365528520828219,-440.757134597838,-0.01685630004214721
2023-09-20T03:15:00-04:00,1.06767,1.06814,1.06752,1.06802,1.0693,1.0683237777777779,1.0683477777777708,1.068307777777772,1.0681885000000058,1.0681769999999988,1.0685750000000045,1.0682388000000063,1.0682414658941983,1.0683728592528976,3220,-492461,-492238.6,0.009392689305027352,-439.7015649929973,0.007491057550057121
2023-09-20T03:30:00-04:00,1.06802,1.06908,1.06797,1.06895,1.0692644,1.0684442222222221,1.0684411111111043,1.06836155555555,1.0682090000000057,1.068197999999999,1.0685826000000045,1.0682484500000065,1.0683831727153588,1.0683798874023178,3043,-489418,-491717.2,0.01715351504429654,-437.0518112430673,0.07864358539852394
2023-09-20T03:45:00-04:00,1.06895,1.06931,1.06877,1.06904,1.06752,1.068564,1.0685388888888818,1.0684051111111055,1.0682465000000056,1.068222999999999,1.0685943000000044,1.0682593000000065,1.068514538172287,1.068377909921854,2835,-486583,-491155.8,0.023630134238640313,-436.8131190685037,0.08238466147393574
2023-09-20T04:00:00-04:00,1.06904,1.06927,1.06895,1.06901,1.0675558,1.0686582222222223,1.0686411111111043,1.06846155555555,1.0682875000000058,1.068243199999999,1.0686064000000044,1.0682665000000062,1.0686136305378295,1.0684099279374828,-2398,-488981,-490624.8,0.028376647169638895,-436.88041308930735,0.08613506352461234
2023-09-20T04:15:00-04:00,1.06901,1.06956,1.06897,1.06934,1.0675908840000001,1.0687980000000001,1.0687188888888821,1.0685375555555499,1.0683415000000056,1.068268999999999,1.0686171000000044,1.0682784500000064,1.0687589044302637,1.068502342349986,2186,-486795,-488847.6,0.03494971493341674,-436.205601815325,0.06550381793680968
2023-09-20T04:30:00-04:00,1.06934,1.06969,1.06927,1.06939,1.0676696486400001,1.0689322222222222,1.068757777777771,1.06861955555555,1.0684115000000056,1.0682957999999991,1.0686235000000044,1.0682921000000063,1.068885123544211,1.0686310738799885,1903,-484892,-487333.8,0.036931354747144304,-436.116621696747,0.0327396542692577
2023-09-20T04:45:00-04:00,1.06939,1.06966,1.06936,1.06961,1.0677908697216,1.0691026666666668,1.0687999999999933,1.0686913333333279,1.0684940000000056,1.068329799999999,1.0686254000000044,1.0683109000000064,1.0690300988353687,1.0687604591039903,2059,-482833,-486016.8,0.03504348012129763,-435.6930344180182,0.03553959391338131
2023-09-20T05:00:00-04:00,1.06961,1.06998,1.06956,1.06987,1.0679048175383041,1.0693166666666667,1.068988888888882,1.0687813333333278,1.0685925000000056,1.0683681999999992,1.0686316000000045,1.0683301500000062,1.069198079068295,1.068897167283192,2102,-480731,-484846.4,0.032518187591451427,-435.1820818278215,0.159150696986438
2023-09-20T05:15:00-04:00,1.06987,1.06992,1.06931,1.06942,1.06807083213524,1.069402888888889,1.0691833333333267,1.0688897777777724,1.0686690000000056,1.0683981999999992,1.0686379000000044,1.068345400000006,1.069242463254636,1.0690229338265533,-1582,-482313,-483512.8,0.03743994880882098,-435.84748977458145,0.16390832373300182
2023-09-20T05:30:00-04:00,1.06942,1.06968,1.06932,1.06956,1.0682235655644208,1.069478222222222,1.0693544444444378,1.0690168888888834,1.0687555000000055,1.0684335999999994,1.0686477000000045,1.068362100000006,1.069305970603709,1.0691323470612422,1523,-480790,-482311.8,0.047680918810352975,-435.6481106718902,0.14419205632854223
2023-09-20T05:45:00-04:00,1.06956,1.06997,1.06935,1.06985,1.068364080319267,1.0695773333333334,1.0694544444444378,1.0691562222222166,1.0688555000000055,1.0684731999999995,1.0686598000000045,1.0683802500000061,1.0694147764829671,1.0692382776489935,1750,-479040,-481141.4,0.05579871828712212,-435.1736164873659,0.08419477056924092
2023-09-20T06:00:00-04:00,1.06985,1.07041,1.06985,1.07014,1.0684933538937258,1.0697144444444446,1.0695766666666602,1.0693115555555504,1.0689655000000056,1.0685197999999994,1.0686753000000044,1.0683998000000061,1.0695598211863737,1.0693442221191947,2124,-476916,-479958,0.056724097606853784,-434.5978722241512,0.10289605627479803
2023-09-20T06:15:00-04:00,1.07014,1.07028,1.06995,1.06997,1.0686850185043533,1.0697931111111112,1.0696833333333267,1.069450444444439,1.0690585000000055,1.0685599999999993,1.0686873000000043,1.068420050000006,1.069641856949099,1.0694329776953555,-1406,-478322,-479476.2,0.05637597285994494,-434.82122617783955,0.08980271466123534
2023-09-20T06:30:00-04:00,1.06997,1.07047,1.06992,1.07012,1.068857516653918,1.0698804444444445,1.0697699999999932,1.0695677777777726,1.0691565000000056,1.0686013999999993,1.0687058000000045,1.0684386500000063,1.0697374855592792,1.0695319821562843,1932,-476390,-478291.6,0.05780068762218987,-434.55037746245523,0.07294218863972197
2023-09-20T06:45:00-04:00,1.07012,1.0705,1.07008,1.07032,1.069051014655448,1.0699904444444444,1.0698733333333266,1.0696715555555503,1.0692680000000054,1.0686447999999993,1.0687201000000044,1.068458300000006,1.0698539884474234,1.069641585725027,1529,-474861,-477105.8,0.05734085407832509,-434.2646151180453,0.0869654662938568
2023-09-20T07:00:00-04:00,1.07032,1.07049,1.06987,1.06992,1.0692538726036853,1.0699997777777779,1.069907777777771,1.069762222222217,1.0693320000000053,1.0686785999999993,1.0687298000000043,1.0684749500000061,1.0698671907579387,1.0697320685800213,-1645,-476506,-476599,0.054143168110368914,-434.8793845327997,0.0289825263413798
2023-09-20T07:15:00-04:00,1.06992,1.07,1.06971,1.06995,1.0694283304391694,1.0700082222222222,1.06991666666666,1.069830222222217,1.0693775000000054,1.0687131999999993,1.0687347000000045,1.0684897500000061,1.069883752606351,1.0697968548640169,1461,-475045,-476224.8,0.05148600032353684,-434.83841885312273,0.007477544000659702
2023-09-20T07:30:00-04:00,1.06995,1.07028,1.06993,1.07022,1.0695783641776857,1.0700688888888887,1.070005555555549,1.0698946666666616,1.0694270000000055,1.0687519999999993,1.0687309000000045,1.0685046000000062,1.0699510020850806,1.0698586838912132,1405,-473640,-475288.4,0.049501798264261154,-434.4838695751191,0.07480690467729348
2023-09-20T07:45:00-04:00,1.07022,1.07049,1.07011,1.07015,1.0697073931928096,1.0700977777777776,1.0700711111111043,1.0699548888888837,1.0695260000000055,1.0687927999999993,1.0687321000000045,1.068518950000006,1.0699908016680646,1.0699093471129704,-1656,-475296,-475069.6,0.05222922619284939,-434.59218375351236,0.055162870713178165
2023-09-20T08:00:00-04:00,1.07015,1.07036,1.0697,1.0697699999999999,1.0705,1.0700375555555555,1.0700622222222154,1.0699926666666615,1.0696310000000055,1.0688257999999993,1.0687280000000043,1.0685334000000062,1.0699466413344516,1.069927877690376,-1982,-477278,-475553,0.04706528722494106,-435.295972941944,-0.007477683787454317
2023-09-20T08:15:00-04:00,1.0697699999999999,1.07035,1.06965,1.06998,1.07049,1.070021111111111,1.0700444444444375,1.0700199999999946,1.0697290000000055,1.0688627999999993,1.0687234000000043,1.0685467500000063,1.0699533130675614,1.0699451021523008,2323,-474955,-475242.8,0.03799204010245666,-434.83995903241197,-0.014951314781258527
2023-09-20T08:30:00-04:00,1.06998,1.06998,1.06921,1.06979,1.0704563999999999,1.0699702222222223,1.0700244444444376,1.0700415555555503,1.0697710000000056,1.0688991999999993,1.0687149000000042,1.0685604000000062,1.069920650454049,1.0699524817218402,-2676,-477631,-475760,0.026838055107057723,-435.31514548449496,-0.016822901576686165
2023-09-20T08:45:00-04:00,1.06979,1.07013,1.06954,1.06979,1.070381616,1.0699233333333333,1.0699877777777709,1.0700379999999947,1.0698085000000055,1.0689281999999993,1.0687041000000044,1.0685754500000062,1.0698945203632393,1.069941185377472,0,-477631,-476558.2,0.021415335089460374,-435.31514548449496,-0.030837663065818924
2023-09-20T09:00:00-04:00,1.06979,1.07098,1.0697,1.07092,1.06921,1.070109777777778,1.0700544444444378,1.0700346666666616,1.0699040000000057,1.0689795999999994,1.0686979000000043,1.0685956000000063,1.0700996162905914,1.0699629483019772,3717,-473914,-476281.8,0.02052335215663882,-431.38894501524373,0.05605800134540661
2023-09-20T09:15:00-04:00,1.07092,1.07096,1.07031,1.07052,1.0692454,1.070202888888889,1.0701211111111044,1.0700464444444393,1.0699630000000055,1.0690201999999993,1.0686891000000045,1.0686153500000062,1.070183693032473,1.0700103586415817,-2953,-476867,-476199.6,0.015670758302916837,-432.49192189493647,0.05607895917451155
2023-09-20T09:30:00-04:00,1.07052,1.0714,1.07035,1.07105,1.069280092,1.0703886666666667,1.0702433333333266,1.0700862222222172,1.0700460000000056,1.0690713999999992,1.0687029000000043,1.0686379000000061,1.0703569544259786,1.0700910869132652,4349,-472518,-475712.2,0.01862012584628302,-430.33879070635464,0.10280854245526436
2023-09-20T09:45:00-04:00,1.07105,1.07183,1.071,1.0717,1.06936488832,1.0706799999999999,1.0704077777777712,1.070162888888884,1.0701505000000056,1.0691355999999994,1.0687202000000042,1.0686648000000063,1.0706255635407829,1.070232069530612,4088,-468430,-473872,0.02469226997141202,-427.8578607777797,0.13828932369046998
2023-09-20T10:00:00-04:00,1.0717,1.07272,1.07159,1.07206,1.0695127950207999,1.0710104444444444,1.0706199999999935,1.0702893333333283,1.0702600000000055,1.0692061999999993,1.0687555000000044,1.0686932000000062,1.0709124508326262,1.0704356556244894,5128,-463302,-471006.2,0.03098099360781227,-426.1352891625893,0.17847965238518698
2023-09-20T10:15:00-04:00,1.07206,1.07208,1.07128,1.07177,1.0697693714191359,1.0712404444444443,1.0708422222222156,1.070446888888884,1.0703775000000055,1.0692693999999994,1.0687836000000044,1.0687181500000063,1.071083960666101,1.0706325244995913,-3573,-466875,-469598.4,0.0376607701129146,-427.10181155872425,0.1869560746702564
2023-09-20T10:30:00-04:00,1.07177,1.07237,1.07172,1.07224,1.070005421705605,1.07152,1.0710933333333268,1.0706413333333287,1.0705115000000056,1.0693351999999994,1.0688120000000043,1.0687500500000062,1.0713151685328808,1.0708588195996729,3161,-463714,-466967.8,0.04818550351249971,-425.71562795589847,0.21121890128788864
2023-09-20T10:45:00-04:00,1.07224,1.07227,1.07168,1.07195,1.0702225879691565,1.071691333333333,1.0713333333333268,1.0708593333333287,1.0706165000000056,1.0694027999999993,1.0688399000000046,1.0687814000000062,1.0714421348263046,1.071075855679738,-3055,-466769,-465818,0.05595097984293165,-426.541888867635,0.20190878583646693
2023-09-20T11:00:00-04:00,1.07195,1.07245,1.07154,1.07217,1.070422380931624,1.0718586666666665,1.0715977777777712,1.0710973333333287,1.0707180000000054,1.0694753999999993,1.0688746000000044,1.0688102000000064,1.0715877078610436,1.0712682845437902,3126,-463643,-464860.6,0.06785563388136226,-425.90032909339146,0.22247356957908082
2023-09-20T11:15:00-04:00,1.07217,1.07219,1.07155,1.07171,1.070606190457094,1.071881111111111,1.071685555555549,1.0713104444444397,1.0708050000000056,1.0695437999999995,1.0689057000000046,1.0688341500000063,1.071612166288835,1.071408227635032,-2362,-466005,-465401.2,0.0787998970031252,-426.9137131649476,0.07376834870950644
2023-09-20T11:30:00-04:00,1.07171,1.072,1.07142,1.07157,1.0707752952205265,1.0718579999999998,1.0718022222222157,1.0715024444444397,1.0708775000000055,1.0696113999999994,1.0689319000000044,1.0688579000000062,1.071603733031068,1.0715121821080253,-2361,-468366,-465699.4,0.07774927326863314,-427.22213615250956,0.09808317453200271
2023-09-20T11:45:00-04:00,1.07157,1.07188,1.07134,1.07142,1.0709308716028845,1.0717815555555557,1.0718433333333268,1.0716524444444397,1.0709325000000054,1.0696745999999995,1.0689565000000045,1.0688839000000063,1.0715669864248543,1.0715625456864202,-2058,-470424,-467041.4,0.08036828720944371,-427.5102181256889,0.03454553942392805
2023-09-20T12:00:00-04:00,1.07142,1.07257,1.07137,1.07256,1.0710740018746536,1.0719248888888888,1.0719388888888826,1.071773555555551,1.0710645000000054,1.0697659999999996,1.0689914000000045,1.0689141000000062,1.0717655891398834,1.0716272365491357,2296,-468128,-467313.2,0.08449967787439863,-425.0672545819807,0.08024633759446308
2023-09-20T12:15:00-04:00,1.07256,1.07367,1.07251,1.07367,1.0712056817246813,1.0722711111111112,1.0721177777777713,1.071877555555551,1.0712505000000054,1.0698801999999994,1.0690447000000045,1.068947950000006,1.0721464713119067,1.0717389892393085,2196,-465932,-467771,0.08620597680567858,-422.7945985067962,0.15017816167004544
2023-09-20T12:30:00-04:00,1.07367,1.07368,1.07334,1.07356,1.07137,1.0725595555555556,1.0723166666666601,1.0720037777777733,1.0714175000000055,1.0699933999999995,1.0690988000000043,1.068979050000006,1.0724291770495253,1.0719023913914465,-1822,-467754,-468120.8,0.08414757026800514,-422.9812666636784,0.1670134450488613
2023-09-20T12:45:00-04:00,1.07356,1.07363,1.0732,1.07351,1.0716472,1.072798222222222,1.0724577777777713,1.0721348888888844,1.0715855000000056,1.0701057999999994,1.0691508000000045,1.0690091000000062,1.0726453416396202,1.0721107131131569,-1890,-469644,-468376.4,0.08575291109288703,-423.06929155283245,0.11844363202267051
2023-09-20T13:00:00-04:00,1.07351,1.07352,1.0729899999999999,1.0731,1.0718911359999999,1.0729266666666666,1.0725855555555492,1.0722833333333288,1.0717520000000056,1.0702111999999995,1.0691960000000045,1.0690365000000062,1.072736273311696,1.0723445704905252,-1705,-471349,-468561.4,0.08065831260095602,-423.72047319063745,0.10728112318671434
2023-09-20T13:15:00-04:00,1.0731,1.07354,1.0729,1.073,1.0721057996799999,1.0730095555555554,1.0726777777777714,1.0724311111111067,1.0719030000000056,1.0703141999999994,1.0692439000000042,1.0690590500000061,1.072789018649357,1.07254925639242,-1802,-473151,-469566,0.07609280950297978,-423.88839789476566,0.07741309680366792
2023-09-20T13:30:00-04:00,1.073,1.07307,1.07244,1.07267,1.0722947037183999,1.0730079999999997,1.072784444444438,1.07256444444444,1.0720470000000055,1.0704087999999996,1.0692903000000042,1.069074800000006,1.0727652149194855,1.0726730051139357,-1775,-474926,-471364.8,0.06879830196557407,-424.43429724238905,0.08957647124689254
2023-09-20T13:45:00-04:00,1.07267,1.07288,1.0725,1.0726499999999999,1.07244,1.072981111111111,1.072904444444438,1.0726819999999957,1.0721900000000055,1.0704995999999996,1.0693322000000043,1.069091100000006,1.0727421719355883,1.0727356040911484,-2013,-476939,-473201.8,0.06485416142008064,-424.4718297547183,0.1007866961561046
2023-09-20T14:00:00-04:00,1.0726499999999999,1.0726499999999999,1.06737,1.06854,1.07368,1.0721082222222225,1.0725844444444381,1.072707333333329,1.0720710000000055,1.0705071999999995,1.0693337000000043,1.0690914000000062,1.0719017375484707,1.0725868832729186,-19114,-496053,-478483.6,0.04214577427338021,-497.70964264801705,-0.26880215041720273
2023-09-20T14:15:00-04:00,1.06854,1.07034,1.0682,1.06974,1.0735538,1.0715393333333334,1.0722711111111045,1.07264444444444,1.0720320000000056,1.0705401999999995,1.0693423000000044,1.0690964500000062,1.0714693900387766,1.0723335066183346,8934,-487119,-481637.6,0.0317176014032866,-487.6765133313805,-0.26292235399418634
2023-09-20T14:30:00-04:00,1.06974,1.07179,1.06924,1.07001,1.073430124,1.071087111111111,1.0718644444444378,1.0724817777777733,1.0719800000000057,1.0705675999999997,1.0693542000000043,1.0691016000000062,1.0711775120310212,1.0720112052946675,16624,-470495,-481106.4,0.010195174284419446,-483.48065265495455,-0.3408868646790911
2023-09-20T14:45:00-04:00,1.07001,1.07032,1.06843,1.06866,1.07330892152,1.070446222222222,1.0713199999999936,1.0721888888888844,1.0718280000000058,1.0705599999999997,1.0693561000000043,1.0690988000000061,1.0706740096248168,1.0715929642357338,-10099,-480594,-482240,-0.02592825922548033,-496.22226254645057,-0.4564253511680881
2023-09-20T15:00:00-04:00,1.06866,1.06889,1.06745,1.0675999999999999,1.0731901430896,1.0697022222222223,1.0706633333333269,1.0717406666666622,1.0716050000000057,1.0705273999999998,1.0693507000000044,1.0690889500000063,1.0700592076998534,1.0710563713885866,-7203,-487797,-484411.6,-0.06333051311377572,-503.36689226965575,-0.5505305027433449
2023-09-20T15:15:00-04:00,1.0675999999999999,1.06785,1.06701,1.06784,1.073073740227808,1.0691375555555553,1.0700788888888824,1.0712395555555512,1.0714085000000055,1.0705207999999997,1.0693498000000043,1.0690811000000062,1.0696153661598826,1.070599097110869,5284,-482513,-481703.6,-0.09750692668489956,-502.17903164769984,-0.49016867020781313
2023-09-20T15:30:00-04:00,1.06784,1.06784,1.06622,1.06627,1.0728311906186958,1.0683757777777778,1.0693311111111048,1.0706515555555511,1.0711100000000058,1.0704927999999996,1.0693323000000043,1.0690659500000061,1.068946292927906,1.070094477688695,-4011,-486524,-481584.6,-0.13684270424133885,-508.07623534862824,-0.6272134203168596
2023-09-20T15:45:00-04:00,1.06627,1.06656,1.06576,1.06585,1.072434519181574,1.0676795555555554,1.068573333333327,1.069993333333329,1.0708050000000058,1.0704493999999998,1.0693132000000043,1.0690517000000062,1.0683270343423248,1.0695243821509557,-2960,-489484,-485382.4,-0.175235291632412,-509.2421689301791,-0.6357966569401632
2023-09-20T16:00:00-04:00,1.06585,1.06592,1.065,1.06544,1.0719005576470482,1.0670528888888888,1.0677722222222157,1.0692837777777733,1.0704685000000056,1.0703791999999996,1.0692886000000044,1.0690367000000063,1.0677496274738598,1.0689395057207645,-1963,-491447,-487553,-0.2138643527086781,-509.99727518340427,-0.6721670628816426
2023-09-20T16:15:00-04:00,1.06544,1.06624,1.06538,1.06611,1.0712105018823435,1.0667204444444445,1.067502222222216,1.0686515555555514,1.0701885000000055,1.0703205999999996,1.0692718000000045,1.0690265000000063,1.067421701979088,1.068412004576611,1307,-490140,-488021.6,-0.24806589225211673,-509.1753706181543,-0.22741310573307075
2023-09-20T16:30:00-04:00,1.06611,1.06622,1.0659399999999999,1.06596,1.070589451694109,1.066412,1.0670822222222158,1.068052222222218,1.0699080000000056,1.0702595999999995,1.0692514000000046,1.0690161000000062,1.0671293615832704,1.0679148036612887,-504,-490644,-489647.8,-0.24665182892695314,-509.246282625358,-0.35335689045935414
2023-09-20T16:45:00-04:00,1.06596,1.0661,1.06591,1.06605,1.0700305065246982,1.0662055555555556,1.0666422222222156,1.06751444444444,1.0696395000000056,1.0701937999999998,1.0692314000000045,1.0690072500000063,1.0669134892666163,1.0675082429290306,1311,-489333,-490209.6,-0.25663488722703987,-509.13559366892446,-0.37008999915888297
2023-09-20T17:00:00-04:00,1.06605,1.06605,1.06521,1.06602,1.0695274558722283,1.066081111111111,1.0663488888888826,1.0670695555555514,1.0693125000000054,1.0701263999999997,1.0692111000000046,1.0689963000000062,1.066734791413293,1.0671897943432245,-61,-489394,-490191.6,-0.2699608750416614,-509.1373102863439,-0.2470383470888754
2023-09-20T17:15:00-04:00,1.06602,1.06615,1.06601,1.06605,1.0690747102850056,1.0660213333333333,1.0661766666666601,1.06675044444444,1.0689315000000055,1.0700551999999997,1.0691925000000044,1.0689838500000064,1.0665978331306343,1.0669594354745793,46,-489348,-489771.8,-0.2654561002656515,-509.13601575153217,-0.14518546272011432
2023-09-20T17:30:00-04:00,1.06605,1.06627,1.06601,1.06626,1.068667239256505,1.0660379999999998,1.0660011111111047,1.0664502222222179,1.0685665000000057,1.0699829999999997,1.0691756000000046,1.0689731500000064,1.0665302665045073,1.0667811483796632,441,-488907,-489525.2,-0.24506691723570015,-509.04914365360054,-0.1479622415343043
2023-09-20T17:45:00-04:00,1.06626,1.06643,1.06625,1.06635,1.0683005153308547,1.0661077777777777,1.0660099999999935,1.0662357777777733,1.0682085000000057,1.0699215999999996,1.0691599000000045,1.0689616000000062,1.066494213203606,1.0666541187037304,188,-488719,-489140.2,-0.22695751075845205,-509.0332751037159,0.007502790100055142
2023-09-20T18:00:00-04:00,1.06635,1.06641,1.0659399999999999,1.0659399999999999,1.0679704637977692,1.0660937777777777,1.0660199999999935,1.066111333333329,1.0678505000000056,1.0698491999999995,1.0691414000000043,1.0689464500000063,1.0663833705628847,1.0665480949629838,-350,-489069,-489087.4,-0.19637442705338362,-509.1678463045411,0.008443964910627525
2023-09-20T18:15:00-04:00,1.0659399999999999,1.06596,1.06568,1.06569,1.0676734174179923,1.0660277777777778,1.0660477777777713,1.0660511111111066,1.0674850000000056,1.0697659999999996,1.0691196000000045,1.0689295500000062,1.0662446964503078,1.066450075970387,-507,-489576,-489123.8,-0.16489093641689356,-509.2867554363871,0.023464484156788135
2023-09-20T18:30:00-04:00,1.06569,1.06572,1.06525,1.06547,1.067406075676193,1.0659122222222221,1.0659766666666601,1.0660111111111064,1.0671250000000057,1.0696725999999996,1.0690962000000044,1.0689110500000063,1.0660897571602463,1.0663484607763094,-761,-490337,-489321.6,-0.13107194814916248,-509.4438555311615,-0.06003132884974102
2023-09-20T18:45:00-04:00,1.06547,1.06564,1.06531,1.0655,1.0671654681085736,1.0658168888888888,1.0659255555555491,1.0659959999999953,1.0667675000000056,1.0695831999999996,1.0690716000000047,1.0688928000000062,1.065971805728197,1.0662367686210472,841,-489496,-489439.4,-0.10483309532287646,-509.42017584050853,-0.04315358925289194
2023-09-20T19:00:00-04:00,1.0655,1.06552,1.0651,1.0652,1.0669489212977163,1.0656717777777778,1.0658311111111045,1.0659602222222175,1.0666005000000056,1.0694847999999997,1.0690431000000045,1.0688732000000063,1.0658174445825577,1.0661014148968377,-715,-490211,-489737.8,-0.07873467392521126,-509.62148977762723,-0.07973359598518057
2023-09-20T19:15:00-04:00,1.0652,1.06537,1.06514,1.06535,1.0667540291679447,1.0655755555555555,1.0657566666666602,1.065907555555551,1.0663810000000056,1.0693853999999996,1.0690151000000043,1.0688533500000061,1.065723955666046,1.0659695319174698,642,-489569,-489837.8,-0.07106641139824207,-509.5310842199854,-0.06285060317817193
2023-09-20T19:30:00-04:00,1.06535,1.06537,1.06512,1.06515,1.0665786262511503,1.065454222222222,1.0656566666666605,1.0658293333333286,1.0661380000000054,1.0692899999999996,1.0689843000000046,1.0688332000000063,1.065609164532837,1.0658424255339756,-640,-490209,-489964.4,-0.0587421743712344,-509.6512325280532,-0.08442380751370958
2023-09-20T19:45:00-04:00,1.06515,1.06522,1.06475,1.06498,1.0664207636260352,1.065318888888889,1.0655144444444382,1.0657368888888843,1.0659540000000054,1.0691905999999995,1.0689519000000045,1.0688121000000061,1.0654833316262695,1.0657211404271802,-912,-491121,-490121.2,-0.04632446151306694,-509.7967894918611,-0.12004576744883498
2023-09-20T20:00:00-04:00,1.06498,1.06501,1.06456,1.06492,1.066220271990911,1.0652,1.0653555555555494,1.0656228888888843,1.0658200000000053,1.0690845999999994,1.0689183000000044,1.0687904500000063,1.0653706653010155,1.065600912341744,-1662,-492783,-490778.6,-0.04219531808413427,-509.8904250530922,-0.13410231162374647
2023-09-20T20:15:00-04:00,1.06492,1.06504,1.06403,1.06409,1.0659878339121835,1.064946888888889,1.0651499999999938,1.0654866666666623,1.0656325000000053,1.0689633999999995,1.0688781000000045,1.0687657500000063,1.0651145322408124,1.065460329873395,-1890,-494673,-491671,-0.047724602991022644,-511.3634934525966,-0.17355573484435405
2023-09-20T20:30:00-04:00,1.06409,1.06413,1.06339,1.0634,1.0656745804862342,1.0645968888888888,1.0648955555555493,1.0653144444444402,1.0654890000000055,1.0688359999999997,1.0688309000000045,1.068737250000006,1.0647716257926498,1.0652698638987155,-2633,-497306,-493218.4,-0.051729416049528756,-513.0708396357204,-0.2148842533945261
2023-09-20T20:45:00-04:00,1.0634,1.06347,1.06297,1.06312,1.0652633559987121,1.0642417777777777,1.0646344444444382,1.0651099999999958,1.0653525000000055,1.0686987999999995,1.0687808000000043,1.068707150000006,1.0644413006341198,1.0650362911189721,-2666,-499972,-495171,-0.061780100031500515,-513.7728144335383,-0.2205599406834404
2023-09-20T21:00:00-04:00,1.06312,1.06336,1.06276,1.06324,1.0648046847989696,1.063962888888889,1.064383333333327,1.0648837777777733,1.0652425000000054,1.0685677999999994,1.0687335000000042,1.0686768500000061,1.064201040507296,1.0647798328951774,2754,-497218,-496390.4,-0.07105406322382155,-513.4619558286774,-0.21210699202251798
2023-09-20T21:15:00-04:00,1.06324,1.06367,1.0631599999999999,1.06364,1.0643957478391757,1.0638142222222222,1.0642099999999937,1.0646546666666623,1.0651190000000053,1.0684447999999995,1.0686865000000043,1.0686486000000064,1.0640888324058366,1.0645234663161416,2058,-495160,-496865.8,-0.08047481077153101,-512.6877185915532,-0.14645137063462316
2023-09-20T21:30:00-04:00,1.06364,1.06372,1.0633299999999999,1.06369,1.0640685982713405,1.0637102222222223,1.0640255555555493,1.0644297777777734,1.0650055000000056,1.0683001999999993,1.0686399000000042,1.0686205000000062,1.0640090659246693,1.064302373052913,1945,-493215,-496574.2,-0.08384128280003841,-512.5962872802071,-0.15581733702539022
2023-09-20T21:45:00-04:00,1.06369,1.06396,1.06364,1.06375,1.06276,1.0636551111111112,1.0638699999999937,1.0642246666666622,1.0648905000000055,1.0681647999999995,1.0685925000000043,1.0685933000000063,1.0639572527397354,1.0641394984423302,1679,-491536,-495420.2,-0.088991793008679,-512.5015792355701,-0.13143688682345847
2023-09-20T22:00:00-04:00,1.06375,1.06415,1.0637,1.06387,1.062784,1.0636551111111112,1.0637466666666606,1.0640471111111067,1.0647830000000056,1.0680211999999996,1.0685463000000042,1.0685655500000062,1.0639398021917883,1.0640391987538638,1571,-489965,-493418.8,-0.09127221210548205,-512.3243571439131,-0.10422730943303576
2023-09-20T22:15:00-04:00,1.06387,1.06397,1.06323,1.0633299999999999,1.06283864,1.0635717777777778,1.0635699999999937,1.0638844444444402,1.0646470000000055,1.0678537999999995,1.0684947000000045,1.068535650000006,1.0638178417534305,1.0639625590030908,-1147,-491112,-492197.6,-0.09474936032419876,-512.906552336935,-0.14930699019646568
2023-09-20T22:30:00-04:00,1.0633299999999999,1.06337,1.06167,1.06198,1.06415,1.0632537777777777,1.0633355555555493,1.0637095555555511,1.0644330000000055,1.0676521999999995,1.0684292000000044,1.0685015000000062,1.0634502734027445,1.0638348472024723,-2989,-494101,-491985.8,-0.1041784090479824,-516.70137614516,-0.19829149789961906
2023-09-20T22:45:00-04:00,1.06198,1.06273,1.06198,1.06271,1.0641003999999998,1.0631286666666666,1.0632588888888828,1.0635562222222181,1.0642510000000054,1.0674709999999994,1.0683702000000044,1.068470800000006,1.0633022187221957,1.0636934777619778,2545,-491556,-491654,-0.10127790824433588,-514.9519552521109,-0.0648862140304549
2023-09-20T23:00:00-04:00,1.06271,1.06321,1.0627,1.06311,1.0640517919999999,1.0630988888888888,1.0632577777777714,1.0634337777777736,1.0641095000000054,1.0672883999999994,1.0683118000000043,1.068444100000006,1.0632637749777565,1.0635547822095819,1550,-490006,-491348,-0.08951979427342077,-514.3685411504275,-0.0009406275867320257
2023-09-20T23:15:00-04:00,1.06311,1.06354,1.06302,1.06347,1.06400415616,1.0631413333333333,1.063283333333327,1.0633411111111069,1.0639985000000054,1.0671187999999994,1.0682608000000045,1.0684201000000062,1.0633050199822052,1.0634278257676653,1222,-488784,-491111.8,-0.07518685955105209,-513.9547363701132,0.021631992776790985
2023-09-20T23:30:00-04:00,1.06347,1.06379,1.06345,1.06374,1.0639574730368,1.0632326666666665,1.063294444444438,1.0632859999999957,1.0639120000000053,1.0669501999999993,1.0682128000000044,1.0683977000000062,1.0633920159857642,1.063342660614132,1282,-487502,-490389.8,-0.06176682386208004,-513.6292546922098,0.00940167725922201
2023-09-20T23:45:00-04:00,1.06374,1.0637699999999999,1.06357,1.06365,1.063911723576064,1.0633037777777778,1.0632899999999939,1.0632768888888846,1.0638195000000055,1.0667889999999993,1.0681664000000044,1.0683741000000062,1.0634436127886113,1.0633413284913054,-1030,-488532,-489276,-0.05353172896273814,-513.7164000472777,-0.003760494128932302
2023-09-21T00:00:00-04:00,1.06365,1.06372,1.06336,1.06341,1.0638668891045426,1.0633277777777779,1.0632522222222158,1.0632755555555513,1.0637300000000054,1.0666257999999993,1.0681186000000045,1.0683480500000062,1.063436890230889,1.063368262793044,-1054,-489586,-488882,-0.04681331077248224,-513.9542226392958,-0.03196239717978914
2023-09-21T00:15:00-04:00,1.06341,1.06357,1.06332,1.06357,1.0638229513224517,1.0633913333333334,1.0632188888888825,1.0632677777777733,1.0636410000000054,1.0664687999999993,1.0680717000000044,1.0683234000000064,1.0634635121847111,1.063408210234435,829,-488757,-488632.2,-0.04121197036260289,-513.8294918205148,-0.02819893408030953
2023-09-21T00:30:00-04:00,1.06357,1.06371,1.06353,1.06353,1.0637798922960027,1.0634535555555555,1.0632411111111049,1.063259333333329,1.0635600000000054,1.0662881999999996,1.0680271000000046,1.068299000000006,1.063476809747769,1.063442568187548,-760,-489517,-488778.8,-0.03626375840254623,-513.8580748004784,0.01880883639135546
2023-09-21T00:45:00-04:00,1.06353,1.06374,1.06344,1.0637,1.06167,1.0635453333333333,1.0634322222222161,1.0632868888888845,1.0634960000000055,1.0660887999999995,1.0679845000000043,1.0682753000000063,1.0635214477982151,1.0634684545500381,1068,-488449,-488968.2,-0.026295170338568503,-513.6873602931303,0.1619616188628944
2023-09-21T01:00:00-04:00,1.0637,1.06374,1.06326,1.06371,1.0617113999999999,1.0636008888888888,1.0635433333333273,1.063337555555551,1.0634355000000055,1.0658917999999995,1.0679426000000043,1.0682519500000063,1.0635591582385722,1.0634915636400302,1274,-487175,-488696.8,-0.004343225888272814,-513.675383231929,0.0940990486586077
2023-09-21T01:15:00-04:00,1.06371,1.06376,1.0635,1.06351,1.061751972,1.063594222222222,1.0635877777777716,1.0634046666666621,1.0634065000000053,1.0656917999999995,1.0678988000000045,1.068227250000006,1.0635493265908578,1.063514050912024,-912,-488087,-488397,0.00949301054731619,-513.8468585400486,0.037625457384462185
2023-09-21T01:30:00-04:00,1.06351,1.06368,1.06329,1.06361,1.06183229312,1.0635986666666668,1.063603333333327,1.0634815555555512,1.0634170000000052,1.0655019999999995,1.0678566000000043,1.0682033000000062,1.0635614612726862,1.063533640729619,1461,-486626,-487970.8,0.016344449649046067,-513.709483245035,0.013164452217742767
2023-09-21T01:45:00-04:00,1.06361,1.06387,1.06334,1.06347,1.0619094013952,1.063572,1.063573333333327,1.063547999999996,1.0634345000000052,1.0653113999999995,1.0678128000000044,1.0681793000000062,1.063543169018149,1.0635469125836952,-1553,-488179,-487703.2,0.01603094420047198,-513.9139002775939,-0.02538214225280543
2023-09-21T02:00:00-04:00,1.06347,1.06426,1.06336,1.06391,1.062027037311488,1.0636393333333334,1.0636022222222161,1.0635819999999958,1.0634680000000052,1.0651361999999995,1.0677725000000045,1.0681565000000062,1.063616535214519,1.063565930066956,3267,-484912,-486995.8,0.014091507482559966,-512.562211936597,0.02444413105814196
2023-09-21T02:15:00-04:00,1.06391,1.06426,1.06376,1.0642,1.0622056743265689,1.0637588888888887,1.0636899999999938,1.0636113333333292,1.063496000000005,1.0649671999999994,1.0677334000000043,1.068135800000006,1.0637332281716152,1.0636007440535644,2440,-482472,-486055.2,0.014964027231013753,-511.89711808467314,0.0742893145635332
2023-09-21T02:30:00-04:00,1.0642,1.06471,1.06411,1.06452,1.0623700203804434,1.063924888888889,1.0637955555555494,1.0636528888888848,1.0635375000000051,1.0648867999999994,1.0676970000000043,1.0681179500000062,1.0638905825372922,1.0636689952428513,2202,-480270,-484491.8,0.02146013063256168,-511.23498690632346,0.08932181238658542
2023-09-21T02:45:00-04:00,1.06452,1.06546,1.0644,1.06503,1.062604018342399,1.0641717777777777,1.063962222222216,1.0637246666666627,1.0636015000000052,1.0647925999999994,1.0676664000000045,1.068103100000006,1.0641184660298337,1.0637803961942809,2985,-477285,-482623.6,0.02918635480852644,-509.8049057429822,0.1410397450001255
2023-09-21T03:00:00-04:00,1.06503,1.06503,1.06386,1.06412,1.0629467361413112,1.0642033333333334,1.0640088888888828,1.0638117777777738,1.0636140000000052,1.0646747999999995,1.0676212000000043,1.068083700000006,1.064118772823867,1.0638955169554243,-3698,-480983,-481184.4,0.03307642543612686,-512.9646101644538,0.03948481714767932
2023-09-21T03:15:00-04:00,1.06412,1.06483,1.0639399999999999,1.06441,1.0632483278043539,1.0642835555555554,1.0640866666666604,1.0639086666666626,1.063668000000005,1.0645897999999994,1.0675749000000043,1.0680667000000061,1.0641770182590937,1.0640076135643395,2825,-478158,-479833.6,0.037333194846908016,-512.1947251890748,0.06580740991437
2023-09-21T03:30:00-04:00,1.06441,1.06572,1.0639,1.06468,1.0635137284678313,1.0644022222222222,1.0642166666666606,1.064013999999996,1.063803000000005,1.0645313999999992,1.0675294000000044,1.068051400000006,1.064277614607275,1.0641164908514713,8455,-469703,-477279.8,0.04040640987323533,-510.05001591351373,0.11001306992883146
2023-09-21T03:45:00-04:00,1.06468,1.06581,1.06468,1.06551,1.0638226064823348,1.0646608888888889,1.0644277777777715,1.0641404444444404,1.063943000000005,1.0644847999999993,1.0675028000000042,1.068039150000006,1.06452409168582,1.0642431926811766,4481,-465222,-474270.2,0.0433989195927307,-506.55673154638043,0.17863690638486032
2023-09-21T04:00:00-04:00,1.06551,1.06617,1.0653,1.06575,1.0639,1.0649253333333333,1.064681111111105,1.0642842222222182,1.064075000000005,1.0644743999999993,1.0674836000000043,1.0680286000000059,1.064769273348656,1.0643733541449412,4292,-460930,-470999.2,0.04990017726893887,-505.58998322867336,0.2143925075460577
2023-09-21T04:15:00-04:00,1.06575,1.06637,1.06569,1.06574,1.0643086000000002,1.0651371111111112,1.0648844444444385,1.0644593333333294,1.064188500000005,1.0644721999999993,1.0674608000000043,1.0680179000000058,1.0649634186789247,1.0645422833159528,-3325,-464255,-467653.6,0.059457006771538604,-505.62118191504464,0.17200703066988735
2023-09-21T04:30:00-04:00,1.06574,1.06582,1.0652,1.0653299999999999,1.06472088,1.0652262222222222,1.0650099999999938,1.0646439999999961,1.064268000000005,1.0644699999999994,1.0674246000000043,1.0680036000000057,1.0650367349431398,1.0647142266527618,-3160,-467415,-465505,0.06447239486173616,-506.8368630380203,0.1061830482991781
2023-09-21T04:45:00-04:00,1.0653299999999999,1.06582,1.06528,1.06555,1.0650507040000001,1.0653342222222222,1.0651244444444383,1.0648255555555515,1.064363000000005,1.0644587999999993,1.067389700000004,1.067992000000006,1.065139387954512,1.064886581322209,2832,-464583,-464481,0.06905311685316463,-506.2520301693314,0.0967572239131333
2023-09-21T05:00:00-04:00,1.06555,1.06646,1.06534,1.06624,1.0652,1.0655573333333332,1.0652588888888828,1.064991777777774,1.0645045000000053,1.0644643999999992,1.0673620000000044,1.067984200000006,1.0653595103636095,1.065053665057767,3087,-461496,-463735.8,0.07361710694096506,-504.2530343455782,0.11361182314114678
2023-09-21T05:15:00-04:00,1.06624,1.06643,1.06571,1.06586,1.06528,1.0656775555555558,1.065452222222216,1.0651459999999962,1.0646190000000053,1.0644605999999992,1.0673272000000045,1.067972150000006,1.0654596082908876,1.0651917320462134,-2848,-464344,-464418.6,0.07044657015269934,-505.2680403479793,0.16351539300079643
2023-09-21T05:30:00-04:00,1.06586,1.06622,1.06559,1.06612,1.06534,1.065811111111111,1.065642222222216,1.0652975555555517,1.0647485000000052,1.0644625999999993,1.0672945000000045,1.0679590000000059,1.06559168663271,1.0653173856369704,2637,-461707,-463909,0.07781827940177802,-504.6247851362256,0.16065238019183192
2023-09-21T05:45:00-04:00,1.06612,1.0663,1.06513,1.0653299999999999,1.06646,1.0657486666666667,1.0657144444444382,1.0654384444444407,1.0648300000000053,1.0644481999999993,1.0672517000000044,1.0679385500000058,1.065539349306168,1.0654179085095763,-2919,-464626,-463351.2,0.0784023470170421,-506.7877780450916,0.06105120787464941
2023-09-21T06:00:00-04:00,1.0653299999999999,1.06535,1.06469,1.0652,1.0664334,1.0656457777777777,1.0656799999999937,1.0655495555555519,1.0649045000000052,1.0644269999999991,1.0672050000000042,1.0679183000000059,1.0654714794449345,1.0654843268076608,-2970,-467596,-463953.8,0.07657254782735107,-507.1502009563021,-0.029094048859234778
2023-09-21T06:15:00-04:00,1.0652,1.06608,1.0652,1.06604,1.066363664,1.0657177777777778,1.065712222222216,1.0656402222222183,1.0650310000000052,1.0644207999999993,1.0671712000000042,1.067904550000006,1.0655851835559476,1.0655294614461284,2688,-464908,-464636.2,0.07112282033798625,-505.03048634871624,0.027210884353753084
2023-09-21T06:30:00-04:00,1.06604,1.06628,1.06521,1.0655999999999999,1.06629671744,1.0656953333333332,1.0656966666666605,1.0656891111111073,1.0651305000000053,1.0644139999999993,1.0671316000000042,1.067889650000006,1.065588146844758,1.0655551691569025,-2852,-467760,-465319.4,0.060363351518724455,-506.2076279193896,-0.013136412258151988
2023-09-21T06:45:00-04:00,1.0655999999999999,1.06561,1.06479,1.06505,1.06628,1.065566,1.0656655555555494,1.065693777777774,1.0652095000000052,1.0644011999999992,1.0670836000000044,1.0678717000000058,1.0654805174758064,1.0655329353255218,-2662,-470422,-467062.4,0.04744349654837289,-507.5815956371069,-0.0262829358039139
2023-09-21T07:00:00-04:00,1.06505,1.06505,1.0639,1.06477,1.06628,1.0653868888888889,1.0655788888888826,1.065666666666663,1.065252500000005,1.0643871999999992,1.0670299000000043,1.067852600000006,1.0653384139806452,1.0654927482604175,-8785,-479207,-469978.6,0.036371829535413173,-509.89115856842517,-0.07320163295950476
2023-09-21T07:15:00-04:00,1.06477,1.06478,1.0637699999999999,1.06393,1.0661372,1.0650571111111111,1.065322222222216,1.0655951111111075,1.065239000000005,1.0643557999999993,1.0669695000000043,1.067828400000006,1.0650567311845163,1.0654097986083337,-3965,-483172,-473093.8,0.021073826343651167,-513.0191580424898,-0.21664915966386875
2023-09-21T07:30:00-04:00,1.06393,1.06436,1.06353,1.06407,1.065947824,1.0648066666666667,1.0651233333333272,1.0654773333333296,1.065216500000005,1.0643331999999994,1.0669090000000043,1.067807400000006,1.0648593849476131,1.065264638886667,3794,-479378,-475987.8,0.0012830342196824673,-512.5199146712154,-0.16793950425008522
2023-09-21T07:45:00-04:00,1.06407,1.06444,1.06336,1.06357,1.0657060416,1.064496,1.0648399999999938,1.0653059999999963,1.0651435000000051,1.0642975999999993,1.0668415000000044,1.067780800000006,1.0646015079580904,1.0650673111093334,-3576,-482954,-479026.6,-0.015969313167296537,-514.2002552503131,-0.2391850823547117
2023-09-21T08:00:00-04:00,1.06357,1.06361,1.06324,1.06345,1.0654245166079999,1.0642179999999999,1.0646311111111049,1.0650991111111074,1.065110000000005,1.0642635999999994,1.0667768000000044,1.067753300000006,1.0643712063664723,1.0648454488874666,-4044,-486998,-482341.8,-0.033975191269526576,-514.6565298725756,-0.17647114039779993
2023-09-21T08:15:00-04:00,1.06345,1.06351,1.0629,1.06323,1.06511868428288,1.0639377777777774,1.064412222222216,1.064865777777774,1.0650510000000053,1.0642285999999992,1.0667096000000043,1.067722150000006,1.0641429650931777,1.0646063591099733,-4350,-491348,-484770,-0.04971511837667679,-515.5564311373275,-0.1849417949680837
2023-09-21T08:30:00-04:00,1.06323,1.06367,1.06236,1.06349,1.0647636947976191,1.0637533333333333,1.0641288888888827,1.0646271111111072,1.0649915000000052,1.0641999999999994,1.0666423000000043,1.067686600000006,1.0640123720745422,1.0643974872879784,8605,-482743,-484684.2,-0.0616601928678537,-513.4521827620923,-0.23920303178117633
2023-09-21T08:45:00-04:00,1.06349,1.0642099999999999,1.06334,1.0642,1.0643310297340476,1.0637675555555555,1.0639733333333272,1.064397111111107,1.0649260000000051,1.064202199999999,1.0665828000000044,1.067657450000006,1.0640498976596338,1.0642355898303826,6167,-476576,-484123.8,-0.07679295726197441,-509.3350119377311,-0.13138138138136693
2023-09-21T09:00:00-04:00,1.0642,1.06483,1.06388,1.06453,1.06236,1.0638788888888888,1.0639155555555495,1.0642122222222183,1.0648650000000053,1.0642247999999992,1.0665304000000044,1.0676292000000058,1.064145918127707,1.064144471864306,6488,-470088,-481550.6,-0.08246191820860921,-507.3231344710899,-0.04882399887329946
2023-09-21T09:15:00-04:00,1.06453,1.06542,1.06402,1.06536,1.0624094,1.0641677777777778,1.0639811111111053,1.0640822222222182,1.064846000000005,1.0642695999999991,1.0664842000000045,1.0676038000000059,1.0643887345021656,1.0641479774914449,5072,-465016,-477154.2,-0.07780827504397103,-503.36856297005136,0.05541102773369746
2023-09-21T09:30:00-04:00,1.06536,1.06598,1.0647199999999999,1.06547,1.0625298239999998,1.0644655555555556,1.0641522222222162,1.0640302222222182,1.0648530000000052,1.0643141999999992,1.0664410000000044,1.0675779500000058,1.0646049876017325,1.0642403819931556,7235,-457781,-470440.8,-0.07002829303998973,-502.6215384900645,0.14474636489241535
2023-09-21T09:45:00-04:00,1.06547,1.06613,1.06395,1.06406,1.06273683456,1.064447111111111,1.064151111111105,1.064034666666663,1.0647785000000052,1.0643225999999992,1.0663837000000045,1.067543900000006,1.064495990081386,1.0643371055945245,-6828,-464609,-466814,-0.06313190036970795,-511.6574381399837,-0.0009397877959218389
2023-09-21T10:00:00-04:00,1.06406,1.06486,1.06376,1.06478,1.0630082877951998,1.064572888888889,1.0642855555555493,1.0640971111111073,1.0647055000000054,1.0643443999999993,1.0663223000000044,1.067510100000006,1.0645527920651088,1.0644376844756196,6741,-457868,-463072.4,-0.05302242585624653,-507.0961164100057,0.11376778209240158
2023-09-21T10:15:00-04:00,1.06478,1.0665499999999999,1.06476,1.0662099999999999,1.063258024771584,1.0649577777777777,1.064592222222216,1.0642324444444404,1.0647230000000052,1.0643935999999992,1.0662792000000045,1.0674841500000058,1.064884233652087,1.0645853475804956,6142,-451726,-459400,-0.02809441009767666,-498.847407756576,0.2595326531571652
2023-09-21T10:30:00-04:00,1.0662099999999999,1.06736,1.0661,1.06644,1.0635872222944256,1.0653273333333333,1.0649488888888827,1.064425999999996,1.0647390000000052,1.0644449999999994,1.0662331000000045,1.0674680000000059,1.0651953869216695,1.0647466780643964,5033,-446693,-455735.4,-0.0026072295835778427,-497.7617023139325,0.3019102169803483
2023-09-21T10:45:00-04:00,1.06644,1.06654,1.06572,1.06598,1.0640399556190945,1.0655335555555556,1.0652255555555492,1.0646406666666626,1.064771500000005,1.0644979999999993,1.0661759000000046,1.0674480500000059,1.0653523095373356,1.0648961424515169,-5194,-451887,-454556.6,0.023845343360654293,-500.00209089650696,0.23413478264956708
2023-09-21T11:00:00-04:00,1.06598,1.0666,1.06549,1.06603,1.0644383609448032,1.0656944444444443,1.0654288888888828,1.0648962222222182,1.064813000000005,1.0645789999999993,1.0661156000000045,1.067435550000006,1.0654878476298686,1.0650945139612134,4085,-447802,-451195.2,0.044567751837563736,-499.8104831740352,0.1719601578650628
2023-09-21T11:15:00-04:00,1.06603,1.0665,1.0657,1.06599,1.064788957631427,1.0658066666666668,1.065591111111105,1.0651573333333295,1.064810500000005,1.0646445999999994,1.0660578000000047,1.0674207000000058,1.0655882781038948,1.0653016111689706,-3554,-451356,-449892.8,0.05784301669128142,-499.9438377700598,0.13714972804899975
2023-09-21T11:30:00-04:00,1.06599,1.06649,1.06581,1.06609,1.0650974827156556,1.0659064444444444,1.065672222222216,1.0653733333333295,1.064835000000005,1.0647041999999993,1.0659963000000046,1.0674041500000058,1.065688622483116,1.0654624889351765,3614,-447742,-449096,0.07226895265715075,-499.6048101994447,0.06852143876247441
2023-09-21T11:45:00-04:00,1.06609,1.06687,1.06609,1.06634,1.065368984789777,1.06604,1.0657688888888828,1.0655373333333293,1.064899500000005,1.0647615999999993,1.0659402000000047,1.0673900500000058,1.0658188979864927,1.0655871911481412,2870,-444872,-448731.8,0.0781602143539119,-498.93179009795216,0.08165410569984594
2023-09-21T12:00:00-04:00,1.06634,1.06657,1.06569,1.06599,1.0656079066150037,1.0660842222222222,1.0659833333333273,1.0656888888888851,1.064960500000005,1.0648065999999994,1.0658784000000048,1.067376500000006,1.0658531183891942,1.0656873529185127,-2661,-447533,-447861,0.07883659348671535,-499.8051982041849,0.18138074920587066
2023-09-21T12:15:00-04:00,1.06599,1.0662099999999999,1.06545,1.06592,1.06736,1.0660715555555556,1.066109999999994,1.0658251111111074,1.065060000000005,1.0648519999999995,1.0658205000000047,1.067363100000006,1.0658664947113554,1.06576308233481,-2464,-449997,-448300,0.09115529397794628,-499.9670008477369,0.10706437010461492
2023-09-21T12:30:00-04:00,1.06592,1.06634,1.06572,1.06583,1.0673218,1.0660155555555555,1.0660677777777718,1.0659204444444408,1.065148000000005,1.0649003999999995,1.0657631000000045,1.0673475000000059,1.0658591957690844,1.0658172658678482,-1729,-451726,-448374,0.092511164871029,-500.11298741333275,-0.03564025848564776
2023-09-21T12:45:00-04:00,1.06583,1.06665,1.06556,1.06557,1.067284364,1.065916,1.0659711111111048,1.0659802222222186,1.065248000000005,1.0649403999999996,1.0657046000000046,1.0673305500000059,1.0658013566152675,1.0658398126942785,-2331,-454057,-449637,0.07979067019624451,-500.68161468034566,-0.08157983571510337
2023-09-21T13:00:00-04:00,1.06557,1.06619,1.06555,1.06602,1.06724767672,1.065925777777778,1.0659755555555492,1.0660215555555517,1.065376500000005,1.0649901999999996,1.0656392000000046,1.067315300000006,1.0658450852922141,1.0658450501554229,2112,-451945,-451051.6,0.06488763567822499,-499.7896976781777,0.003752415617557553
2023-09-21T13:15:00-04:00,1.06602,1.067,1.06602,1.06684,1.0672117231856002,1.0660986666666665,1.0660655555555492,1.066037999999996,1.065557000000005,1.0650529999999996,1.0655709000000047,1.067307800000006,1.0660440682337713,1.065883240124338,1953,-449992,-451543.4,0.05779827543768899,-498.28741817122653,0.07598285226494352
2023-09-21T13:30:00-04:00,1.06684,1.06705,1.06652,1.06657,1.0671764887218882,1.0661995555555555,1.0661299999999936,1.066041999999996,1.0657110000000052,1.0651101999999997,1.0655010000000047,1.0672999000000059,1.066149254587017,1.0659397920994704,-1710,-451702,-451884.4,0.04793162481794488,-498.7201915955451,0.054409516036738145
2023-09-21T13:45:00-04:00,1.06657,1.06685,1.06633,1.06659,1.0671419589474505,1.0662915555555554,1.0661855555555493,1.0660655555555514,1.0658305000000052,1.0651717999999994,1.0654318000000047,1.067291300000006,1.0662374036696136,1.0660154336795764,1564,-450138,-451566.8,0.03970365683836438,-498.69086393772625,0.04690035550468956
2023-09-21T14:00:00-04:00,1.06659,1.06708,1.06634,1.06691,1.0671081197685015,1.0664364444444443,1.0662488888888826,1.0661211111111069,1.0659495000000052,1.0652377999999993,1.0653699000000045,1.067282950000006,1.066371922935691,1.0661295469436614,2050,-448088,-450373,0.03528488816792056,-498.07581973142373,0.05345387024775957
2023-09-21T14:15:00-04:00,1.06691,1.06708,1.06669,1.06695,1.06545,1.0665766666666667,1.0663555555555493,1.0661971111111068,1.0660290000000052,1.0653073999999996,1.0653094000000047,1.0672766500000062,1.0664875383485528,1.0662580375549289,1717,-446371,-449258.2,0.030193058678983933,-498.0114469164721,0.09005712999184531
2023-09-21T14:30:00-04:00,1.06695,1.06697,1.0666,1.06687,1.0654826,1.0666795555555555,1.0664611111111049,1.066276222222218,1.0660990000000052,1.0653665999999995,1.0652514000000046,1.067270850000006,1.0665640306788422,1.0663620300439434,-1596,-447967,-448853.2,0.03170079665188048,-498.1311151296031,0.08912488742119544
2023-09-21T14:45:00-04:00,1.06687,1.06687,1.06613,1.06617,1.065514548,1.0666213333333334,1.0664988888888827,1.0663499999999957,1.066204500000005,1.0654059999999996,1.0651866000000048,1.067259400000006,1.0664852245430738,1.0664292240351547,-1599,-449566,-448426,0.030918141963694787,-499.1802588865743,0.031900021579427014
2023-09-21T15:00:00-04:00,1.06617,1.06657,1.06589,1.0665499999999999,1.0655458570399998,1.0666315555555554,1.0666077777777716,1.0664344444444402,1.066293000000005,1.0654465999999996,1.0651667000000047,1.0672502000000061,1.066498179634459,1.0664813792281238,2024,-447542,-447906.8,0.02654680705885194,-498.4588729912671,0.0919695561999663
2023-09-21T15:15:00-04:00,1.0665499999999999,1.06668,1.06631,1.0664,1.0655765398991999,1.06659,1.0666499999999937,1.0665146666666625,1.066302500000005,1.0654739999999996,1.0651333000000045,1.0672378000000062,1.0664785437075672,1.0665027033824992,-1524,-449066,-448102.4,0.027094183436788714,-498.6732089342607,0.03564661075777631
2023-09-21T15:30:00-04:00,1.0664,1.06652,1.06613,1.06637,1.065606609101216,1.066534,1.0665977777777718,1.066563111111107,1.066299000000005,1.0655189999999997,1.0650969000000046,1.067225550000006,1.0664568349660537,1.0664965627059995,-1691,-450757,-448979.6,0.029661823063532662,-498.7207802020776,-0.044055341007083575
2023-09-21T15:45:00-04:00,1.06637,1.06656,1.06588,1.06592,1.0656360769191917,1.0663984444444443,1.0665255555555495,1.066575999999996,1.0662960000000052,1.0655491999999998,1.0650695000000046,1.0672128000000063,1.066349467972843,1.0664536501647994,-2104,-452861,-449958.4,0.023356660221063183,-499.6086521414609,-0.06094302296145958
2023-09-21T16:00:00-04:00,1.06592,1.06607,1.06574,1.06576,1.065664955380808,1.0662453333333335,1.0664333333333271,1.066562888888885,1.0662825000000051,1.0655707999999995,1.0650511000000045,1.0672009000000062,1.0662315743782744,1.0664029201318397,-1197,-454058,-450856.8,0.016742825906969624,-499.78832791450196,-0.07781809317543634
2023-09-21T16:15:00-04:00,1.06576,1.06589,1.06576,1.06584,1.0656932562731918,1.0661266666666667,1.0663144444444381,1.066504222222218,1.0662750000000052,1.0655773999999996,1.0650311000000046,1.0671904500000062,1.0661532595026195,1.0663339361054718,395,-453663,-452081,0.010557582367399388,-499.75867771182976,-0.1002896214301231
2023-09-21T16:30:00-04:00,1.06584,1.06615,1.06584,1.06614,1.065720991147728,1.0660917777777779,1.0662244444444382,1.066419111111107,1.066277500000005,1.0655851999999997,1.0650298000000042,1.0671810500000063,1.0661506076020957,1.0662683488843774,550,-453113,-452890.4,0.0026661736256931045,-499.6038702360359,-0.07591733445803246
2023-09-21T16:45:00-04:00,1.06614,1.0663,1.06579,1.06579,1.0657481713247734,1.066004888888889,1.0661044444444383,1.0663204444444403,1.066250000000005,1.0655861999999996,1.0650292000000043,1.0671712000000062,1.0660784860816765,1.0661926791075018,-671,-453784,-453495.8,-0.006873192939567963,-499.82415087460123,-0.10123070289725739
2023-09-21T17:00:00-04:00,1.06579,1.06617,1.06542,1.0659,1.06708,1.0659640000000001,1.066074444444438,1.066230222222218,1.0662455000000053,1.0655975999999996,1.0650338000000046,1.0671612000000061,1.0660427888653412,1.0661313432860016,144,-453640,-453651.6,-0.01400568981131941,-499.8092886597184,-0.025324291623286387
2023-09-21T17:15:00-04:00,1.0659,1.06615,1.0657699999999999,1.0659,1.0670468,1.065929111111111,1.0660022222222159,1.0661439999999958,1.0662445000000051,1.0656045999999995,1.0650317000000045,1.0671517500000063,1.066014231092273,1.0660878746288012,0,-453640,-453568,-0.0161360844023215,-499.8092886597184,-0.060944165768113776
2023-09-21T17:30:00-04:00,1.0659,1.0659399999999999,1.06576,1.0659,1.067014264,1.0659086666666666,1.0659466666666604,1.0660704444444404,1.0662480000000052,1.0655977999999995,1.0650311000000043,1.0671412500000061,1.0659913848738183,1.066055499703041,0,-453640,-453563.4,-0.022143032916499408,-499.8092886597184,-0.04688672168041494
2023-09-21T17:45:00-04:00,1.0659,1.0659399999999999,1.06585,1.06587,1.06698237872,1.0658933333333334,1.0658911111111047,1.0660037777777736,1.066263000000005,1.0655979999999996,1.0650293000000044,1.0671303500000062,1.0659671078990547,1.0660187997624326,-292,-453932,-453727.2,-0.027292422835435523,-499.8175070666984,-0.046888040736324625
2023-09-21T18:00:00-04:00,1.06587,1.06629,1.06586,1.0662099999999999,1.0669511311456,1.0659571111111112,1.065923333333327,1.0659675555555514,1.066272500000005,1.0655997999999995,1.0650312000000044,1.0671211500000062,1.0660156863192438,1.0660062398099464,459,-453473,-453665,-0.031650445459644884,-499.67109146254415,0.0272065445811976
2023-09-21T18:15:00-04:00,1.0662099999999999,1.06637,1.06619,1.06631,1.0669205085226878,1.0660344444444445,1.0659844444444382,1.0659495555555514,1.0662460000000054,1.0656193999999994,1.0650338000000046,1.0671131500000062,1.0660745490553951,1.066012591847957,466,-453007,-453538.4,-0.02928755935201794,-499.62738525082216,0.05160636541060374
2023-09-21T18:30:00-04:00,1.06631,1.06633,1.06614,1.06615,1.066890498352234,1.0660675555555554,1.0660188888888826,1.065952888888885,1.066225000000005,1.0656383999999994,1.0650327000000044,1.0671041500000062,1.066089639244316,1.0660276734783658,-291,-453298,-453470,-0.022549168038700197,-499.67104985117294,0.029085040906705745
2023-09-21T18:45:00-04:00,1.06615,1.0662,1.06609,1.06614,1.0668610883851894,1.066091777777778,1.0660188888888826,1.065967333333329,1.066202500000005,1.0656403999999995,1.0650306000000045,1.0670952500000062,1.066099711395453,1.0660493387826926,-331,-453629,-453467.8,-0.017815480039701303,-499.67415447997746,0
2023-09-21T19:00:00-04:00,1.06614,1.06619,1.06602,1.06606,1.0668322666174856,1.0661,1.0660488888888828,1.065998888888885,1.066160000000005,1.0656495999999995,1.0650318000000045,1.067086600000006,1.0660917691163623,1.0660742710261542,-455,-454084,-453498.2,-0.016199116484716128,-499.70829633751964,0.025333320823050738
2023-09-21T19:15:00-04:00,1.06606,1.06613,1.06587,1.06592,1.066804021285136,1.0660742222222221,1.066051111111105,1.0660244444444404,1.0661085000000052,1.0656669999999995,1.0650341000000045,1.0670768500000063,1.0660574152930897,1.0660826168209232,-488,-454572,-453718,-0.010558699939765675,-499.7723827866876,0.0018763486255660923
2023-09-21T19:30:00-04:00,1.06592,1.06614,1.06587,1.06613,1.0667763408594333,1.0660900000000002,1.0660766666666606,1.066042888888885,1.0660715000000052,1.0656941999999996,1.0650407000000046,1.0670684500000063,1.0660719322344718,1.0660820934567385,765,-453807,-453878,-0.004739082466998923,-499.6216679112748,0.021578009194103805
2023-09-21T19:45:00-04:00,1.06613,1.06616,1.06599,1.06603,1.0667492140422445,1.0660806666666667,1.066091111111105,1.0660573333333294,1.0660645000000053,1.0657361999999995,1.0650460000000046,1.067058800000006,1.0660635457875776,1.066076874765391,-639,-454446,-454107.6,0.0002322728886732726,-499.6816043167788,0.012196266066231679
2023-09-21T20:00:00-04:00,1.06603,1.06628,1.06552,1.06562,1.0667226297613996,1.0659864444444445,1.0660633333333274,1.0660662222222184,1.0660180000000052,1.0657671999999996,1.0650502000000046,1.0670466500000062,1.065974836630062,1.066051899812313,-1692,-456138,-454609.4,0.00006253654496873553,-500.3323552337324,-0.023455017966551594
2023-09-21T20:15:00-04:00,1.06562,1.06575,1.0654,1.06552,1.0666965771661716,1.0658777777777777,1.0659866666666609,1.066053777777774,1.065974000000005,1.0658061999999995,1.0650519000000045,1.0670335000000062,1.0658838693040498,1.0660103198498505,-1215,-457353,-455263.2,0.0013803343895044493,-500.44637336402275,-0.06471520619764
2023-09-21T20:30:00-04:00,1.06552,1.06571,1.06534,1.06571,1.0666447140795248,1.0658224444444444,1.065919999999994,1.0660275555555518,1.0659410000000051,1.0658513999999994,1.0650575000000047,1.0670209000000062,1.0658490954432398,1.0659686558798804,1105,-456248,-455598.4,-0.0002278292029648483,-500.2493334210842,-0.05626881488499179
2023-09-21T20:45:00-04:00,1.06571,1.06607,1.0655999999999999,1.06575,1.0665664312347534,1.0657884444444443,1.0658755555555495,1.0659873333333296,1.0659325000000053,1.0659017999999996,1.0650652000000047,1.067008550000006,1.0658292763545918,1.0659201247039045,1494,-454754,-455787.8,-0.0027116893465466466,-500.1932581285562,-0.03751817286497735
2023-09-21T21:00:00-04:00,1.06575,1.06576,1.06464,1.06491,1.0664928453606681,1.0655953333333332,1.065738888888883,1.0659168888888852,1.0658900000000053,1.0659301999999995,1.0650651000000044,1.066991700000006,1.0656454210836734,1.0658364997631238,-1875,-456629,-456224.4,-0.00983310965711108,-501.67109064087134,-0.11536946367269442
2023-09-21T21:15:00-04:00,1.06491,1.06502,1.06442,1.06463,1.0663446177318148,1.0653735555555557,1.0655799999999942,1.0658202222222184,1.0658295000000053,1.0659387999999996,1.0650705000000045,1.066974300000006,1.0654423368669388,1.065729999810499,-2488,-459117,-456820.2,-0.018952365761731108,-502.325267989192,-0.13413879143763413
2023-09-21T21:30:00-04:00,1.06463,1.06463,1.06409,1.06412,1.0661521559586333,1.0650815555555555,1.0653799999999942,1.065698888888885,1.0657285000000054,1.0659305999999995,1.0650777000000045,1.0669543000000061,1.065177869493551,1.0655887998483993,-2299,-461416,-457632.8,-0.029471808534918688,-503.4265801821605,-0.16886820774542402
2023-09-21T21:45:00-04:00,1.06412,1.06446,1.06408,1.06431,1.0659046972435973,1.0648675555555553,1.065177777777772,1.0655504444444408,1.0656545000000053,1.0659095999999995,1.0650896000000045,1.066935200000006,1.0650042955948409,1.0654198398787194,1192,-460224,-458428,-0.03640486029667121,-503.21374704304066,-0.17071088891597955
2023-09-21T22:00:00-04:00,1.06431,1.06487,1.06423,1.06481,1.0656492396294936,1.064794,1.0650422222222165,1.0653837777777742,1.0656000000000052,1.0658963999999995,1.0651053000000046,1.066919400000006,1.0649654364758727,1.0652470719029759,1635,-458589,-459195,-0.04441435523421937,-502.4456437648605,-0.1144433083496711
2023-09-21T22:15:00-04:00,1.06481,1.06504,1.06467,1.06482,1.0654295460813645,1.0647495555555555,1.0649533333333272,1.065226666666663,1.0655460000000052,1.0659115999999995,1.0651171000000046,1.066901800000006,1.0649363491806982,1.0651052575223807,1448,-457141,-459297.4,-0.05094557671717166,-502.4320450946751,-0.07507366603478838
2023-09-21T22:30:00-04:00,1.06482,1.06496,1.06473,1.06485,1.0652406096299736,1.0647288888888888,1.064878888888883,1.0650864444444408,1.0654935000000052,1.0659129999999997,1.0651287000000045,1.066884300000006,1.0649190793445587,1.0650006060179047,1113,-456028,-458679.6,-0.05348195838607296,-502.40068768215474,-0.06288009610330622
2023-09-21T22:45:00-04:00,1.06485,1.0651599999999999,1.06437,1.06481,1.06408,1.064715111111111,1.0647788888888827,1.0649662222222185,1.0654405000000051,1.0658849999999997,1.0651393000000047,1.066865900000006,1.0648972634756468,1.064944484814324,-3062,-459090,-458214.4,-0.0552767682038901,-502.5157085771166,-0.08445074175900583
2023-09-21T23:00:00-04:00,1.06481,1.06518,1.06474,1.06517,1.0641015999999999,1.0647933333333333,1.0647144444444383,1.0648735555555517,1.065388500000005,1.0658595999999998,1.0651523000000045,1.0668493000000059,1.0649518107805174,1.064933987851459,1558,-457532,-457676,-0.057218250843018834,-501.98896671706655,-0.054421768707485337
2023-09-21T23:15:00-04:00,1.06517,1.06531,1.06491,1.06503,1.0641447359999998,1.0648564444444446,1.0647277777777715,1.0648106666666628,1.065324500000005,1.0658405999999996,1.0651693000000046,1.066832000000006,1.0649674486244138,1.0649343902811672,-1353,-458885,-457735.2,-0.058705213473366345,-502.16679748586404,0.011268557906292359
2023-09-21T23:30:00-04:00,1.06503,1.0653,1.06503,1.0651599999999999,1.0642146518399997,1.064942888888889,1.0647866666666606,1.0647773333333297,1.065275000000005,1.0658231999999999,1.0652011000000046,1.0668151500000058,1.065005958899531,1.0649483122249337,1169,-457716,-457850.2,-0.05122107667501055,-502.02410666964295,0.049782553563202186
2023-09-21T23:45:00-04:00,1.0651599999999999,1.06525,1.06491,1.06515,1.0642803727295997,1.0650155555555554,1.0649011111111049,1.064781777777774,1.065225500000005,1.0658063999999998,1.0652255000000046,1.066797850000006,1.065034767119625,1.0649714497799472,-1133,-458849,-458414.4,-0.041871827595379156,-502.03474356926347,0.09679359470737195
2023-09-22T00:00:00-04:00,1.06515,1.06564,1.06511,1.06554,1.0643421503658237,1.0651433333333333,1.0650377777777715,1.0648335555555515,1.065199500000005,1.0657953999999998,1.0652498000000046,1.0667808000000059,1.0651358136956999,1.0650191598239576,1316,-457533,-458103,-0.025860469690355076,-501.55289594216885,0.11556783268031327
2023-09-22T00:15:00-04:00,1.06554,1.06557,1.06517,1.06534,1.0644459783365579,1.0652037777777776,1.0650966666666604,1.064909999999996,1.0651705000000047,1.0657754,1.0652685000000046,1.0667646500000059,1.06517665095656,1.0650641278591662,-1111,-458644,-458325.4,-0.012973119892143893,-501.76142870489946,0.049774138109138666
2023-09-22T00:30:00-04:00,1.06534,1.06559,1.0652,1.06557,1.0645415000696332,1.0652984444444444,1.0651799999999936,1.0650004444444403,1.065142500000005,1.065767,1.0652868000000046,1.066749800000006,1.065255320765248,1.0651217022873332,913,-457731,-458094.6,-0.004273775558666937,-501.56431792336497,0.07043443962358016
2023-09-22T00:45:00-04:00,1.06557,1.0657,1.06528,1.06547,1.0646293800640625,1.0653564444444446,1.0652488888888825,1.0650928888888846,1.0651145000000048,1.0657579999999998,1.0653050000000046,1.0667357000000057,1.0652982566121985,1.0651801618298666,-1039,-458770,-458305.4,0.004779080413901635,-501.66182442223413,0.05822416302764172
2023-09-22T01:00:00-04:00,1.06547,1.06564,1.06524,1.06544,1.0647364420576562,1.0653946666666665,1.0653188888888825,1.0651764444444403,1.065105500000005,1.0657501999999999,1.0653253000000047,1.0667219500000058,1.0653266052897588,1.0652385294638935,-1296,-460066,-458548.8,0.012956164975310571,-501.6983153605055,0.05916548492218409
2023-09-22T01:15:00-04:00,1.06544,1.0657699999999999,1.06524,1.0653299999999999,1.0648327978518906,1.0653968888888887,1.0653366666666604,1.065236222222218,1.0650960000000047,1.0657454,1.0653429000000048,1.0667073000000058,1.065327284231807,1.0652768235711148,-1444,-461510,-459344.2,0.019134956883920064,-501.8473993070441,0.015021076447885124
2023-09-22T01:30:00-04:00,1.0653299999999999,1.0654,1.06515,1.06536,1.0649452621096638,1.0654015555555554,1.0653733333333268,1.0652915555555513,1.0650785000000047,1.0657322,1.0653612000000046,1.0666941500000058,1.0653338273854456,1.0653082588568918,1255,-460255,-459666.4,0.021634280073554855,-501.8120581451504,0.030985042674869585
2023-09-22T01:45:00-04:00,1.06536,1.06549,1.06492,1.06492,1.0657699999999999,1.065310888888889,1.0653466666666602,1.0653248888888847,1.0650370000000047,1.0656938,1.0653734000000046,1.0666789500000058,1.0652510619083564,1.0653074070855137,-1353,-461608,-460441.8,0.024134318795801607,-502.3708551715077,-0.02253182620449472
2023-09-22T02:00:00-04:00,1.06492,1.06523,1.0647199999999999,1.06495,1.065753,1.0652315555555556,1.065324444444438,1.065339999999996,1.0650390000000047,1.0656614,1.0653858000000047,1.066664200000006,1.065190849526685,1.065285925668411,2526,-459082,-460504.2,0.02574031921227846,-502.2996948965575,-0.018776698117633946
2023-09-22T02:15:00-04:00,1.06495,1.06541,1.06471,1.06532,1.06571168,1.0652306666666667,1.0652999999999935,1.065336222222218,1.0650735000000047,1.065636,1.0654039000000046,1.066651350000006,1.065216679621348,1.0652639405347286,2667,-456415,-459774,0.025502881593273862,-501.3730880136053,-0.020646808191141296
2023-09-22T02:30:00-04:00,1.06532,1.06597,1.06518,1.06595,1.06471,1.0653606666666668,1.0653677777777713,1.0653424444444402,1.0651650000000046,1.0656168,1.0654273000000045,1.066641950000006,1.0653633436970784,1.065271152427783,3663,-452752,-458022.4,0.023449284718721923,-499.2068938184342,0.0572587155274372
2023-09-22T02:45:00-04:00,1.06595,1.06598,1.06561,1.06595,1.06471,1.065477111111111,1.0654099999999933,1.0653497777777736,1.0652470000000047,1.0655968,1.0654521000000046,1.066632450000006,1.0654806749576626,1.0653005219422265,0,-452752,-456521.8,0.020993104373314066,-499.2068938184342,0.03566166464897163
2023-09-22T03:00:00-04:00,1.06595,1.06679,1.06557,1.06649,1.0647608,1.0656931111111112,1.0655233333333267,1.0653851111111066,1.0653310000000047,1.0655892,1.0654779000000045,1.066625200000006,1.06568253996613,1.065386817553781,4790,-447962,-453792.6,0.019882501923376636,-496.78032596815984,0.0957323997860119
2023-09-22T03:15:00-04:00,1.06649,1.06649,1.06147,1.06225,1.06679,1.0650384444444443,1.0651688888888822,1.0653539999999957,1.0652025000000047,1.0655108,1.0654584000000047,1.066595900000006,1.064996031972904,1.0653478540430248,-11414,-459376,-453851.4,0.0010997426335515328,-542.1584917268639,-0.2994068178405191
2023-09-22T03:30:00-04:00,1.06225,1.0652,1.06225,1.06439,1.06679,1.0648826666666666,1.065064444444438,1.0653068888888844,1.0651795000000046,1.0654675999999998,1.0654571000000046,1.066577050000006,1.0648748255783231,1.06527948323442,7711,-451665,-452901.4,-0.006835523621515776,-526.6239753700738,-0.08823557019889997
2023-09-22T03:45:00-04:00,1.06439,1.06514,1.064,1.06456,1.0666836,1.0647817777777777,1.064975555555549,1.0652284444444402,1.0651670000000046,1.0654308,1.0654524000000045,1.066559400000006,1.0648118604626584,1.065169186587536,4092,-447573,-451865.6,-0.01276815471983846,-525.97041793342,-0.07509198768492659
2023-09-22T04:00:00-04:00,1.06456,1.0651599999999999,1.06407,1.0643,1.066579328,1.0646466666666665,1.06490666666666,1.0651277777777732,1.0651235000000046,1.0653894,1.0654542000000047,1.0665377000000058,1.0647094883701267,1.0650149492700287,-3991,-451564,-451628,-0.020440243136812492,-526.945149277825,-0.058220335799878384
2023-09-22T04:15:00-04:00,1.0643,1.06463,1.06422,1.06444,1.06647714144,1.0645533333333332,1.0648499999999934,1.0649931111111068,1.0650940000000046,1.0653598000000002,1.0654545000000046,1.066514700000006,1.0646555906961013,1.0648095594160227,3042,-448522,-451740,-0.021683817746685388,-526.5449989442723,-0.04788957228038973
2023-09-22T04:30:00-04:00,1.06444,1.06474,1.06392,1.06466,1.0663769986112,1.0645153333333333,1.06477666666666,1.0649146666666625,1.0650690000000045,1.0653378,1.0654543000000045,1.066491850000006,1.064656472556881,1.0647416475328182,3992,-444530,-448770.8,-0.022752736900610963,-525.7199266057661,-0.06195321593512793
2023-09-22T04:45:00-04:00,1.06466,1.06479,1.0642099999999999,1.06461,1.066278858638976,1.0644820000000002,1.064627777777771,1.064827333333329,1.0650420000000045,1.0653132,1.0654453000000046,1.0664740500000058,1.064647178045505,1.0646961180262544,-2842,-447372,-447912.2,-0.02696057719763005,-525.8533964459025,-0.12570946104412936
2023-09-22T05:00:00-04:00,1.06461,1.06486,1.0642099999999999,1.06442,1.0661826814661965,1.0644404444444444,1.064457777777771,1.0647237777777734,1.0649860000000047,1.0652788000000002,1.0654320000000046,1.066457800000006,1.0646017424364038,1.0646540944210034,-2961,-450333,-448464.2,-0.03806349669070493,-526.381843482846,-0.14353393686383334
2023-09-22T05:15:00-04:00,1.06442,1.06442,1.06341,1.06359,1.0660884278368725,1.0642668888888889,1.064135555555549,1.0645695555555512,1.0648985000000046,1.0652348,1.0654105000000047,1.0664356500000058,1.064399393949123,1.0645920755368026,-2521,-452854,-448722.2,-0.0515084752658084,-528.3476370605688,-0.2719200367560786
2023-09-22T05:30:00-04:00,1.06359,1.06407,1.06345,1.06345,1.065996059280135,1.0641297777777778,1.0642688888888823,1.064453333333329,1.0647925000000045,1.0651858,1.0653917000000046,1.066408150000006,1.0642095151592983,1.064502860429442,-2079,-454933,-450004.4,-0.07160994248113364,-528.6212951431006,0.11296775711933066
2023-09-22T05:45:00-04:00,1.06345,1.06405,1.0634,1.06385,1.0659055380945324,1.0640459999999998,1.0642088888888823,1.0643397777777734,1.0647115000000045,1.0651448000000001,1.0653747000000047,1.066382200000006,1.0641376121274386,1.0643990883435532,1866,-453067,-451711.8,-0.048896004865727566,-527.9194285767365,-0.050733283852721744
2023-09-22T06:00:00-04:00,1.06385,1.06447,1.06382,1.06442,1.0658168273326418,1.0640882222222223,1.0641933333333264,1.0642528888888845,1.0646605000000045,1.0651152000000002,1.0653565000000045,1.0663592500000059,1.0641940897019508,1.0643084706748427,2208,-450859,-452409.2,-0.04392036191793805,-526.7364046541911,-0.013150973172017452
2023-09-22T06:15:00-04:00,1.06442,1.0647199999999999,1.06352,1.06386,1.065729890785989,1.0640215555555554,1.0641444444444377,1.064190222222218,1.0645870000000044,1.065075,1.0653365000000046,1.0663318500000059,1.0641272717615606,1.064213576539874,-2309,-453168,-452976.2,-0.04343145143780915,-527.9511882922285,-0.04134172695668476
2023-09-22T06:30:00-04:00,1.06386,1.06392,1.06343,1.06365,1.0656446929702692,1.0639226666666666,1.0640566666666598,1.06417444444444,1.0645015000000044,1.0650238,1.0653118000000048,1.066303150000006,1.0640318174092485,1.0641400612318992,-1858,-455026,-453410.6,-0.04202565913618567,-528.3179470762791,-0.07421742888279925
2023-09-22T06:45:00-04:00,1.06365,1.06378,1.06349,1.06355,1.0655611991108638,1.0638213333333333,1.0639333333333265,1.0641073333333289,1.0644330000000044,1.0649686,1.0652940000000046,1.066272850000006,1.0639354539273989,1.0640852489855193,-2158,-457184,-453860.8,-0.042293001836713334,-528.5208333640617,-0.10425863656002334
2023-09-22T07:00:00-04:00,1.06355,1.06403,1.06355,1.0638,1.0654793751286464,1.0637946666666667,1.0638433333333266,1.0640342222222177,1.0643755000000046,1.0649216,1.0652800000000047,1.066242500000006,1.063908363141919,1.0640393991884154,1888,-455296,-454306.6,-0.04536413441726095,-528.0770366455246,-0.07608419984782948
2023-09-22T07:15:00-04:00,1.0638,1.06401,1.06356,1.0639,1.0653991876260736,1.063806,1.0637855555555487,1.0639526666666623,1.0643045000000044,1.0648768,1.0652586000000048,1.066214900000006,1.0639066905135353,1.063981919350732,1818,-453478,-454830.4,-0.0473392953731577,-527.9061398604146,-0.048852896413056304
2023-09-22T07:30:00-04:00,1.0639,1.0642,1.06376,1.06413,1.065320603873552,1.063874888888889,1.0638455555555486,1.0638928888888846,1.0642135000000044,1.0648381999999998,1.065243900000005,1.066187750000006,1.0639513524108282,1.0639467354805856,1724,-451754,-454547.6,-0.044742288890037354,-527.5334356588919,0.05077144388344991
2023-09-22T07:45:00-04:00,1.06413,1.06417,1.06356,1.06362,1.065243591796081,1.0638297777777779,1.0638644444444376,1.06385444444444,1.0640970000000045,1.0647922,1.0652296000000048,1.066156600000006,1.0638850819286625,1.0639173883844684,-2314,-454068,-454356,-0.03403900770929225,-528.6424542938331,0.015985706897362686
2023-09-22T08:00:00-04:00,1.06362,1.0649,1.06362,1.06487,1.0651681199601593,1.064030888888889,1.063977777777771,1.063863333333329,1.0640160000000045,1.064767,1.0652306000000047,1.066130250000006,1.06408206554293,1.0639467107075746,3755,-450313,-452981.8,-0.0158635617341443,-524.2294590511714,0.095878178314614
2023-09-22T08:15:00-04:00,1.06487,1.06575,1.06462,1.06574,1.06147,1.0643833333333332,1.0641244444444378,1.0639195555555512,1.0641905000000045,1.0647612,1.0652487000000048,1.066109100000006,1.064413652434344,1.0640477685660594,2859,-447454,-451413.4,0.0052537225803543424,-521.8936528025215,0.12401119858702278
2023-09-22T08:30:00-04:00,1.06574,1.06606,1.06484,1.0651,1.0615556,1.0645784444444444,1.0642622222222156,1.0640148888888845,1.0642260000000046,1.0647507999999999,1.0652590000000048,1.0660840000000062,1.0645509219474751,1.0641766148528473,-3426,-450880,-450893.8,-0.0011096738049538965,-523.9510401577863,0.11655668979000129
2023-09-22T08:45:00-04:00,1.0651,1.0659399999999999,1.0651,1.06557,1.061735776,1.06484,1.064475555555549,1.0641408888888848,1.0642765000000043,1.0647518,1.0652790000000047,1.066060250000006,1.06475473755798,1.0643372918822778,3370,-447510,-450045,0.009677813378096228,-522.4639497437408,0.1805105062755532
2023-09-22T09:00:00-04:00,1.06557,1.06586,1.06503,1.0651,1.06190874496,1.0649648888888887,1.064647777777771,1.0642975555555512,1.0643165000000043,1.0647396,1.0652955000000048,1.0660361500000062,1.064823790046384,1.064525033505822,-3603,-451113,-449454,0.02088531732679406,-524.0531555209304,0.1457383291805689
2023-09-22T09:15:00-04:00,1.0651,1.06531,1.06471,1.06485,1.0620747951616,1.0650053333333331,1.0647644444444377,1.0644548888888845,1.0643370000000043,1.0647216,1.065311700000005,1.066010650000006,1.0648290320371072,1.0646744268046575,-3456,-454569,-450305.2,0.030638203441774675,-524.8643469583537,0.09870276367738252
2023-09-22T09:30:00-04:00,1.06485,1.06489,1.06419,1.06435,1.0622342033551362,1.0649224444444445,1.0648144444444376,1.0645928888888847,1.0643215000000041,1.0647103999999998,1.0653203000000049,1.065981300000006,1.0647332256296858,1.0647383414437257,-5105,-459674,-452749.2,0.03620852495354549,-527.261398186227,0.042297208384231545
2023-09-22T09:45:00-04:00,1.06435,1.06623,1.06435,1.06605,1.0623872352209307,1.0651695555555556,1.0650277777777708,1.0647459999999958,1.0643935000000044,1.0647388,1.065338800000005,1.065960800000006,1.0649965805037487,1.0648274731549805,7102,-452572,-453087.6,0.05018682490730585,-515.9179491328139,0.18042908291279466
2023-09-22T10:00:00-04:00,1.06605,1.06671,1.06597,1.06608,1.0626178011076748,1.06538,1.0653011111111041,1.064911111111107,1.0644765000000043,1.0647779999999998,1.065354300000005,1.0659423500000063,1.065213264402999,1.0649191785239842,4977,-447595,-453104.6,0.06192641568959295,-515.7778900361487,0.23128560952218902
2023-09-22T10:15:00-04:00,1.06608,1.06669,1.06574,1.06656,1.0629451770190608,1.0656317777777777,1.065488888888882,1.065079333333329,1.0646250000000044,1.0648229999999999,1.065366300000005,1.0659252500000063,1.0654826115223992,1.0650509428191874,3396,-444199,-451721.8,0.07996478811832514,-514.2488490636138,0.1587048184285377
2023-09-22T10:30:00-04:00,1.06656,1.06717,1.06646,1.06677,1.063246362857536,1.065888,1.0656033333333266,1.0652471111111068,1.0647910000000043,1.0648621999999999,1.065379300000005,1.0659101500000063,1.0657400892179194,1.0652331542553497,3560,-440639,-448935.8,0.08357607381656339,-513.5479039691041,0.09664646161353486
2023-09-22T10:45:00-04:00,1.06677,1.06679,1.06571,1.06582,1.0636387265717824,1.0659313333333333,1.0656833333333267,1.0654208888888845,1.0648895000000043,1.0648821999999998,1.065396900000005,1.0658903000000062,1.0657560713743355,1.0654377234042798,-3493,-444132,-445827.4,0.07371999549249227,-516.658555749713,0.0675992864519814
2023-09-22T11:00:00-04:00,1.06582,1.06595,1.0653299999999999,1.0655999999999999,1.063991853914604,1.0659146666666668,1.06568666666666,1.0655526666666624,1.064948500000004,1.0648971999999999,1.0654051000000049,1.0658637000000062,1.0657248570994684,1.0655833787234237,-3157,-447289,-444770.8,0.07058411090645363,-517.3102042457069,0.00281539457754765
2023-09-22T11:15:00-04:00,1.0655999999999999,1.0657699999999999,1.06535,1.06572,1.0643096685231437,1.0659213333333333,1.065755555555549,1.0656435555555515,1.0650415000000042,1.0649153999999998,1.0654002000000051,1.0658397000000064,1.0657238856795748,1.0656855029787389,2174,-445115,-444274.8,0.06617574399664666,-517.0653844258869,0.058210496666985724
2023-09-22T11:30:00-04:00,1.06572,1.06647,1.0657,1.06627,1.0645957016708294,1.066024222222222,1.0659133333333268,1.0657284444444406,1.065172500000004,1.0649373999999998,1.065398500000005,1.0658158000000062,1.0658331085436599,1.065755602382991,2112,-443003,-444035.6,0.06637874378013633,-515.9754170798673,0.1333521153214046
2023-09-22T11:45:00-04:00,1.06627,1.06653,1.06587,1.06593,1.0648531315037464,1.0660275555555556,1.0660888888888824,1.0658255555555516,1.0652915000000043,1.0649553999999997,1.0653980000000052,1.0657869500000061,1.065852486834928,1.0657780819063927,-1693,-444696,-444847,0.06631833336484307,-516.5152615845425,0.1484474092169058
2023-09-22T12:00:00-04:00,1.06593,1.06603,1.06563,1.06588,1.0650848183533717,1.0659857777777777,1.0660699999999936,1.065902888888885,1.0653955000000042,1.0649697999999999,1.065396500000005,1.0657560500000063,1.0658579894679423,1.065798465525114,-1418,-446114,-445243.4,0.07025837542164064,-516.5817762712481,-0.015946719197036115
2023-09-22T12:15:00-04:00,1.06588,1.06598,1.06552,1.06555,1.0652933365180344,1.0658817777777778,1.0660111111111046,1.065967777777774,1.0654780000000041,1.0649777999999999,1.0653921000000048,1.0657249500000063,1.0657963915743538,1.0658127724200912,-1757,-447871,-445359.8,0.05773805213876486,-517.1257493263762,-0.0497148431637325
2023-09-22T12:30:00-04:00,1.06555,1.06616,1.06548,1.06597,1.06717,1.0658735555555556,1.065945555555549,1.066005777777774,1.0655700000000041,1.0649863999999998,1.065390900000005,1.0656936000000063,1.065831113259483,1.0658342179360727,1533,-446338,-445604.4,0.04744915539448595,-516.5214980007696,-0.05531803180316798
2023-09-22T12:45:00-04:00,1.06597,1.06598,1.0655,1.06554,1.0671362,1.0657924444444444,1.0658088888888821,1.065984888888885,1.0656660000000042,1.0649904,1.065382900000005,1.0656615500000062,1.0657728906075865,1.065822174348858,-1289,-447627,-446529.2,0.03157268151963409,-517.0414657296927,-0.1153013301836445
2023-09-22T13:00:00-04:00,1.06554,1.0659399999999999,1.06547,1.06589,1.067103076,1.0658086666666666,1.06581666666666,1.0659304444444406,1.0657170000000042,1.0649968,1.0653819000000049,1.0656301500000063,1.0657963124860692,1.0658109394790862,1474,-446153,-446820.6,0.013168471988237677,-516.5572980776101,0.006567713122292178
2023-09-22T13:15:00-04:00,1.06589,1.06614,1.06557,1.06568,1.06703775296,1.0657813333333335,1.065825555555549,1.0658815555555516,1.0657140000000043,1.0650009999999999,1.065379500000005,1.065600000000006,1.0657730499888554,1.0657939515832688,-1738,-447891,-447176,0.008235023918842697,-516.8997161507697,0.007507507507515016
2023-09-22T13:30:00-04:00,1.06568,1.06569,1.06523,1.06536,1.0669750428415998,1.0656882222222221,1.065785555555549,1.0658364444444406,1.0657270000000043,1.0649994,1.065374800000005,1.0655689500000063,1.0656904399910843,1.0657727612666148,-1731,-449622,-447526.2,0.0076810887040055335,-517.4194969480069,-0.03377997973200427
2023-09-22T13:45:00-04:00,1.06536,1.06544,1.0651599999999999,1.06518,1.066870340271104,1.0655671111111111,1.0656644444444379,1.0657802222222184,1.0657075000000042,1.0649963999999998,1.0653709000000051,1.0655377500000063,1.0655883519928675,1.065724209013292,-1594,-451216,-448501.8,0.0022565072308200463,-517.6888143618389,-0.10222551511343612
2023-09-22T14:00:00-04:00,1.06518,1.06528,1.06487,1.06492,1.0667335130494155,1.0654182222222222,1.0655522222222156,1.065728888888885,1.0656985000000043,1.0649875999999998,1.065359900000005,1.0654995500000062,1.065454681594294,1.0656605672106334,-1476,-452692,-449514.8,-0.0075070143663895465,-518.0490914980975,-0.09475293874831887
2023-09-22T14:15:00-04:00,1.06492,1.06494,1.06451,1.06463,1.066547161744474,1.0652337777777776,1.0654133333333267,1.0656482222222183,1.0656875000000043,1.0649818,1.065337800000005,1.0654543500000062,1.0652897452754353,1.0655592537685066,-1149,-453841,-451052.4,-0.017606105833089882,-518.361988241515,-0.1172739895673034
2023-09-22T14:30:00-04:00,1.06463,1.06467,1.06392,1.06398,1.066302702335137,1.064947111111111,1.0652388888888822,1.065530888888885,1.0656690000000044,1.0649623999999998,1.0653119000000049,1.0654064500000062,1.0650277962203483,1.0654102030148052,-1536,-455377,-452549.6,-0.0315492232678097,-519.2997788354303,-0.14734174839285546
2023-09-22T14:45:00-04:00,1.06398,1.06497,1.06397,1.06469,1.0659691240082179,1.0648373333333334,1.06509666666666,1.0653931111111075,1.0656010000000042,1.0649498,1.065292900000005,1.0653623500000062,1.0649602369762785,1.0652641624118437,2044,-453333,-453291.8,-0.04113848960150048,-517.9358058284189,-0.12007842622214225
2023-09-22T15:00:00-04:00,1.06469,1.06512,1.06465,1.06494,1.0656822466470675,1.064806,1.0650299999999933,1.0652662222222182,1.0655440000000043,1.0649296,1.065273200000005,1.0653215500000064,1.064956189581023,1.0651377299294749,2201,-451132,-453275,-0.045846263299246785,-517.4189887267271,-0.05630947688495354
2023-09-22T15:15:00-04:00,1.06494,1.06507,1.06487,1.06497,1.065435532116478,1.064794,1.064927777777771,1.0651413333333293,1.0654645000000043,1.0649099999999998,1.065253400000005,1.0652814000000062,1.0649589516648184,1.0650385839435796,1965,-449167,-452570,-0.046237349642461095,-517.3636334954465,-0.08631284654139094
2023-09-22T15:30:00-04:00,1.06497,1.06502,1.06462,1.06467,1.065223357620171,1.0647424444444444,1.0648155555555487,1.065021777777774,1.0653595000000042,1.0648735999999999,1.065231400000005,1.0652414000000061,1.0649011613318546,1.0649608671548636,-1405,-450572,-451916.2,-0.04924474701826874,-517.7594192922295,-0.0947751670294981
2023-09-22T15:45:00-04:00,1.06467,1.06479,1.06435,1.06435,1.06507,1.0646493333333333,1.0647033333333265,1.0649146666666627,1.0652860000000042,1.0649156,1.065213200000005,1.065199900000006,1.0647909290654838,1.0649134937238909,-1761,-452333,-451307.4,-0.050917370909504454,-518.2887100583825,-0.09480363445222059
2023-09-22T16:00:00-04:00,1.06435,1.06471,1.06435,1.06464,1.06502,1.0646366666666667,1.0646433333333265,1.0648239999999962,1.0652380000000043,1.0649206,1.065194100000005,1.0651804000000062,1.0647607432523871,1.0648735949791126,996,-451337,-450908.2,-0.05240416336603699,-518.017333161685,-0.050695657072042745
2023-09-22T16:15:00-04:00,1.06464,1.06465,1.06413,1.06417,1.064866,1.0645419999999999,1.064559999999993,1.0647299999999962,1.0651605000000042,1.0649128,1.0651718000000048,1.065152550000006,1.0646425946019098,1.06481087598329,-1073,-452410,-451163.8,-0.05549661964146665,-518.4910237988956,-0.0704278255643643
2023-09-22T16:30:00-04:00,1.06417,1.06453,1.06414,1.06449,1.06473356,1.064528,1.0645444444444376,1.0646533333333295,1.0650715000000042,1.0649165999999999,1.065153000000005,1.0651249500000062,1.0646120756815278,1.0647415007866319,386,-452024,-451735.2,-0.05403774192235016,-518.374952118619,-0.013150108488397753
2023-09-22T16:45:00-04:00,1.06449,1.06456,1.0643,1.06452,1.06465,1.0645231111111113,1.0646044444444376,1.0646111111111074,1.0650010000000043,1.0649182000000001,1.0651390000000047,1.065104250000006,1.0645936605452222,1.0646800006293056,969,-451055,-451831.8,-0.04725039624951183,-518.3476432664927,0.050752833699880165
2023-09-24T17:00:00-04:00,1.06452,1.06511,1.06452,1.06505,1.06392,1.0646122222222223,1.0646444444444376,1.0645993333333295,1.0649595000000043,1.064926,1.0651319000000046,1.065091500000006,1.0646849284361777,1.064658800503444,45,-451010,-451567.2,-0.03327063139065934,-518.3252388025089,0.03381265908387775
2023-09-24T17:15:00-04:00,1.06505,1.06507,1.06497,1.065,1.0639437999999999,1.0646833333333334,1.0646511111111043,1.064600888888885,1.0649320000000044,1.0649338,1.0651235000000048,1.0650773000000062,1.0647479427489421,1.0646562404027553,-72,-451082,-451516.2,-0.026426175059176132,-518.3286189255078,0.005634120232120963
2023-09-24T17:30:00-04:00,1.065,1.06511,1.0647199999999999,1.06494,1.063967124,1.0647411111111111,1.064647777777771,1.0646184444444406,1.0648805000000043,1.0649442,1.0651115000000049,1.0650706500000062,1.0647863541991538,1.0646849923222041,-161,-451243,-451282.8,-0.023699246721527137,-518.337689348043,-0.002816980760019014
2023-09-24T17:45:00-04:00,1.06494,1.06494,1.06406,1.06428,1.06398998152,1.0646675555555554,1.0646044444444376,1.0646304444444405,1.0648175000000042,1.064958,1.0650964000000047,1.0650628000000062,1.064685083359323,1.0646995938577632,-198,-451441,-451166.2,-0.022623311356808617,-518.4604004866987,-0.03663106878188664
2023-09-24T18:00:00-04:00,1.06428,1.06515,1.0642,1.06513,1.0640123818896001,1.0647726666666668,1.0646911111111044,1.0646477777777739,1.0647795000000042,1.0649916,1.0650887000000049,1.065061250000006,1.0647740666874586,1.0647356750862105,572,-450869,-451129,-0.01647028729748015,-518.00356581913,0.07328416404378287
2023-09-24T18:15:00-04:00,1.06513,1.0651599999999999,1.0649899999999999,1.06513,1.064057886614016,1.0648604444444443,1.0647455555555487,1.0646679999999962,1.0647520000000044,1.0650172,1.0650810000000048,1.065056350000006,1.0648452533499668,1.0647677400689681,0,-450869,-451100.8,-0.005746684364199599,-518.00356581913,0.04602494740004879
2023-09-24T18:30:00-04:00,1.06513,1.06513,1.06484,1.06491,1.064124013417175,1.0648933333333335,1.064827777777771,1.0647033333333296,1.064729500000004,1.065027,1.0650711000000048,1.065051100000006,1.0648582026799736,1.0647897920551745,-322,-451191,-451122.6,0.000232558659737211,-518.0700741326692,0.06953776182376527
2023-09-24T18:45:00-04:00,1.06491,1.06496,1.06466,1.0649,1.0641861726121444,1.0649077777777778,1.0648733333333267,1.0647484444444406,1.0647155000000041,1.0650477999999999,1.065061400000005,1.065045350000006,1.0648665621439788,1.0648058336441395,-377,-451568,-451187.6,0.00914600467201193,-518.0736143379448,0.03851609691025951
2023-09-24T19:00:00-04:00,1.0649,1.06495,1.06469,1.06485,1.0642446022554157,1.0649031111111111,1.0649099999999931,1.0648095555555517,1.064712000000004,1.0650718000000001,1.0650478000000048,1.065039500000006,1.064863249715183,1.0648414669153115,-904,-452472,-451393.8,0.014003209423052086,-518.1160596379729,0.03099988727315255
2023-09-24T19:15:00-04:00,1.06485,1.06503,1.06482,1.0649,1.0642995261200907,1.064901111111111,1.0648933333333266,1.0648499999999963,1.0647255000000042,1.0650988000000001,1.065033700000005,1.065033750000006,1.0648705997721464,1.0648607735322488,558,-451914,-451602.8,0.017661681084506765,-518.0898587646104,-0.0140838458288432
2023-09-24T19:30:00-04:00,1.0649,1.06519,1.0649,1.06496,1.0643511545528852,1.0649144444444443,1.0648888888888821,1.064878666666663,1.0647745000000042,1.0651220000000001,1.0650218000000047,1.0650272500000062,1.0648884798177172,1.0648694188257992,697,-451217,-451672.4,0.01534025627634192,-518.0505874715313,-0.0037558685446046954
2023-09-24T19:45:00-04:00,1.06496,1.06496,1.06474,1.06483,1.0644182621886544,1.0649026666666666,1.06487666666666,1.0648884444444406,1.064781500000004,1.0651406,1.0650087000000048,1.0650196500000062,1.0648767838541737,1.064873135060639,-967,-452184,-451871,0.009941718186649134,-518.1686294637188,-0.010329220425568999
2023-09-24T20:00:00-04:00,1.06483,1.06513,1.0648,1.06501,1.064480001213562,1.0649293333333332,1.064957777777771,1.0649053333333296,1.064785000000004,1.0651582,1.0649982000000047,1.065015000000006,1.064903427083339,1.064880508048511,1405,-450779,-451713.2,0.009167895015685632,-517.9311267637572,0.06859097230053365
2023-09-24T20:15:00-04:00,1.06501,1.06519,1.06487,1.06515,1.064536801116477,1.0649677777777775,1.0649599999999932,1.0649153333333294,1.064794000000004,1.0651888,1.0649905000000046,1.065012300000006,1.0649527416666713,1.0648984064388087,996,-449783,-451175.4,0.016399197705043764,-517.8001984156666,0.0018777050688771348
2023-09-24T20:30:00-04:00,1.06515,1.06529,1.06488,1.06517,1.064589057027159,1.0650097777777776,1.0649644444444377,1.0649295555555518,1.064819000000004,1.0651948000000002,1.0649809000000048,1.065010800000006,1.064996193333337,1.064923525151047,1152,-448631,-450518.8,0.015880291846930458,-517.7785676594352,0.003755410137733423
2023-09-24T20:45:00-04:00,1.06517,1.06556,1.06509,1.06544,1.064659151324443,1.0651048888888888,1.0650233333333265,1.0649564444444408,1.064873500000004,1.0651888000000003,1.0649750000000047,1.065010500000006,1.0650849546666696,1.0649628201208372,1304,-447327,-449740.8,0.015347587987182615,-517.4480288721994,0.049769464086159336
2023-09-24T21:00:00-04:00,1.06544,1.0655,1.06487,1.0649,1.06476725316551,1.0650802222222222,1.0650233333333268,1.064985777777774,1.064886500000004,1.0651848000000002,1.064967800000005,1.065009000000006,1.0650479637333357,1.0649970560966697,-1165,-448492,-449002.4,0.012793813893775666,-518.0384891515206,0
2023-09-24T21:15:00-04:00,1.0649,1.06514,1.06488,1.06489,1.0648623827856487,1.0650535555555556,1.0650277777777712,1.0649997777777742,1.064922500000004,1.0651712000000004,1.0649615000000048,1.065006700000006,1.0650163709866685,1.0650196448773355,-1136,-449628,-448772.2,0.011581827174276884,-518.0491568198463,0.003756397614670419
2023-09-24T21:30:00-04:00,1.06489,1.06506,1.06443,1.0645,1.06556,1.064948,1.064983333333327,1.0650044444444409,1.0649230000000043,1.0651592000000003,1.0649494000000048,1.065003450000006,1.0649130967893348,1.0650117159018682,-1689,-451317,-449079,0.006819314983225806,-518.667727752055,-0.037562212414307065
2023-09-24T21:45:00-04:00,1.0645,1.06486,1.06448,1.06466,1.0655374,1.0648833333333332,1.0649499999999936,1.0650015555555519,1.0649300000000042,1.0651554000000003,1.0649385000000047,1.065001850000006,1.064862477431468,1.0649849727214944,1526,-449791,-449311,0.00380537241691534,-518.4383618525718,-0.028170072115381514
2023-09-24T22:00:00-04:00,1.06466,1.06471,1.06443,1.06459,1.065515252,1.0648113333333333,1.064923333333327,1.064981555555552,1.064907000000004,1.0651602000000002,1.0649353000000048,1.0650002000000063,1.0648079819451743,1.0649295781771955,-1440,-451231,-450091.8,0.000017886536043654768,-518.5330399657723,-0.022538809011768825
2023-09-24T22:15:00-04:00,1.06459,1.06466,1.0643,1.06441,1.06549354696,1.0647086666666667,1.0648566666666606,1.0649482222222186,1.0648775000000041,1.0651274000000002,1.0649331000000049,1.065001800000006,1.0647283855561396,1.0648656625417563,-985,-452216,-450836.6,-0.0010642793418192324,-518.6995829541527,-0.05633749917840526
2023-09-24T22:30:00-04:00,1.06441,1.0648,1.06434,1.06473,1.0654458050816,1.0646833333333334,1.0648099999999938,1.064904666666663,1.0648670000000042,1.0651004000000002,1.0649392000000049,1.0650084500000059,1.0647287084449117,1.064808130033405,1422,-450794,-451069.8,-0.0024863296585104187,-518.2720785150739,-0.03943106604704379
2023-09-24T22:45:00-04:00,1.06473,1.06495,1.0647,1.0649,1.065399972878336,1.0647013333333333,1.0647799999999938,1.0648639999999965,1.0648980000000041,1.0650672000000003,1.0649451000000048,1.065017350000006,1.0647629667559293,1.064778104026724,1223,-449571,-450720.6,-0.004655168712775011,-518.0768083526852,-0.025348066505815267
2023-09-24T23:00:00-04:00,1.0649,1.06506,1.0648,1.06505,1.0653559739632026,1.0647553333333333,1.0647366666666604,1.0648213333333298,1.0648940000000042,1.0650328000000002,1.0649475000000046,1.065026400000006,1.0648203734047434,1.0647696832213789,1188,-448383,-450439,-0.009225055124326384,-517.9094686963793,-0.036604595284566985
2023-09-24T23:15:00-04:00,1.06505,1.06507,1.06485,1.06491,1.0653137350046744,1.06479,1.0647377777777718,1.0647842222222188,1.0648830000000042,1.0650146000000003,1.064948400000005,1.0650327500000059,1.0648382987237948,1.064775746577103,-957,-449340,-450060.8,-0.01321838643550085,-518.0352656073226,0.0009390553103639321
2023-09-24T23:30:00-04:00,1.06491,1.06493,1.06476,1.06486,1.0652731856044875,1.0648144444444443,1.0647344444444384,1.0647597777777744,1.0648805000000043,1.0649998000000003,1.0649485000000047,1.0650386000000056,1.0648426389790357,1.0647985972616822,-945,-450285,-449674.6,-0.012386797194389806,-518.0796355540788,-0.0028171923860656495
2023-09-24T23:45:00-04:00,1.06486,1.06498,1.06481,1.06482,1.065234258180308,1.0648315555555556,1.064769999999994,1.0647517777777744,1.0648765000000044,1.0649818000000002,1.0649486000000048,1.065043950000006,1.0648381111832286,1.0648204778093455,-675,-450960,-449707.8,-0.012641738844828117,-518.104990999865,0.030061061531244528
2023-09-25T00:00:00-04:00,1.06482,1.06482,1.06458,1.06465,1.0651968878530957,1.0648075555555556,1.0647688888888829,1.0647495555555522,1.0648665000000042,1.0649494000000002,1.0649434000000046,1.065047850000006,1.064800488946583,1.0648279822474764,-444,-451404,-450074.4,-0.010115292873776723,-518.1758762199022,-0.0009392669960215907
2023-09-25T00:15:00-04:00,1.06465,1.06492,1.06463,1.06482,1.0651610123389719,1.0648177777777776,1.0647944444444386,1.064761111111108,1.0648625000000043,1.0649272000000003,1.0649413000000048,1.0650553000000058,1.0648043911572664,1.0648247857979811,695,-450709,-450539.6,-0.008478612297824348,-518.0649007819649,0.021604561380453934
2023-09-25T00:30:00-04:00,1.06482,1.06496,1.06475,1.06482,1.065126571845413,1.0648228888888889,1.064839999999994,1.0647815555555522,1.0648555000000042,1.0649060000000001,1.0649379000000048,1.0650695000000059,1.0648075129258132,1.0648186286383847,0,-450709,-450813.4,-0.0059609866168732996,-518.0649007819649,0.03851899174190598
2023-09-25T00:45:00-04:00,1.06482,1.06505,1.06481,1.06489,1.0650935089715965,1.064832888888889,1.064857777777772,1.064806222222219,1.0648585000000044,1.0648928,1.0649353000000048,1.0650804000000058,1.0648240103406506,1.0648149029107077,547,-450162,-450788.8,-0.0011403273408209218,-518.0289416527224,0.015027283912347542
2023-09-25T01:00:00-04:00,1.06489,1.06502,1.06481,1.06494,1.0650617686127326,1.0648493333333333,1.0648622222222164,1.0648246666666634,1.0648550000000043,1.0648722000000002,1.0649293000000046,1.065089550000006,1.0648472082725204,1.0648167223285658,864,-449298,-450456.4,0.0003398605947676342,-517.988374082363,0.003756221241434877
2023-09-25T01:15:00-04:00,1.06494,1.06497,1.06482,1.06495,1.06505,1.064866888888889,1.0648511111111052,1.0648411111111078,1.0648450000000043,1.0648604,1.0649254000000048,1.0650969500000058,1.0648677666180164,1.0648301778628526,507,-448791,-449933.8,0.0010777187245609257,-517.9836132507668,-0.009389230552555184
2023-09-25T01:30:00-04:00,1.06495,1.06496,1.06441,1.06446,1.06502,1.0647886666666668,1.064801111111105,1.0648424444444413,1.0648095000000042,1.0648317999999999,1.0649143000000045,1.065100550000006,1.064786213294413,1.0648265422902816,-1018,-449809,-449753.8,-0.0013773759733507049,-518.452010828118,-0.04225709214863805
2023-09-25T01:45:00-04:00,1.06446,1.06448,1.0642,1.06441,1.0649912000000001,1.0647104444444444,1.064751111111105,1.0648246666666634,1.0647580000000043,1.0648064,1.0649037000000048,1.065104350000006,1.0647109706355304,1.0648072338322252,-1138,-450947,-449801.4,-0.0026743468420153678,-518.5054651617706,-0.04225907631048583
2023-09-25T02:00:00-04:00,1.06441,1.0647199999999999,1.0643,1.06471,1.06496,1.0647022222222224,1.064738888888883,1.0648008888888856,1.0647485000000043,1.0647934,1.0648964000000045,1.0651108500000057,1.0647107765084243,1.06478458706578,2207,-448740,-449517,-0.0008184305183809473,-517.8834304195192,-0.010330384478132875
2023-09-25T02:15:00-04:00,1.06471,1.06479,1.06435,1.06451,1.0649144,1.0646564444444444,1.0647233333333272,1.064773111111108,1.0647295000000043,1.0647799999999998,1.0648882000000046,1.0651155500000058,1.0646706212067394,1.064749269652624,-1387,-450127,-449682.8,-0.0019857349095453677,-518.1439708483683,-0.013149861456819517
2023-09-25T02:30:00-04:00,1.06451,1.06452,1.06426,1.06452,1.0648715359999998,1.0646157777777778,1.0646899999999941,1.0647408888888856,1.0647305000000042,1.0647719999999998,1.0648798000000046,1.065120500000006,1.0646404969653915,1.064703815722099,1509,-448618,-449648.2,-0.0015519401262270363,-518.1297953122064,-0.02817377584945709
2023-09-25T02:45:00-04:00,1.06452,1.06532,1.06449,1.06462,1.0642,1.0646017777777779,1.0646677777777718,1.064714222222219,1.0647285000000042,1.0647718,1.0648768000000046,1.065125100000006,1.0646363975723132,1.0646738525776789,2514,-446104,-448907.2,-0.003967041798634323,-517.8936325346165,-0.018782517232978344
2023-09-25T03:00:00-04:00,1.06462,1.06529,1.06439,1.06518,1.0642224,1.064704222222222,1.064699999999994,1.0647039999999968,1.0647580000000043,1.0647958,1.0648791000000046,1.065132450000006,1.0647451180578507,1.0646806820621428,3379,-442725,-447262.8,-0.0029114815682246276,-516.1162471764601,0.027232859732002696
2023-09-25T03:15:00-04:00,1.06518,1.0652,1.06429,1.0644,1.064244352,1.064644222222222,1.064639999999994,1.064684222222219,1.0647575000000042,1.06479,1.0648699000000046,1.065136900000006,1.0646760944462805,1.0646737456497142,-2744,-445469,-446608.6,-0.006663816282397646,-518.1255977087645,-0.05070708208913037
2023-09-25T03:30:00-04:00,1.0644,1.06458,1.06357,1.06361,1.06532,1.0644382222222222,1.064491111111105,1.0646377777777747,1.0647015000000042,1.0647634000000001,1.0648465000000045,1.065136900000006,1.0644628755570245,1.0646321965197711,-2763,-448232,-446229.6,-0.015577786961140067,-520.1763023310872,-0.12582750363867964
2023-09-25T03:45:00-04:00,1.06361,1.0639,1.06317,1.0638,1.065285,1.0643,1.0644177777777717,1.06458333333333,1.0646465000000043,1.0647399999999998,1.0648250000000046,1.065138550000006,1.0643303004456195,1.0645701572158166,2719,-445513,-445608.6,-0.022220403321585022,-519.6905885826264,-0.06200326926327743
2023-09-25T04:00:00-04:00,1.0638,1.0643,1.06337,1.06354,1.0652004,1.0641244444444444,1.0643211111111048,1.0645139999999969,1.0645710000000044,1.0647174,1.0647955000000047,1.0651367000000058,1.0641722403564955,1.0644773257726532,-4099,-449612,-446310.2,-0.02478029849952317,-520.6924122336892,-0.08173542150112723
2023-09-25T04:15:00-04:00,1.06354,1.0637699999999999,1.06287,1.06296,1.0651191839999998,1.0638522222222222,1.0641266666666604,1.0643993333333301,1.0644735000000043,1.0646896000000001,1.0648026000000046,1.065130500000006,1.0639297922851965,1.0643142606181224,-3238,-452850,-448335.2,-0.029054708741451437,-522.4582508481278,-0.16436400522209244
2023-09-25T04:30:00-04:00,1.06296,1.06324,1.06267,1.06275,1.0649842329599999,1.063576888888889,1.063931111111105,1.0642575555555525,1.0643680000000042,1.0646518,1.0647862000000046,1.065121650000006,1.0636938338281572,1.0641178084944978,-5027,-457877,-450816.8,-0.03780832507891191,-523.4513926408567,-0.1653342852580045
2023-09-25T04:45:00-04:00,1.06275,1.0629,1.0624,1.06256,1.0647990943232,1.0633026666666667,1.063713333333327,1.0641019999999968,1.0642550000000042,1.0646196,1.0647662000000044,1.065109300000006,1.0634670670625257,1.063918646795598,-3531,-461408,-453452,-0.04584356454052331,-524.0826699873639,-0.18412054259196275
2023-09-25T05:00:00-04:00,1.06256,1.06304,1.06239,1.0625499999999999,1.06455918489088,1.06307,1.063483333333327,1.0639151111111078,1.0641500000000041,1.0645807999999999,1.0647487000000044,1.065101450000006,1.0632836536500205,1.0637093174364782,-3562,-464970,-457343.4,-0.05420256716011077,-524.1161928001935,-0.19443557325618685
2023-09-25T05:15:00-04:00,1.0625499999999999,1.06306,1.06242,1.06301,1.0642988827039743,1.0629753333333332,1.0632422222222158,1.06369933333333,1.0640595000000042,1.0645505999999998,1.0647344000000045,1.065094450000006,1.0632289229200165,1.0635206539491824,2730,-462240,-459869,-0.061997645216994184,-522.9343190060188,-0.20372143675247426
2023-09-25T05:30:00-04:00,1.06301,1.06322,1.0625499999999999,1.06322,1.0640698167794973,1.062970888888889,1.0631111111111047,1.0634962222222186,1.0639795000000043,1.064514,1.0647200000000046,1.0650871500000059,1.0632271383360132,1.0633801231593458,1954,-460286,-461356.2,-0.07326217161227053,-522.5483019412686,-0.11086057872979696
2023-09-25T05:45:00-04:00,1.06322,1.06369,1.06303,1.06347,1.0638682387659577,1.0630426666666666,1.0630955555555492,1.0633291111111076,1.0639085000000041,1.0644833999999999,1.0647086000000046,1.065076950000006,1.0632757106688107,1.0632964985274764,2182,-458104,-461401.6,-0.07596542282010176,-522.0352378529335,-0.013162719417834451
2023-09-25T06:00:00-04:00,1.06347,1.06389,1.06338,1.06385,1.06239,1.0631935555555554,1.0631011111111048,1.063206666666663,1.063854000000004,1.0644616,1.0647029000000046,1.065067450000006,1.0633905685350484,1.063281198821981,2574,-455530,-460226,-0.06905821407352769,-521.1154939955609,0.004700131603673949
2023-09-25T06:15:00-04:00,1.06385,1.06416,1.06367,1.06415,1.06242,1.0634033333333333,1.0631688888888826,1.0631437777777741,1.063814000000004,1.064459,1.0647085000000047,1.065059500000006,1.0635424548280388,1.0633329590575848,2038,-453492,-457930.4,-0.06223471133841352,-520.5407889149575,0.05735562367188817
2023-09-25T06:30:00-04:00,1.06415,1.06417,1.06352,1.06363,1.0624896,1.0634955555555556,1.0632433333333269,1.0631439999999963,1.063772500000004,1.0644289999999998,1.0647103000000047,1.065051000000006,1.0635599638624311,1.0633991672460676,-2006,-455498,-456582,-0.05548366130368455,-521.5210266633949,0.06303153458269084
2023-09-25T06:45:00-04:00,1.06363,1.06389,1.06352,1.06372,1.062590424,1.063590888888889,1.063351111111105,1.0631919999999966,1.063738000000004,1.0644007999999998,1.0647090000000048,1.065041850000006,1.0635919710899449,1.063472133796854,1887,-453611,-455247,-0.04502853060320134,-521.3613564773341,0.09127264173134936
2023-09-25T07:00:00-04:00,1.06372,1.06404,1.06361,1.06404,1.0626851985599999,1.0637286666666668,1.0635155555555493,1.0632759999999966,1.063704500000004,1.0643833999999999,1.0647052000000046,1.0650308500000059,1.0636815768719559,1.0635533070374832,1889,-451722,-453970.6,-0.03124608304810073,-520.7930866318859,0.13928625207048523
2023-09-25T07:15:00-04:00,1.06404,1.06435,1.06362,1.06363,1.0627742866463998,1.0637515555555555,1.0636355555555492,1.0633828888888854,1.0636605000000041,1.064358,1.0647029000000048,1.0650197000000061,1.0636712614975647,1.0636094456299863,-1978,-453700,-453604.6,-0.01635350429653095,-521.5552572269763,0.10164227565763419
2023-09-25T07:30:00-04:00,1.06363,1.06384,1.0634,1.0637,1.0629003437146878,1.0637644444444445,1.0637122222222162,1.063491555555552,1.063619500000004,1.0643349999999998,1.0647034000000046,1.0650076000000062,1.0636770091980519,1.063636356503989,1987,-451713,-453248.8,-0.0019161110464782753,-521.4244880685284,0.06491001966115835
2023-09-25T07:45:00-04:00,1.0637,1.06376,1.06291,1.06304,1.06435,1.06363,1.0636922222222163,1.0635813333333297,1.0635405000000042,1.0642977999999998,1.0646983000000048,1.0649961500000062,1.0635496073584414,1.0636342852031908,-2716,-454429,-453035,0.004992068655279678,-523.1097000643921,-0.016929704106400274
2023-09-25T08:00:00-04:00,1.06304,1.06346,1.06303,1.06314,1.0643212,1.0635195555555557,1.0636555555555496,1.0636422222222186,1.0634385000000042,1.0642614,1.0646917000000047,1.0649858500000062,1.0634676858867531,1.0636094281625526,2470,-451959,-452704.6,0.0108668641241315,-522.8773475658973,-0.031030494513238877
2023-09-25T08:15:00-04:00,1.06314,1.06325,1.06252,1.06275,1.064292976,1.0633384444444443,1.0635333333333274,1.0636457777777744,1.063356000000004,1.0642197999999998,1.0646802000000046,1.064969400000006,1.0633241487094025,1.063537942530042,-2883,-454842,-453328.6,0.014978828131934387,-523.9349411095507,-0.10339803543731531
2023-09-25T08:30:00-04:00,1.06275,1.06294,1.06206,1.06229,1.06422205696,1.0630897777777777,1.0633266666666605,1.0635839999999965,1.0632900000000043,1.0641654,1.0646618000000045,1.064952850000006,1.063117318967522,1.0634271540240332,-3585,-458427,-454274,0.00975843069768275,-525.4866701144911,-0.17478738899590968
2023-09-25T08:45:00-04:00,1.06229,1.0625499999999999,1.06193,1.06221,1.0640923335424,1.0628664444444444,1.0631688888888828,1.0634753333333298,1.0632105000000043,1.0641066000000001,1.0646477000000047,1.0649386500000062,1.0629358551740176,1.0632789232192263,-2962,-461389,-456209.2,-0.002216946337579055,-525.7097353791547,-0.13350507225256686
2023-09-25T09:00:00-04:00,1.06221,1.06243,1.06087,1.06093,1.063919346859008,1.0624186666666666,1.0628588888888828,1.063308666666663,1.0630800000000042,1.0640218,1.0646083000000046,1.064919450000006,1.062534684139214,1.063075938575381,-4298,-465687,-458460.8,-0.014759145967074047,-530.8889748892335,-0.26228706802542684
2023-09-25T09:15:00-04:00,1.06093,1.06165,1.06084,1.06106,1.0636144121731073,1.0620588888888889,1.0625277777777717,1.0630831111111074,1.062985000000004,1.0639341999999998,1.0645615000000048,1.064905100000006,1.0622397473113712,1.0628303508603045,3115,-462572,-460583.4,-0.02867489806300323,-530.5072814693095,-0.28006465922335666
2023-09-25T09:30:00-04:00,1.06106,1.0611,1.0596,1.05974,1.0632814827123345,1.0615013333333334,1.0620955555555496,1.0627955555555517,1.0628345000000041,1.063831,1.0645079000000046,1.0648834500000062,1.061739797849097,1.0625134806882435,-5258,-467830,-463181,-0.05471015401798407,-537.0484384255608,-0.3657286838468425
2023-09-25T09:45:00-04:00,1.05974,1.0603799999999999,1.05956,1.06019,1.0627660751326076,1.061120222222222,1.0617055555555492,1.0624713333333295,1.0627160000000042,1.063737,1.0644541000000047,1.0648665500000063,1.0614298382792775,1.0621759845505945,4123,-463707,-464237,-0.07561540860527691,-535.2976788052763,-0.3299802575914378
2023-09-25T10:00:00-04:00,1.06019,1.0607199999999999,1.05917,1.05937,1.0622531031113904,1.060653111111111,1.0612977777777717,1.062097111111107,1.0625570000000042,1.0636344,1.0643968000000048,1.0648461500000062,1.061017870623422,1.0617923876404753,-4219,-467926,-465544.4,-0.10208083019862581,-538.5608486144616,-0.3452363034316735
2023-09-25T10:15:00-04:00,1.05937,1.0594,1.05783,1.05846,1.06169814455134,1.0600855555555553,1.0607777777777718,1.0616808888888851,1.0623295000000041,1.0635104,1.0643329000000048,1.064822300000006,1.0605062964987375,1.06138671011238,-5374,-473300,-467067,-0.1268781152505994,-543.1771205496682,-0.44020542920029515
2023-09-25T10:30:00-04:00,1.05846,1.05906,1.05807,1.0583,1.060924515641072,1.05959,1.0602833333333272,1.0612319999999962,1.062083500000004,1.0633846,1.0642724000000048,1.0647963500000062,1.06006503719899,1.0609517680899039,-5498,-478798,-470312.2,-0.15135694459804103,-544.0082147809095,-0.4187250058809753
2023-09-25T10:45:00-04:00,1.0583,1.05862,1.05751,1.05773,1.0603056125128576,1.0590793333333335,1.0597766666666606,1.0607682222222183,1.061796500000004,1.0632510000000002,1.0641892000000048,1.064764000000006,1.059598029759192,1.0605234144719229,-4564,-483362,-473418.6,-0.1740495259960031,-546.4663835421302,-0.42926131282417207
2023-09-25T11:00:00-04:00,1.05773,1.0587199999999999,1.05759,1.0584,1.059746490010286,1.058804,1.0593533333333274,1.060297777777774,1.0615240000000041,1.0631244000000002,1.0641124000000048,1.064733350000006,1.0593584238073537,1.0601091315775382,4007,-479355,-476548.2,-0.1879895022633717,-543.9282216293549,-0.35868613550993594
2023-09-25T11:15:00-04:00,1.0584,1.05903,1.0584,1.05871,1.0592991920082289,1.0586753333333334,1.0591066666666606,1.059859555555552,1.0612520000000043,1.0630006,1.0640339000000048,1.064700100000006,1.059228739045883,1.0597513052620304,3214,-476141,-478191.2,-0.19794797388308583,-542.9868573058476,-0.2092503746712685
2023-09-25T11:30:00-04:00,1.05871,1.05929,1.0585499999999999,1.05915,1.05751,1.058684,1.0588944444444384,1.059482888888885,1.0610280000000043,1.0628826,1.063957700000005,1.0646685000000062,1.0592129912367063,1.059492644209624,2908,-473233,-478177.8,-0.19232918046358805,-541.778292165252,-0.18000867057469477
2023-09-25T11:45:00-04:00,1.05915,1.05928,1.05871,1.059,1.0575455999999999,1.058705111111111,1.0588122222222163,1.0591886666666628,1.0607920000000042,1.0627644,1.0638895000000048,1.0646432000000061,1.059170392989365,1.059313715367699,-2681,-475914,-477601,-0.19100466975088515,-542.1579834271131,-0.06982844848736133
2023-09-25T12:00:00-04:00,1.059,1.05962,1.05879,1.05952,1.057580488,1.0588466666666667,1.0587377777777718,1.058980888888885,1.0605660000000041,1.0626576,1.0638287000000048,1.064616900000006,1.059240314391492,1.059242172294159,2428,-473486,-475625.8,-0.17425980994226237,-540.9657643525143,-0.06319621954554829
2023-09-25T12:15:00-04:00,1.05952,1.05963,1.05928,1.05935,1.05766206848,1.058969111111111,1.0587355555555495,1.0588573333333293,1.060352000000004,1.0625482,1.063765000000005,1.0645826000000063,1.0592622515131935,1.0592229378353268,-1781,-475267,-474808.2,-0.16115815105673412,-541.2515258294095,-0.0018879145152221586
2023-09-25T12:30:00-04:00,1.05935,1.05936,1.05904,1.05906,1.0577801443712,1.059034,1.0588022222222162,1.0587964444444407,1.0601200000000042,1.0624364,1.063692900000005,1.0645457000000063,1.0592218012105548,1.0592215502682614,-1935,-477202,-475020.4,-0.143590480595832,-541.7812374450231,0.056686128904250885
2023-09-25T12:45:00-04:00,1.05906,1.05917,1.05876,1.0589,1.057891135708928,1.0590535555555556,1.0588688888888826,1.0587913333333294,1.059913000000004,1.0623179999999999,1.063622600000005,1.0645103000000062,1.0591574409684439,1.0592104402146088,-2481,-479683,-476310.4,-0.11790865762535797,-542.1560604012294,0.056694699045632985
2023-09-25T13:00:00-04:00,1.0589,1.05963,1.05886,1.05949,1.0579954675663923,1.0591777777777778,1.0590644444444384,1.0588417777777737,1.0597305000000041,1.0622113999999998,1.063558700000005,1.0644776000000062,1.0592239527747551,1.0592211521716868,1742,-477941,-476715.8,-0.09075041277736055,-541.1854493898023,0.1663940703204016
2023-09-25T13:15:00-04:00,1.05949,1.05974,1.05937,1.05966,1.0580935395124087,1.059296888888889,1.0592044444444384,1.0589351111111072,1.059576000000004,1.0621067999999998,1.063499800000005,1.064445950000006,1.0593111622198041,1.0592353217373494,1553,-476388,-477296.2,-0.0569149201476834,-540.9362634607232,0.11904761904762272
2023-09-25T13:30:00-04:00,1.05966,1.05966,1.0591599999999999,1.05918,1.058225256351416,1.0592920000000001,1.0592566666666605,1.0590393333333292,1.059420500000004,1.0619915999999998,1.0634319000000054,1.064411400000006,1.0592849297758433,1.0592398573898791,-1632,-478020,-477846.8,-0.033518046623045514,-541.675519448493,0.04439364887457098
2023-09-25T13:45:00-04:00,1.05918,1.05952,1.05896,1.05948,1.0583464358433028,1.0593366666666666,1.0592933333333272,1.0591375555555516,1.0592840000000041,1.0618821999999999,1.0633713000000053,1.064377100000006,1.0593239438206747,1.0592602859119031,1642,-476378,-477682,-0.013623763871348553,-541.2104426910014,0.03115705990652329
2023-09-25T14:00:00-04:00,1.05948,1.05988,1.05948,1.05965,1.0584579209758385,1.059408,1.0593655555555495,1.059236888888885,1.059220000000004,1.061786,1.0633089000000053,1.064345400000006,1.0593891550565397,1.0593066287295223,1321,-475057,-476756.8,0.0026027934853965263,-540.9984802188452,0.06137865911237389
2023-09-25T14:15:00-04:00,1.05965,1.05976,1.05946,1.05947,1.0586001288782545,1.059428888888889,1.0593599999999939,1.0592959999999958,1.0591405000000043,1.0616872,1.0632468000000053,1.064313150000006,1.0594053240452317,1.0593429029836177,-1175,-476232,-476415,0.013603747909192939,-541.1980744244792,-0.004719118091221073
2023-09-25T14:30:00-04:00,1.05947,1.05948,1.05877,1.05884,1.0587281159904292,1.0593248888888889,1.0593033333333275,1.0593157777777737,1.0590955000000044,1.0615698,1.0631816000000054,1.0642782000000062,1.0592922592361853,1.0593391223868938,-1464,-477696,-476676.6,0.017165992631173427,-542.0686229062671,-0.04814272903195454
2023-09-25T14:45:00-04:00,1.05884,1.059,1.05856,1.05869,1.05988,1.0592022222222224,1.0592622222222163,1.0593168888888849,1.0590205000000044,1.0614533999999998,1.0631167000000052,1.064243800000006,1.0591718073889482,1.0593164979095147,-1768,-479464,-476965.4,0.015656052444857824,-542.3190856768464,-0.0349366419277455
2023-09-25T15:00:00-04:00,1.05869,1.05893,1.05853,1.05866,1.0598535999999998,1.059081777777778,1.0592355555555497,1.0593053333333295,1.0589850000000043,1.0613362,1.063054100000005,1.064207000000006,1.0590694459111585,1.0592655983276114,-2058,-481522,-477994.2,0.018759777275090962,-542.3774030313127,-0.022665029747853244
2023-09-25T15:15:00-04:00,1.05866,1.05906,1.05865,1.0588899999999999,1.059800656,1.0590126666666664,1.059168888888883,1.0592659999999963,1.0590065000000042,1.0612215999999999,1.0629967000000051,1.064167250000006,1.0590335567289269,1.0591944786620888,1217,-480305,-479043.8,0.020824161963762584,-542.113002751714,-0.0566310205853907
2023-09-25T15:30:00-04:00,1.0588899999999999,1.05909,1.05883,1.05899,1.0597498297599999,1.0589768888888889,1.0590944444444383,1.0592128888888852,1.0590410000000041,1.0610978,1.0629468000000053,1.064129350000006,1.0590248453831415,1.0591183829296706,953,-479352,-479667.8,0.013719068020941262,-542.0230028461524,-0.06322782779381579
2023-09-25T15:45:00-04:00,1.05899,1.0593299999999999,1.05899,1.05928,1.0597010365695998,1.0590140000000001,1.0591055555555495,1.0591733333333295,1.0591185000000043,1.0609954,1.0628927000000052,1.064092800000006,1.0590758763065131,1.0590751063437363,1733,-477619,-479652.4,0.0057238951266287705,-541.5484280154176,0.009441265884928812
2023-09-25T16:00:00-04:00,1.05928,1.05928,1.05908,1.05926,1.059654195106816,1.059044888888889,1.0590811111111051,1.0591371111111072,1.059161500000004,1.0609083999999998,1.0628359000000052,1.064054550000006,1.0591127010452106,1.0590632850749888,-591,-478210,-479401.6,-0.00040015052830431603,-541.5595865381878,-0.020764903537573806
2023-09-25T16:15:00-04:00,1.05926,1.0594,1.05925,1.05938,1.0596092273025433,1.0591046666666668,1.0590511111111052,1.0591002222222183,1.0591950000000043,1.0608199999999999,1.0627800000000052,1.064016700000006,1.0591661608361684,1.059082628059991,267,-477943,-478685.8,-0.005750224456291927,-541.5293390068923,-0.025480111357523
2023-09-25T16:30:00-04:00,1.05938,1.05947,1.05931,1.05938,1.0595660582104416,1.0591704444444445,1.059041111111105,1.0590746666666626,1.0592065000000042,1.0607368,1.0627271000000051,1.063979250000006,1.0592089286689348,1.0591177024479925,0,-477943,-478213.4,-0.011311281429465454,-541.5293390068923,-0.008494813444450855
2023-09-25T16:45:00-04:00,1.05938,1.05942,1.05911,1.0593,1.059524615882024,1.059222222222222,1.0590922222222163,1.0590742222222183,1.0592215000000043,1.0606635999999998,1.0626766000000052,1.0639449000000059,1.0592271429351479,1.0591581619583939,-1418,-479361,-478215.2,-0.01359052987755453,-541.6364205073927,0.04344376865247865
2023-09-25T17:00:00-04:00,1.0593,1.05931,1.05897,1.05931,1.059484831246743,1.0592657777777779,1.059161111111105,1.0590853333333294,1.0592110000000043,1.0605947999999998,1.0626233000000052,1.0639087000000058,1.0592437143481184,1.0591917295667146,61,-479300,-478551.4,-0.010546787545371814,-541.635844655415,0.058562940993120274
2023-09-25T17:15:00-04:00,1.05931,1.05931,1.05883,1.05911,1.0594466379968734,1.0592555555555556,1.059211111111105,1.0591113333333293,1.0591990000000044,1.0605257999999997,1.0625727000000051,1.063872250000006,1.0592169714784947,1.0592125836533717,-356,-479656,-478840.6,-0.004738499136344034,-541.703058218961,0.042506564902807464
2023-09-25T17:30:00-04:00,1.05911,1.05923,1.05906,1.05914,1.0594099724769985,1.0592413333333335,1.059238888888883,1.0591488888888851,1.0592030000000043,1.0604575999999997,1.062519200000005,1.063836100000006,1.0592015771827958,1.0592196669226972,363,-479293,-479110.6,0.000737306637079535,-541.6927760008723,0.023609628951079292
2023-09-25T17:45:00-04:00,1.05914,1.05924,1.05901,1.0591599999999999,1.0593747735779186,1.0592255555555556,1.059257777777772,1.0591922222222183,1.0592160000000044,1.0603805999999998,1.062465600000005,1.0638023000000059,1.0591932617462367,1.0592165335381574,1120,-478173,-479156.6,0.002836819489532339,-541.671626766588,0.016053031662223573
2023-09-25T18:00:00-04:00,1.0591599999999999,1.05945,1.05905,1.05929,1.05853,1.059232,1.0592588888888832,1.0592255555555519,1.0592060000000045,1.0603019999999999,1.0624080000000051,1.063769950000006,1.0592126093969894,1.0592136268305257,392,-477781,-478840.6,0.003915731304650935,-541.6235131671318,0.0009440374594125738
2023-09-25T18:15:00-04:00,1.05929,1.05966,1.05925,1.0594999999999999,1.0585484,1.0592802222222222,1.0592855555555498,1.059250444444441,1.0591980000000043,1.0602226,1.062353000000005,1.063738250000006,1.0592700875175916,1.0592189014644204,669,-477112,-478403,0.005947772889729108,-541.4908865965044,0.022657326813038905
2023-09-25T18:30:00-04:00,1.0594999999999999,1.0596,1.05926,1.05948,1.058592864,1.059319111111111,1.0592966666666608,1.0592675555555522,1.0592130000000044,1.0601352,1.0622984000000049,1.063704950000006,1.0593120700140732,1.0592379211715361,-885,-477997,-478071.2,0.008834065234748634,-541.5075925898975,0.009439483471463402
2023-09-25T18:45:00-04:00,1.05948,1.05953,1.05928,1.05939,1.05863554944,1.0593377777777777,1.059297777777772,1.05927933333333,1.0592085000000044,1.0600399999999999,1.062249500000005,1.0636729500000062,1.0593276560112586,1.0592631369372287,-1001,-478998,-478012.2,0.007984301137869602,-541.5926248698838,0.0009439483471526282
2023-09-25T19:00:00-04:00,1.05939,1.05948,1.0593,1.05942,1.0586765274624,1.0593622222222223,1.059311111111105,1.0592899999999965,1.0591970000000044,1.0599557999999998,1.062192400000005,1.0636405500000061,1.0593461248090068,1.0592937095497825,423,-478575,-478092.6,0.008631700188919787,-541.5806462784302,0.011328235627312378
2023-09-25T19:15:00-04:00,1.05942,1.05952,1.05937,1.05937,1.058715866363904,1.059374,1.0593177777777718,1.0593017777777742,1.0591920000000044,1.0598687999999998,1.062134800000005,1.063607900000006,1.0593508998472054,1.0593213676398257,-187,-478762,-478288.8,0.010551487166506569,-541.5894718622402,0.005664064343766129
2023-09-25T19:30:00-04:00,1.05937,1.05946,1.05923,1.05932,1.0587536317093478,1.0593744444444442,1.059341111111105,1.0593128888888852,1.0592160000000044,1.0597743999999998,1.062078900000005,1.0635750000000062,1.0593447198777644,1.0593362941118603,-357,-479119,-478690.2,0.011320333981569439,-541.6063214992886,0.019827968766232353
2023-09-25T19:45:00-04:00,1.05932,1.05938,1.05911,1.05913,1.058789886440974,1.0593322222222223,1.059339999999994,1.059321555555552,1.0592380000000043,1.0596843999999996,1.0620212000000049,1.063541300000006,1.0593017759022114,1.059334235289488,-498,-479617,-479014.2,0.010205251433835572,-541.6956429507858,-0.0009441622448463388
2023-09-25T20:00:00-04:00,1.05913,1.0592,1.0589,1.05904,1.058824690983335,1.0592722222222224,1.0593266666666605,1.0593273333333297,1.0592570000000046,1.0595911999999996,1.061963100000005,1.063505450000006,1.059249420721769,1.0593185882315903,-1130,-480747,-479364,0.00768753540337456,-541.7916651576913,-0.01132973299594943
2023-09-25T20:15:00-04:00,1.05904,1.05904,1.05841,1.05842,1.05966,1.0590908888888888,1.059229999999994,1.0593111111111075,1.0592335000000044,1.0594987999999999,1.0618983000000048,1.063466000000006,1.0590835365774152,1.059266070585272,-849,-481596,-479968.2,0.0017802905652573142,-542.2887002083032,-0.08213048362583886
2023-09-25T20:30:00-04:00,1.05842,1.05844,1.05806,1.05833,1.059635,1.0589108888888887,1.059099999999994,1.059267555555552,1.0592005000000044,1.0594025999999999,1.0618320000000048,1.063426900000006,1.0589328292619322,1.0591824564682173,-1113,-482709,-480757.6,-0.004765544215913581,-542.383341277066,-0.11042944785275068
2023-09-25T20:45:00-04:00,1.05833,1.05852,1.05809,1.05842,1.0595720000000002,1.0587748888888888,1.0589822222222163,1.059195777777774,1.0591575000000044,1.0593159999999997,1.0617679000000049,1.063388300000006,1.0588302634095457,1.0590795651745737,1616,-481093,-481152.4,-0.012399724310460623,-542.2459172221872,-0.10004908068109458
2023-09-25T21:00:00-04:00,1.05842,1.05875,1.05837,1.05864,1.0595115200000003,1.0587064444444445,1.0588988888888828,1.059107555555552,1.0591265000000045,1.0592429999999997,1.061704200000005,1.063351200000006,1.0587922107276366,1.0589776521396586,1538,-479555,-481140,-0.017453631204807495,-541.9262331648185,-0.07079545776343257
2023-09-25T21:15:00-04:00,1.05864,1.0587,1.05832,1.05867,1.0594534592000002,1.0586606666666667,1.0588155555555496,1.05900533333333,1.0590910000000044,1.0591722,1.061639400000005,1.063314950000006,1.0587677685821093,1.0588813217117266,1587,-477968,-480584.2,-0.021599553980663797,-541.8812603695341,-0.07079345302146725
2023-09-25T21:30:00-04:00,1.05867,1.05877,1.05851,1.05858,1.0593977208320002,1.0586135555555554,1.0587277777777717,1.0589048888888857,1.0590510000000044,1.0591251999999998,1.0615735000000048,1.0632772000000061,1.0587302148656874,1.058810657369381,-1541,-479509,-480166.8,-0.02593478534535461,-542.0122643651133,-0.07457262335160014
2023-09-25T21:45:00-04:00,1.05858,1.05876,1.05844,1.05865,1.0593442119987202,1.058598,1.0586533333333275,1.0588155555555523,1.0590185000000045,1.0590769999999998,1.061505600000005,1.0632403000000061,1.05871417189255,1.0587669258955046,1584,-477925,-479210,-0.029451875859430356,-541.9075202739723,-0.06324812143638829
2023-09-25T22:00:00-04:00,1.05865,1.05876,1.0582799999999999,1.05832,1.0592928435187714,1.0585313333333333,1.0585633333333273,1.0587317777777745,1.0589690000000045,1.0590486,1.061439800000005,1.0632038000000061,1.0586353375140398,1.0587279407164034,-1441,-479366,-478864.6,-0.034489441599076416,-542.3567055571161,-0.07647786390716696
2023-09-25T22:15:00-04:00,1.05832,1.05864,1.05823,1.05853,1.0592435297780205,1.0585246666666666,1.0585066666666605,1.05865333333333,1.0589400000000044,1.0590154,1.0613762000000049,1.063168850000006,1.0586142700112318,1.0586923525731227,1517,-477849,-478523.4,-0.036649127548135,-542.0556907411814,-0.04815682127209647
2023-09-25T22:30:00-04:00,1.05853,1.05874,1.05827,1.05871,1.0591961885868997,1.0585653333333334,1.0585388888888827,1.0585979999999966,1.0589185000000043,1.0590022,1.0613183000000048,1.063133850000006,1.0586334160089854,1.0586654820584978,1154,-476695,-478268.8,-0.03796738034044183,-541.8594563406447,0.02739933107841155
2023-09-25T22:45:00-04:00,1.05871,1.05875,1.05797,1.05801,1.0591507410434238,1.0584595555555556,1.0585033333333271,1.0585531111111075,1.0588610000000043,1.0589932,1.0612518000000049,1.063095150000006,1.0585087328071883,1.058621185646798,-1437,-478132,-477993.4,-0.03675958047101562,-542.8095748811328,-0.030236315704940613
2023-09-25T23:00:00-04:00,1.05801,1.05821,1.05783,1.058,1.0590798965808184,1.0583588888888888,1.0584566666666606,1.0585137777777742,1.0587965000000044,1.0589872,1.061185900000005,1.0630606000000062,1.0584069862457506,1.0585597485174383,-1074,-479206,-478249.6,-0.03466122664826117,-542.8197260139196,-0.039681789837669824
2023-09-25T23:15:00-04:00,1.058,1.05844,1.05799,1.05837,1.058979904854353,1.0583415555555555,1.0584266666666606,1.0584864444444408,1.0587400000000042,1.059,1.0611255000000048,1.0630293000000064,1.0583995889966005,1.0585125988139503,880,-478326,-478041.6,-0.03099715304704663,-542.5119755413299,-0.02550442076626544
2023-09-25T23:30:00-04:00,1.05837,1.0585499999999999,1.0582799999999999,1.05852,1.0588879124660047,1.0583602222222221,1.0584099999999939,1.0584671111111075,1.0586920000000044,1.0590024,1.0610634000000048,1.0630013000000063,1.0584236711972803,1.05847447905116,1022,-477304,-477932.6,-0.02772415455694568,-542.3671301658942,-0.014168721131239622
2023-09-25T23:45:00-04:00,1.05852,1.05866,1.05849,1.05858,1.0588032794687243,1.0583942222222222,1.0584099999999939,1.0584413333333296,1.0586515000000043,1.0589998,1.061000200000005,1.0629726500000063,1.0584549369578242,1.0584387832409277,951,-476353,-477864.2,-0.02452724444728097,-542.3132247129976,0
2023-09-26T00:00:00-04:00,1.05858,1.05869,1.05842,1.05851,1.0587254171112264,1.0584142222222221,1.0583944444444384,1.058419555555552,1.0586060000000044,1.058987,1.0609348000000047,1.0629411500000063,1.0584659495662594,1.0584302265927419,-1040,-477393,-477716.4,-0.021231097800444687,-542.3819960859689,-0.013224389552734991
2023-09-26T00:15:00-04:00,1.05851,1.05869,1.05845,1.05869,1.05783,1.0584733333333334,1.0584355555555496,1.0584153333333297,1.0585720000000045,1.0589807999999998,1.0608726000000046,1.0629105000000063,1.0585107596530074,1.0584509812741936,631,-476762,-477227.6,-0.017570209992098563,-542.2746943127217,0.03496107037568802
2023-09-26T00:30:00-04:00,1.05869,1.05887,1.05863,1.05885,1.0578472,1.0585562222222222,1.0584711111111051,1.0584242222222187,1.0585485000000046,1.0589674,1.0608125000000046,1.0628805000000063,1.058578607722406,1.0584867850193544,358,-476404,-476843.2,-0.010224787890492412,-542.2205897117526,0.03023060281712356
2023-09-26T00:45:00-04:00,1.05885,1.05929,1.05885,1.05927,1.057888112,1.058716,1.0585333333333273,1.0584488888888854,1.0585555000000046,1.0589658,1.0607570000000046,1.0628528000000061,1.0587168861779248,1.0585454280154833,1118,-475286,-476439.6,-0.0030094142031348177,-541.7771274649756,0.05289456036118426
2023-09-26T01:00:00-04:00,1.05927,1.05931,1.05881,1.05882,1.0579722252800001,1.0587733333333333,1.0586233333333273,1.058491555555552,1.0585445000000044,1.058961,1.0606987000000045,1.0628210500000064,1.0587375089423399,1.0586019424123865,-1092,-476378,-476444.6,-0.0005758002834104836,-542.241031851959,0.07655882269545652
2023-09-26T01:15:00-04:00,1.05882,1.0588899999999999,1.0582,1.05841,1.0580792472576002,1.0587306666666667,1.0586688888888829,1.0585464444444408,1.0585440000000044,1.0589512,1.0606346000000046,1.0627879500000064,1.058672007153872,1.058643153929909,-1212,-477590,-476484,0.006037077191156206,-542.7103467496753,0.03875236294896233
2023-09-26T01:30:00-04:00,1.05841,1.05869,1.05821,1.05847,1.0581777074769922,1.0586908888888888,1.058679999999994,1.0585953333333298,1.0585510000000045,1.0589308000000002,1.0605711000000047,1.0627545000000063,1.0586316057230976,1.058667323143927,1555,-476035,-476338.6,0.01025221160337464,-542.622195655109,0.009448491548323269
2023-09-26T01:45:00-04:00,1.05847,1.05881,1.05835,1.05877,1.0582,1.0587088888888891,1.0587077777777718,1.0586426666666633,1.0585685000000045,1.058913,1.0605099000000044,1.0627226000000063,1.0586592845784781,1.0586834585151415,1285,-474750,-476007.8,0.012051395897370375,-542.2579907177939,0.02361788157050254
2023-09-26T02:00:00-04:00,1.05877,1.0588899999999999,1.05826,1.05883,1.05931,1.0587333333333333,1.0587355555555495,1.0586831111111077,1.0585780000000045,1.0589060000000001,1.0604488000000045,1.0626890500000064,1.0586934276627824,1.0586787668121131,3077,-471673,-475285.2,0.013135284433127444,-542.0836185689798,0.023616542915968698
2023-09-26T02:15:00-04:00,1.05883,1.05883,1.05791,1.05806,1.059289,1.0585982222222223,1.0586855555555497,1.0586955555555524,1.0585475000000044,1.0588776,1.0603799000000047,1.0626526500000064,1.0585667421302258,1.0586446134496903,-2371,-474044,-474818.4,0.010832393896327534,-543.807851920887,-0.04251258844980788
2023-09-26T02:30:00-04:00,1.05806,1.05832,1.05756,1.05775,1.0592338399999999,1.0584111111111112,1.0585811111111052,1.0586779999999967,1.0585060000000044,1.0588396,1.0603128000000046,1.0626135500000062,1.0584033937041806,1.058590890759752,-2003,-476047,-474509.8,0.007791728711321743,-544.3947089989355,-0.08878897505407068
2023-09-26T02:45:00-04:00,1.05775,1.05797,1.0571,1.05715,1.0591334095999998,1.0581248888888888,1.0583922222222162,1.0586204444444411,1.0584310000000046,1.0587932,1.0602402000000046,1.0625719500000064,1.0581527149633445,1.0584951126078015,-2397,-478444,-474991.6,-0.00032392641985925624,-545.7543875619228,-0.16055154176701467
2023-09-26T03:00:00-04:00,1.05715,1.0576,1.057,1.0570599999999999,1.0589707368319998,1.0578584444444443,1.0581466666666608,1.0585082222222189,1.0583680000000044,1.0587576,1.0601637000000046,1.0625300500000063,1.0579341719706756,1.0583500900862408,-3416,-481860,-476413.6,-0.010082931095670416,-546.0452072185473,-0.20863424811427167
2023-09-26T03:15:00-04:00,1.0570599999999999,1.05823,1.05699,1.05813,1.0587736631487998,1.057855111111111,1.0580699999999943,1.058375111111108,1.0583480000000045,1.0587463999999998,1.0600999000000046,1.0624940500000064,1.0579733375765406,1.0582060720689923,3474,-478386,-477756.2,-0.01999955906459286,-542.528680247514,-0.06516688388962046
2023-09-26T03:30:00-04:00,1.05813,1.05874,1.058,1.05857,1.05699,1.057955111111111,1.058087777777772,1.0582555555555524,1.0583410000000044,1.0587445999999998,1.0600404000000048,1.0624601000000065,1.0580926700612325,1.0581112576551939,3558,-474828,-477913,-0.022541644675926974,-541.0491644980315,0.015117015145353687
2023-09-26T03:45:00-04:00,1.05857,1.05887,1.05816,1.0585,1.05699,1.0580375555555555,1.0580911111111053,1.0581575555555525,1.0583655000000047,1.0587368,1.0599792000000046,1.0624280000000064,1.058174136048986,1.058065406124155,-3609,-478437,-478391,-0.020746607922593408,-541.2878166419615,0.002834279667820013
2023-09-26T04:00:00-04:00,1.0585,1.05929,1.05825,1.05907,1.0570652,1.0582333333333334,1.0581244444444386,1.0581039999999968,1.0584190000000047,1.0587384,1.0599181000000046,1.0623986000000063,1.0583533088391888,1.0581055248993239,3892,-474545,-477611.2,-0.019845786853029707,-539.1919829149896,0.028334765813157435
2023-09-26T04:15:00-04:00,1.05907,1.05999,1.05895,1.05974,1.057198688,1.0585564444444446,1.0582255555555495,1.0581197777777747,1.0584875000000047,1.0587475999999998,1.0598715000000045,1.0623707000000062,1.058630647071351,1.058244819919459,3120,-471425,-475524.2,-0.018508087953218153,-537.2181757067788,0.08594391923160152
2023-09-26T04:30:00-04:00,1.05974,1.05982,1.05946,1.05962,1.05742199296,1.0588353333333334,1.058398888888883,1.0581855555555522,1.0585425000000046,1.0587548,1.0598316000000048,1.0623390500000063,1.0588285176570806,1.058415855935567,-2609,-474034,-474653.8,-0.01666713901447948,-537.513606661541,0.14743965370583953
2023-09-26T04:45:00-04:00,1.05962,1.05995,1.05939,1.05959,1.0576274335231999,1.0590735555555555,1.0586033333333273,1.058288666666663,1.0585930000000046,1.058759,1.0597895000000046,1.0623072500000064,1.0589808141256645,1.0585934847484535,-2232,-476266,-474941.4,-0.007026401636437309,-537.5767991267643,0.1739541479555721
2023-09-26T05:00:00-04:00,1.05959,1.05988,1.05932,1.05986,1.0578164388413438,1.059324888888889,1.0589044444444384,1.0584513333333299,1.0586605000000047,1.0587685999999998,1.0597527000000044,1.0622741000000062,1.0591566513005315,1.0587899877987623,2439,-473827,-474019.4,0.007147445182173213,-536.9553040201665,0.2563496192593284
2023-09-26T05:15:00-04:00,1.05986,1.06015,1.05973,1.06004,1.0579903237340362,1.059552,1.0592355555555495,1.058673555555552,1.0587280000000046,1.0587834,1.0597235000000047,1.0622630500000063,1.0593333210404252,1.0589859902390097,2326,-471501,-473410.6,0.027562322197845684,-536.5602707138806,0.2819139878531214
2023-09-26T05:30:00-04:00,1.06004,1.06029,1.05984,1.06002,1.0582062913606327,1.0597088888888888,1.0594455555555493,1.0589175555555521,1.0587865000000045,1.0587976,1.0596962000000045,1.0622412000000063,1.0594706568323402,1.0591539921912076,-2177,-473678,-473861.2,0.049535453334646685,-536.6013446356197,0.17861699413115092
2023-09-26T05:45:00-04:00,1.06002,1.06029,1.05966,1.05974,1.0584563363973567,1.0597677777777776,1.0595755555555495,1.0591528888888853,1.0588100000000045,1.0588102000000001,1.0596680000000047,1.062217100000006,1.059524525465872,1.0592931937529657,-2333,-476011,-474256.6,0.06073629205975172,-537.2175971591572,0.1105264649479858
2023-09-26T06:00:00-04:00,1.05974,1.06013,1.05951,1.05952,1.0586763760296738,1.0597566666666667,1.059688888888883,1.0593699999999964,1.0588450000000045,1.0588178,1.0596377000000046,1.0621932000000063,1.0595236203726976,1.0594017550023724,-1960,-477971,-474597.6,0.06858334247802148,-537.6244894157483,0.09636277751535388
2023-09-26T06:15:00-04:00,1.05952,1.06015,1.05947,1.06002,1.0588700109061129,1.059822888888889,1.0597944444444383,1.0595479999999964,1.0589255000000046,1.058835,1.0596078000000047,1.0621711000000063,1.0596228962981582,1.0594950040018978,2105,-475866,-475005.4,0.07753771655451644,-536.6311150575484,0.08970134174322815
2023-09-26T06:30:00-04:00,1.06002,1.06003,1.05948,1.05961,1.0590404095973793,1.0597860000000001,1.0597799999999937,1.059656888888885,1.0589825000000046,1.0588414,1.0595717000000047,1.0621458500000063,1.0596203170385265,1.059552403201518,-1684,-477550,-476215.2,0.07723674483300151,-537.2824612585636,-0.012267159869398483
2023-09-26T06:45:00-04:00,1.05961,1.05972,1.05932,1.0596,1.0591903604456938,1.05975,1.0597777777777717,1.0597233333333296,1.0590240000000046,1.0588434,1.0595330000000047,1.0621208000000062,1.0596162536308213,1.0595815225612142,-1758,-479308,-477341.2,0.07082972672214878,-537.2990522684631,-0.0018874690926850171
2023-09-26T07:00:00-04:00,1.0596,1.0596,1.05893,1.0591599999999999,1.06029,1.0596264444444445,1.0597299999999938,1.0597542222222185,1.0590405000000047,1.058837,1.0594861000000046,1.0620945000000062,1.059525002904657,1.0595816180489712,-1845,-481153,-478369.6,0.06473126363581329,-538.0651904338089,-0.04058173444446932
2023-09-26T07:15:00-04:00,1.0591599999999999,1.06025,1.05907,1.05997,1.0602628,1.0596744444444444,1.0597422222222161,1.059764888888885,1.0591360000000045,1.0588486000000001,1.0594443000000044,1.0620764000000062,1.0596140023237257,1.0595996944391768,2032,-479121,-478599.6,0.06319022983930395,-536.5112042560828,0.010378729266134631
2023-09-26T07:30:00-04:00,1.05997,1.06034,1.05992,1.06033,1.05893,1.059792,1.0597744444444384,1.0597608888888852,1.0592650000000046,1.0588668,1.0594113000000045,1.062060800000006,1.0597572018589805,1.059626555551341,2093,-477028,-478832,0.05741568714746016,-535.8003539489988,0.027357458209114883
2023-09-26T07:45:00-04:00,1.06033,1.06033,1.05975,1.0599399999999999,1.0589582,1.059825111111111,1.0597655555555494,1.0597579999999962,1.0594045000000045,1.0588782,1.0593735000000044,1.0620412500000063,1.0597937614871844,1.0596612444410727,-2251,-479279,-479177.8,0.04662120975115608,-536.6282943071894,-0.007547027414584632
2023-09-26T08:00:00-04:00,1.0599399999999999,1.0608,1.05984,1.06053,1.058985836,1.059978,1.0598533333333269,1.0597731111111073,1.0595780000000046,1.0589024000000002,1.0593384000000043,1.0620218000000063,1.0599410091897474,1.059726195552858,3420,-475859,-478488,0.036235955308918356,-534.7246016453404,0.07454658689867973
2023-09-26T08:15:00-04:00,1.06053,1.06091,1.06022,1.06042,1.05905840256,1.0600913333333333,1.059953333333327,1.059817777777774,1.0596925000000046,1.0589282,1.0593063000000045,1.062004600000006,1.0600368073517978,1.059828556442286,-3328,-479187,-478094.8,0.027548110325694493,-535.0697875429578,0.0849441256417907
2023-09-26T08:30:00-04:00,1.06042,1.06073,1.06002,1.06063,1.0591694984064,1.0602266666666667,1.060021111111105,1.0598735555555518,1.0597955000000048,1.0589600000000001,1.0592756000000043,1.0619895000000061,1.0601554458814382,1.0599368451538287,3651,-475536,-477377.8,0.026785617997148587,-534.346762703743,0.05754608403615021
2023-09-26T08:45:00-04:00,1.06063,1.06088,1.06046,1.06057,1.0592739285020158,1.0603364444444443,1.0601277777777716,1.0599442222222184,1.0598990000000046,1.0590030000000001,1.0592509000000043,1.061974600000006,1.0602383567051505,1.0600330761230627,-3414,-478950,-477762.2,0.0229865639132916,-534.5398932016545,0.09059937146686724
2023-09-26T09:00:00-04:00,1.06057,1.06066,1.05943,1.05974,1.0593720927918948,1.060258888888889,1.060143333333327,1.060019777777774,1.0599325000000046,1.0590312000000002,1.0592169000000045,1.0619543000000062,1.0601386853641204,1.06010206089845,-3850,-482800,-478466.4,0.01864072330881011,-537.552895643738,0.013212533031314358
2023-09-26T09:15:00-04:00,1.05974,1.05974,1.05894,1.0594,1.06091,1.0601102222222223,1.0601699999999936,1.0600831111111073,1.0599155000000047,1.0590508,1.0591834000000047,1.0619318000000064,1.0599909482912964,1.0601120487187594,-3569,-486369,-480568.4,0.015270879524702786,-538.6979500910553,0.022659465991919824
2023-09-26T09:30:00-04:00,1.0594,1.05956,1.05878,1.0594,1.0608706,1.059956222222222,1.0601066666666603,1.060113777777774,1.0599045000000047,1.0590660000000003,1.0591545000000047,1.0619081500000063,1.059872758633037,1.0600792389750073,0,-486369,-482004.8,0.01906305725095486,-538.6979500910553,-0.05377510684266361
2023-09-26T09:45:00-04:00,1.0594,1.05946,1.0585499999999999,1.05922,1.0607869760000002,1.0597788888888888,1.059983333333327,1.0601062222222184,1.0598860000000045,1.0590770000000003,1.0591246000000047,1.0618861500000063,1.0597422069064295,1.0599965911800056,-3953,-490322,-484962,0.013784235381768078,-539.3695944180323,-0.10468439070854775
2023-09-26T10:00:00-04:00,1.05922,1.05986,1.05841,1.0586,1.0606527574400002,1.0595022222222221,1.059834444444438,1.0600475555555517,1.0598230000000046,1.0590774000000003,1.0591013000000047,1.0618548000000063,1.0595137655251436,1.0598516729440042,-6813,-497135,-488599,0.001909569956111677,-543.357491172248,-0.1264222503160459
2023-09-26T10:15:00-04:00,1.0586,1.05939,1.0585499999999999,1.05881,1.0604733368448003,1.0592973333333333,1.059643333333327,1.0599475555555518,1.0597615000000045,1.0590806000000001,1.0590788000000046,1.0618201500000064,1.0593730124201148,1.0596985383552031,4673,-492462,-490531.4,-0.004034999350498369,-542.4304838040257,-0.16218305941368408
2023-09-26T10:30:00-04:00,1.05881,1.05922,1.05835,1.0586,1.0603082698972162,1.0590886666666666,1.0594411111111046,1.0598017777777737,1.0596905000000045,1.0590862000000003,1.0590674000000047,1.0617876500000063,1.059218409936092,1.0595440306841621,-5605,-498067,-492871,-0.01577705949918369,-543.5421563420639,-0.17163010882479893
2023-09-26T10:45:00-04:00,1.0586,1.0589,1.05781,1.05838,1.0601124429074946,1.0588764444444445,1.0591911111111045,1.0596186666666625,1.0596225000000046,1.0590832000000003,1.0590493000000047,1.0617517000000065,1.0590507279488737,1.0593796245473297,-4408,-502475,-496092.2,-0.027660198838629906,-544.4582341807183,-0.21213806888357517
2023-09-26T11:00:00-04:00,1.05838,1.05844,1.0574,1.05821,1.0598361497585953,1.0586802222222222,1.0589288888888824,1.0594077777777737,1.0595570000000045,1.0590732000000003,1.0590377000000049,1.0617172500000065,1.058882582359099,1.0592076996378634,-4937,-507412,-499510.2,-0.04362567222702579,-545.2512291352715,-0.2225218514572275
2023-09-26T11:15:00-04:00,1.05821,1.05827,1.05735,1.0574999999999999,1.059495088792392,1.0583944444444444,1.0586799999999934,1.0591768888888846,1.0594310000000042,1.0590630000000003,1.0590281000000048,1.0616805000000065,1.0586060658872791,1.0590261597102906,-3539,-510951,-502273.4,-0.06352747853327916,-547.6257011209839,-0.21137260082661974
2023-09-26T11:30:00-04:00,1.0574999999999999,1.05807,1.05735,1.05772,1.0591518745856092,1.0582024444444444,1.0584933333333266,1.0589468888888847,1.0593365000000043,1.0590574000000001,1.0590223000000045,1.0616473500000065,1.0584288527098233,1.0588373277682321,3052,-507899,-505360.8,-0.07226357234468932,-546.9907696789032,-0.15858032848781423
2023-09-26T11:45:00-04:00,1.05772,1.05774,1.05676,1.05725,1.0588635746519117,1.0579537777777779,1.0582544444444377,1.0587095555555515,1.0592190000000044,1.0590350000000002,1.0590175000000046,1.0616033500000066,1.0581930821678587,1.0586322622145854,-2453,-510352,-507817.8,-0.08195925369447829,-548.0807651408402,-0.20294506324333345
2023-09-26T12:00:00-04:00,1.05725,1.05768,1.05713,1.05747,1.0584849312145677,1.057796888888889,1.0580599999999933,1.058483333333329,1.0591345000000043,1.0590140000000003,1.0590082000000047,1.0615603000000067,1.058048465734287,1.0584318097716683,2339,-508013,-508925.4,-0.09061296609744254,-547.5940496052528,-0.16521591359681087
2023-09-26T12:15:00-04:00,1.05747,1.0574999999999999,1.05713,1.05716,1.0581744435959455,1.057616888888889,1.0578999999999934,1.0582775555555513,1.0589940000000042,1.0589856000000004,1.0589927000000048,1.0615133000000068,1.0578707725874297,1.0582294478173344,-1740,-509753,-509393.6,-0.10107981843378473,-548.104134997746,-0.13602871717361475
2023-09-26T12:30:00-04:00,1.05716,1.05718,1.05681,1.05699,1.0579198437486752,1.0574348888888891,1.0576977777777712,1.058081111111107,1.0588270000000044,1.0589552000000004,1.0589711000000046,1.0614644000000066,1.0576946180699438,1.0580471582538673,-1853,-511606,-509524.6,-0.10289667565601406,-548.4021125981092,-0.17189108527497216
2023-09-26T12:45:00-04:00,1.05699,1.05709,1.05681,1.0569,1.0577110718739136,1.0572753333333331,1.0575088888888822,1.057884222222218,1.0586750000000045,1.0589194000000004,1.0589501000000048,1.0614198000000066,1.057535694455955,1.0578685266030936,-1704,-513310,-510606.8,-0.10552573061094807,-548.5472038477901,-0.16058945777442232
2023-09-26T13:00:00-04:00,1.0569,1.05741,1.05674,1.0574,1.057539878936609,1.0572535555555556,1.0573999999999932,1.057713333333329,1.0585185000000046,1.0588904000000003,1.0589289000000046,1.0613788000000066,1.057508555564764,1.0577316212824748,2007,-511303,-510797,-0.10544782262503082,-547.597728968426,-0.09259434229673678
2023-09-26T13:15:00-04:00,1.0574,1.05761,1.05728,1.05734,1.05674,1.0572415555555554,1.0573033333333266,1.057561999999996,1.0583645000000046,1.0588518000000005,1.0589088000000044,1.0613369000000068,1.0574748444518112,1.0576168970259796,-1373,-512676,-511729.6,-0.10093707358943371,-547.6756370448398,-0.08221430528913433
2023-09-26T13:30:00-04:00,1.05734,1.05735,1.05674,1.05682,1.05761,1.057144888888889,1.0572277777777712,1.0574275555555512,1.0581740000000046,1.0588118000000002,1.0588864000000044,1.0612896500000069,1.057343875561449,1.0575115176207832,-1286,-513962,-512571.4,-0.09788918431356747,-548.3080920734965,-0.06430260047279357
2023-09-26T13:45:00-04:00,1.05682,1.05725,1.0567,1.05709,1.05761,1.0571173333333332,1.0571577777777712,1.0573195555555515,1.0580000000000047,1.0587854000000003,1.0588683000000045,1.0612454500000068,1.0572931004491593,1.0574312140966264,1190,-512772,-512804.6,-0.08584838282702568,-548.0040667900992,-0.05956207692015925
2023-09-26T14:00:00-04:00,1.05709,1.05716,1.05658,1.05664,1.0575736,1.0570137777777777,1.0570899999999932,1.0572357777777737,1.0578450000000046,1.0587488000000003,1.0588398000000045,1.0611992500000067,1.0571624803593274,1.057356571277301,-1600,-514372,-513017,-0.07838268973141482,-548.6851819269372,-0.057696855048474764
2023-09-26T14:15:00-04:00,1.05664,1.05668,1.05624,1.05636,1.057513984,1.0568677777777777,1.05696666666666,1.057149111111107,1.0576930000000044,1.0587006000000003,1.0588068000000046,1.0611533000000068,1.0570019842874618,1.0572552570218403,-1543,-515915,-513939.4,-0.07159237320385825,-549.0940629081607,-0.10496751680898224
2023-09-26T14:30:00-04:00,1.05636,1.05656,1.0562,1.05642,1.05741206528,1.0567584444444444,1.0568844444444379,1.0570653333333293,1.0575440000000047,1.0586524000000004,1.0587792000000045,1.0611055500000068,1.0568855874299694,1.057137405617472,1803,-514112,-514226.6,-0.06811260371299062,-548.9916546382528,-0.06999886488328966
2023-09-26T14:45:00-04:00,1.05642,1.05665,1.05631,1.05662,1.057290858752,1.0567055555555556,1.0568433333333267,1.0569884444444404,1.0574140000000045,1.0586236000000002,1.0587506000000044,1.0610609500000068,1.0568324699439755,1.0570351244939773,1858,-512254,-513885,-0.06070921985790697,-548.6399006010329,-0.03500506154270177
2023-09-26T15:00:00-04:00,1.05662,1.05719,1.05661,1.0571,1.0562,1.0567568888888887,1.0568655555555488,1.0569299999999962,1.0573390000000047,1.0586106000000004,1.0587251000000044,1.0610170000000068,1.0568859759551803,1.0569536995951814,1647,-510607,-513452,-0.050127491625662234,-547.8917035197737,0.018923266155736397
2023-09-26T15:15:00-04:00,1.0571,1.05712,1.05643,1.05663,1.0562198,1.0567097777777776,1.0567799999999934,1.0568679999999961,1.0572300000000048,1.0586002,1.0586967000000045,1.0609717500000067,1.0568347807641443,1.056888159676145,-1313,-511920,-512961.6,-0.043813089971081964,-548.4754798890859,-0.07282012483449381
2023-09-26T15:30:00-04:00,1.05663,1.05717,1.05663,1.05714,1.0562392040000002,1.0567817777777777,1.0567577777777712,1.0568262222222184,1.0571570000000048,1.0586018000000004,1.0586797000000046,1.0609306500000069,1.0568958246113154,1.0568669277409157,1242,-510678,-511914.2,-0.038753719302845824,-547.8760079831208,-0.018915391454024058
2023-09-26T15:45:00-04:00,1.05714,1.05716,1.05665,1.05701,1.0562582199200001,1.0568322222222222,1.0567788888888823,1.0568051111111072,1.0570885000000048,1.0585794000000002,1.0586629000000045,1.0608898000000069,1.0569186596890523,1.0568735421927322,-1569,-512247,-511541.2,-0.034715981648521146,-548.0689530991885,0.017978463692957403
2023-09-26T16:00:00-04:00,1.05701,1.0574,1.057,1.0574,1.0562768555216002,1.0569564444444444,1.0568133333333265,1.0567991111111072,1.0570480000000047,1.0585560000000003,1.0586503000000045,1.060852200000007,1.0570149277512417,1.0569100337541852,825,-511422,-511374.8,-0.02481624312954056,-547.7645567358619,0.029325790613837083
2023-09-26T16:15:00-04:00,1.0574,1.05755,1.05724,1.05743,1.0563217813007362,1.0570797777777778,1.0569011111111044,1.0568062222222183,1.0570445000000048,1.0585346000000002,1.0586357000000046,1.0608162000000068,1.0570979422009934,1.056952427003348,533,-510889,-511431.2,-0.01808689729274525,-547.7494347385098,0.07476529376136323
2023-09-26T16:30:00-04:00,1.05743,1.05743,1.05717,1.0572,1.056395474422692,1.0571395555555556,1.0569944444444377,1.0568491111111071,1.0570185000000047,1.0584972000000001,1.0586178000000046,1.060782300000007,1.0571183537607947,1.057009141602678,-389,-511278,-511302.8,-0.011437921010056381,-547.8340455401705,0.07951834601839827
2023-09-26T16:45:00-04:00,1.0572,1.05725,1.05694,1.05722,1.0564647459573304,1.0571846666666667,1.0570833333333267,1.0569142222222183,1.0570170000000048,1.0584468000000002,1.0585972000000046,1.0607449500000068,1.0571386830086358,1.0570577132821422,1081,-510197,-511206.6,-0.0010496634992476208,-547.8135952942376,0.07572745688269192
2023-09-26T17:00:00-04:00,1.05722,1.05722,1.05666,1.05703,1.0565298611998906,1.0571739999999998,1.0571288888888823,1.0569842222222186,1.0569950000000048,1.0583950000000002,1.0585749000000044,1.060705400000007,1.0571169464069086,1.0570973706257134,-36,-510233,-510803.8,0.005712388449871921,-547.8200650923875,0.038802975525735035
2023-09-26T17:15:00-04:00,1.05703,1.0571,1.05693,1.05698,1.056591069527897,1.0571442222222223,1.057115555555549,1.057044666666663,1.0569860000000049,1.0583428000000004,1.0585509000000044,1.060665450000007,1.0570895571255268,1.0571122965005704,-130,-510363,-510592,0.011325916074948227,-547.826214397516,-0.011351811559918453
2023-09-26T17:30:00-04:00,1.05698,1.05722,1.05697,1.05722,1.0566486053562232,1.057165111111111,1.0571811111111045,1.057100666666663,1.0569975000000047,1.0582900000000002,1.0585293000000044,1.060628200000007,1.0571156457004214,1.0571158372004559,297,-510066,-510427.4,0.012190869552553153,-547.7587769814816,0.05583789973785436
2023-09-26T17:45:00-04:00,1.05722,1.05728,1.05704,1.05711,1.0567026890348499,1.057150888888889,1.057177777777771,1.0571373333333298,1.0570080000000046,1.0582314000000002,1.0585074000000043,1.060592000000007,1.057114516560337,1.0571150697603644,-255,-510321,-510236,0.016191333447141396,-547.7853088291575,-0.0028378455076881483
2023-09-26T18:00:00-04:00,1.05711,1.05743,1.05702,1.05705,1.0567535276927589,1.0571253333333333,1.0571822222222156,1.0571571111111076,1.0569905000000048,1.0581720000000003,1.0584848000000044,1.060554050000007,1.0571016132482696,1.057107655808291,-569,-510890,-510374.6,0.014664005071171663,-547.8176044275342,0.0037842593731412196
2023-09-26T18:15:00-04:00,1.05705,1.05709,1.05695,1.05703,1.0568013160311933,1.0570948888888887,1.0571411111111044,1.0571595555555517,1.0569750000000047,1.0581178000000002,1.0584640000000045,1.060518350000007,1.0570872905986157,1.0571017246466325,-489,-511379,-510603.8,0.01652036956637188,-547.8268565915757,-0.03499148855683577
2023-09-26T18:30:00-04:00,1.05703,1.05718,1.05702,1.05711,1.0568462370693217,1.0570886666666666,1.057105555555549,1.057157555555552,1.0569895000000047,1.0580696000000003,1.0584437000000044,1.060481450000007,1.0570918324788925,1.057102179717306,262,-511117,-510754.6,0.014813072807312661,-547.8070274476536,-0.030262050443064598
2023-09-26T18:45:00-04:00,1.05711,1.05718,1.0571,1.05713,1.0568884628451625,1.0570935555555556,1.057097777777771,1.0571408888888854,1.0569915000000047,1.0580118,1.0584234000000046,1.0604445000000071,1.0570994659831139,1.0570989437738443,208,-510909,-510923.2,0.01057804416133296,-547.8030921902064,-0.006621263715476211
2023-09-26T19:00:00-04:00,1.05713,1.05731,1.05712,1.0573,1.0569281550744527,1.0571339999999998,1.0571066666666598,1.057126666666663,1.0570245000000047,1.0579656000000002,1.0584035000000045,1.060405750000007,1.0571395727864912,1.057103955019075,373,-510536,-510966.2,0.01057794408583637,-547.743109028249,0.007567015379945324
2023-09-26T19:15:00-04:00,1.0573,1.05731,1.05682,1.0570599999999999,1.05755,1.0571246666666665,1.0571099999999933,1.0571122222222187,1.0570595000000047,1.0579148000000003,1.0583791000000045,1.060366050000007,1.057123658229193,1.0571083640152596,-705,-511241,-511036.4,0.007171962671793331,-547.9031392940203,0.0028381408285454994
2023-09-26T19:30:00-04:00,1.0570599999999999,1.05725,1.05676,1.05677,1.0575354,1.0570566666666665,1.0570866666666598,1.0571013333333297,1.0570770000000047,1.0578670000000003,1.0583520000000044,1.060325200000007,1.0570529265833544,1.0571014912122076,-2052,-513293,-511419.2,0.0028651281471672335,-548.4660969312404,-0.019867925599353204
2023-09-26T19:45:00-04:00,1.05677,1.05699,1.05675,1.0569,1.0575043839999998,1.0570193333333333,1.057051111111104,1.057090444444441,1.0570910000000049,1.0578056,1.0583271000000045,1.0602883000000072,1.0570223412666835,1.0570875929697656,851,-512442,-511684.2,-0.00005405785245445812,-548.3614100078796,-0.030268061519844305
2023-09-26T20:00:00-04:00,1.0569,1.05721,1.05683,1.05707,1.0574591209599997,1.057023111111111,1.0570466666666596,1.0570802222222184,1.057089500000005,1.0577404,1.0583036000000043,1.0602480000000072,1.0570318730133468,1.0570740743758122,1791,-510651,-511632.6,-0.0035001750085044965,-548.0733316655577,-0.003783901391533521
2023-09-26T20:15:00-04:00,1.05707,1.05708,1.05659,1.05671,1.0574165737023997,1.0569557777777776,1.0570088888888818,1.0570606666666627,1.0570935000000048,1.0576758,1.0582770000000046,1.060205900000007,1.0569674984106774,1.0570396595006495,-966,-511617,-511848.8,-0.005527400499771111,-548.402316500999,-0.032164987465115834
2023-09-26T20:30:00-04:00,1.05671,1.05671,1.05587,1.05599,1.0573504478062077,1.056752,1.0568933333333261,1.0570173333333295,1.057036000000005,1.0575850000000002,1.0582437000000045,1.060161300000007,1.056771998728542,1.0569693276005192,-1340,-512957,-512192,-0.012672392743881126,-549.3153389953446,-0.09838888205632101
2023-09-26T20:45:00-04:00,1.05599,1.05612,1.05559,1.05598,1.0572024030255869,1.0565693333333332,1.0567677777777706,1.0569535555555516,1.0569845000000049,1.0574962,1.0582122000000043,1.0601167000000071,1.0566135989828336,1.056881462080415,-2222,-515179,-512569.2,-0.017380962034634594,-549.3363808612716,-0.1068952143107222
2023-09-26T21:00:00-04:00,1.05598,1.05616,1.05587,1.0561,1.0570089146625166,1.0564357777777778,1.0566533333333261,1.0568739999999963,1.056919500000005,1.0574056,1.0581828000000044,1.060072950000007,1.056510879186267,1.0567791696643318,1656,-513523,-512785.4,-0.022837664259476587,-549.1481954789724,-0.0974336174358749
2023-09-26T21:15:00-04:00,1.0561,1.05661,1.0561,1.05641,1.0568386449030145,1.056387111111111,1.0565544444444372,1.0567755555555518,1.0568685000000049,1.0573224,1.0581627000000042,1.0600305000000072,1.0564907033490136,1.0566709357314652,1823,-511700,-512995.2,-0.02519058518183914,-548.6130851674488,-0.08417667643997309
2023-09-26T21:30:00-04:00,1.05641,1.05697,1.05641,1.05665,1.05559,1.0564062222222221,1.0565088888888816,1.0566755555555516,1.0568410000000048,1.0572606000000002,1.0581459000000044,1.0599889500000073,1.056522562679211,1.056581948585172,2760,-508940,-512459.8,-0.02782731564601036,-547.9860558890437,-0.038786823832119226
2023-09-26T21:45:00-04:00,1.05665,1.057,1.05662,1.05695,1.0556176,1.0564944444444444,1.0565288888888817,1.0566026666666626,1.056827500000005,1.0572116,1.0581312000000043,1.0599495500000071,1.0566080501433688,1.0565491588681373,1811,-507129,-511294.2,-0.027742019494365677,-547.471883741218,0.017033034624380803
2023-09-26T22:00:00-04:00,1.05695,1.05697,1.05635,1.05637,1.055672896,1.0564626666666665,1.056469999999993,1.056543111111107,1.056794500000005,1.0571510000000002,1.0581085000000043,1.0599063500000072,1.056560440114695,1.0565385270945096,-1581,-508710,-510000.4,-0.02769802261230437,-548.3394555279629,-0.05014665531269935
2023-09-26T22:15:00-04:00,1.05637,1.05645,1.05597,1.0561099999999999,1.0557259801599999,1.0563906666666667,1.0563633333333262,1.056485111111107,1.0567510000000049,1.0570888,1.0580829000000043,1.0598611500000072,1.056470352091756,1.0565304216756073,-1284,-509994,-509294.6,-0.031029199711286343,-548.6554811629205,-0.09081706982508934
2023-09-26T22:30:00-04:00,1.0561099999999999,1.05632,1.05588,1.05625,1.0557769409535998,1.056368,1.056312222222215,1.0564366666666627,1.056702500000005,1.0570418000000001,1.0580596000000042,1.0598165500000072,1.0564262816734047,1.0565175373404856,1095,-508899,-508734.4,-0.03550044679702166,-548.5103258287223,-0.04353133783158359
2023-09-26T22:45:00-04:00,1.05625,1.0565499999999999,1.05623,1.05644,1.0558258633154558,1.0563935555555553,1.0563622222222149,1.0564073333333295,1.056669000000005,1.0569944,1.0580375000000044,1.0597715500000071,1.0564290253387238,1.056498829872388,1065,-507834,-508513.2,-0.03454182399729927,-548.3187518642252,0.04261403990568675
2023-09-26T23:00:00-04:00,1.05644,1.05649,1.05595,1.05643,1.0558728287828376,1.056407111111111,1.056412222222215,1.0563839999999962,1.0566380000000049,1.0569510000000002,1.0580186000000043,1.0597292000000074,1.056429220270979,1.0564630638979102,-1287,-509121,-508911.6,-0.02731433932935244,-548.3309342882153,0.042614443455374296
2023-09-26T23:15:00-04:00,1.05643,1.05649,1.05626,1.05644,1.0559179156315242,1.0564126666666669,1.0564499999999928,1.056379999999996,1.056608500000005,1.0569122000000002,1.0579977000000043,1.0596869500000072,1.0564313762167832,1.0564372511183278,1031,-508090,-508787.6,-0.020212535827940862,-548.3211750045901,0.03219392103020613
2023-09-26T23:30:00-04:00,1.05644,1.05649,1.05626,1.05632,1.05595,1.0563866666666668,1.0564399999999927,1.0563953333333296,1.056569000000005,1.0568744000000003,1.0579738000000043,1.0596460500000073,1.0564091009734264,1.0564250008946618,-921,-509011,-508591,-0.014931164761256114,-548.4257905057073,-0.008519419543562208
2023-09-26T23:45:00-04:00,1.05632,1.05634,1.056,1.0562,1.055992,1.0563386666666668,1.0563899999999926,1.056410888888885,1.056522500000005,1.0568484000000002,1.0579557000000042,1.0596037500000073,1.0563672807787412,1.0564132007157292,-1097,-510108,-508832.8,-0.01281798195174913,-548.5504118325778,-0.042587422514556515
2023-09-27T00:00:00-04:00,1.0562,1.05633,1.05596,1.05598,1.057,1.0562566666666666,1.056282222222215,1.0563948888888848,1.056456500000005,1.0568136000000004,1.0579355000000041,1.0595607000000071,1.056289824622993,1.0563853605725833,-1103,-511211,-509508.2,-0.013977012074202624,-548.7801599863367,-0.09177349921946519
2023-09-27T00:15:00-04:00,1.05598,1.05603,1.05587,1.0559,1.0569792,1.056180222222222,1.056229999999993,1.0563584444444405,1.056398500000005,1.0567866000000004,1.0579108000000044,1.0595181500000073,1.0562118596983945,1.0563418884580664,-860,-512071,-510098.2,-0.01760646706330856,-548.8453127354417,-0.04449198670919947
2023-09-27T00:30:00-04:00,1.0559,1.05592,1.05572,1.05583,1.056934832,1.0561002222222224,1.0561988888888818,1.0563082222222184,1.0563515000000048,1.0567538000000003,1.0578839000000044,1.0594736500000073,1.0561354877587157,1.0562827107664527,-1200,-513271,-511134.4,-0.017174695047462673,-548.924865723414,-0.02651238980786433
2023-09-27T00:45:00-04:00,1.05583,1.05604,1.05582,1.05602,1.05686194208,1.0560644444444445,1.056173333333326,1.0562548888888852,1.0563075000000048,1.0567310000000005,1.0578583000000044,1.0594292500000073,1.0561123902069725,1.056223368613162,969,-512302,-511792.6,-0.014646317796428106,-548.7504910608263,-0.021775147928989585
2023-09-27T01:00:00-04:00,1.05602,1.05604,1.05571,1.05576,1.0567934255552,1.0559817777777778,1.0560977777777705,1.0561964444444407,1.0562420000000048,1.0567064000000004,1.0578308000000043,1.0593828000000074,1.056041912165578,1.0561582948905293,-1057,-513359,-512442.8,-0.014146662753290191,-549.0107323441352,-0.06436711976070708
2023-09-27T01:15:00-04:00,1.05576,1.05592,1.05547,1.05592,1.056706751510784,1.055946222222222,1.0560411111111039,1.0561482222222185,1.0562025000000046,1.0566868000000005,1.0578031000000043,1.0593378500000072,1.0560175297324623,1.0561038359124233,1208,-512151,-512630.8,-0.013885908327470478,-548.8276604338527,-0.048275796787294045
2023-09-27T01:30:00-04:00,1.05592,1.05641,1.05584,1.05625,1.0565830763597055,1.0559880000000001,1.0560199999999926,1.0561062222222186,1.0562155000000046,1.0566638000000004,1.0577771000000042,1.0592948000000073,1.0560640237859698,1.056074268729938,1432,-510719,-512360.4,-0.013516498874845857,-548.3801265297691,-0.017984930521386402
2023-09-27T01:45:00-04:00,1.05625,1.05642,1.056,1.05602,1.056471768723735,1.0559880000000001,1.0559866666666593,1.056063777777774,1.0562175000000047,1.0566374000000003,1.0577446000000044,1.0592508000000074,1.0560552190287757,1.0560582149839501,-2510,-513229,-512352,-0.017628231861012353,-548.9266827427867,-0.02840048470160245
2023-09-27T02:00:00-04:00,1.05602,1.05662,1.05573,1.05648,1.05547,1.0560866666666666,1.0560177777777702,1.0560326666666628,1.0562365000000047,1.0566306000000005,1.0577212000000042,1.0592099500000074,1.0561401752230206,1.0560637719871597,2737,-510492,-511990,-0.018367211686535753,-547.7344515350442,0.026510130657078013
2023-09-27T02:15:00-04:00,1.05648,1.05669,1.05636,1.05648,1.055493,1.056179111111111,1.0560733333333259,1.0560277777777738,1.0562400000000045,1.0566184000000005,1.0577019000000043,1.0591682500000075,1.0562081401784165,1.0560970175897275,0,-510492,-511416.6,-0.01742916639776426,-547.7344515350442,0.047349381617091894
2023-09-27T02:30:00-04:00,1.05648,1.05648,1.05608,1.05617,1.05554088,1.0561984444444446,1.0561033333333258,1.0560402222222183,1.0562160000000045,1.0566090000000006,1.0576789000000044,1.0591250000000074,1.0562005121427331,1.0561336140717816,-2340,-512832,-511552.8,-0.014548507120915525,-548.4210712533541,0.02557060327682474
2023-09-27T02:45:00-04:00,1.05617,1.0570599999999999,1.05615,1.05691,1.0555868447999999,1.0563597777777778,1.0562233333333257,1.0560808888888846,1.0562140000000046,1.0566200000000006,1.0576603000000042,1.0590851000000074,1.0563424097141865,1.056189291257425,2104,-510728,-511554.6,-0.0061583600185313,-546.9469146308408,0.10228919428316773
2023-09-27T03:00:00-04:00,1.05691,1.05722,1.0565,1.0566,1.055675234112,1.0564351111111112,1.0562877777777704,1.056141111111107,1.0562255000000045,1.0566236000000004,1.0576380000000043,1.0590434000000075,1.0563939277713492,1.0562570330059395,-2945,-513673,-511643.4,0.0027095408300363073,-547.8107062498055,0.05492320221208168
2023-09-27T03:15:00-04:00,1.0566,1.05737,1.05643,1.05722,1.05579881538304,1.0566215555555556,1.0564499999999923,1.0562275555555514,1.0562810000000045,1.0566356000000006,1.0576296000000043,1.0590047500000075,1.0565591422170795,1.0563408264047514,3040,-510633,-511671.6,0.010238155455249144,-546.0268713075377,0.138289005076913
2023-09-27T03:30:00-04:00,1.05722,1.05741,1.05665,1.0568,1.055955933844736,1.0566915555555556,1.0565477777777703,1.0563224444444401,1.0563085000000043,1.0566296000000006,1.0576201000000043,1.0589664500000073,1.0566073137736636,1.0564206611238007,-2803,-513436,-512260.4,0.01697290016177358,-547.1404143733142,0.08333964694294946
2023-09-27T03:45:00-04:00,1.0568,1.05691,1.0565,1.0565,1.0561304217833676,1.0566820000000001,1.056575555555548,1.0564168888888847,1.0563115000000045,1.0566270000000006,1.0576136000000043,1.0589269000000072,1.0565858510189308,1.0564977288990403,-2691,-516127,-512919.4,0.021336475726610193,-547.9043242900439,0.023668639053262344
2023-09-27T04:00:00-04:00,1.0565,1.05697,1.05637,1.0565,1.0562839711693635,1.0566668888888888,1.0566288888888815,1.0564979999999957,1.0563150000000046,1.0566142000000007,1.0576080000000043,1.0588858500000071,1.0565686808151447,1.056542983119232,0,-516127,-513999.2,0.023432643322400287,-547.9043242900439,0.04545368458931043
2023-09-27T04:15:00-04:00,1.0565,1.05687,1.05625,1.05679,1.05741,1.056699111111111,1.056663333333326,1.0565731111111067,1.0563325000000043,1.0566098000000006,1.0575946000000043,1.0588472500000072,1.0566129446521157,1.056586786495385,2812,-513315,-513927.6,0.02909874142904163,-547.1324549100158,0.02934272300467689
2023-09-27T04:30:00-04:00,1.05679,1.05692,1.0563,1.05661,1.0573868,1.0566884444444444,1.0566777777777705,1.0566186666666624,1.0563470000000046,1.0565940000000005,1.0575750000000044,1.0588077000000071,1.0566123557216927,1.0565974291963078,-2568,-515883,-514977.6,0.029562832514556783,-547.5698549611135,0.012305012872933086
2023-09-27T04:45:00-04:00,1.05661,1.05671,1.05572,1.05597,1.057364064,1.056546888888889,1.0566555555555484,1.056640222222218,1.0563355000000045,1.0565648000000005,1.0575497000000043,1.058764450000007,1.056483884577354,1.056572743357046,-2248,-518131,-515916.6,0.026313049099806165,-548.9314926514628,-0.018936345474684754
2023-09-27T05:00:00-04:00,1.05597,1.05603,1.0556,1.0556,1.05729830144,1.0563357777777778,1.0565099999999925,1.056627111111107,1.0563165000000043,1.0565328000000005,1.0575150000000044,1.058716550000007,1.0563071076618833,1.0565169946856365,-2829,-520960,-516883.2,0.023622427060405186,-549.9227424028761,-0.12394622058641912
2023-09-27T05:15:00-04:00,1.0556,1.05596,1.0554999999999999,1.05569,1.0571964033535999,1.056171777777778,1.0564088888888812,1.0565831111111068,1.0563060000000044,1.0565022000000004,1.0574745000000043,1.058673000000007,1.0561836861295066,1.0564399957485089,2301,-518659,-517389.6,0.013380206131226105,-549.7265601368664,-0.08612530759038108
2023-09-27T05:30:00-04:00,1.05569,1.05569,1.05529,1.05541,1.057060691085312,1.0559720000000001,1.0562077777777703,1.0564919999999955,1.0562850000000044,1.0564698000000003,1.0574324000000044,1.0586320000000071,1.0560289489036052,1.056323196598807,-1853,-520512,-518829,0.004323416825028593,-550.2180301706833,-0.17120372297157538
2023-09-27T05:45:00-04:00,1.05541,1.05637,1.05536,1.056,1.0568836219767808,1.0559304444444444,1.0561188888888813,1.0563802222222178,1.0562840000000044,1.0564502000000005,1.0573965000000043,1.058593000000007,1.0560231591228841,1.056205357279045,2603,-517909,-519234.2,-0.007993075372624336,-548.7628895144452,-0.07570022710067296
2023-09-27T06:00:00-04:00,1.056,1.05618,1.05582,1.05585,1.0567242597791027,1.0558766666666666,1.0560466666666593,1.05625844444444,1.0562885000000044,1.0564228000000007,1.0573564000000044,1.058554550000007,1.0559885272983074,1.0561062858232357,-2502,-520411,-519690.2,-0.016220702539115714,-549.1182872417181,-0.061523899668721196
2023-09-27T06:15:00-04:00,1.05585,1.05598,1.05571,1.0558,1.0565808338011924,1.0558273333333335,1.0559688888888816,1.0561502222222177,1.0562825000000045,1.0563966000000005,1.0573140000000045,1.058518750000007,1.055950821838646,1.0560350286585884,-1910,-522321,-519962.4,-0.02302812650289081,-549.2087356955702,-0.06625650733553459
2023-09-27T06:30:00-04:00,1.0558,1.05588,1.05536,1.05556,1.056451750421073,1.0557455555555555,1.055832222222215,1.0560348888888846,1.0562480000000045,1.0563668000000006,1.0572694000000045,1.058482800000007,1.0558726574709167,1.0559728229268703,-1851,-524172,-521065,-0.030304929261868004,-549.6294972034316,-0.11639020051285898
2023-09-27T06:45:00-04:00,1.05556,1.05562,1.05525,1.05542,1.0563355753789658,1.0556631111111112,1.0556999999999925,1.0559333333333292,1.0562180000000045,1.0563346000000005,1.0572262000000046,1.058447100000007,1.0557821259767335,1.055923458341496,-2078,-526250,-522212.6,-0.039534940338852353,-549.9051044640327,-0.11262433632087755
2023-09-27T07:00:00-04:00,1.05542,1.05547,1.05487,1.05488,1.05620530633349,1.0554991111111112,1.0555788888888817,1.0558253333333292,1.0561380000000047,1.0562900000000006,1.0571798000000046,1.058408750000007,1.0556017007813867,1.0558391666731965,-2509,-528759,-524382.6,-0.050777213285616726,-551.1888208991959,-0.10322262943076368
2023-09-27T07:15:00-04:00,1.05488,1.05488,1.05343,1.05382,1.0560183634468014,1.0551473333333334,1.0553811111111038,1.055692222222218,1.0560050000000045,1.0562238000000006,1.0571178000000045,1.058362800000007,1.0552453606251093,1.0556905333385571,-3880,-532639,-526828.2,-0.0591479840440996,-555.087652993842,-0.16862447896931743
2023-09-27T07:30:00-04:00,1.05382,1.0541,1.05344,1.05387,1.0556042252953133,1.0548451111111112,1.0551788888888813,1.0555342222222182,1.0558900000000047,1.0561552000000005,1.0570604000000046,1.0583160500000068,1.0549702885000876,1.0554944266708453,2528,-530111,-528386.2,-0.06376846365325686,-554.9677084112755,-0.17239909443112397
2023-09-27T07:45:00-04:00,1.05387,1.05453,1.05366,1.05395,1.055256349248063,1.0545993333333332,1.0550166666666592,1.055371111111107,1.0557420000000044,1.0560930000000006,1.0570039000000044,1.058268450000007,1.05476623080007,1.055273141336676,2215,-527896,-529131,-0.07024253836492544,-554.7995662305514,-0.1383348651235081
2023-09-27T08:00:00-04:00,1.05395,1.0542,1.05357,1.05377,1.054964133368373,1.0543500000000001,1.0547688888888815,1.0551848888888848,1.0556005000000046,1.0560330000000007,1.0569500000000047,1.058218050000007,1.054566984640056,1.0550301130693405,-3509,-531405,-530162,-0.07162379598869098,-555.3988546218408,-0.21117424242423807
2023-09-27T08:15:00-04:00,1.05377,1.05471,1.05377,1.05416,1.0547186720294333,1.0542282222222223,1.0545811111111036,1.0549853333333292,1.0554475000000045,1.0559782000000006,1.0568919000000045,1.058168100000007,1.054485587712045,1.0548068904554722,3659,-527746,-529959.4,-0.07805588425930338,-554.0446596836667,-0.16006061467064162
2023-09-27T08:30:00-04:00,1.05416,1.05458,1.05348,1.05457,1.05343,1.0542259999999999,1.054444444444437,1.054797999999996,1.0553360000000045,1.0559282000000008,1.0568343000000047,1.058122800000007,1.054502470169636,1.0546583123643773,6115,-521631,-527757.8,-0.07823666998711576,-551.6663205321147,-0.1164993369956492
2023-09-27T08:45:00-04:00,1.05457,1.05513,1.05448,1.05466,1.0534530000000002,1.054269111111111,1.054344444444437,1.054631111111107,1.0552440000000047,1.0558872000000008,1.0567815000000045,1.0580775000000069,1.0545339761357087,1.0545710498915015,4525,-517106,-525156.8,-0.07939036287417692,-551.2801441758751,-0.08526279889348999
2023-09-27T09:00:00-04:00,1.05466,1.05487,1.05426,1.0547199999999999,1.05348,1.0543442222222221,1.0542666666666591,1.054481111111107,1.0551550000000047,1.0558618000000008,1.0567234000000045,1.058030900000007,1.054571180908567,1.054532039913201,3460,-513646,-522306.8,-0.0793245365436396,-551.083303487881,-0.0663243069110065
2023-09-27T09:15:00-04:00,1.0547199999999999,1.05487,1.05301,1.05302,1.05513,1.0540948888888888,1.0540599999999924,1.054339333333329,1.0549665000000048,1.0558026000000007,1.0566494000000046,1.057977850000007,1.0542609447268536,1.0544708319305605,-3934,-517580,-519541.8,-0.08637793981944458,-557.4241332815697,-0.1763233732746827
2023-09-27T09:30:00-04:00,1.05302,1.05331,1.05219,1.05256,1.0550875999999998,1.0537948888888888,1.0539199999999924,1.054207111111107,1.0547640000000047,1.0557318000000009,1.0565687000000046,1.0579221500000069,1.053920755781483,1.054357865544448,-5233,-522813,-518555.2,-0.08929260663503837,-559.7101107558823,-0.119565011102469
2023-09-27T09:45:00-04:00,1.05256,1.05267,1.05121,1.05202,1.0549716959999997,1.053414888888889,1.0537144444444368,1.0540611111111073,1.0545665000000046,1.0556440000000007,1.0564832000000046,1.057867050000007,1.0535406046251863,1.0541654924355581,-6110,-528923,-520013.6,-0.08565378172474188,-562.8447539116167,-0.17554347310390553
2023-09-27T10:00:00-04:00,1.05202,1.0522799999999999,1.05097,1.05104,1.0547459942399997,1.0528799999999998,1.0533911111111034,1.0538704444444404,1.0543385000000047,1.055531800000001,1.0563962000000044,1.0578065500000071,1.053040483700149,1.0538667939484463,-6225,-535148,-523622,-0.09024779190270416,-568.6435980400553,-0.27610417951515426
2023-09-27T10:15:00-04:00,1.05104,1.0526,1.05101,1.0518,1.0544439147007998,1.0525617777777778,1.0531722222222146,1.0536515555555515,1.0541440000000046,1.0554288000000007,1.0563202000000045,1.057751800000007,1.0527923869601192,1.0535110351587567,5304,-529844,-526861.6,-0.09349294014888418,-564.8083110861805,-0.18694781593706664
2023-09-27T10:30:00-04:00,1.0518,1.05223,1.0514,1.05143,1.0541660015247358,1.0522133333333334,1.0528688888888813,1.0534133333333293,1.0539450000000046,1.0553300000000008,1.0562405000000046,1.057697500000007,1.0525199095680955,1.053162828127005,-4568,-534412,-530228,-0.09646562282684351,-566.4152325541402,-0.25897396979584686
2023-09-27T10:45:00-04:00,1.05143,1.05164,1.05083,1.05087,1.053910321402757,1.0518135555555557,1.0524577777777702,1.0531208888888848,1.0536885000000047,1.0552252000000006,1.0561570000000045,1.0576408000000073,1.0521899276544764,1.0528166625016036,-5786,-540198,-533705,-0.10719044978744485,-569.496902280133,-0.35085390253847887
2023-09-27T11:00:00-04:00,1.05087,1.05233,1.05085,1.0516699999999999,1.0536022892624812,1.051656,1.0521255555555478,1.052803111111107,1.0534795000000048,1.0551336000000007,1.0560877000000044,1.057594500000007,1.052085942123581,1.0525257300012825,5181,-535017,-534923.8,-0.11516607127326695,-565.5527417274485,-0.2835036883924723
2023-09-27T11:15:00-04:00,1.0516699999999999,1.05216,1.05156,1.05196,1.0533250603362332,1.051622888888889,1.0518188888888813,1.0524886666666624,1.0532875000000046,1.0550440000000008,1.0560192000000044,1.0575490000000072,1.0520607536988649,1.0523297840010257,4328,-530689,-534032,-0.12323277527987075,-564.3592875070176,-0.26168082524270647
2023-09-27T11:30:00-04:00,1.05196,1.05239,1.05185,1.05229,1.0530755543026098,1.051717111111111,1.05173777777777,1.0522017777777737,1.0531240000000046,1.0549612000000008,1.0559561000000044,1.057511750000007,1.052106602959092,1.0521926272008202,3864,-526825,-533428.2,-0.1304545972424339,-563.1471501633926,-0.06932441928929359
2023-09-27T11:45:00-04:00,1.05229,1.05239,1.0508,1.05087,1.052850998872349,1.0515435555555555,1.0515499999999924,1.0519379999999958,1.0528965000000048,1.0548498000000008,1.0558810000000043,1.0574651500000072,1.0518592823672737,1.052060501760656,-3940,-530765,-532698.8,-0.1296908880830778,-568.4639354602213,-0.1605609181424308
2023-09-27T12:00:00-04:00,1.05087,1.05097,1.05006,1.05021,1.052604879007667,1.0512755555555555,1.0513488888888813,1.0517162222222183,1.0526630000000048,1.0547276000000008,1.0558010000000044,1.0574193500000073,1.051529425893819,1.0519284014085244,-3110,-533875,-531434.2,-0.12847756527649762,-570.4171742052607,-0.1720499610273443
2023-09-27T12:15:00-04:00,1.05021,1.05088,1.05016,1.05048,1.05239,1.0511017777777778,1.0512866666666592,1.0515484444444403,1.0524960000000045,1.0546132000000008,1.0557308000000045,1.057379450000007,1.0513195407150553,1.0517751211268194,2981,-530894,-530609.6,-0.12322801480617175,-569.6507846260338,-0.053280560207022945
2023-09-27T12:30:00-04:00,1.05048,1.05074,1.05006,1.05069,1.0520638,1.0509824444444444,1.0511633333333255,1.0514173333333292,1.0523370000000045,1.0545074000000008,1.0556605000000046,1.0573414000000072,1.0511936325720441,1.051601696901455,2803,-528091,-530090,-0.11240866202299092,-569.0904407832195,-0.10553337136339289
2023-09-27T12:45:00-04:00,1.05069,1.05087,1.05015,1.05029,1.0517832679999999,1.050807777777778,1.0510366666666588,1.051277111111107,1.0521540000000047,1.054395200000001,1.0555909000000046,1.057304200000007,1.0510129060576352,1.0513829575211635,-2698,-530789,-530882.8,-0.1105759461788309,-570.1175753328963,-0.10842376572859257
2023-09-27T13:00:00-04:00,1.05029,1.0510599999999999,1.05004,1.0501,1.05154201048,1.0506204444444447,1.0509511111111034,1.0511573333333293,1.0519705000000048,1.054280600000001,1.0555172000000046,1.057262700000007,1.0508303248461082,1.0511771660169305,-3688,-534477,-531625.2,-0.10581093350942204,-570.7847434483689,-0.07327262173246334
2023-09-27T13:15:00-04:00,1.0501,1.05014,1.04913,1.04944,1.0513016888032,1.0503182222222223,1.0507033333333256,1.051028222222218,1.051734500000005,1.0541490000000007,1.0554400000000046,1.0572163500000071,1.0505522598768866,1.050981732813544,-5026,-539503,-532750.8,-0.09982411940830158,-573.943642600831,-0.21204370192170116
2023-09-27T13:30:00-04:00,1.04944,1.0497,1.04904,1.04969,1.0510599999999999,1.0501155555555555,1.0504511111111035,1.0508611111111068,1.0514905000000048,1.0540276000000008,1.0553670000000046,1.0571690500000068,1.0503798079015092,1.050793786250835,3694,-535809,-533733.8,-0.09843156113016069,-573.0636494616327,-0.21578767253507683
2023-09-27T13:45:00-04:00,1.04969,1.04999,1.04953,1.04988,1.0506559999999998,1.0500013333333333,1.0501833333333255,1.050665111111107,1.0512515000000047,1.0539068000000007,1.0552968000000045,1.0571234500000068,1.0502798463212073,1.0506110290006676,2876,-532933,-534702.2,-0.09699411540612184,-572.5430767211096,-0.2290243183913202
2023-09-27T14:00:00-04:00,1.04988,1.04997,1.049,1.04924,1.0503327999999998,1.0498126666666667,1.0500022222222143,1.0504582222222179,1.0509775000000048,1.0537666000000008,1.0552152000000046,1.057072050000007,1.050071877056966,1.0504228232005337,-3507,-536440,-535832.4,-0.10148013954671084,-574.6809210461753,-0.15510957587522914
2023-09-27T14:15:00-04:00,1.04924,1.04945,1.04881,1.04935,1.0500662399999998,1.0496822222222222,1.0499066666666588,1.0502493333333291,1.0507940000000047,1.0536332000000008,1.0551353000000043,1.057022050000007,1.0499275016455727,1.0502422585604265,2685,-533755,-535688,-0.09163574079320848,-574.3994315871381,-0.08188838422792422
2023-09-27T14:30:00-04:00,1.04935,1.05083,1.04935,1.05081,1.04881,1.049862888888889,1.0499433333333255,1.0500973333333292,1.0507065000000047,1.0535198000000008,1.0550752000000045,1.0569808000000072,1.0501040013164582,1.0501526068483409,3579,-530176,-533822.6,-0.07591985929886011,-569.4198346938232,0.031414210646555994
2023-09-27T14:45:00-04:00,1.05081,1.05092,1.05046,1.0507,1.04881,1.0500142222222222,1.0499444444444366,1.049995999999996,1.0506405000000048,1.0534042000000008,1.0550113000000045,1.056939800000007,1.0502232010531665,1.0501212854786721,-3160,-533336,-533328,-0.06540272460701858,-569.7506271301344,0.0009517555130500445
2023-09-27T15:00:00-04:00,1.0507,1.05188,1.05057,1.05143,1.0488944,1.0503113333333334,1.0500711111111032,1.0499735555555514,1.0506600000000046,1.0533094000000007,1.0549592000000045,1.0568995000000072,1.0504645608425331,1.0501582283829376,3841,-529495,-532640.4,-0.05568739281258525,-567.0819966932823,0.108541450456554
2023-09-27T15:15:00-04:00,1.05143,1.05162,1.05101,1.05122,1.049073536,1.0505411111111111,1.0501955555555478,1.0500122222222181,1.0506310000000048,1.053195600000001,1.0549078000000045,1.0568573000000072,1.0506156486740266,1.0502669827063496,-2916,-532411,-531834.6,-0.04765137719419863,-567.6644035106646,0.10665650890391486
2023-09-27T15:30:00-04:00,1.05122,1.05124,1.05016,1.05027,1.0492419238400001,1.050556,1.05028777777777,1.0500884444444403,1.0505730000000049,1.053069000000001,1.0548463000000046,1.056812750000007,1.0505465189392214,1.0503907861650794,-2321,-534732,-532030,-0.03910185836899684,-569.7619187786389,0.07908980027444242
2023-09-27T15:45:00-04:00,1.05027,1.05069,1.05012,1.05058,1.0494002084096001,1.0506144444444443,1.050386666666659,1.0501771111111071,1.0505585000000048,1.052936200000001,1.0547859000000046,1.0567682500000073,1.050553215151377,1.0504806289320634,2412,-532320,-532458.8,-0.024399375578654982,-569.049987560952,0.08478693709571944
2023-09-27T16:00:00-04:00,1.05058,1.05059,1.05018,1.0503,1.0495489959050242,1.0505971111111112,1.0504333333333258,1.0502748888888849,1.0504900000000048,1.052806200000001,1.0547179000000044,1.0567215000000072,1.0505025721211017,1.0505365031456502,-1097,-533417,-532475,-0.01600981258237773,-569.342359393654,0.04000457195108841
2023-09-27T16:15:00-04:00,1.0503,1.05035,1.04985,1.04994,1.0496888561507227,1.0504984444444445,1.0505111111111036,1.050362888888885,1.050389000000005,1.052675000000001,1.0546510000000044,1.0566738500000072,1.0503900576968814,1.05052160251652,-560,-533977,-533371.4,-0.007597551013362755,-569.5343045521801,0.06671495558691481
2023-09-27T16:30:00-04:00,1.04994,1.05051,1.04993,1.0502799999999999,1.0498203247816793,1.0504522222222223,1.0506144444444367,1.0504466666666628,1.0502885000000048,1.052550600000001,1.0545824000000046,1.0566310500000073,1.0503680461575051,1.0504720820132156,846,-533131,-533515.4,0.009919276672965228,-569.2603460402653,0.08862629246675326
2023-09-27T16:45:00-04:00,1.0502799999999999,1.0504499999999999,1.05017,1.05022,1.04985,1.0503733333333332,1.050548888888881,1.0504988888888849,1.050256000000005,1.052419200000001,1.0545145000000047,1.0565887000000074,1.050338436926004,1.0504304656105723,-1115,-534246,-533418.2,0.027588877216957807,-569.324043340033,-0.056147162665000375
2023-09-27T17:00:00-04:00,1.05022,1.05072,1.05007,1.05055,1.04993,1.0503735555555553,1.0505322222222147,1.050527999999996,1.050273000000005,1.052298000000001,1.0544460000000047,1.0565481500000073,1.0503807495408033,1.0503959724884575,73,-534173,-533788.8,0.02656459767525635,-569.301105288958,-0.014276196821154703
2023-09-27T17:15:00-04:00,1.05055,1.05087,1.05043,1.05051,1.050047,1.050369111111111,1.0504299999999924,1.0505273333333291,1.0502745000000049,1.052188800000001,1.0543768000000044,1.0565062500000073,1.0504065996326426,1.0503767779907658,-271,-534444,-533994.2,0.023395026380983307,-569.3114236936032,-0.08749988111429499
2023-09-27T17:30:00-04:00,1.05051,1.05067,1.05006,1.05051,1.05188,1.050385111111111,1.0503511111111035,1.0504953333333291,1.050265500000005,1.0520870000000009,1.0543099000000047,1.0564638500000074,1.050427279706114,1.0503842223926123,0,-534444,-534087.6,0.01449945593076092,-569.3114236936032,-0.06754057190692608
2023-09-27T17:45:00-04:00,1.05051,1.0506,1.0502799999999999,1.05051,1.0518436,1.050416888888889,1.05037777777777,1.0504479999999958,1.0502765000000047,1.051983400000001,1.0542428000000046,1.0564200000000072,1.0504438237648912,1.0503993779140894,0,-534444,-534350.2,0.008555564926121846,-569.3114236936032,0.022851266817105885
2023-09-27T18:00:00-04:00,1.05051,1.05076,1.05046,1.05055,1.051807928,1.0504513333333332,1.050374444444437,1.0504131111111072,1.0502990000000048,1.051886200000001,1.0541780000000045,1.0563764500000072,1.050465059011913,1.0504247023312712,543,-533901,-534281.2,0.010042582363178095,-569.2907480217866,-0.002855565497151525
2023-09-27T18:15:00-04:00,1.05055,1.05064,1.05031,1.05037,1.05177296944,1.0504504444444445,1.0503822222222148,1.050383111111107,1.0503455000000048,1.051773600000001,1.0541119000000045,1.0563314000000075,1.0504460472095303,1.0504377618650165,-334,-534235,-534293.6,0.006818897959476488,-569.3479751885088,0.006664762448825526
2023-09-27T18:30:00-04:00,1.05037,1.05051,1.05037,1.05048,1.0517387100512,1.0504700000000002,1.050442222222215,1.0503855555555517,1.050385000000005,1.051666200000001,1.0540445000000045,1.0562869000000072,1.0504528377676243,1.0504470094920129,218,-534017,-534208.2,0.0038173147416068714,-569.3251451381456,0.05143151037201982
2023-09-27T18:45:00-04:00,1.05048,1.05048,1.05031,1.05034,1.0517051358501759,1.0504495555555555,1.0504488888888814,1.050405111111107,1.050408000000005,1.051557000000001,1.0539768000000047,1.0562421000000073,1.0504302702140995,1.0504476075936098,-269,-534286,-534176.6,0.0046785661830620355,-569.3609954161137,0.005712762311019065
2023-09-27T19:00:00-04:00,1.05034,1.05051,1.05023,1.0504,1.0516722331331723,1.0504397777777779,1.0504688888888816,1.0504233333333295,1.050466000000005,1.0514538000000009,1.0539103000000045,1.0561975500000074,1.0504242161712796,1.0504436860748876,596,-533690,-534025.8,0.0034635080444393113,-569.326949297714,0.017139266058546685
2023-09-27T19:15:00-04:00,1.0504,1.05042,1.05024,1.05024,1.0516399884705088,1.050394,1.050434444444437,1.0504353333333296,1.050510500000005,1.051350200000001,1.0538424000000046,1.0561532000000073,1.0503873729370237,1.0504281488599099,-445,-534135,-534072.6,-0.0008794373048081586,-569.3947329991611,-0.029508352767601012
2023-09-27T19:30:00-04:00,1.05024,1.05051,1.05022,1.05051,1.0516083887010985,1.0504091111111111,1.050434444444437,1.0504457777777738,1.050495500000005,1.051262800000001,1.0537764000000047,1.0561100500000073,1.050411898349619,1.0504213190879275,544,-533591,-533943.8,-0.006518372926718736,-569.2548792514463,0
2023-09-27T19:45:00-04:00,1.05051,1.05071,1.05041,1.05053,1.0515774209270765,1.0504282222222223,1.0504366666666591,1.0504446666666627,1.050487000000005,1.051197000000001,1.0537104000000046,1.0560669000000074,1.0504355186796952,1.0504178552703416,717,-532874,-533715.2,-0.0050588292886308995,-569.2412287388381,0.0019038371838353732
2023-09-27T20:00:00-04:00,1.05053,1.05102,1.0505,1.05101,1.051547072508535,1.0505428888888888,1.0504922222222148,1.0504533333333295,1.050466000000005,1.0511398000000012,1.0536475000000045,1.0560255000000074,1.0505504149437561,1.0504418842162728,1854,-531020,-533062,-0.001704384483386392,-568.3941134732103,0.047595929596095696
2023-09-27T20:15:00-04:00,1.05101,1.05117,1.05096,1.05117,1.0515173310583643,1.0506784444444444,1.0505611111111037,1.0504717777777737,1.0504635000000049,1.0510842000000011,1.0535886000000045,1.0559838500000074,1.050674331955005,1.0504919073730181,1038,-529982,-532320.4,0.005756898419220336,-568.2360940442801,0.05901670553518089
2023-09-27T20:30:00-04:00,1.05117,1.05138,1.05113,1.05121,1.051488184437197,1.0508082222222221,1.050654444444437,1.0505157777777736,1.0505105000000048,1.0510330000000012,1.0535330000000045,1.0559425000000073,1.050781465564004,1.0505707258984143,1270,-528712,-531235.8,0.012084959167160226,-568.1877669420986,0.07997181945409254
2023-09-27T20:45:00-04:00,1.05121,1.05153,1.05104,1.05151,1.05006,1.0509793333333335,1.0507688888888813,1.0505826666666624,1.0505570000000048,1.0509800000000014,1.0534791000000046,1.0559031000000072,1.0509271724512033,1.050673780718731,1592,-527120,-529941.6,0.017315059750909332,-567.7334333646022,0.09805041504834593
2023-09-27T21:00:00-04:00,1.05151,1.05161,1.05138,1.05158,1.0500894,1.0511415555555554,1.050906666666659,1.0506766666666627,1.050621000000005,1.050920200000001,1.0534242000000047,1.0558639000000074,1.0510577379609627,1.0507982245749843,1621,-525499,-528466.6,0.023251892786015967,-567.6255218849205,0.11805701011100289
2023-09-27T21:15:00-04:00,1.05158,1.05158,1.05107,1.05133,1.050150224,1.0512262222222222,1.0510099999999925,1.0507802222222182,1.0506905000000049,1.0508536000000013,1.0533704000000046,1.0558237000000072,1.0511121903687701,1.0509105796599871,-2135,-527634,-527789.4,0.0280052121696311,-568.1330914469127,0.08853769992384782
2023-09-27T21:30:00-04:00,1.05133,1.05136,1.05098,1.0510599999999999,1.05020861504,1.0512362222222222,1.0511011111111037,1.0508882222222182,1.050729500000005,1.0507804000000014,1.0533211000000045,1.0557824000000073,1.0511017522950161,1.0509960637279896,-1819,-529453,-527683.6,0.02920932686248105,-568.6002425792882,0.07807739183423035
2023-09-27T21:45:00-04:00,1.0510599999999999,1.05131,1.05095,1.05104,1.0502646704384,1.0512240000000002,1.0511599999999925,1.0509893333333296,1.050770500000005,1.0507408000000014,1.0532717000000047,1.0557419500000074,1.0510894018360128,1.0510576509823912,-1727,-531180,-528177.2,0.03337770097693815,-568.6331046423481,0.050451685371859324
2023-09-27T22:00:00-04:00,1.05104,1.05118,1.0505,1.05069,1.0503184836208639,1.05113,1.0511777777777702,1.0510711111111073,1.0507775000000048,1.0507034000000015,1.0532176000000046,1.0557002000000073,1.0510095214688102,1.051074120785913,-1717,-532897,-529332.6,0.03296006090824699,-569.20487165407,0.015230407508584998
2023-09-27T22:15:00-04:00,1.05069,1.0507,1.05034,1.05035,1.05161,1.0509644444444444,1.0511044444444368,1.0511106666666628,1.050769500000005,1.0506700000000013,1.0531570000000046,1.0556598500000072,1.0508776171750482,1.05103809662873,-1128,-534025,-531037.8,0.03215368509816106,-569.5698889284325,-0.06279673837547739
2023-09-27T22:30:00-04:00,1.05035,1.05037,1.04993,1.05012,1.0515846,1.0507675555555556,1.05098777777777,1.0511062222222183,1.050750000000005,1.0506516000000012,1.0530917000000046,1.055618800000007,1.0507260937400387,1.0509608773029837,-1455,-535480,-532607,0.025451485146183138,-569.8884970114524,-0.09988869545363695
2023-09-27T22:45:00-04:00,1.05012,1.05015,1.04987,1.04995,1.051518416,1.05056,1.05084777777777,1.0510555555555516,1.050722000000005,1.0506146000000014,1.0530217000000046,1.055576450000007,1.0505708749920308,1.0508547018423866,-988,-536468,-534010,0.016378917695576787,-570.0484406369428,-0.11986187346011158
2023-09-27T23:00:00-04:00,1.04995,1.0501,1.0499,1.04994,1.05141951104,1.0503784444444444,1.0506733333333258,1.0509582222222182,1.050691500000005,1.0505848000000015,1.0529574000000046,1.0555329500000072,1.0504446999936248,1.0507257614739092,-783,-537251,-535224.2,0.006875334815995223,-570.0558981349188,-0.14930908883413846
2023-09-27T23:15:00-04:00,1.04994,1.0503,1.04994,1.05022,1.0513265403776,1.0502877777777777,1.0505222222222146,1.0508271111111072,1.050684000000005,1.0505718000000015,1.0528985000000046,1.055490700000007,1.0503997599948998,1.050603809179127,1013,-536238,-535892.4,-0.003906807680043517,-569.7857493645131,-0.12932919987067346
2023-09-27T23:30:00-04:00,1.05022,1.05054,1.05022,1.05037,1.0512391479549439,1.0502573333333332,1.050415555555548,1.0506893333333294,1.050678500000005,1.0505458000000014,1.0528397000000045,1.0554496500000072,1.0503938079959199,1.0505070473433011,1353,-534885,-536064.4,-0.015423279044077448,-569.5925041397029,-0.09131290841125735
2023-09-27T23:45:00-04:00,1.05037,1.05055,1.05032,1.05041,1.0511569990776473,1.0502562222222223,1.0503433333333259,1.0505604444444405,1.050682000000005,1.0505148000000015,1.0527794000000044,1.0554084500000072,1.0503970463967358,1.0504412378746406,1239,-533646,-535697.6,-0.02386242191990707,-569.5453207662249,-0.06184233059956781
2023-09-28T00:00:00-04:00,1.05041,1.05041,1.0498,1.04992,1.0510797791329884,1.0501715555555555,1.0502188888888813,1.0504346666666626,1.050658000000005,1.0504674000000016,1.0527143000000043,1.0553664500000073,1.0503016371173886,1.0503873902997125,-1488,-535134,-535430.8,-0.032809755089046,-570.2394497253933,-0.10656112041406701
2023-09-28T00:15:00-04:00,1.04992,1.05005,1.04968,1.0500099999999999,1.0509773968023495,1.0501297777777776,1.0501433333333259,1.0503286666666625,1.050646500000005,1.0504502000000016,1.0526500000000043,1.0553238500000073,1.0502433096939108,1.0503471122397694,1185,-533949,-534770.4,-0.040846351634529744,-570.1378705574568,-0.06471937488698036
2023-09-28T00:30:00-04:00,1.0500099999999999,1.05046,1.0500099999999999,1.05044,1.0508476571221146,1.050189111111111,1.050153333333326,1.050254888888885,1.0506430000000049,1.0504548000000016,1.0525912000000044,1.0552825000000072,1.0502826477551286,1.0503236897918151,1020,-532929,-534108.6,-0.04413197077291532,-569.7201602499358,0.008568572380648882
2023-09-28T00:45:00-04:00,1.05044,1.05059,1.05031,1.05042,1.0507308914099032,1.0502424444444443,1.050186666666659,1.0502091111111072,1.0506375000000048,1.0504536000000015,1.0525334000000044,1.0552445500000074,1.0503101182041028,1.0503069518334516,-912,-533841,-533899.8,-0.043057967808610854,-569.7375244021007,0.028568163638438178
2023-09-28T01:00:00-04:00,1.05042,1.05068,1.05037,1.05068,1.04968,1.0503411111111112,1.0502677777777703,1.0501939999999959,1.0506210000000047,1.0504534000000016,1.0524804000000045,1.0552079500000071,1.0503840945632823,1.050304361466761,1219,-532622,-533695,-0.03840744616735846,-569.4357974738242,0.06952712033907514
2023-09-28T01:15:00-04:00,1.05068,1.05087,1.05064,1.05073,1.0496999999999999,1.0504335555555557,1.050355555555548,1.0502213333333292,1.0505990000000047,1.0504622000000017,1.0524287000000043,1.0551697500000072,1.0504532756506257,1.0503346891734084,1118,-531504,-532969,-0.029714705288796807,-569.3825938342766,0.07524239480349794
2023-09-28T01:30:00-04:00,1.05073,1.05081,1.04959,1.05059,1.05087,1.0504804444444442,1.050396666666659,1.0502719999999959,1.0505680000000048,1.0504720000000018,1.0523763000000044,1.0551301000000073,1.0504806205205006,1.0503821513387266,-2424,-533928,-532964.8,-0.020899650403048028,-569.7055692894364,0.03523071356477514
2023-09-28T01:45:00-04:00,1.05059,1.05096,1.05015,1.05088,1.04959,1.050577111111111,1.0504533333333257,1.050331999999996,1.0505365000000046,1.0505008000000018,1.0523249000000043,1.0550916000000072,1.0505604964164006,1.0504377210709808,1704,-532224,-532823.8,-0.013121967669313596,-569.2352050179317,0.04855431895427425
2023-09-28T02:00:00-04:00,1.05088,1.05091,1.05034,1.05035,1.04959,1.0505564444444444,1.0504466666666592,1.0503839999999958,1.0504750000000047,1.0505140000000017,1.0522708000000043,1.0550508000000074,1.0505183971331205,1.0504793768567844,-2553,-534777,-533011,-0.008054909369453559,-570.5227830477737,-0.005712055292711515
2023-09-28T02:15:00-04:00,1.05035,1.0506199999999999,1.04997,1.05032,1.0496174,1.0505311111111113,1.0504911111111035,1.0504286666666625,1.0504245000000048,1.0505228000000018,1.0522148000000042,1.0550089500000073,1.0504787177064963,1.0504983014854272,-2385,-537162,-533919,-0.0032003887607732987,-570.5909031981997,0.03809814081072424
2023-09-28T02:30:00-04:00,1.05032,1.05053,1.04934,1.04939,1.05096,1.0503108888888888,1.0504222222222146,1.0504419999999957,1.0503410000000049,1.0505258000000017,1.0521462000000044,1.0549616500000072,1.050260974165197,1.0504598411883415,-2645,-539807,-535579.6,0.0005485567972603715,-572.9329037313703,-0.05904705669468319
2023-09-28T02:45:00-04:00,1.04939,1.04962,1.04909,1.0495,1.0509275999999999,1.0501264444444445,1.0503177777777701,1.050426222222218,1.0502640000000047,1.0505288000000017,1.0520810000000043,1.0549128000000074,1.0501087793321575,1.0503854729506727,3010,-536797,-536153.4,0.0027656472161959574,-572.6173870978973,-0.08948631049845215
2023-09-28T03:00:00-04:00,1.0495,1.0511,1.04941,1.05104,1.04909,1.050270888888889,1.050386666666659,1.0504128888888846,1.0502815000000048,1.0505334000000017,1.0520266000000043,1.0548739000000074,1.050295023465726,1.0503323783605378,5314,-531483,-536005.2,0.008478295563694215,-564.8198072979933,0.0590240094438477
2023-09-28T03:15:00-04:00,1.05104,1.0519,1.0508899999999999,1.05097,1.04909,1.0503875555555557,1.0504188888888815,1.050407333333329,1.0503125000000049,1.0505388000000015,1.0519715000000043,1.0548367000000074,1.0504300187725808,1.0503147026884299,-4319,-535802,-536210.2,0.012445254481971863,-565.107455722411,0.027601172573942727
2023-09-28T03:30:00-04:00,1.05097,1.05156,1.05075,1.05119,1.0492024,1.0505417777777777,1.0504699999999927,1.0504031111111067,1.0503660000000048,1.0505340000000019,1.0519217000000043,1.0548003000000075,1.0505820150180647,1.0503353621507434,3290,-532512,-535280.2,0.013492046221478638,-564.4187586140251,0.04377908692053401
2023-09-28T03:45:00-04:00,1.05119,1.05145,1.05078,1.05086,1.049310304,1.0506197777777777,1.0504999999999924,1.0504186666666624,1.050411500000005,1.0505268000000019,1.0518612000000045,1.0547607500000076,1.0506376120144518,1.0504106897205945,-2852,-535364,-534391.6,0.011374465164730682,-565.3140867659296,0.025699844849084084
2023-09-28T04:00:00-04:00,1.05086,1.0516699999999999,1.05047,1.0516699999999999,1.04941389184,1.0508537777777778,1.0505877777777703,1.0504726666666624,1.0504980000000048,1.0505548000000018,1.0518119000000044,1.0547249500000075,1.0508440896115614,1.0505577517764753,3886,-531478,-533327.8,0.013857723743417916,-562.318768645533,0.07517509135199513
2023-09-28T04:15:00-04:00,1.0516699999999999,1.05243,1.05149,1.05162,1.0495133361664,1.051060222222222,1.0507288888888815,1.050541111111107,1.0505680000000048,1.0505756000000017,1.0517559000000043,1.0546927500000074,1.0509992716892491,1.0506986014211799,-4300,-535778,-534186.8,0.013285539839282993,-562.5232053985064,0.12091207692674866
2023-09-28T04:30:00-04:00,1.05162,1.05198,1.05124,1.05182,1.049688335996416,1.0512784444444445,1.0508955555555484,1.0506364444444405,1.0506405000000048,1.0506060000000017,1.0517061000000043,1.0546631000000075,1.0511634173513993,1.0508452811369435,3685,-532093,-533445,0.020024311998865563,-561.8223819071313,0.1428136187066853
2023-09-28T04:45:00-04:00,1.05182,1.052,1.05118,1.05166,1.049852835836631,1.0514313333333332,1.0511477777777705,1.050771999999996,1.0507030000000048,1.0506404000000018,1.0516577000000042,1.0546356500000074,1.0512627338811193,1.0509814249095544,-4479,-536572,-534257,0.02693017326079361,-562.5037152151115,0.21631614557028314
2023-09-28T05:00:00-04:00,1.05166,1.05224,1.05152,1.05196,1.050007465686433,1.0515937777777777,1.0514211111111038,1.0509562222222182,1.0508050000000049,1.0506740000000017,1.0516123000000044,1.0546101500000074,1.0514021871048955,1.0511343399276432,3682,-532890,-533762.2,0.044362327234701356,-561.4533757517869,0.2343973320628782
2023-09-28T05:15:00-04:00,1.05196,1.05281,1.0516699999999999,1.05263,1.050152817745247,1.0518355555555556,1.0515977777777705,1.0511582222222182,1.0509360000000048,1.0507222000000018,1.051570700000004,1.0545826500000075,1.0516477496839165,1.0512950719421144,3522,-529368,-533340.2,0.061861285176218625,-559.2101916002985,0.15127873344496692
2023-09-28T05:30:00-04:00,1.05263,1.05364,1.05258,1.05353,1.0503653923256273,1.0522220000000002,1.051882222222215,1.051388888888885,1.0510905000000048,1.0507818000000018,1.0515399000000043,1.0545574500000074,1.0520241997471331,1.051500057553691,4292,-525076,-531199.8,0.069594173679938,-555.5405260957997,0.24358449813030988
2023-09-28T05:45:00-04:00,1.05353,1.05414,1.05346,1.05395,1.0506928530930646,1.0526355555555555,1.0521888888888817,1.0516475555555516,1.0512670000000046,1.0508506000000017,1.0515197000000043,1.0545347000000076,1.0524093597977064,1.0517492460429525,4025,-521051,-528991.4,0.08203115090974834,-553.9359206265682,0.26255957533841395
2023-09-28T06:00:00-04:00,1.05395,1.05417,1.05379,1.05398,1.0511065107218969,1.0529937777777776,1.0525355555555485,1.0519251111111072,1.0514320000000046,1.0509200000000019,1.0515035000000041,1.0545092500000075,1.052723487838165,1.0520413968343616,2746,-518305,-525338,0.09243038282008445,-553.8577575258519,0.296899682165085
2023-09-28T06:15:00-04:00,1.05398,1.05405,1.05327,1.05327,1.0515353992208314,1.0531406666666665,1.0527133333333263,1.0521835555555517,1.0515590000000046,1.0509752000000017,1.0514793000000042,1.0544769000000076,1.0528327902705321,1.0523275174674889,-2642,-520947,-522949.4,0.10360969680646495,-555.6375066672018,0.15213897895728185
2023-09-28T06:30:00-04:00,1.05327,1.05347,1.05317,1.05338,1.051904243329915,1.053274,1.0529088888888818,1.052445777777774,1.0516985000000048,1.0510318000000018,1.0514590000000041,1.0544457000000076,1.0529422322164257,1.0525864139739909,2468,-518479,-520771.6,0.10785815972824497,-555.3797569923795,0.16736083376124303
2023-09-28T06:45:00-04:00,1.05338,1.054,1.05338,1.05398,1.052221449263727,1.0534882222222222,1.0531488888888818,1.0526991111111073,1.0518535000000049,1.0511040000000016,1.0514388000000041,1.0544176500000078,1.0531497857731404,1.0528115311791924,2349,-516130,-518982.4,0.11493144452100128,-554.0417782952334,0.20535833127340608
2023-09-28T07:00:00-04:00,1.05398,1.05416,1.05383,1.05403,1.0524942463668052,1.0536644444444445,1.053412222222215,1.0529437777777741,1.0520375000000048,1.0511750000000017,1.0514206000000044,1.0543885000000077,1.0533258286185123,1.0529948249433534,2432,-513698,-517511.8,0.12166438067855265,-553.9264060870319,0.2253580054390186
2023-09-28T07:15:00-04:00,1.05403,1.0543,1.0537,1.05406,1.0527288518754525,1.053794,1.0536455555555484,1.053165777777774,1.0522245000000048,1.0512494000000017,1.0514032000000042,1.0543586000000078,1.05347266289481,1.0531446599546825,2057,-511641,-516179,0.1276634648593001,-553.8678593663503,0.19962736225711916
2023-09-28T07:30:00-04:00,1.05406,1.05484,1.05399,1.05466,1.0529802355753801,1.0539968888888889,1.053871111111104,1.0533973333333297,1.0524880000000048,1.0513346000000017,1.051394200000004,1.0543318000000077,1.0537101303158478,1.0533201279637456,2643,-508998,-513789.2,0.133656724354028,-552.3633909300186,0.19285028927543166
2023-09-28T07:45:00-04:00,1.05466,1.05476,1.05403,1.05413,1.0533149931718118,1.0540486666666666,1.0539377777777705,1.0536031111111075,1.052719500000005,1.0514124000000016,1.051381300000004,1.0543037500000079,1.0537941042526782,1.053490502370996,-2332,-511330,-512359.4,0.12643475876904967,-553.5352946715085,0.05695139198693287
2023-09-28T08:00:00-04:00,1.05413,1.0543,1.05344,1.0536,1.05484,1.053981111111111,1.0538988888888816,1.0537531111111076,1.0528475000000048,1.0514742000000017,1.0513685000000041,1.0542741500000077,1.0537552834021426,1.0536116018967963,-4084,-515414,-512216.2,0.10853089765318832,-555.5886656978522,-0.03320840647088102
2023-09-28T08:15:00-04:00,1.0536,1.05425,1.05351,1.05369,1.054812,1.0539393333333333,1.0538666666666594,1.0538439999999962,1.0529835000000047,1.0515374000000015,1.051367200000004,1.0542425000000077,1.053742226721714,1.0536948815174367,3893,-511521,-511780.8,0.09406331069600891,-555.2561201397659,-0.027514753600628234
2023-09-28T08:30:00-04:00,1.05369,1.05573,1.05307,1.05336,1.05307,1.053838,1.0538766666666595,1.0538902222222184,1.0530920000000048,1.0515844000000016,1.051362100000004,1.0542112500000078,1.0536657813773713,1.0537335052139492,-11865,-523386,-514129.8,0.07735710574297093,-558.9720612609678,0.008544817568158737
2023-09-28T08:45:00-04:00,1.05336,1.05344,1.05176,1.0518,1.05573,1.0534226666666666,1.0537011111111039,1.0538562222222183,1.0531390000000047,1.0515970000000017,1.051340600000004,1.0541722500000075,1.053292625101897,1.0536500041711592,-11939,-535325,-519395.2,0.06063678345164514,-576.6534237581199,-0.1499933547247826
2023-09-28T09:00:00-04:00,1.0518,1.05395,1.05178,1.05331,1.05573,1.0533444444444444,1.0536266666666598,1.0537939999999963,1.0532210000000048,1.0516390000000018,1.051336000000004,1.0541430000000076,1.0532961000815175,1.0535504033369267,10669,-524656,-522060.4,0.04888748418041837,-561.336643001323,-0.06356856866353712
2023-09-28T09:15:00-04:00,1.05331,1.05469,1.05302,1.05459,1.0556506,1.053537111111111,1.0536888888888818,1.0537519999999962,1.0533695000000047,1.0517006000000018,1.0513403000000041,1.0541161000000079,1.053554880065214,1.053510322669541,7407,-517249,-522427.4,0.04147111466594789,-552.3355322172237,0.05312941756874984
2023-09-28T09:30:00-04:00,1.05459,1.05547,1.05358,1.0538399999999999,1.055572788,1.0535673333333333,1.0536644444444372,1.053711555555552,1.0534705000000049,1.0517458000000017,1.051333000000004,1.0540836500000077,1.0536119040521712,1.0534842581356325,-9965,-527214,-525566,0.029627647287606088,-559.422409581887,-0.020871677134139326
2023-09-28T09:45:00-04:00,1.0538399999999999,1.0550599999999999,1.05362,1.05494,1.05549653224,1.0538224444444444,1.0536955555555485,1.0536753333333295,1.0536345000000047,1.0518180000000017,1.051335800000004,1.0540586500000075,1.053877523241737,1.0535266065085058,7825,-519389,-524766.6,0.023874147715427424,-551.254661157078,0.026548840384584417
2023-09-28T10:00:00-04:00,1.05494,1.05586,1.05491,1.05581,1.05176,1.0542453333333333,1.053882222222215,1.0537115555555518,1.0538270000000047,1.0519130000000019,1.051346700000004,1.0540350500000075,1.0542640185933896,1.053720885206804,7294,-512095,-520120.6,0.01602910274118048,-545.2393617087687,0.15937313234609618
2023-09-28T10:15:00-04:00,1.05581,1.05586,1.05468,1.05558,1.051842,1.054584888888889,1.0541022222222152,1.053806666666663,1.0539745000000047,1.052003800000002,1.051372300000004,1.0540108500000076,1.0545272148747116,1.053967108165443,-5780,-517875,-518764.4,0.013428446981498773,-546.4984897715827,0.18792710706149113
2023-09-28T10:30:00-04:00,1.05558,1.05577,1.05455,1.05576,1.0519223599999998,1.0549164444444445,1.0543322222222151,1.0539353333333294,1.0540860000000047,1.052105200000002,1.051404300000004,1.0539865000000075,1.0547737718997692,1.054210886532354,5960,-511915,-517697.6,0.019778407743680494,-545.4821764651537,0.1964524670443884
2023-09-28T10:45:00-04:00,1.05576,1.05677,1.05566,1.05629,1.0520011127999997,1.0553080000000001,1.0546577777777706,1.0541339999999964,1.0542030000000047,1.0522240000000018,1.051447000000004,1.0539651000000076,1.0550770175198154,1.054503909225883,5343,-506572,-513569.2,0.031972160099663006,-542.7999475494914,0.27815751499960856
2023-09-28T11:00:00-04:00,1.05629,1.0568,1.05581,1.05589,1.0521918682879998,1.0555544444444445,1.055112222222215,1.0544173333333293,1.0542985000000047,1.0523394000000017,1.0514955000000041,1.0539458500000076,1.0552396140158524,1.0547763273807058,-5002,-511574,-512006.2,0.04720426197927541,-544.6941243380626,0.3888571971857698
2023-09-28T11:15:00-04:00,1.05589,1.0568899999999999,1.05581,1.05681,1.0524683561907198,1.055894,1.0555011111111037,1.0547411111111071,1.0544755000000046,1.0524766000000019,1.051545600000004,1.0539329000000075,1.055553691212682,1.0550342619045643,4361,-507213,-511029.8,0.08193189834374823,-540.8943724699701,0.3322858417749816
2023-09-28T11:30:00-04:00,1.05681,1.05788,1.0567,1.05786,1.0528220876954621,1.056365777777778,1.0558644444444372,1.0550935555555516,1.0546995000000048,1.0526350000000018,1.051609900000004,1.0539252000000077,1.0560149529701455,1.0553318095236512,3761,-503452,-508145.2,0.10433292982452408,-537.1576080563101,0.3100731089807514
2023-09-28T11:45:00-04:00,1.05786,1.05786,1.05728,1.05763,1.053327878925916,1.0567188888888888,1.0562855555555482,1.055484222222218,1.0548820000000048,1.0527832000000017,1.051677500000004,1.0539172500000076,1.0563379623761164,1.0556446476189207,-3702,-507154,-507193,0.11394651948739438,-537.962497172072,0.35963713656723817
2023-09-28T12:00:00-04:00,1.05763,1.05784,1.05653,1.0565499999999999,1.0537830910333243,1.0567717777777779,1.056464444444437,1.0558455555555515,1.0550080000000048,1.0529068000000017,1.0517263000000039,1.0539070000000077,1.0563803699008931,1.055905318095136,-3866,-511020,-508082.6,0.12802092967552178,-541.9102671861608,0.15261531461503872
2023-09-28T12:15:00-04:00,1.0565499999999999,1.05744,1.05653,1.0573,1.0541927819299919,1.0569388888888887,1.0566299999999929,1.056149111111107,1.0551700000000046,1.0530446000000018,1.051779700000004,1.0538994500000074,1.0565642959207144,1.0561702544761085,3310,-507710,-507309.8,0.1356112117547559,-539.5606386782813,0.14112387645504318
2023-09-28T12:30:00-04:00,1.0573,1.05743,1.0567,1.05699,1.0545615037369926,1.0570108888888887,1.0567866666666594,1.0564062222222184,1.0552865000000047,1.0531860000000017,1.051826700000004,1.0538914000000077,1.0566494367365715,1.0563894035808865,-2833,-510543,-507975.8,0.13355360623199972,-540.3912733136729,0.13357585403286662
2023-09-28T12:45:00-04:00,1.05699,1.05701,1.05559,1.05578,1.0548933533632934,1.0568095555555554,1.0567888888888817,1.0565911111111073,1.0553690000000047,1.0533014000000016,1.0518758000000041,1.0538784000000077,1.0564755493892573,1.0564815228647089,-3081,-513624,-510010.2,0.13038822715634232,-543.9182792456121,0.001894369932551809
2023-09-28T13:00:00-04:00,1.05578,1.0562,1.05545,1.05599,1.055192018026964,1.0566497777777775,1.0567555555555483,1.0566851111111073,1.055488500000005,1.0534124000000018,1.0519336000000041,1.0538673000000076,1.0563784395114058,1.0564896182917667,4240,-509384,-510456.2,0.12416433060526548,-543.0749217279473,-0.02840129131204186
2023-09-28T13:15:00-04:00,1.05599,1.0564,1.05577,1.05583,1.05545,1.0564646666666666,1.0567488888888819,1.0567419999999963,1.0555955000000048,1.0535206000000017,1.051987100000004,1.0538589500000075,1.0562687516091247,1.056467294633413,-3299,-512683,-510788.8,0.10973309993894656,-543.5747749462541,-0.005682410099532052
2023-09-28T13:30:00-04:00,1.05583,1.05585,1.055,1.05509,1.05788,1.056132888888889,1.0565577777777706,1.0567275555555518,1.0556820000000047,1.053608800000002,1.052031100000004,1.0538458000000075,1.0560330012872998,1.0563610357067301,-2997,-515680,-512382.8,0.09583164162976622,-545.6752835508589,-0.16275394820260441
2023-09-28T13:45:00-04:00,1.05509,1.05543,1.05501,1.05508,1.0578223999999998,1.0558373333333333,1.056248888888882,1.0566199999999961,1.0558460000000047,1.0536958000000018,1.052079000000004,1.0538349500000075,1.05584240102984,1.0561996285653836,-1908,-517588,-513791.8,0.07167757092004766,-545.693367316225,-0.26279469873140154
2023-09-28T14:00:00-04:00,1.05508,1.05578,1.05498,1.05575,1.0577659519999998,1.0557375555555555,1.056039999999993,1.0564702222222184,1.055968000000005,1.0537990000000017,1.052135500000004,1.0538263500000076,1.055823920823872,1.0560693028523067,2156,-515432,-514153.4,0.03386601613636238,-544.3242578648092,-0.17775592598546786
2023-09-28T14:15:00-04:00,1.05575,1.05644,1.05571,1.0563,1.0576545139199998,1.0557895555555556,1.0560122222222152,1.0563215555555518,1.0560535000000049,1.0539074000000017,1.0522041000000042,1.0538220500000073,1.0559191366590976,1.0559774422818449,1734,-513698,-515016.2,0.007783308366296198,-543.4209190061778,-0.023661918508339545
2023-09-28T14:30:00-04:00,1.0563,1.05637,1.05547,1.05591,1.0575475333631998,1.0557691111111114,1.0558577777777707,1.0561433333333294,1.0561570000000047,1.0540186000000018,1.0522663000000043,1.0538166500000075,1.055917309327278,1.0559071538254756,-2375,-516073,-515694.2,-0.004229611064875687,-544.2978005739145,-0.13146694410290385
2023-09-28T14:45:00-04:00,1.05591,1.05616,1.05532,1.05549,1.0574448320286718,1.0556955555555558,1.0556911111111038,1.0559699999999963,1.0561845000000047,1.0541220000000018,1.0523224000000042,1.0538096000000075,1.0558318474618225,1.0558669230603803,-2663,-518736,-516305.4,-0.028807009269435514,-545.357038577153,-0.14191241165952911
2023-09-28T15:00:00-04:00,1.05549,1.05561,1.05524,1.0556,1.057346238747525,1.0556773333333334,1.055671111111104,1.0558544444444407,1.056174000000005,1.0542462000000017,1.0523860000000043,1.0538006000000073,1.055785477969458,1.055855538448304,2818,-515918,-515971.4,-0.0449428272949155,-545.0633550747038,-0.017049006421777924
2023-09-28T15:15:00-04:00,1.0556,1.0561099999999999,1.05531,1.05606,1.057251589197624,1.0557551111111112,1.055678888888882,1.0557822222222186,1.056198000000005,1.0543774000000017,1.0524531000000041,1.0537942000000076,1.0558403823755664,1.0558588307586427,1663,-514255,-515736,-0.04341839370850126,-544.3386676931201,0.006628850651996183
2023-09-28T15:30:00-04:00,1.05606,1.05616,1.05557,1.05607,1.057160725629719,1.0558333333333332,1.0557055555555483,1.0557208888888852,1.056213500000005,1.0544780000000018,1.052505700000004,1.0537904500000075,1.055886305900453,1.0558522646069137,1581,-512674,-515531.2,-0.0448691908889794,-544.3236969528211,0.022730932062928498
2023-09-28T15:45:00-04:00,1.05607,1.05645,1.05605,1.05642,1.0570734966045303,1.0559762222222222,1.055853333333326,1.055719999999996,1.0562200000000048,1.0545870000000017,1.0525629000000039,1.0537871000000074,1.0559930447203625,1.0558674116855307,1779,-510895,-514495.6,-0.042257477111553185,-543.7341053537797,0.12605559715283352
2023-09-28T16:00:00-04:00,1.05642,1.05658,1.05627,1.05657,1.056989756740349,1.0561195555555556,1.0560188888888815,1.0557855555555515,1.056254000000005,1.0546946000000017,1.052614300000004,1.0537867500000073,1.05610843577629,1.0559227293484241,988,-509907,-512729.8,-0.02950727583119956,-543.5938202399044,0.14122151874739275
2023-09-28T16:15:00-04:00,1.05657,1.05674,1.05647,1.0565499999999999,1.056909366470735,1.0562257777777777,1.0561077777777708,1.055872888888885,1.0562410000000049,1.0548084000000018,1.052667600000004,1.0537877000000073,1.056196748621032,1.0560049834787388,-711,-510618,-511669.8,-0.018564911595454373,-543.6072788843861,0.07577551503669543
2023-09-28T16:30:00-04:00,1.0565499999999999,1.05667,1.05641,1.05652,1.0568321918119055,1.0563082222222222,1.056132222222215,1.0559635555555515,1.056174000000005,1.0549054000000018,1.0527301000000042,1.0537882000000074,1.0562613988968255,1.0560891867829907,-738,-511356,-511090,-0.009967837830951674,-543.628233879417,0.020827416453648297
2023-09-28T16:45:00-04:00,1.05652,1.05666,1.05652,1.05654,1.0567581041394292,1.0563897777777775,1.0562022222222152,1.0560628888888852,1.056119500000005,1.0550038000000015,1.0527897000000042,1.0537878000000074,1.0563171191174603,1.0561753494263921,1433,-509923,-510539.8,-0.0017448135751734588,-543.6011070857925,0.0596641759240968
2023-09-28T17:00:00-04:00,1.05654,1.05654,1.05565,1.05641,1.056686979973852,1.0564313333333335,1.0563044444444374,1.0561531111111075,1.056112500000005,1.0550956000000016,1.052850800000004,1.0537843500000073,1.0563356952939682,1.0562438795411133,-182,-510105,-510381.8,0.008490089635429753,-543.6235009374213,0.08716330803702847
2023-09-28T17:15:00-04:00,1.05641,1.05661,1.05635,1.0565499999999999,1.05666,1.0564804444444442,1.056409999999993,1.0562313333333297,1.056075000000005,1.0551934000000016,1.052916900000004,1.0537839500000075,1.0563785562351746,1.0562979036328903,136,-509969,-510394.2,0.01852670117437112,-543.6054776320759,0.08999621068584542
2023-09-28T17:30:00-04:00,1.0565499999999999,1.05665,1.05654,1.05661,1.05498,1.0565204444444445,1.056471111111104,1.0563039999999964,1.056056000000005,1.0552864000000017,1.0529802000000041,1.0537813000000071,1.0564248449881397,1.0563435229063116,433,-509536,-510177.8,0.03120193740613898,-543.580888166362,0.05208037422116645
2023-09-28T17:45:00-04:00,1.05661,1.05663,1.05637,1.05649,1.0550134,1.0565242222222222,1.0565177777777706,1.0563811111111074,1.0560915000000048,1.0553636000000017,1.0530429000000041,1.0537787000000072,1.0564378759905118,1.056378818325049,-444,-509980,-509902.6,0.03752884102508302,-543.631313583498,0.039770090997743035
2023-09-28T18:00:00-04:00,1.05649,1.05668,1.05639,1.05665,1.055046132,1.0565506666666666,1.056543333333326,1.0564493333333296,1.056124500000005,1.0554260000000015,1.0531039000000042,1.0537749500000073,1.0564803007924095,1.056411454660039,400,-509580,-509834,0.03909645746717656,-543.5707356319792,0.021771643853786802
2023-09-28T18:15:00-04:00,1.05665,1.05668,1.0565499999999999,1.05664,1.05511148672,1.05657,1.0565511111111041,1.0564986666666631,1.056165000000005,1.0554798000000016,1.053165200000004,1.0537710000000073,1.0565122406339276,1.0564467637280308,-514,-510094,-509831.8,0.03824766796561736,-543.5756000620175,0.006625211770163311
2023-09-28T18:30:00-04:00,1.05664,1.05675,1.05659,1.05659,1.0551742272512,1.0565777777777778,1.0565555555555484,1.0565277777777742,1.0562400000000047,1.0555320000000017,1.053226000000004,1.0537679500000074,1.0565277925071421,1.0564766109824242,-258,-510352,-509908.4,0.03500919075821772,-543.5878085720116,0.0037859069613402118
2023-09-28T18:45:00-04:00,1.05659,1.05662,1.05647,1.05649,1.055268773616128,1.0565646666666666,1.0565522222222148,1.0565439999999962,1.0563105000000048,1.0555964000000018,1.053285800000004,1.0537643000000072,1.0565202340057136,1.056495688785939,-205,-510557,-510112.6,0.02812730909727997,-543.6072106106453,-0.0028395108469290212
2023-09-28T19:00:00-04:00,1.05649,1.0565,1.05627,1.0562799999999999,1.0553576471991601,1.056510222222222,1.0565233333333262,1.0565451111111073,1.056337000000005,1.0556544000000017,1.0533431000000042,1.0537605500000073,1.0564721872045708,1.056502551028751,-581,-511138,-510344.2,0.020444052944737112,-543.7226967960328,-0.024608628163642548
2023-09-28T19:15:00-04:00,1.0562799999999999,1.05646,1.0562,1.05622,1.0554411883672106,1.0564495555555555,1.056502222222215,1.056536888888885,1.0563330000000049,1.0556992000000016,1.0534016000000042,1.0537567500000073,1.0564217497636565,1.0564908408230003,-607,-511745,-510777.2,0.01529552413228862,-543.7571762901063,-0.017985441258614978
2023-09-28T19:30:00-04:00,1.05622,1.05637,1.0562,1.05627,1.055519717065178,1.0564031111111112,1.056471111111104,1.056520888888885,1.056351000000005,1.0557440000000016,1.0534595000000042,1.0537520000000073,1.0563913998109253,1.0564666726583998,634,-511111,-510980.6,0.014105440534950366,-543.7271636033553,-0.02650134872933945
2023-09-28T19:45:00-04:00,1.05627,1.05633,1.05619,1.05623,1.0555935340412672,1.056354888888889,1.056428888888882,1.0564955555555517,1.056388000000005,1.0557874000000016,1.0535184000000042,1.0537476000000074,1.0563591198487403,1.0564329381267192,-448,-511559,-511222,0.009633394565988131,-543.744128962591,-0.03596407378314108
2023-09-28T20:00:00-04:00,1.05623,1.05642,1.05605,1.05621,1.0556629219987912,1.056311111111111,1.0563977777777707,1.0564646666666628,1.0564185000000048,1.0558184000000017,1.0535765000000041,1.0537434000000074,1.0563292958789923,1.056394750501375,-1126,-512685,-511647.6,0.002600977192318036,-543.7654500763635,-0.0265028537894193
2023-09-28T20:15:00-04:00,1.05621,1.0562799999999999,1.05608,1.05621,1.0557281466788637,1.0562735555555556,1.0563488888888817,1.0564297777777742,1.0564260000000048,1.0558600000000018,1.0536362000000041,1.0537393000000075,1.0563054367031939,1.0563614004010995,0,-512685,-511957,-0.0027992416351519073,-543.7654500763635,-0.0416410353475603
2023-09-28T20:30:00-04:00,1.05621,1.05631,1.05599,1.056,1.055789457878132,1.056203777777778,1.0562777777777708,1.0563848888888852,1.0564225000000047,1.0559080000000016,1.053691100000004,1.0537337500000072,1.056244349362555,1.0563259203208792,-815,-513500,-512308,-0.008681729421876784,-543.9274917158103,-0.06056935190793212
2023-09-28T20:45:00-04:00,1.056,1.05647,1.05579,1.05641,1.05675,1.0562302222222222,1.0562577777777706,1.0563422222222187,1.0564220000000049,1.0559624000000019,1.0537499000000041,1.0537301500000074,1.056277479490044,1.056303136256703,2228,-511272,-512340.2,-0.012391333548837365,-543.0624538370224,-0.017035936361298798
2023-09-28T21:00:00-04:00,1.05641,1.05698,1.0562,1.05693,1.05579,1.0563646666666666,1.0563066666666598,1.0563177777777741,1.0564400000000047,1.0560338000000018,1.053809100000004,1.0537283000000073,1.0564079835920352,1.056312909005362,1050,-510222,-512072.8,-0.011471523801238072,-542.5456090513807,0.04164734166911149
2023-09-28T21:15:00-04:00,1.05693,1.05716,1.0568899999999999,1.05701,1.05579,1.0565053333333334,1.056387777777771,1.0563157777777743,1.0564630000000048,1.0561380000000016,1.053867500000004,1.0537280500000072,1.0565283868736282,1.0563527272042894,1328,-508894,-511314.6,-0.008532480896306502,-542.4450915147414,0.06911046313478618
2023-09-28T21:30:00-04:00,1.05701,1.05727,1.05691,1.0570599999999999,1.0558448,1.0566397777777778,1.0564811111111043,1.0563422222222187,1.0564900000000048,1.0562130000000016,1.053926000000004,1.0537295000000073,1.0566347094989026,1.056418581763431,1668,-507226,-510222.8,-0.0034480707027681676,-542.3661897068117,0.0795288860275276
2023-09-28T21:45:00-04:00,1.0570599999999999,1.05761,1.05703,1.05736,1.055930312,1.0568155555555554,1.0566022222222153,1.0564071111111075,1.0565310000000048,1.0562684000000018,1.053984500000004,1.0537318000000073,1.0567797675991222,1.0565256654107444,1595,-505631,-508649,0.0035561108319210805,-541.9135190920875,0.10319331231598317
2023-09-28T22:00:00-04:00,1.05736,1.05773,1.05735,1.05772,1.0560646870400001,1.0570391111111113,1.0567677777777709,1.0565091111111076,1.0565965000000046,1.0563460000000016,1.0540459000000042,1.0537350500000071,1.0569678140792977,1.056663732328595,1620,-504011,-507196.8,0.011961237298769922,-541.3619567103067,0.14106775986290782
2023-09-28T22:15:00-04:00,1.05772,1.05827,1.05771,1.05806,1.056231218336,1.0572975555555555,1.0569733333333267,1.0566424444444409,1.0566720000000047,1.0564084000000016,1.054113200000004,1.0537418000000072,1.0571862512634382,1.0568193858628756,1491,-502520,-505656.4,0.021843182444225222,-540.8826805313557,0.17515456206624697
2023-09-28T22:30:00-04:00,1.05806,1.05812,1.05778,1.05801,1.0564758721356802,1.057504888888889,1.0571733333333266,1.056799555555552,1.0567420000000047,1.0564524000000015,1.0541827000000041,1.0537519000000073,1.0573510010107505,1.0569839086903001,-1210,-503730,-504623.6,0.03229622219391347,-540.9398606534661,0.1704206549833652
2023-09-28T22:45:00-04:00,1.05801,1.05807,1.05778,1.05792,1.0566911674793986,1.0576542222222223,1.0573866666666598,1.056980666666663,1.0568135000000045,1.0564992000000015,1.0542515000000041,1.0537616000000072,1.0574648008086005,1.0571499269522397,-908,-504638,-504106,0.04257244254456692,-541.0170999990298,0.1818181818181744
2023-09-28T23:00:00-04:00,1.05792,1.05793,1.05769,1.05775,1.0568806273818707,1.0577268888888889,1.0575355555555488,1.0571673333333298,1.0568685000000047,1.0565390000000014,1.054322100000004,1.0537698500000072,1.0575218406468805,1.0572983415617911,-1059,-505697,-504119.2,0.053451335089569764,-541.1872735471242,0.12684469098171133
2023-09-28T23:15:00-04:00,1.05775,1.05781,1.05762,1.05771,1.0570473520960462,1.0577617777777777,1.0576222222222154,1.0573382222222185,1.0569220000000046,1.0565674000000016,1.0543957000000042,1.0537763500000072,1.0575594725175044,1.0574166732494326,-710,-506407,-504598.4,0.0609729723886934,-541.2141229916999,0.07379864324032841
2023-09-28T23:30:00-04:00,1.05771,1.05805,1.0577,1.05785,1.0571940698445206,1.0578073333333333,1.0577155555555489,1.057486666666663,1.0569850000000047,1.0566066000000014,1.0544730000000042,1.0537823500000072,1.0576175780140036,1.0575029385995456,1013,-505394,-505173.2,0.06422244438169958,-541.0800408708917,0.07946944683588159
2023-09-28T23:45:00-04:00,1.05785,1.0579,1.05754,1.05755,1.057323181463178,1.0577742222222222,1.0577699999999934,1.0576059999999965,1.0570380000000046,1.0566214000000014,1.0545490000000042,1.0537853500000072,1.0576040624112029,1.057553550879636,-746,-506140,-505655.2,0.06500354773698433,-541.2916020563149,0.04635498457988208
2023-09-29T00:00:00-04:00,1.05755,1.0577,1.05751,1.05769,1.0574367996875966,1.0577582222222222,1.05780666666666,1.0576899999999965,1.0571085000000044,1.0566180000000014,1.0546265000000041,1.0537919500000072,1.0576212499289623,1.0575848407037085,990,-505150,-505757.6,0.06555412652709067,-541.160544423106,0.031209805553448346
2023-09-29T00:15:00-04:00,1.05769,1.05797,1.05764,1.05791,1.05751,1.0577788888888888,1.0578277777777711,1.057748444444441,1.0571930000000045,1.0566236000000016,1.054703400000004,1.0538009500000072,1.05767899994317,1.0576162725629665,688,-504462,-505510.6,0.06340968140676301,-541.0174401108785,0.017963166055280456
2023-09-29T00:30:00-04:00,1.05791,1.05813,1.05785,1.05809,1.05751,1.0578313333333331,1.0578311111111045,1.0577902222222186,1.0572840000000043,1.0566544000000013,1.0547806000000042,1.0538101500000072,1.057761199954536,1.0576566180503728,845,-503617,-504952.6,0.058481349611379255,-540.8736660658274,0.002835377955879108
2023-09-29T00:45:00-04:00,1.05809,1.0581099999999999,1.05792,1.05801,1.0576012,1.057867111111111,1.0578311111111045,1.0578133333333297,1.0573730000000046,1.0566686000000012,1.0548566000000041,1.0538180000000072,1.0578109599636287,1.0576952944402978,-804,-504421,-504758,0.050167337050935464,-540.9344548456098,0
2023-09-29T01:00:00-04:00,1.05801,1.05832,1.0579,1.0581,1.0576814559999999,1.057920888888889,1.0578511111111044,1.0578295555555521,1.0574675000000044,1.0566908000000013,1.0549384000000042,1.0538263500000071,1.057868767970903,1.0577482355522378,1039,-503382,-504206.4,0.04259293618374723,-540.8460719380757,0.017014519056267864
2023-09-29T01:15:00-04:00,1.0581,1.05825,1.05792,1.05801,1.0577708521599998,1.0579526666666665,1.057879999999993,1.0578442222222186,1.0575575000000044,1.0567354000000013,1.0550184000000042,1.0538342000000072,1.0578970143767223,1.05780338844179,-1122,-504504,-504077.2,0.035335132136566465,-540.9415071521388,0.024580477428496995
2023-09-29T01:30:00-04:00,1.05801,1.05802,1.05771,1.0578,1.05832,1.0579366666666667,1.0578899999999931,1.0578566666666631,1.0576475000000045,1.0567716000000014,1.0550920000000041,1.0538416000000073,1.057877611501378,1.0578431107534314,-974,-505478,-504280.4,0.028646108888740515,-541.1348323570044,0.008508948577601188
2023-09-29T01:45:00-04:00,1.0578,1.05861,1.05755,1.05764,1.05755,1.0578866666666666,1.0578666666666596,1.0578637777777742,1.0577090000000045,1.0568078000000012,1.0551642000000043,1.0538488000000072,1.0578300892011023,1.0578568886027446,-2191,-507669,-505090.8,0.020598282171024208,-541.4662371594248,-0.01985158576358118
2023-09-29T02:00:00-04:00,1.05764,1.05891,1.05762,1.05881,1.05755,1.0580753333333333,1.0580066666666597,1.0578988888888852,1.0578030000000045,1.0568822000000013,1.0552455000000043,1.0538629500000072,1.0580260713608818,1.0578999108821951,3007,-504662,-505139,0.01886733843596129,-538.139783923919,0.11914330291712344
2023-09-29T02:15:00-04:00,1.05881,1.05896,1.05837,1.0585499999999999,1.05755,1.058184,1.0581022222222152,1.0579491111111072,1.0578800000000046,1.0569516000000012,1.0553237000000042,1.0538762000000075,1.0581308570887054,1.0579523287057557,-2327,-506989,-505860.4,0.021026702697234154,-538.711199003112,0.0813092683111177
2023-09-29T02:30:00-04:00,1.0585499999999999,1.05891,1.05801,1.05866,1.05762,1.0582955555555555,1.0581855555555486,1.0580102222222183,1.0579600000000045,1.0570098000000012,1.0554044000000042,1.0538903500000074,1.0582366856709642,1.0580202629646043,3198,-503791,-505717.8,0.022767108415377702,-538.3788764864618,0.07089449953209899
2023-09-29T02:45:00-04:00,1.05866,1.05919,1.05738,1.05901,1.05919,1.0584604444444443,1.0582877777777708,1.058089777777774,1.0580425000000044,1.0570640000000011,1.0554857000000042,1.0539053000000074,1.0583913485367713,1.0581230103716828,5713,-498078,-504237.8,0.024385402784670242,-536.4901208897637,0.08694912531070438
2023-09-29T03:00:00-04:00,1.05901,1.05981,1.0588,1.0594,1.05738,1.0586828888888888,1.0584422222222152,1.058204888888885,1.0581265000000044,1.0571338000000012,1.0555762000000042,1.0539235000000073,1.0585930788294171,1.058275608297346,5172,-492906,-501285.2,0.027582947986846868,-534.5854363258791,0.1313787204279735
2023-09-29T03:15:00-04:00,1.0594,1.06019,1.05921,1.05963,1.05738,1.0589204444444444,1.0586122222222152,1.058325999999996,1.0582050000000045,1.057216600000001,1.0556693000000041,1.0539420500000074,1.0588004630635337,1.0584304866378762,4315,-488591,-498071,0.03429459602507312,-533.6486324746418,0.14459880918628024
2023-09-29T03:30:00-04:00,1.05963,1.06107,1.0596,1.06061,1.0574923999999999,1.05932,1.058901111111104,1.058485777777774,1.0583350000000045,1.057316800000001,1.0557815000000041,1.0539638500000073,1.059162370450827,1.0586367893103006,4283,-484308,-493534.8,0.04653379054234991,-529.6874950965005,0.24574436914586423
2023-09-29T03:45:00-04:00,1.06061,1.06097,1.06035,1.06064,1.057707056,1.0596677777777777,1.0592166666666598,1.0586919999999964,1.0584710000000046,1.057408400000001,1.0558929000000041,1.0539869500000074,1.0594578963606616,1.05888103144824,3249,-481059,-488988.4,0.05954378706604895,-529.5955951521289,0.2684817545849833
2023-09-29T04:00:00-04:00,1.06064,1.06064,1.05992,1.06023,1.05790883264,1.0598704444444447,1.0595044444444375,1.0589353333333296,1.0585950000000044,1.057491600000001,1.055984800000004,1.0540057000000074,1.0596123170885292,1.0591252251585916,-4374,-485433,-486459.4,0.07210189994017044,-531.2864044748021,0.2448848379410851
2023-09-29T04:15:00-04:00,1.06023,1.06075,1.05993,1.0603799999999999,1.0580985026815999,1.0600455555555555,1.0596788888888817,1.0591826666666628,1.0587285000000044,1.057570800000001,1.0560789000000042,1.0540252000000074,1.0597658536708234,1.0593597801268728,3740,-481693,-484216.8,0.08614501076835923,-530.7572740031125,0.14827967246246723
2023-09-29T04:30:00-04:00,1.0603799999999999,1.06119,1.0601,1.06102,1.058276792520704,1.0603137777777778,1.0599533333333264,1.0594508888888852,1.0588870000000044,1.057659800000001,1.0561772000000043,1.0540494500000073,1.0600166829366588,1.059603024101498,3303,-478390,-482176.6,0.09211808636535379,-528.7637245208508,0.23333805677579655
2023-09-29T04:45:00-04:00,1.06102,1.06165,1.06052,1.06091,1.0585098491190477,1.060505111111111,1.0602033333333263,1.0597113333333297,1.0590550000000045,1.057747000000001,1.0562777000000043,1.0540694500000074,1.060195346349327,1.0598096192811979,-4483,-482873,-481889.6,0.1006311084533033,-529.2284942707144,0.21253282451401634
2023-09-29T05:00:00-04:00,1.06091,1.06101,1.06036,1.06101,1.0588238642071428,1.0606664444444445,1.0604255555555486,1.0599531111111073,1.0592210000000046,1.0578368000000011,1.0563711000000042,1.0540915000000075,1.0603582770794615,1.059989695424958,4058,-478815,-481440.8,0.107247019280312,-528.8459924562344,0.18885562931417094
2023-09-29T05:15:00-04:00,1.06101,1.06105,1.06049,1.06074,1.0591064777864285,1.0607293333333334,1.0605744444444376,1.0601671111111075,1.0593625000000044,1.057920800000001,1.0564623000000042,1.0541091000000076,1.0604346216635692,1.0601541563399661,-2896,-481711,-480696.4,0.10985310962049162,-529.5829506375899,0.1264866905795846
2023-09-29T05:30:00-04:00,1.06074,1.06142,1.06058,1.06142,1.0593608300077857,1.0608984444444443,1.0607733333333265,1.0603859999999965,1.0595290000000044,1.0580210000000012,1.056558300000004,1.0541322000000075,1.0606316973308554,1.0603273250719725,3449,-478262,-480010.2,0.11312586325407686,-527.371928143859,0.1689268895746589
2023-09-29T05:45:00-04:00,1.06142,1.06171,1.0612,1.06142,1.059589747007007,1.061027777777778,1.0608633333333264,1.0605679999999964,1.0596995000000045,1.0581184000000012,1.056655900000004,1.0541568000000074,1.0607893578646843,1.0604818600575774,0,-478262,-479984.6,0.11503685062043038,-527.371928143859,0.07637114490717392
2023-09-29T06:00:00-04:00,1.06142,1.06156,1.06092,1.06154,1.0598441773661662,1.0611631111111113,1.0609633333333264,1.0607199999999963,1.0598715000000043,1.0582170000000013,1.056751700000004,1.0541820000000073,1.0609394862917474,1.0606306880460616,2367,-475895,-478589,0.10793272503532184,-527.1043243677857,0.08485442751545301
2023-09-29T06:15:00-04:00,1.06154,1.06164,1.0607,1.06091,1.0600680760822263,1.0611524444444445,1.061038888888882,1.0608426666666628,1.0600165000000044,1.0583054000000012,1.0568345000000041,1.0542026000000075,1.060933589033398,1.060745750436849,-2437,-478332,-478492.4,0.09784197743430009,-528.5506287934312,0.0641370268715292
2023-09-29T06:30:00-04:00,1.06091,1.06122,1.06064,1.06106,1.0602651069523592,1.0611566666666665,1.0611144444444376,1.0609506666666628,1.0601795000000043,1.0583936000000014,1.0569098000000041,1.0542248500000075,1.0609588712267184,1.0608506003494789,2529,-475803,-477310.8,0.09195742044882323,-528.1930584057454,0.06412795412965296
2023-09-29T06:45:00-04:00,1.06106,1.06125,1.06075,1.0609,1.060438494118076,1.061113777777778,1.0611011111111042,1.0610162222222186,1.0603425000000044,1.0584788000000014,1.056979300000004,1.0542495000000074,1.0609470969813748,1.0609136802795827,-2290,-478093,-477277,0.08292577103742654,-528.5383734680415,-0.011309871632968276
2023-09-29T07:00:00-04:00,1.0609,1.06111,1.0601099999999999,1.06017,1.06171,1.0609275555555555,1.0610188888888819,1.0610473333333297,1.0604105000000046,1.0585504000000012,1.0570412000000042,1.0542723500000073,1.0607916775850998,1.0609141442236658,-2411,-480504,-477725.4,0.06353791391958048,-530.197370545994,-0.0697514398016762
2023-09-29T07:15:00-04:00,1.06017,1.06022,1.05944,1.05959,1.061678,1.060641777777778,1.0608611111111041,1.0610268888888852,1.0604625000000045,1.0586124000000015,1.0571044000000043,1.0542918500000074,1.0605513420680799,1.060836515378932,-2853,-483357,-479217.8,0.047584404386852554,-531.7581956966774,-0.13383474236811876
2023-09-29T07:30:00-04:00,1.05959,1.06008,1.05899,1.05978,1.06158848,1.0604255555555555,1.0607544444444374,1.0609699999999964,1.0605185000000046,1.0586824000000012,1.0571684000000041,1.0543137000000073,1.060397073654464,1.0607292123031455,3030,-480327,-479616.8,0.03045934196526818,-531.214872335755,-0.09050285649641494
2023-09-29T07:45:00-04:00,1.05978,1.05978,1.05912,1.05943,1.0614325712,1.0601606666666665,1.0605333333333264,1.060853777777774,1.0605395000000046,1.0587466000000014,1.0572229000000042,1.0543308500000075,1.060203658923571,1.060578169842516,-3224,-483551,-481166.4,0.014647639404282662,-532.2796216233426,-0.18748469032050802
2023-09-29T08:00:00-04:00,1.05943,1.05982,1.05906,1.05967,1.0612860169279998,1.0599880000000002,1.0603388888888818,1.0607013333333297,1.0605530000000045,1.0588146000000014,1.057279300000004,1.0543499500000075,1.0600969271388567,1.0604081358740125,3522,-480029,-481553.6,-0.004818041477153166,-531.4817586215404,-0.1648734713873999
2023-09-29T08:15:00-04:00,1.05967,1.06016,1.05953,1.06005,1.0611482559123198,1.0599302222222222,1.0601733333333263,1.0605322222222187,1.0605740000000046,1.0588910000000014,1.0573392000000041,1.0543712000000076,1.0600875417110853,1.0602673086992094,3364,-476665,-480785.8,-0.020654560998295688,-530.275420799388,-0.14036211541722324
2023-09-29T08:30:00-04:00,1.06005,1.06102,1.05881,1.06047,1.05881,1.0599895555555554,1.0601244444444373,1.0603848888888852,1.0605670000000047,1.0589762000000014,1.0573973000000043,1.0543957500000076,1.0601640333688682,1.0601898469593671,10608,-466057,-477325.8,-0.03451426570168023,-526.0724492414417,-0.04147382907126862
2023-09-29T08:45:00-04:00,1.06047,1.06048,1.05965,1.05998,1.05881,1.0599606666666668,1.0600044444444374,1.060234888888885,1.0605340000000045,1.0590516000000014,1.057455800000004,1.0544185500000076,1.0601272266950945,1.0601358775674934,-6906,-472963,-475853,-0.0404556173587755,-529.2634305987651,-0.10178500744538198
2023-09-29T09:00:00-04:00,1.05998,1.06063,1.05894,1.06062,1.05881,1.0600837777777778,1.059973333333326,1.0601228888888852,1.0605535000000046,1.0591440000000014,1.0575260000000042,1.0544472500000075,1.0602257813560756,1.0601403020539941,6456,-466507,-472444.2,-0.04451468930845032,-525.3653947867689,-0.02639268545575059
2023-09-29T09:15:00-04:00,1.06062,1.06074,1.05863,1.05865,1.06102,1.059819111111111,1.0598044444444374,1.060015999999996,1.0604670000000045,1.0591888000000014,1.0575756000000043,1.0544714000000075,1.0599106250848604,1.060103041643195,-4578,-471085,-470655.4,-0.058640162516404255,-533.8685910304746,-0.1433732325947693
2023-09-29T09:30:00-04:00,1.05865,1.05897,1.05821,1.05852,1.0609722000000001,1.059562222222222,1.0596855555555484,1.0599184444444405,1.0603420000000043,1.0592206000000015,1.0576272000000042,1.0544946500000076,1.0596325000678883,1.0600120333145555,-7528,-478613,-471045,-0.06585275819026781,-534.793013644182,-0.10098245547807419
2023-09-29T09:45:00-04:00,1.05852,1.05896,1.05747,1.05806,1.0608617120000001,1.0592371111111112,1.0594944444444374,1.0597924444444407,1.0601995000000044,1.0592416000000016,1.0576898000000043,1.0545152000000073,1.0593180000543108,1.0598428266516442,-6306,-484919,-474817.4,-0.06699783066599935,-537.5334058899585,-0.16229783539979467
2023-09-29T10:00:00-04:00,1.05806,1.05829,1.0571,1.05753,1.06065820928,1.0588442222222223,1.0592833333333262,1.0596482222222183,1.0600255000000047,1.0592510000000015,1.0577320000000041,1.0545340000000076,1.0589604000434487,1.059609461321315,-7515,-492434,-478711.6,-0.07304981870038633,-541.297795433084,-0.17934172149174676
2023-09-29T10:15:00-04:00,1.05753,1.05771,1.05698,1.05718,1.0603735525376001,1.0584235555555557,1.0590066666666595,1.059454888888885,1.0598475000000045,1.0592474000000016,1.0577579000000041,1.0545491000000076,1.058604320034759,1.0592851690570515,-5955,-498389,-485088,-0.07708347092600405,-543.2686615078057,-0.2349788141591138
2023-09-29T10:30:00-04:00,1.05718,1.05826,1.05718,1.05821,1.06003419728384,1.0582642222222223,1.058802222222215,1.0592544444444405,1.0596870000000045,1.0592572000000018,1.0578016000000041,1.0545673000000075,1.0585254560278072,1.0590081352456409,6367,-492022,-489275.4,-0.07950066411541305,-537.0653564887924,-0.17357671807932096
2023-09-29T10:45:00-04:00,1.05821,1.05928,1.05771,1.0587,1.059728777555456,1.0582437777777778,1.0586055555555485,1.0590384444444405,1.0595510000000046,1.0592700000000017,1.0578392000000043,1.0545875000000076,1.0585603648222457,1.0587937081965124,9812,-482210,-489994.8,-0.08002717904170441,-532.5219482805929,-0.1669071260856082
2023-09-29T11:00:00-04:00,1.0587,1.05903,1.05756,1.05841,1.0594538997999103,1.0582046666666665,1.058431111111104,1.0588257777777739,1.0593945000000047,1.0592780000000017,1.0578652000000042,1.0546059500000076,1.0585302918577966,1.0586361665572097,-6987,-489197,-490850.4,-0.08595276373351857,-534.4358332338369,-0.14811600218870632
2023-09-29T11:15:00-04:00,1.05841,1.05854,1.05772,1.05774,1.05928,1.0580664444444443,1.0581111111111043,1.0585913333333294,1.0592360000000047,1.0592744000000016,1.0578868000000041,1.0546295500000076,1.0583722334862373,1.0585185332457674,-5223,-494420,-491247.6,-0.09003116567143477,-537.7421228569516,-0.2715392883407812
2023-09-29T11:30:00-04:00,1.05774,1.05799,1.05727,1.05775,1.05905,1.0579942222222223,1.0580111111111041,1.0583922222222184,1.0590705000000047,1.0592744000000016,1.0579067000000042,1.0546555000000075,1.05824778678899,1.0584472265966136,5027,-489393,-489448.4,-0.10293371194814002,-537.6945969999354,-0.08501393283900466
2023-09-29T11:45:00-04:00,1.05775,1.05852,1.05772,1.05834,1.058843,1.05806,1.0579911111111042,1.058229999999996,1.0589425000000046,1.0592870000000016,1.0579272000000042,1.0546871000000075,1.058266229431192,1.0583953812772904,3991,-485402,-488124.4,-0.09364313897390647,-535.4684660616225,-0.017004874730741693
2023-09-29T12:00:00-04:00,1.05834,1.05856,1.05781,1.05782,1.0586567,1.0580257777777777,1.0579644444444376,1.058101777777774,1.0588250000000046,1.0592864000000017,1.0579465000000041,1.0547210000000076,1.0581769835449535,1.0583187050218321,-3255,-488657,-489413.8,-0.08641581675652338,-537.067763073925,-0.02268302364705385
2023-09-29T12:15:00-04:00,1.05782,1.05856,1.05765,1.05853,1.05698,1.0581388888888887,1.0580755555555486,1.058030666666663,1.0587720000000045,1.0593060000000016,1.0579637000000042,1.0547546500000076,1.0582475868359629,1.0582621640174652,3604,-485053,-488585,-0.07460749996719283,-534.6487882010733,0.09455996520192238
2023-09-29T12:30:00-04:00,1.05853,1.05867,1.058,1.05801,1.0570116,1.0581257777777777,1.058167777777771,1.0580419999999964,1.0586835000000048,1.0593124000000018,1.0579652000000042,1.0547875500000077,1.0582000694687703,1.058227731213972,-3158,-488211,-487343.2,-0.06297268305166893,-536.2001471611409,0.07851075502751531
2023-09-29T12:45:00-04:00,1.05801,1.0585,1.05745,1.05776,1.057077936,1.0580442222222224,1.0581177777777708,1.0580633333333296,1.0586000000000046,1.0593094000000016,1.057966500000004,1.0548220000000075,1.0581120555750163,1.058200584971177,-3498,-491709,-487806.4,-0.048413439890972645,-537.026698895056,-0.04252464066679217
2023-09-29T13:00:00-04:00,1.05776,1.05777,1.05641,1.05697,1.05867,1.0578146666666666,1.0579255555555485,1.0580502222222186,1.0584650000000047,1.0592870000000016,1.0579707000000043,1.0548485000000074,1.057883644460013,1.0581240679769413,-3744,-495453,-489816.6,-0.04906660092641481,-539.8229475715046,-0.16340795315009063
2023-09-29T13:15:00-04:00,1.05697,1.05708,1.05653,1.05708,1.0586248,1.0576455555555555,1.0577777777777708,1.0580128888888851,1.0583165000000045,1.0592684000000017,1.057968500000004,1.0548741000000075,1.0577229155680103,1.0580332543815527,2639,-492814,-490648,-0.05272563503345753,-539.5483040149229,-0.12566018839580628
2023-09-29T13:30:00-04:00,1.05708,1.05725,1.0569,1.05694,1.058580504,1.0574780000000001,1.057688888888882,1.0579355555555519,1.0581400000000045,1.0592452000000017,1.0579680000000042,1.0548973500000074,1.0575663324544082,1.0578970035052417,-2999,-495813,-492800,-0.05262951851798667,-539.9454924964002,-0.0756329532777348
2023-09-29T13:45:00-04:00,1.05694,1.05715,1.05648,1.05649,1.05853709392,1.057238222222222,1.0575488888888818,1.057811777777774,1.0579655000000046,1.0592148000000017,1.0579751000000042,1.0549254500000074,1.0573510659635266,1.0577272028041933,-2388,-498201,-494798,-0.04654064103734772,-540.9622011080529,-0.11912077523044566
2023-09-29T14:00:00-04:00,1.05649,1.05703,1.05645,1.05695,1.0584945520416,1.0571184444444444,1.0573944444444374,1.0576671111111073,1.0577820000000047,1.0591978000000015,1.0579847000000042,1.0549591500000073,1.0572708527708212,1.057558962243354,2402,-495799,-495616,-0.040470358196875236,-539.9163606363019,-0.1313377553527224
2023-09-29T14:15:00-04:00,1.05695,1.05697,1.05638,1.05656,1.058452861000768,1.0569515555555555,1.0572544444444374,1.057532888888885,1.0576775000000045,1.0591762000000016,1.057992000000004,1.0549895500000073,1.057128682216657,1.0574079697946828,-2529,-498328,-496191,-0.039028101673612134,-540.8495268220253,-0.11911289255261187
2023-09-29T14:30:00-04:00,1.05656,1.05713,1.0564,1.05702,1.0583699465607372,1.0569046666666666,1.0570866666666596,1.057394666666663,1.0576025000000047,1.0591404000000015,1.0580113000000042,1.0550212000000074,1.0571069457733255,1.0572847758357458,2092,-496236,-496875.4,-0.039256083927393104,-539.938721945823,-0.1426506570432487
2023-09-29T14:45:00-04:00,1.05702,1.05799,1.05678,1.05776,1.0582903486983077,1.0570393333333334,1.0570588888888819,1.0572686666666626,1.0575875000000046,1.0591246000000016,1.0580381000000043,1.0550585500000074,1.0572375566186605,1.057219020668596,2661,-493575,-496427.8,-0.043116082487643745,-538.0758054447161,-0.023629266264010875
2023-09-29T15:00:00-04:00,1.05776,1.05792,1.05714,1.05735,1.0582139347503754,1.0570975555555555,1.0570133333333263,1.0571615555555516,1.0575785000000046,1.0590984000000017,1.058054100000004,1.0550948000000073,1.0572600452949283,1.0572008165348765,-2611,-496186,-496024.8,-0.046161258222765345,-539.0878592187292,-0.03876115564967681
2023-09-29T15:15:00-04:00,1.05735,1.05746,1.05699,1.05722,1.0581405773603605,1.0571388888888889,1.057041111111104,1.0570908888888848,1.0575805000000045,1.0590626000000016,1.0580633000000044,1.0551337000000074,1.0572520362359428,1.057197053227901,-2434,-498620,-496589,-0.04987214521796151,-539.3871167966362,0.023652516154676433
2023-09-29T15:30:00-04:00,1.05722,1.05748,1.05709,1.0573,1.058070154265946,1.0571906666666666,1.0570655555555486,1.0570531111111072,1.0575350000000046,1.0590206000000015,1.0580772000000043,1.0551717500000073,1.0572616289887542,1.0572236425823205,2513,-496107,-496144.8,-0.047291830170620545,-539.1969577001381,0.020812048283941325
2023-09-29T15:45:00-04:00,1.0573,1.05754,1.05702,1.05723,1.0580025480953081,1.0572235555555556,1.0570977777777708,1.0570553333333295,1.0574615000000045,1.0589726000000015,1.0580946000000042,1.0552085000000073,1.0572553031910032,1.057253314065856,-2948,-499055,-496708.6,-0.04146266671387863,-539.3921340928365,0.02743769750410633
2023-09-29T16:00:00-04:00,1.05723,1.05732,1.05693,1.05698,1.0579376461714958,1.0572,1.0571522222222152,1.057073999999996,1.0573900000000045,1.0589000000000015,1.0581084000000045,1.0552472000000073,1.0572002425528026,1.0572458512526846,-1578,-500633,-498120.2,-0.03334202459559635,-539.7652790092689,0.04637999413152055
2023-09-29T16:15:00-04:00,1.05698,1.05741,1.05694,1.05738,1.057875340324636,1.0572455555555558,1.057199999999993,1.0571113333333293,1.0573720000000044,1.0588348000000014,1.0581216000000044,1.0552873500000073,1.0572361940422421,1.0572410810021473,779,-499854,-498853.8,-0.020288058912158805,-539.4704768370424,0.04068309759212171
2023-09-29T16:30:00-04:00,1.05738,1.05762,1.05724,1.05754,1.0578155267116505,1.0573135555555555,1.057308888888882,1.057164888888885,1.0573615000000043,1.0587810000000015,1.0581363000000044,1.0553210000000073,1.0572969552337936,1.0572500648017176,661,-499193,-498968.4,-0.01380771340457686,-539.3704560308989,0.09275384265919408
2023-09-29T16:45:00-04:00,1.05754,1.05763,1.05692,1.05739,1.0577581056431844,1.0573297777777775,1.0573499999999931,1.0572217777777737,1.0573140000000045,1.0587212000000015,1.0581460000000045,1.0553544500000074,1.0573155641870349,1.0572608518413737,-1084,-500277,-499802.4,-0.004336935286215599,-539.5242090804288,0.035004068040338066
2023-10-01T17:00:00-04:00,1.05661,1.05724,1.0565499999999999,1.05686,1.057702981417457,1.0572317777777778,1.0572499999999931,1.0572522222222183,1.0572660000000045,1.0586380000000015,1.0581489000000044,1.0553816000000074,1.0572244513496278,1.0572546814730985,-137,-500414,-500074.2,0.0008152000125144748,-539.5928781618463,-0.08508546362124896
2023-10-01T17:15:00-04:00,1.05686,1.057,1.05669,1.05675,1.0576500621607587,1.0571317777777778,1.0571833333333265,1.0572584444444406,1.0571770000000045,1.0585548000000016,1.0581509000000044,1.0554092500000072,1.0571295610797022,1.0572405451784785,-133,-500547,-500057,-0.003918553540042641,-539.6067210549447,-0.05674563767909717
2023-10-01T17:30:00-04:00,1.05675,1.05675,1.0563,1.05632,1.0575992596743284,1.056959111111111,1.0570833333333265,1.0572351111111074,1.0570925000000044,1.0584610000000017,1.0581489000000046,1.0554395000000074,1.0569676488637618,1.0571868361427825,-147,-500694,-500225,-0.003707230585909862,-539.6665365269107,-0.08512892302454766
2023-10-01T17:45:00-04:00,1.05632,1.05675,1.05621,1.05664,1.0575213040938687,1.0568704444444443,1.0570099999999931,1.0571753333333294,1.0570365000000046,1.0583790000000015,1.0581499000000045,1.0554698000000073,1.0569021190910095,1.0571078689142257,844,-499850,-500356.4,-0.003022728122272756,-539.4108564299703,-0.06242315331503669
2023-10-01T18:00:00-04:00,1.05664,1.05707,1.05615,1.05664,1.0574163997663593,1.0567964444444444,1.0569444444444376,1.0570942222222186,1.0570200000000045,1.0582834000000017,1.0581522000000045,1.0555015000000072,1.0568496952728077,1.0570146951313804,0,-499850,-500271,-0.004221220802036997,-539.4108564299703,-0.05580621056911632
2023-10-01T18:15:00-04:00,1.05664,1.05692,1.0562799999999999,1.05634,1.0572897597897233,1.0566755555555556,1.0568733333333264,1.0570188888888852,1.0569830000000047,1.0581818000000016,1.0581501000000046,1.0555335000000072,1.0567477562182461,1.056919356105104,-610,-500460,-500280.2,-0.009803241376684597,-539.5840469205821,-0.0605498684932519
2023-10-01T18:30:00-04:00,1.05634,1.05638,1.05583,1.0559,1.057175783810751,1.0564808888888888,1.056708888888882,1.0569239999999964,1.0569310000000045,1.0580690000000017,1.0581430000000045,1.0555616000000072,1.0565782049745969,1.056809084884083,-598,-501058,-500382.4,-0.014705643831228589,-539.833133388954,-0.13996860163800393
2023-10-01T18:45:00-04:00,1.0559,1.05612,1.05576,1.05591,1.057014289753461,1.0563211111111113,1.056527777777771,1.0568128888888852,1.0569020000000047,1.0579690000000017,1.0581372000000044,1.0555900500000073,1.0564445639796776,1.0567044679072661,714,-500344,-500312.4,-0.023974375668015444,-539.8263713849765,-0.1541312858142501
2023-10-01T19:00:00-04:00,1.05591,1.05604,1.05577,1.05591,1.0568386891879764,1.0561975555555556,1.0563633333333264,1.0566835555555518,1.0568500000000047,1.0578660000000015,1.0581298000000043,1.0556168500000074,1.0563376511837421,1.0565915743258127,0,-500344,-500411.2,-0.03678479946089253,-539.8263713849765,-0.13996727792017588
2023-10-01T19:15:00-04:00,1.05591,1.05615,1.05591,1.05609,1.0566876727016596,1.0561428888888889,1.056277777777771,1.0565502222222185,1.0568265000000046,1.0577698000000018,1.0581243000000042,1.0556447500000075,1.0562881209469936,1.0564792594606498,597,-499747,-500390.6,-0.045212271026499745,-539.7246013477574,-0.07285733209696058
2023-10-01T19:30:00-04:00,1.05609,1.05634,1.05582,1.05626,1.0565577985234273,1.0561393333333333,1.0562233333333264,1.0564202222222183,1.0567885000000046,1.0576916000000016,1.0581210000000043,1.0556735000000075,1.056282496757595,1.0563862075685198,773,-498974,-500093.4,-0.04953861141367673,-539.6001706647663,-0.04636858291933773
2023-10-01T19:45:00-04:00,1.05626,1.05647,1.0562,1.05641,1.05576,1.0561766666666668,1.0562333333333265,1.0563251111111074,1.0567210000000045,1.0576280000000018,1.0581202000000045,1.0557030000000074,1.056307997406076,1.0563321660548155,1446,-497528,-499387.4,-0.05000860663512635,-539.3948234964554,0.008520145410495448
2023-10-01T20:00:00-04:00,1.05641,1.05668,1.05619,1.05642,1.0557742,1.056214,1.0562088888888819,1.0562613333333295,1.0566745000000046,1.0575608000000019,1.0581216000000042,1.0557323500000073,1.0563303979248608,1.0563093328438522,1680,-495848,-498488.2,-0.04302676239366794,-539.3789205799743,-0.020820714718362828
2023-10-01T20:15:00-04:00,1.05642,1.05677,1.0562799999999999,1.05662,1.0558104320000001,1.0562962222222223,1.0562066666666599,1.0562299999999962,1.0566445000000044,1.0575046000000017,1.0581256000000043,1.0557636000000072,1.0563883183398886,1.0563194662750814,1219,-494629,-497345.2,-0.03992769751908749,-539.1481411551243,-0.0018927922471353557
2023-10-01T20:30:00-04:00,1.05662,1.05683,1.05632,1.05658,1.05586800608,1.0563708888888887,1.0562333333333265,1.0562211111111073,1.0566085000000045,1.0574428000000018,1.0581287000000044,1.0557941000000073,1.0564266546719108,1.0563471730200649,-1229,-495858,-496567.4,-0.03761243508726231,-539.1946668691935,0.0227199575894142
2023-10-01T20:45:00-04:00,1.05658,1.0566,1.0563,1.05641,1.0559449655936002,1.0564062222222221,1.0562899999999928,1.0562344444444405,1.0565675000000045,1.0573700000000017,1.0581305000000043,1.0558244500000074,1.0564233237375287,1.0563753384160517,-1404,-497262,-496225,-0.03294036842358761,-539.4205655233418,0.04830002841178241
2023-10-01T21:00:00-04:00,1.05641,1.05682,1.0564,1.05663,1.0560157683461122,1.0564742222222223,1.0563699999999931,1.0562617777777736,1.0565500000000045,1.0572932000000017,1.0581347000000043,1.0558556000000074,1.0564646589900228,1.0564066707328412,1300,-495962,-495911.8,-0.023327946031845917,-539.1498373022914,0.06818762962753018
2023-10-01T21:15:00-04:00,1.05663,1.05686,1.05646,1.05676,1.0560809068784232,1.0565522222222223,1.0564644444444375,1.0563128888888849,1.0565190000000046,1.0572288000000019,1.0581402000000044,1.0558882000000074,1.0565237271920183,1.0564453365862725,1099,-494863,-495714.8,-0.014291663511565045,-539.0146244084686,0.08049928497694098
2023-10-01T21:30:00-04:00,1.05676,1.05703,1.05665,1.05692,1.0561588161905808,1.0566433333333334,1.0565566666666597,1.0563828888888849,1.0564880000000045,1.057154800000002,1.0581494000000042,1.0559202500000076,1.0566029817536147,1.0564882692690178,1028,-493835,-495556,-0.0026591788994390344,-538.8589788503474,0.07859178668485721
2023-10-01T21:45:00-04:00,1.05692,1.05698,1.05677,1.05678,1.0562633582477112,1.056688,1.0566144444444374,1.056459111111107,1.0564575000000045,1.0571174000000019,1.0581531000000044,1.0559515000000075,1.0566383854028918,1.0565306154152139,-927,-494762,-495336.8,0.007297217141779544,-538.9817696008299,0.04923030314506617
2023-10-01T22:00:00-04:00,1.05678,1.05704,1.05677,1.05682,1.0563553552579859,1.0567291111111112,1.056659999999993,1.0565331111111071,1.0564555000000044,1.0570834000000018,1.0581520000000042,1.0559805500000075,1.0566747083223134,1.056580892332171,892,-493870,-494658.4,0.015167243082194248,-538.9480066605774,0.03881068903172267
2023-10-01T22:15:00-04:00,1.05682,1.05694,1.05677,1.05683,1.0564512055218678,1.056763111111111,1.0567055555555487,1.0566002222222184,1.0564595000000045,1.0570588000000019,1.0581502000000043,1.0560088500000075,1.0567057666578508,1.0566291138657364,551,-493319,-494129.8,0.019277975150199963,-538.9427929061065,0.03881032165237514
2023-10-01T22:30:00-04:00,1.05683,1.05709,1.05681,1.05695,1.0565336367488063,1.0568119999999999,1.0567422222222154,1.0566557777777739,1.0564910000000043,1.0570472000000017,1.0581491000000043,1.0560375500000074,1.0567546133262806,1.056675291092589,786,-492533,-493663.8,0.02339298318699267,-538.8535448718909,0.031231663228044475
2023-10-01T22:45:00-04:00,1.05695,1.05697,1.05677,1.05679,1.0566226548689972,1.0568215555555558,1.0567655555555489,1.0566975555555518,1.0564985000000044,1.0570394000000016,1.0581434000000043,1.0560639500000073,1.0567616906610244,1.0567070328740709,-672,-493205,-493537.8,0.022883171426577465,-538.9552715382423,0.019875447197545044
2023-10-01T23:00:00-04:00,1.05679,1.0568899999999999,1.05677,1.05687,1.0566974300899576,1.0568424444444446,1.0568166666666599,1.0567379999999962,1.0565100000000045,1.0570126000000017,1.0581349000000042,1.0560904000000075,1.0567833525288195,1.0567360262992564,526,-492679,-493121.2,0.024591154035667973,-538.9154528420017,0.04354369988923854
2023-10-01T23:15:00-04:00,1.05687,1.05693,1.05679,1.05682,1.0567602412755643,1.0568431111111112,1.0568377777777709,1.056773555555552,1.0565340000000045,1.0569750000000016,1.0581225000000043,1.0561178500000075,1.0567906820230557,1.056759221039405,-424,-493103,-492967.8,0.027660316707891056,-538.9355120735061,0.01798169652575968
2023-10-01T23:30:00-04:00,1.05682,1.05703,1.05678,1.0569,1.05709,1.0568555555555557,1.0568533333333265,1.0568031111111074,1.0565840000000044,1.0569448000000015,1.0581114000000043,1.0561470500000076,1.0568125456184445,1.0567805768315237,759,-492344,-492772.8,0.027691167761601063,-538.8780566884832,0.013248041182485048
2023-10-01T23:45:00-04:00,1.0569,1.05696,1.05678,1.05696,1.0570838,1.0568768888888889,1.056857777777771,1.0568262222222184,1.0566365000000044,1.0569292000000017,1.0581018000000042,1.0561766500000076,1.0568420364947555,1.0567980614652188,698,-491646,-492595.4,0.02480548605072346,-538.8384313691531,0.003784581614485293
2023-10-02T00:00:00-04:00,1.05696,1.05712,1.0568899999999999,1.05708,1.05678,1.0569213333333332,1.0568911111111043,1.0568513333333294,1.0566950000000044,1.0569158000000016,1.0580951000000043,1.0562086000000075,1.0568896291958043,1.0568236491721748,904,-490742,-492102.8,0.021045696200399693,-538.735797400034,0.0283881224095807
2023-10-02T00:15:00-04:00,1.05708,1.05708,1.05691,1.05702,1.05678,1.056947111111111,1.0569133333333265,1.0568706666666627,1.0567415000000044,1.0568894000000015,1.0580882000000043,1.0562419500000075,1.0569157033566434,1.0568501193377395,-599,-491341,-491835.2,0.018313796814407892,-538.7697967189124,0.018924698624172325
2023-10-02T00:30:00-04:00,1.05702,1.05702,1.0568,1.05692,1.0567868,1.0569484444444444,1.0569233333333266,1.0568877777777739,1.0567745000000044,1.0568714000000015,1.0580789000000044,1.0562759500000076,1.0569165626853148,1.0568752954701912,-853,-492194,-491653.4,0.015519280814010054,-538.8504952865837,0.008516033799205692
2023-10-02T00:45:00-04:00,1.05692,1.05703,1.05681,1.05687,1.056793464,1.056937777777778,1.0569144444444376,1.0568999999999962,1.0567975000000045,1.0568382000000014,1.0580721000000042,1.0563105500000076,1.0569072501482517,1.0568942363761527,-739,-492933,-491771.2,0.01314866918184829,-538.8854553592478,-0.00756894838924074
2023-10-02T01:00:00-04:00,1.05687,1.05694,1.05667,1.05677,1.05712,1.056908888888889,1.0569122222222154,1.0569108888888852,1.0568150000000045,1.0568134000000016,1.0580629000000044,1.0563447000000077,1.0568798001186013,1.0569017891009218,-702,-493635,-492169,0.009823041069511044,-538.9518779088518,-0.0018925235855665726
2023-10-02T01:15:00-04:00,1.05677,1.05683,1.05661,1.05673,1.0571110000000001,1.0568724444444444,1.0568966666666597,1.0569119999999963,1.0568205000000046,1.0567928000000013,1.0580511000000044,1.0563772500000075,1.056849840094881,1.0568938312807372,-916,-494551,-492930.8,0.007858323086314033,-538.9865495971094,-0.013246662314194649
2023-10-02T01:30:00-04:00,1.05673,1.05679,1.05624,1.05626,1.05709096,1.0567451111111112,1.0568344444444375,1.0568962222222185,1.0568045000000046,1.0567786000000015,1.0580328000000043,1.0564067000000077,1.0567318720759047,1.0568570650245896,-1434,-495985,-493859.6,0.0037084316580313584,-539.62434733163,-0.052989156147699314
2023-10-02T01:45:00-04:00,1.05626,1.05627,1.056,1.05616,1.0570399024000001,1.0566102222222222,1.0567522222222152,1.0568619999999962,1.0567920000000046,1.0567602000000014,1.0580143000000044,1.0564354500000075,1.0566174976607237,1.0567972520196713,-1206,-497191,-494859,-0.0006443690926218456,-539.7385237654626,-0.07001608477622887
2023-10-02T02:00:00-04:00,1.05616,1.0566,1.05608,1.05632,1.0569567102080002,1.0565237777777778,1.0566811111111043,1.0568153333333294,1.0567765000000047,1.0567478000000015,1.0579965000000044,1.0564674500000075,1.0565579981285789,1.0567274016157366,2136,-495055,-495283.4,-0.005727247820653033,-539.4149364302104,-0.06055101422948588
2023-10-02T02:15:00-04:00,1.05632,1.05686,1.05619,1.05685,1.0568801733913602,1.0565575555555555,1.0566555555555486,1.056763999999996,1.0567810000000044,1.0567550000000012,1.0579849000000043,1.0565016500000075,1.0566163985028632,1.056674721292589,2248,-492807,-495117.8,-0.007759420125089139,-538.2870206471141,-0.021758050478672613
2023-10-02T02:30:00-04:00,1.05685,1.05754,1.05681,1.05739,1.056,1.0567044444444444,1.0566966666666597,1.056723999999996,1.0568045000000046,1.0567638000000015,1.0579808000000044,1.0565364000000075,1.0567711188022906,1.056658977034071,2065,-490742,-494356,-0.0076645754675127315,-537.2319040269693,0.035004068040338066
2023-10-02T02:45:00-04:00,1.05739,1.05896,1.05715,1.05894,1.0560308,1.0571531111111112,1.0569211111111043,1.0567413333333293,1.0569125000000046,1.0568114000000015,1.0579938000000044,1.0565790000000075,1.0572048950418325,1.0567535816272566,5277,-485465,-492252,0.0014012145964065346,-529.4964894684813,0.19112137153236863
2023-10-02T03:00:00-04:00,1.05894,1.05918,1.05822,1.05825,1.056147968,1.057418888888889,1.0570744444444375,1.056805777777774,1.0569840000000048,1.0568360000000012,1.0579882000000043,1.0566168500000075,1.057413916033466,1.0569128653018052,-5276,-490741,-490962,0.007361520960712467,-532.9343046421459,0.13057424281131425
2023-10-02T03:15:00-04:00,1.05825,1.05856,1.05786,1.05835,1.0563298899200002,1.057674,1.0572499999999931,1.0569195555555515,1.0570600000000048,1.0568478000000012,1.0579862000000042,1.0566549500000075,1.0576011328267727,1.0571214922414438,3054,-487687,-489488.4,0.014469752496210827,-532.6457149894173,0.1495121928139439
2023-10-02T03:30:00-04:00,1.05835,1.0588,1.05755,1.05755,1.0565008965248002,1.057734,1.0573411111111042,1.0570566666666628,1.0570900000000045,1.0568518000000013,1.0579751000000044,1.0566897500000074,1.0575909062614182,1.0573163937931547,-3077,-490764,-489079.8,0.018604651162933566,-534.9715996211552,0.07759787268271394
2023-10-02T03:45:00-04:00,1.05755,1.0578,1.05712,1.05724,1.0566616427333122,1.0577137777777776,1.0574499999999931,1.0572073333333294,1.0571125000000046,1.0568522000000014,1.0579574000000043,1.0567215500000073,1.0575207250091345,1.0574663150345236,-3402,-494166,-489764.6,0.02212257827379458,-535.9688290665716,0.0927801866964555
2023-10-02T04:00:00-04:00,1.05724,1.05781,1.05708,1.05718,1.0568127441693134,1.0576597777777779,1.0575633333333263,1.0573357777777737,1.0571280000000045,1.0568498000000013,1.0579352000000042,1.0567557000000074,1.0574525800073076,1.0575158520276187,-4046,-498212,-492314,0.02906831391632731,-536.1984458044928,0.0965762763217714
2023-10-02T04:15:00-04:00,1.05718,1.05718,1.05615,1.05671,1.05918,1.057489111111111,1.0576066666666597,1.0574422222222182,1.0571225000000046,1.0568394000000014,1.0579060000000045,1.0567876500000073,1.057304064005846,1.0574938816220945,-3398,-501610,-494487.8,0.03499214163363613,-537.7091251590019,0.036920630112097896
2023-10-02T04:30:00-04:00,1.05671,1.05681,1.05625,1.05645,1.0591194,1.0572577777777779,1.0575622222222152,1.0575046666666625,1.0571000000000046,1.0568288000000015,1.0578644000000041,1.0568229500000073,1.0571332512046767,1.0574003052976753,-2819,-504429,-497836.2,0.03788926478354892,-538.4027307840082,-0.037848322846210716
2023-10-02T04:45:00-04:00,1.05645,1.05653,1.056,1.05622,1.059060012,1.0569893333333333,1.0574322222222152,1.0575228888888848,1.0570630000000047,1.0568056000000015,1.0578202000000043,1.0568565500000076,1.0569506009637413,1.0572722442381401,-2171,-506600,-501003.4,0.03499379680007359,-538.8753797498844,-0.11064980754500377
2023-10-02T05:00:00-04:00,1.05622,1.0562799999999999,1.05526,1.05588,1.05893761152,1.056678888888889,1.0570922222222154,1.057451333333329,1.0570030000000048,1.0567724000000014,1.0577767000000042,1.0568807500000075,1.056736480770993,1.0571153953905117,-3186,-509786,-504127.4,0.025575366916789525,-539.9009615415566,-0.2889682134965213
2023-10-02T05:15:00-04:00,1.05588,1.05593,1.05474,1.05481,1.0587169548288,1.0562224444444446,1.056709999999993,1.0572806666666623,1.056892500000005,1.0567208000000015,1.0577210000000044,1.0568999500000076,1.0563511846167943,1.0568951163124092,-2745,-512531,-506991.2,-0.003271026142381483,-542.6826696902097,-0.3250649657453237
2023-10-02T05:30:00-04:00,1.05481,1.0549,1.05402,1.05435,1.058398798442496,1.0557504444444443,1.0562655555555485,1.0570124444444402,1.0567640000000047,1.0566706000000012,1.0576543000000043,1.0569157500000075,1.0559509476934354,1.0566244930499271,-3146,-515677,-509804.6,-0.028145023927177583,-544.0546324133545,-0.37794680398733915
2023-10-02T05:45:00-04:00,1.05435,1.05454,1.05347,1.0539,1.0579609185982464,1.0552773333333334,1.055859999999993,1.0566719999999958,1.0566155000000046,1.0566136000000013,1.0575842000000044,1.0569309500000075,1.0555407581547485,1.0563059944399416,-3690,-519367,-512792.2,-0.05665373844354426,-545.6295363826241,-0.34513734575196736
2023-10-02T06:00:00-04:00,1.0539,1.05412,1.05359,1.05382,1.0574220083664567,1.0548693333333334,1.055479999999993,1.0562815555555514,1.0564680000000046,1.0565636000000014,1.0575123000000044,1.0569417000000074,1.0551966065237988,1.055955195551953,-3437,-522804,-516033,-0.07822004107959483,-545.8904340009942,-0.323483787976238
2023-10-02T06:15:00-04:00,1.05382,1.05407,1.05355,1.05361,1.0569477673624819,1.0544953333333333,1.0550833333333263,1.0558797777777733,1.0563120000000048,1.0565030000000013,1.0574410000000043,1.0569516500000073,1.054879285219039,1.0555837564415622,-2153,-524957,-519067.2,-0.09835022091258883,-546.3194731158336,-0.33769083788948645
2023-10-02T06:30:00-04:00,1.05361,1.05404,1.05338,1.05387,1.056530435278984,1.0542526666666667,1.0547677777777706,1.055491333333329,1.0561925000000048,1.0564476000000014,1.0573655000000044,1.0569619000000074,1.0546774281752311,1.0552490051532497,2163,-522794,-521119.8,-0.116807355779454,-545.7857082502759,-0.268758694438394
2023-10-02T06:45:00-04:00,1.05387,1.05438,1.05375,1.05395,1.0560893743399262,1.054089111111111,1.0544899999999928,1.0551362222222178,1.0560820000000049,1.0563998000000014,1.0572908000000043,1.0569733500000076,1.054531942540185,1.0549652041225994,2486,-520308,-522046,-0.1325379433486485,-545.5969942722713,-0.2366415826588998
2023-10-02T07:00:00-04:00,1.05395,1.05402,1.05314,1.05344,1.0557100619323365,1.0538791111111112,1.0541811111111037,1.0548004444444399,1.055938000000005,1.0563506000000014,1.0572098000000043,1.0569807500000075,1.054313554032148,1.0547197632980796,-1981,-522289,-522630.4,-0.14879314978786534,-546.5555881334602,-0.2632027418530235
2023-10-02T07:15:00-04:00,1.05344,1.05377,1.05315,1.05355,1.0552988520231628,1.0537528888888887,1.0539222222222149,1.0544888888888841,1.0557730000000052,1.0563034000000016,1.0571362000000042,1.0569853500000075,1.0541608432257183,1.0545126106384637,2944,-519345,-521938.6,-0.16160697735135934,-546.2481762258052,-0.2206690154184134
2023-10-02T07:30:00-04:00,1.05355,1.05425,1.05348,1.0537,1.0549534356994568,1.0537084444444444,1.0537988888888816,1.0542319999999952,1.055588500000005,1.0562592000000015,1.0570626000000043,1.0569862000000074,1.0540686745805747,1.0543504885107706,3372,-515973,-520141.8,-0.16807132069944136,-545.7680851053075,-0.10523222191673802
2023-10-02T07:45:00-04:00,1.0537,1.05378,1.05301,1.05313,1.0546632859875438,1.0535746666666665,1.053663333333326,1.0540111111111063,1.055298000000005,1.0562000000000014,1.0569849000000042,1.0569821000000075,1.0538809396644597,1.0541911908086166,-2942,-518915,-519366,-0.16480110444879312,-547.359562755493,-0.11571110162659448
2023-10-02T08:00:00-04:00,1.05313,1.05342,1.05273,1.05317,1.054365694509786,1.053476,1.0535822222222149,1.0538295555555508,1.055044000000005,1.0561382000000012,1.0569149000000042,1.0569780500000074,1.0537387517315677,1.054032552646893,3228,-515687,-518441.8,-0.1499878379700528,-547.2369568094084,-0.0692665338267501
2023-10-02T08:15:00-04:00,1.05317,1.05374,1.05285,1.05347,1.0540385556078287,1.0534535555555555,1.053543333333326,1.0537019999999953,1.054800000000005,1.0560794000000013,1.0568537000000042,1.0569790500000074,1.0536850013852541,1.0539068421175144,4653,-511034,-516190.8,-0.13252024997335368,-545.9115297653416,-0.03321250308402502
2023-10-02T08:30:00-04:00,1.05347,1.05356,1.05303,1.05331,1.053776844486263,1.0534068888888888,1.0535099999999926,1.0536195555555508,1.054588000000005,1.0560172000000012,1.0567890000000042,1.0569787000000075,1.0536100011082032,1.0537966736940114,-3629,-514663,-515254.4,-0.11463111040466631,-546.4626987592377,-0.028473533850283023
2023-10-02T08:45:00-04:00,1.05331,1.05337,1.05248,1.05293,1.05374,1.0532908888888888,1.0534055555555482,1.0535408888888842,1.0543725000000048,1.0559434000000012,1.0567240000000042,1.0569734500000074,1.0534740008865626,1.053677738955209,-4146,-518809,-515821.6,-0.10024073491195076,-547.9584407535226,-0.08919506200956122
2023-10-02T09:00:00-04:00,1.05293,1.05325,1.05241,1.05315,1.05356,1.0532397777777778,1.0533166666666594,1.0534715555555507,1.054171000000005,1.0558748000000011,1.0566588000000043,1.0569690500000073,1.0534092007092501,1.053583391164167,3950,-514859,-515010.4,-0.08861548467509146,-547.1331247306147,-0.07590492907632354
2023-10-02T09:15:00-04:00,1.05315,1.05318,1.0522799999999999,1.0523,1.05337,1.0530364444444444,1.0531899999999925,1.0533931111111063,1.053950500000005,1.055792600000001,1.0565813000000042,1.0569602500000073,1.0531873605674,1.0534731129313335,-3489,-518348,-515542.6,-0.08224263769135147,-549.9491053601547,-0.10821688942891089
2023-10-02T09:30:00-04:00,1.0523,1.05268,1.0521099999999999,1.05247,1.05325,1.0528924444444443,1.0530699999999926,1.0532984444444398,1.053751500000005,1.0557094000000011,1.0565013000000043,1.0569493000000072,1.05304388845392,1.0533448903450666,6210,-512138,-515763.4,-0.07230424716273165,-548.9458743423841,-0.10251055953680129
2023-10-02T09:45:00-04:00,1.05247,1.05247,1.05149,1.05155,1.05318,1.0525884444444444,1.0528311111111037,1.0531626666666623,1.053518000000005,1.0556052000000011,1.0564170000000044,1.0569364000000072,1.052745110763136,1.0531719122760532,-6079,-518217,-516474.2,-0.06915664327688807,-554.2597360201518,-0.20404289646010212
2023-10-02T10:00:00-04:00,1.05155,1.05274,1.04977,1.04986,1.052842,1.0519942222222223,1.0524677777777702,1.0529751111111065,1.053217000000005,1.055464000000001,1.0563094000000044,1.0569177000000072,1.052168088610509,1.0529107298208424,-12579,-530796,-518871.6,-0.07687988636629124,-574.4760928267702,-0.3105029768404551
2023-10-02T10:15:00-04:00,1.04986,1.05162,1.04986,1.05112,1.05274,1.0517246666666669,1.0522399999999925,1.0527597777777733,1.0530325000000051,1.0553508000000011,1.0562341000000044,1.0569048500000071,1.051958470888407,1.0526205838566738,8556,-522240,-520347.8,-0.07445922445193344,-564.2075236842176,-0.19465043630182072
2023-10-02T10:30:00-04:00,1.05112,1.05128,1.0492299999999999,1.0497,1.05274,1.0512166666666667,1.0518211111111038,1.0524859999999954,1.052800000000005,1.0552084000000008,1.0561459000000044,1.0568865500000073,1.0515067767107258,1.052284467085339,-7712,-529952,-522668.6,-0.08432250054828966,-574.6259725768272,-0.3578649605588986
2023-10-02T10:45:00-04:00,1.0497,1.0498,1.04921,1.04953,1.052038,1.0507584444444444,1.0514011111111037,1.0521522222222175,1.0525815000000052,1.055062400000001,1.0560606000000046,1.0568752000000072,1.0511114213685806,1.0518979736682712,-6736,-536688,-527578.6,-0.09996593612539156,-575.7168747393498,-0.3588687091169641
2023-10-02T11:00:00-04:00,1.04953,1.05063,1.04953,1.05047,1.0514724,1.0505722222222222,1.0511277777777701,1.051811555555551,1.052414000000005,1.054932800000001,1.0559900000000044,1.0568610000000072,1.0509831370948646,1.0515455789346169,5723,-530965,-530128.2,-0.11144642364288648,-570.5911327405506,-0.23363376482766252
2023-10-02T11:15:00-04:00,1.05047,1.05126,1.05046,1.05095,1.04921,1.050536666666667,1.0508833333333256,1.051494666666662,1.0522810000000051,1.054816000000001,1.0559277000000045,1.0568428000000072,1.0509765096758916,1.0513072631476934,4959,-526006,-529170.2,-0.11728915441837837,-568.3251755975573,-0.20889711816929968
2023-10-02T11:30:00-04:00,1.05095,1.05124,1.05022,1.0506199999999999,1.049251,1.050484,1.050696666666659,1.0511859999999955,1.052118500000005,1.054691000000001,1.0558518000000043,1.0568267000000071,1.0509052077407133,1.0510966105181545,-4677,-530683,-530858.8,-0.1278181265227759,-569.7937611629989,-0.15965028984131197
2023-10-02T11:45:00-04:00,1.0506199999999999,1.05066,1.04977,1.04988,1.04929118,1.0503206666666667,1.0504088888888814,1.050903555555551,1.051915000000005,1.054552200000001,1.0557636000000044,1.0568014000000072,1.0507001661925706,1.0509352884145238,-3660,-534343,-531737,-0.13278412112833676,-572.3716675420892,-0.24608777447339042
2023-10-02T12:00:00-04:00,1.04988,1.04994,1.04909,1.04956,1.05126,1.0501508888888889,1.0501877777777702,1.0506608888888844,1.0517210000000052,1.054405400000001,1.0556751000000044,1.0567701500000073,1.0504721329540565,1.0508074307316186,-3263,-537606,-531920.6,-0.14060212261384183,-573.366219300385,-0.1892444486710034
2023-10-02T12:15:00-04:00,1.04956,1.04986,1.04938,1.04957,1.0512166,1.0500273333333332,1.050155555555548,1.0504664444444398,1.0515220000000052,1.054257600000001,1.0555934000000045,1.0567401000000074,1.050291706363245,1.0506691445852947,3078,-534528,-532633.2,-0.14193087390445003,-573.3368927254397,-0.027622730649812688
2023-10-02T12:30:00-04:00,1.04957,1.04957,1.04899,1.04929,1.0511740680000001,1.0498542222222222,1.0499522222222146,1.0502802222222176,1.0513015000000052,1.0541018000000009,1.0555088000000046,1.0567077500000073,1.050091365090596,1.0504921156682356,-3054,-537582,-534948.4,-0.12808580539694195,-574.1516263782685,-0.17410000761092911
2023-10-02T12:45:00-04:00,1.04929,1.04937,1.04882,1.04892,1.0510867052800001,1.0496477777777777,1.049865555555548,1.0501139999999953,1.0510910000000053,1.053939800000001,1.0554146000000046,1.0566709000000074,1.0498570920724768,1.0502824925345884,-3390,-540972,-537006.2,-0.1273887370072404,-575.3470061112307,-0.07430694484138352
2023-10-02T13:00:00-04:00,1.04892,1.04979,1.0489,1.04966,1.0509507029632001,1.0496066666666666,1.0498799999999926,1.0500082222222176,1.0509155000000052,1.053794600000001,1.0553330000000047,1.0566397500000073,1.0498176736579814,1.0501059940276707,2782,-538190,-537775.6,-0.11206770003631908,-573.3843397496398,0.012386496812855608
2023-10-02T13:15:00-04:00,1.04966,1.05042,1.04966,1.05035,1.0508228607854082,1.0497006666666666,1.0498666666666592,1.0499439999999953,1.0507595000000052,1.053664200000001,1.0552512000000047,1.0566074500000073,1.0499241389263851,1.0499963952221363,2685,-535505,-537355.4,-0.09150079796407869,-571.6193396543713,-0.01142345807116053
2023-10-02T13:30:00-04:00,1.05035,1.05051,1.04977,1.04992,1.0507026891382838,1.0497113333333332,1.0497522222222146,1.0498633333333287,1.0505900000000052,1.053527200000001,1.0551703000000048,1.0565677500000072,1.0499233111411082,1.049922716177709,-2400,-537905,-538030.8,-0.08066127927744941,-572.6018692873506,-0.09800656548837589
2023-10-02T13:45:00-04:00,1.04992,1.05013,1.04956,1.04959,1.0505897277899867,1.049678888888889,1.0496377777777703,1.0498004444444398,1.0504230000000052,1.053384400000001,1.0550886000000046,1.0565275500000073,1.0498566489128864,1.0498757729421668,-1861,-539766,-538467.6,-0.07675853606676138,-573.1867995677528,-0.09803734937464206
2023-10-02T14:00:00-04:00,1.04959,1.05021,1.0493999999999999,1.05021,1.05051,1.0497933333333334,1.049674444444437,1.0497622222222176,1.0502760000000053,1.0532634000000012,1.0550210000000046,1.0564958500000075,1.0499273191303091,1.0498898183537333,2296,-537470,-537767.2,-0.06834047564956928,-571.8305366460404,0.031432163675864246
2023-10-02T14:15:00-04:00,1.05021,1.05021,1.04921,1.04927,1.0504086000000001,1.0497124444444443,1.0496422222222148,1.049714666666662,1.0501245000000052,1.053125600000001,1.0549429000000046,1.0564557000000072,1.0497958553042472,1.0498854546829866,-2189,-539659,-538061,-0.056568210352378176,-573.7898209796502,-0.027630626167167525
2023-10-02T14:30:00-04:00,1.04927,1.04953,1.04907,1.04915,1.0503132840000002,1.049614,1.0495955555555483,1.0496604444444397,1.0499585000000051,1.0529822000000013,1.0548650000000046,1.0564165000000072,1.0496666842433977,1.0498339637463892,-2009,-541668,-539293.6,-0.04619611058394023,-574.0195807173725,-0.04001638766350648
2023-10-02T14:45:00-04:00,1.04915,1.04946,1.04904,1.04925,1.0502236869600001,1.049544888888889,1.0495911111111038,1.0496282222222177,1.0498435000000053,1.0528302000000012,1.0547926000000045,1.0563838500000073,1.0495833473947183,1.049765970997111,2336,-539332,-539579,-0.0346464735340248,-573.79692428121,-0.0038121015162671905
2023-10-02T15:00:00-04:00,1.04925,1.0493999999999999,1.04894,1.04896,1.0501394657424001,1.0494186666666665,1.0495955555555483,1.0496197777777732,1.0497985000000052,1.052661600000001,1.0547127000000045,1.0563487000000071,1.0494586779157746,1.0496863767976887,-2687,-542019,-540029.6,-0.026045741983748965,-574.5395785580747,0.0038134462113238337
2023-10-02T15:15:00-04:00,1.04896,1.04907,1.04877,1.04885,1.0500602977978561,1.0492695555555556,1.0495055555555481,1.0495859999999955,1.049685000000005,1.0524598000000012,1.0546356000000046,1.0563138000000072,1.0493369423326198,1.049568301438151,-1975,-543994,-541334.4,-0.02213218343344697,-574.7466884574033,-0.07716784482594148
2023-10-02T15:30:00-04:00,1.04885,1.04907,1.04857,1.04865,1.0499570739740276,1.0490984444444444,1.0493166666666593,1.0495208888888845,1.0496325000000053,1.0522678000000012,1.0545519000000045,1.0562816000000073,1.0491995538660959,1.0494490411505206,-1788,-545782,-542559,-0.02055134774638388,-575.0876333017566,-0.16185081163419934
2023-10-02T15:45:00-04:00,1.04865,1.04884,1.04806,1.04809,1.0498183665766248,1.0488531111111112,1.049113333333326,1.04942444444444,1.0495605000000052,1.0520626000000013,1.0544552000000047,1.0562466500000072,1.0489776430928768,1.0493112329204164,-2285,-548067,-543838.8,-0.03478104637126706,-576.3078688426904,-0.17429899420908243
2023-10-02T16:00:00-04:00,1.04809,1.0482799999999999,1.048,1.04809,1.0496073625874298,1.0486484444444446,1.0489466666666591,1.0492955555555512,1.0494415000000052,1.0518734000000012,1.0543626000000046,1.0562083500000072,1.0488001144743013,1.0491545863363332,0,-548067,-545585.8,-0.045686568992544634,-576.3078688426904,-0.14291294696024703
2023-10-02T16:15:00-04:00,1.04809,1.04823,1.04799,1.048,1.0493823318251896,1.0484591111111112,1.0487011111111035,1.0491166666666623,1.0492940000000053,1.0516886000000012,1.0542704000000045,1.0561668500000072,1.0486400915794412,1.0489908690690664,-551,-548618,-546905.6,-0.049635088168208025,-576.3551834817004,-0.21043410365546367
2023-10-02T16:30:00-04:00,1.048,1.04802,1.04779,1.0479,1.0491595587331592,1.048298888888889,1.0485488888888814,1.0489253333333288,1.0491580000000054,1.0515030000000012,1.0541764000000045,1.0561268000000072,1.048492073263553,1.048821895255253,-699,-549317,-547970.2,-0.05781577196457767,-576.4218819549828,-0.13056696560464623
2023-10-02T16:45:00-04:00,1.0479,1.04802,1.04766,1.04771,1.0489130381611906,1.0481311111111111,1.0483888888888813,1.048739777777773,1.0490495000000055,1.0513230000000011,1.0540812000000046,1.0560879000000072,1.0483356586108423,1.0486491162042024,-3837,-553154,-549444.6,-0.059484713948996376,-577.1175876520919,-0.13725396749750826
2023-10-02T17:00:00-04:00,1.04771,1.04806,1.04764,1.0478399999999999,1.0486624305289525,1.0480213333333335,1.0482322222222147,1.0485635555555508,1.0489635000000055,1.0511508000000012,1.0539898000000045,1.0560491000000072,1.0482365268886737,1.0485008929633617,115,-553039,-550439,-0.06271781115916757,-577.1033184363738,-0.13438170121516638
2023-10-02T17:15:00-04:00,1.0478399999999999,1.0479,1.04776,1.0478399999999999,1.0484579444231619,1.0479428888888889,1.04810777777777,1.0483957777777728,1.0488770000000054,1.0509832000000012,1.0538944000000046,1.0560080000000074,1.048157221510939,1.0483723143706893,0,-553039,-551433.4,-0.06835667502445085,-577.1033184363738,-0.10677242220866477
2023-10-02T17:30:00-04:00,1.0478399999999999,1.04789,1.04774,1.04783,1.0482943555385296,1.0478873333333332,1.047994444444437,1.0482544444444397,1.0488040000000054,1.0508222000000011,1.0537973000000047,1.0559668000000073,1.0480917772087512,1.0482626514965514,-210,-553249,-552359.6,-0.07123603371916812,-577.1053225591406,-0.09724936835582026
2023-10-02T17:45:00-04:00,1.04783,1.0479,1.04776,1.04789,1.0481634844308236,1.0478664444444445,1.0479099999999923,1.0481266666666618,1.0487525000000053,1.0506838000000012,1.0537023000000045,1.0559241500000072,1.048051421767001,1.0481745211972409,172,-553077,-553111.6,-0.07403751458056403,-577.0954736332652,-0.07247413340963085
2023-10-02T18:00:00-04:00,1.04789,1.04813,1.04768,1.04812,1.04764,1.0479084444444444,1.0479133333333257,1.0480315555555508,1.0486755000000054,1.0505592000000012,1.0536149000000046,1.0558819000000073,1.0480651374136007,1.0481204169577927,837,-552240,-552928.8,-0.07546143448001429,-576.9117616024223,0.002862349607378612
2023-10-02T18:15:00-04:00,1.04812,1.04827,1.04807,1.04824,1.0476497999999999,1.0479737777777778,1.0479299999999927,1.0479711111111063,1.0485700000000056,1.0504460000000013,1.0535298000000046,1.0558403500000073,1.0481001099308807,1.048093133566234,809,-551431,-552607.2,-0.06758772577096187,-576.8191386203209,0.014311748036914245
2023-10-02T18:30:00-04:00,1.04824,1.04825,1.04794,1.04809,1.047674608,1.0480057777777776,1.0479399999999925,1.047937555555551,1.0484785000000056,1.0503314000000012,1.0534475000000045,1.0557982000000072,1.0480980879447046,1.0480813068529873,-374,-551805,-552360.4,-0.05733102810268227,-576.8726568985778,0.008587786259534682
2023-10-02T18:45:00-04:00,1.04809,1.04809,1.04763,1.04765,1.04827,1.047947777777778,1.0479122222222148,1.0479211111111064,1.0483815000000054,1.0502122000000012,1.0533576000000047,1.0557537500000074,1.0480084703557637,1.0480646454823899,-305,-552110,-552132.6,-0.05036512329880241,-577.0006993376813,-0.023857238286103966
2023-10-02T19:00:00-04:00,1.04765,1.0479,1.04758,1.04772,1.0482572000000001,1.0479093333333331,1.0479133333333257,1.0479217777777732,1.0482570000000053,1.0500892000000013,1.0532684000000045,1.0557103000000074,1.047950776284611,1.0480445163859116,683,-551427,-551802.6,-0.04359231172777726,-576.9550638678202,0.0009544625898450442
2023-10-02T19:15:00-04:00,1.04772,1.04775,1.04751,1.04761,1.0482301120000002,1.0478486666666667,1.0478877777777704,1.0479166666666622,1.0481740000000055,1.0499624000000012,1.0531811000000046,1.0556656000000073,1.0478826210276888,1.0480080131087293,-611,-552038,-551762.2,-0.03274011652319774,-577.0192126862067,-0.021949916017708095
2023-10-02T19:30:00-04:00,1.04761,1.0479,1.04759,1.04788,1.0481869052800001,1.0478471111111112,1.047892222222215,1.0479091111111067,1.0481105000000055,1.049851200000001,1.0531009000000047,1.0556219500000072,1.047882096822151,1.0479644104869834,466,-551572,-551790.4,-0.026045641886562273,-576.8991107398717,0.0038173766987364493
2023-10-02T19:45:00-04:00,1.04788,1.04826,1.04788,1.04799,1.04751,1.0478666666666667,1.0479099999999926,1.0479031111111066,1.0480475000000053,1.0497400000000012,1.0530217000000046,1.0555794500000073,1.0479036774577208,1.0479255283895865,813,-550759,-551581.2,-0.01934557614178735,-576.8137669982219,0.015269652519963922
2023-10-02T20:00:00-04:00,1.04799,1.04804,1.04642,1.04729,1.04826,1.0477426666666665,1.047843333333326,1.0478893333333288,1.0479640000000054,1.0496118000000012,1.0529355000000047,1.0555326500000073,1.0477809419661768,1.047880022711669,-3150,-553909,-551941,-0.01559415927834664,-578.9177947084098,-0.05725791829294429
2023-10-02T20:15:00-04:00,1.04729,1.04744,1.04677,1.04681,1.04826,1.047536,1.0476977777777703,1.0478462222222176,1.0478620000000054,1.0494854000000011,1.0528427000000047,1.0554835000000073,1.0475867535729415,1.0478072181693352,-1830,-555739,-552803.4,-0.01613189803349575,-579.7565308750877,-0.12498568866159623
2023-10-02T20:30:00-04:00,1.04681,1.0472,1.04674,1.04714,1.0482232,1.0474244444444445,1.047575555555548,1.047783777777773,1.0477865000000055,1.049364800000001,1.0527515000000045,1.0554362500000074,1.0474974028583532,1.047730174535468,1325,-554414,-553278.6,-0.01771465499122442,-579.3388332986412,-0.10493780050371106
2023-10-02T20:45:00-04:00,1.04714,1.04746,1.04705,1.0472299999999999,1.0481871360000001,1.0473553333333332,1.0474799999999922,1.0477013333333285,1.0477435000000053,1.0492400000000013,1.0526597000000046,1.0553899500000072,1.0474439222866825,1.0476425396283742,1297,-553117,-553587.6,-0.020901733221175906,-579.2273582332251,-0.08205402207826455
2023-10-02T21:00:00-04:00,1.0472299999999999,1.04747,1.04676,1.0467899999999999,1.0481517932800002,1.0472173333333334,1.0473844444444367,1.0475962222222175,1.0476785000000053,1.049109600000001,1.0525634000000046,1.0553425000000072,1.0473131378293459,1.0475244317026993,-1363,-554480,-554331.8,-0.027402477812856343,-579.8000309030302,-0.08208848374935168
2023-10-02T21:15:00-04:00,1.0467899999999999,1.04746,1.04675,1.04705,1.0481171574144001,1.0471504444444446,1.0473099999999922,1.0474895555555506,1.0476310000000053,1.0489920000000013,1.0524677000000044,1.0552966500000072,1.0472605102634767,1.0474203453621593,1495,-552985,-554147,-0.02840374498519071,-579.4287052312143,-0.06394838315580006
2023-10-02T21:30:00-04:00,1.04705,1.04741,1.04691,1.04728,1.048083214266112,1.0471444444444444,1.0472733333333255,1.0474046666666617,1.0476000000000052,1.048874600000001,1.0523747000000043,1.0552517000000072,1.0472644082107814,1.0473558762897273,2132,-550853,-553169.8,-0.02933195150867082,-578.9603799363383,-0.03150027204779846
2023-10-02T21:45:00-04:00,1.04728,1.04742,1.04695,1.04712,1.0480499499807898,1.0471137777777777,1.0471888888888812,1.0473273333333284,1.0475705000000053,1.0487710000000012,1.0522818000000045,1.0552061500000072,1.047235526568625,1.0473035010317817,-1729,-552582,-552803.4,-0.030464854957653914,-579.2245308797344,-0.07252738863227393
2023-10-02T22:00:00-04:00,1.04712,1.04714,1.04674,1.04702,1.048017350981174,1.04708,1.0470811111111034,1.0472475555555507,1.0475295000000053,1.0486620000000013,1.0521857000000043,1.0551602000000073,1.0471924212549,1.0472532008254254,-1779,-554361,-553052.2,-0.03553889982130702,-579.3944254476922,-0.09255813509670087
2023-10-02T22:15:00-04:00,1.04702,1.04705,1.04643,1.04643,1.0479854039615506,1.0469497777777779,1.0469855555555478,1.0471677777777728,1.0474590000000052,1.0485596000000013,1.0520824000000044,1.055111300000007,1.04703993700392,1.04719856066034,-1425,-555786,-553313.4,-0.04402414508859249,-580.1974187047457,-0.08211670120024854
2023-10-02T22:30:00-04:00,1.04643,1.04665,1.04637,1.04655,1.0479540958823197,1.0468626666666667,1.0469566666666588,1.0470971111111063,1.0473950000000052,1.0484934000000012,1.0519787000000043,1.055064050000007,1.046941949603136,1.0471348485282719,1301,-554485,-553613.4,-0.04522695995978754,-580.0482257343605,-0.024837363036265124
2023-10-02T22:45:00-04:00,1.04655,1.04694,1.04655,1.04665,1.047890732047027,1.0468013333333333,1.0469022222222142,1.047022888888884,1.0473330000000052,1.0484040000000012,1.0518774000000044,1.0550152500000072,1.0468835596825088,1.0470586788226175,1132,-553353,-554113.4,-0.041392072126774954,-579.9400608115187,-0.046794124949851926
2023-10-02T23:00:00-04:00,1.04665,1.04696,1.04657,1.04686,1.0478299027651459,1.046792888888889,1.0468611111111032,1.0469573333333284,1.047270000000005,1.0483472000000011,1.0517778000000044,1.0549649000000072,1.046878847746007,1.0469873430580938,902,-552451,-554087.2,-0.03938432774728077,-579.7590834074201,-0.03533130257918332
2023-10-02T23:15:00-04:00,1.04686,1.04686,1.04654,1.04676,1.04777150665454,1.0467726666666668,1.04685777777777,1.0469126666666615,1.0471960000000053,1.048291800000001,1.0516771000000043,1.0549136500000071,1.0468550781968056,1.046919874446475,-992,-553443,-553903.6,-0.03769070432356,-579.8538429741244,-0.002865904336110824
2023-10-02T23:30:00-04:00,1.04676,1.04707,1.04649,1.04698,1.0477154463883585,1.046797111111111,1.046849999999992,1.0468855555555503,1.0471405000000051,1.0482220000000013,1.0515774000000042,1.0548632500000072,1.0468800625574444,1.04688789955718,1533,-551910,-553128.4,-0.030148834290390523,-579.5316487748809,-0.006685449596486748
2023-10-02T23:45:00-04:00,1.04698,1.04703,1.0467,1.04683,1.0476616285328242,1.046793111111111,1.046799999999992,1.0468542222222168,1.047099500000005,1.0481396000000012,1.0514778000000045,1.054810600000007,1.0468700500459556,1.0468735196457437,-995,-552905,-552812.4,-0.02652158016213934,-579.6742016412203,-0.042968451607980816
2023-10-03T00:00:00-04:00,1.04683,1.04705,1.04646,1.04647,1.0476099633915112,1.0467271111111112,1.0467277777777697,1.046819333333328,1.047037000000005,1.0480566000000011,1.0513738000000044,1.0547543500000072,1.0467900400367645,1.0468548157165949,-1207,-554112,-552964.2,-0.028892428118962126,-580.089283364136,-0.062075024830013696
2023-10-03T00:15:00-04:00,1.04647,1.04661,1.04597,1.04612,1.0475603648558507,1.0466055555555556,1.0466277777777695,1.0467726666666615,1.0469625000000051,1.0479814000000012,1.0512668000000045,1.0546946500000072,1.0466560320294116,1.0468102525732756,-1626,-555738,-553621.6,-0.031168616164242404,-580.633111663084,-0.08595824339555337
2023-10-03T00:30:00-04:00,1.04612,1.04663,1.0461,1.04651,1.0474649429644995,1.046582,1.0466366666666584,1.0467284444444391,1.046894000000005,1.047920400000001,1.0511629000000042,1.0546371500000071,1.0466268256235294,1.0467646020586205,1321,-554417,-553816.4,-0.03103827204502351,-580.140634700594,0.007645040757631185
2023-10-03T00:45:00-04:00,1.04651,1.04655,1.04614,1.04632,1.0473752463866295,1.0465186666666666,1.046611111111103,1.0466806666666613,1.0468105000000052,1.0478554000000013,1.0510565000000043,1.054579150000007,1.0465654604988235,1.0467016816468964,-1209,-555626,-554559.6,-0.02499522384242342,-580.3601357087068,-0.021976971955489418
2023-10-03T01:00:00-04:00,1.04632,1.04652,1.04617,1.04634,1.0472909316034318,1.0464644444444444,1.0465766666666587,1.0466359999999946,1.0467630000000052,1.0477964000000013,1.0509491000000044,1.0545221000000071,1.0465203683990587,1.0466317453175171,1490,-554136,-554805.8,-0.019497283072110627,-580.3316549380055,-0.029618306023984374
2023-10-03T01:15:00-04:00,1.04634,1.04657,1.0463,1.04647,1.0472116757072258,1.046443111111111,1.046533333333325,1.0465971111111056,1.0467460000000053,1.0477474000000013,1.0508436000000045,1.0544659000000072,1.046510294719247,1.0465757962540136,1168,-552968,-554577,-0.017487249638551746,-580.1865395835318,-0.0372542651357288
2023-10-03T01:30:00-04:00,1.04647,1.04661,1.04623,1.04638,1.0471371751647922,1.0464124444444445,1.046491111111103,1.0465697777777723,1.0467080000000055,1.0476818000000012,1.0507382000000043,1.054408550000007,1.0464842357753976,1.0465414370032107,-1608,-554576,-554344.6,-0.020117099534452534,-580.3248330845398,-0.03630249531887204
2023-10-03T01:45:00-04:00,1.04638,1.0466,1.04606,1.04657,1.0470671446549047,1.046428222222222,1.0464455555555476,1.04653155555555,1.0466750000000054,1.0476062000000013,1.0506352000000043,1.0543536500000072,1.046501388620318,1.0465163496025687,1944,-552632,-553987.6,-0.019339667062777375,-579.9718446864437,-0.03916025138971341
2023-10-03T02:00:00-04:00,1.04657,1.04677,1.04622,1.04676,1.0470013159756104,1.0464911111111113,1.0464377777777698,1.0464968888888833,1.0466735000000056,1.0475430000000012,1.0505351000000043,1.0542990000000072,1.0465531108962545,1.0465138796820548,2912,-549720,-552806.4,-0.019303684305700827,-579.4431843961623,-0.006686854599124452
2023-10-03T02:15:00-04:00,1.04676,1.04703,1.0464,1.04688,1.04597,1.0465795555555555,1.0464833333333252,1.0464782222222166,1.0466650000000055,1.0474888000000013,1.0504366000000045,1.054243850000007,1.0466184887170036,1.0465335037456438,3054,-546666,-551312.4,-0.01923536249409498,-579.093075488676,0.03917933624471045
2023-10-03T02:30:00-04:00,1.04688,1.04717,1.04654,1.04709,1.0459912,1.046700888888889,1.046591111111103,1.0464897777777724,1.0466555000000055,1.0474264000000013,1.0503449000000042,1.0541888500000072,1.046712790973603,1.0465740029965152,3120,-543546,-549428,-0.013493846105406996,-578.4672157912894,0.09272358811609925
2023-10-03T02:45:00-04:00,1.04709,1.04746,1.04684,1.04728,1.046038352,1.0468386666666667,1.0466766666666585,1.0465268888888832,1.0466635000000057,1.0473866000000012,1.0502561000000044,1.0541352000000073,1.0468262327788824,1.046642402397212,2862,-540684,-546649.6,-0.002411240200800938,-577.9478908048987,0.07357789223227082
2023-10-03T03:00:00-04:00,1.04728,1.04789,1.04713,1.04773,1.04612365088,1.0470493333333333,1.0468333333333253,1.046604444444439,1.0466990000000056,1.0473582000000012,1.0501702000000044,1.054083350000007,1.047006986223106,1.0467435219177694,4002,-536682,-543459.6,0.0064692234203428765,-576.2282933715474,0.13475800902210924
2023-10-03T03:15:00-04:00,1.04773,1.04798,1.04701,1.04711,1.0462649588096,1.0471046666666666,1.046918888888881,1.0467006666666612,1.0467330000000055,1.0473154000000013,1.0500728000000044,1.054028850000007,1.0470275889784848,1.0468384175342158,-3528,-540210,-541557.6,0.013607150509959772,-578.3160068091698,0.07358984651259987
2023-10-03T03:30:00-04:00,1.04711,1.04808,1.04689,1.04808,1.04643646292864,1.047336888888889,1.0470977777777697,1.04682355555555,1.0468095000000055,1.0472978000000013,1.0499797000000042,1.053980250000007,1.0472380711827878,1.0469623340273726,3082,-537128,-539650,0.022722372188471764,-575.460967701531,0.1538505642779907
2023-10-03T03:45:00-04:00,1.04808,1.04844,1.04789,1.04825,1.0466336873772033,1.0475673333333333,1.0473055555555475,1.046966444444439,1.0468895000000056,1.0472858000000014,1.0498728000000042,1.053933300000007,1.0474404569462301,1.0471078672218979,2956,-534172,-537775.2,0.03199080804434326,-574.9815004852879,0.17871136680745198
2023-10-03T04:00:00-04:00,1.04825,1.04897,1.04785,1.04881,1.0468865711443949,1.0478682222222222,1.0475544444444365,1.0471419999999945,1.0469870000000054,1.0472890000000012,1.049778400000004,1.053883300000007,1.047714365556984,1.0472854937775185,4283,-529889,-535616.2,0.04537309088277483,-572.6934203517316,0.21403250618687902
2023-10-03T04:15:00-04:00,1.04881,1.04935,1.04857,1.04864,1.0472199197612917,1.048085333333333,1.0477633333333254,1.0473279999999945,1.0470810000000055,1.0473000000000012,1.049681300000004,1.053833750000007,1.0478994924455873,1.0474639950220146,-2857,-532746,-534829,0.057043765843704436,-573.156507088128,0.17960181894609117
2023-10-03T04:30:00-04:00,1.04864,1.04878,1.04827,1.04829,1.0476033342042592,1.0481906666666667,1.047919999999992,1.0475282222222166,1.0471465000000055,1.0473040000000013,1.0495887000000041,1.053781900000007,1.04797759395647,1.0476539960176117,-2571,-535317,-533850.4,0.06469330706685038,-574.0146185467794,0.13468592388811623
2023-10-03T04:45:00-04:00,1.04829,1.04887,1.0481,1.04853,1.0479177340474926,1.0483126666666667,1.0480799999999921,1.047724666666661,1.0472315000000054,1.0473146000000013,1.0495016000000041,1.053729500000007,1.048088075165176,1.0478239968140894,3084,-532233,-532871.4,0.07339667307231044,-573.3085543851447,0.13752399507204593
2023-10-03T05:00:00-04:00,1.04853,1.0487,1.04803,1.04846,1.04935,1.0483886666666666,1.0482111111111032,1.0479057777777723,1.0473310000000053,1.0473258000000012,1.049414400000004,1.053674800000007,1.0481624601321409,1.0479683974512715,-3111,-535344,-533105.8,0.07906119603941222,-573.5162451522186,0.11267282866090815
2023-10-03T05:15:00-04:00,1.04846,1.04875,1.0483,1.04847,1.0493236,1.0484404444444444,1.0482933333333253,1.04805355555555,1.0474485000000056,1.0473410000000012,1.049332000000004,1.053619000000007,1.0482239681057126,1.0480703179610174,2313,-533031,-533734.2,0.0813226952016238,-573.494184224763,0.07062888339552775
2023-10-03T05:30:00-04:00,1.04847,1.0491,1.04834,1.0488899999999999,1.049297728,1.0485597777777778,1.048491111111103,1.0481991111111053,1.0475675000000053,1.0473620000000012,1.049256400000004,1.053560400000007,1.04835717448457,1.0481618543688138,2831,-530200,-533225,0.07979412542868312,-572.3601317482976,0.16999169141731937
2023-10-03T05:45:00-04:00,1.0488899999999999,1.04913,1.0483,1.04839,1.04927237344,1.0485395555555557,1.0485255555555475,1.0483202222222165,1.0476710000000056,1.0473730000000012,1.049178100000004,1.0534991500000068,1.0483637395876562,1.048239083495051,-2922,-533122,-532786,0.08346007725557278,-573.7530328151395,0.02957789481719263
2023-10-03T06:00:00-04:00,1.04839,1.04855,1.04818,1.04834,1.0492475259712,1.0485024444444446,1.0485355555555476,1.0484113333333274,1.0477710000000056,1.0473832000000012,1.0491027000000042,1.0534397000000069,1.048358991670125,1.048293266796041,-2365,-535487,-533436.8,0.07675295067313835,-573.8658248104845,0.008585738135000767
2023-10-03T06:15:00-04:00,1.04834,1.04841,1.04792,1.0480099999999999,1.049223175451776,1.0483973333333334,1.0484466666666588,1.0484584444444385,1.0478480000000057,1.047385600000001,1.0490347000000042,1.0533778500000068,1.0482891933361,1.0483186134368325,-2728,-538215,-534011,0.06686684757796472,-574.724553848774,-0.07627692337030863
2023-10-03T06:30:00-04:00,1.0480099999999999,1.0482799999999999,1.04763,1.04817,1.049171048433705,1.048342,1.0483944444444364,1.0484786666666608,1.0479375000000055,1.047386600000001,1.048972900000004,1.053313600000007,1.04826535466888,1.048326890749466,2496,-535719,-534548.6,0.053028543798752124,-574.3434887826006,-0.04481995727799535
2023-10-03T06:45:00-04:00,1.04817,1.04848,1.04753,1.04758,1.0490785855276825,1.048179111111111,1.0483155555555477,1.0484435555555496,1.0479880000000055,1.047373400000001,1.048909700000004,1.053246950000007,1.048128283735104,1.048281112599573,-2525,-538244,-536157.4,0.037457404301536934,-575.764775405954,-0.0677293497028483
2023-10-03T07:00:00-04:00,1.04758,1.04778,1.04692,1.04722,1.0489546986854679,1.0479599999999998,1.048169999999992,1.0483724444444387,1.0480110000000054,1.047356000000001,1.048843700000004,1.053178000000007,1.0479466269880833,1.0481976900796584,-2609,-540853,-537703.6,0.024292292718154987,-576.6613560966886,-0.12493681630472399
2023-10-03T07:15:00-04:00,1.04722,1.04751,1.04697,1.04738,1.0487512288169212,1.0478020000000001,1.048049999999992,1.0482753333333275,1.0480360000000053,1.047350600000001,1.0487814000000042,1.053111200000007,1.0478333015904666,1.0480925520637265,3319,-537534,-538113,0.010500917864846372,-576.1542611214209,-0.10300822158212711
2023-10-03T07:30:00-04:00,1.04738,1.04816,1.04736,1.04788,1.048568105935229,1.0477679999999998,1.0479844444444362,1.048182888888883,1.0480755000000053,1.0473538000000011,1.048721500000004,1.053043500000007,1.0478426412723734,1.0480032416509812,3285,-534249,-537319.8,0.000422562089502825,-574.5860623778896,-0.05627247322289531
2023-10-03T07:45:00-04:00,1.04788,1.04789,1.04708,1.04734,1.0484032953417062,1.0476391111111112,1.047812222222214,1.0480664444444383,1.0480785000000055,1.047348400000001,1.0486554000000041,1.0529731000000069,1.0477421130178988,1.047898593320785,-3128,-537377,-537651.4,-0.011495375723716944,-576.198002676397,-0.1477752671872113
2023-10-03T08:00:00-04:00,1.04734,1.04757,1.04675,1.04756,1.0482549658075355,1.0475886666666665,1.0477199999999918,1.0479473333333271,1.0480700000000054,1.047342000000001,1.048596600000004,1.0529032000000071,1.047705690414319,1.0478140746566278,3799,-533578,-536718.2,-0.025457616907028226,-575.4000001175332,-0.07916901153195724
2023-10-03T08:15:00-04:00,1.04756,1.04787,1.04683,1.04759,1.0480743699106312,1.0475626666666666,1.0476366666666583,1.0478406666666604,1.0480940000000054,1.047334000000001,1.048537000000004,1.052836600000007,1.0476825523314552,1.0477612597253025,4503,-529075,-534362.6,-0.03245491955773792,-575.2710433036037,-0.07154167541065193
2023-10-03T08:30:00-04:00,1.04759,1.04759,1.04621,1.04659,1.0479154455213555,1.0473533333333334,1.0474788888888806,1.047726444444438,1.0480195000000054,1.0473200000000011,1.048465900000004,1.052764250000007,1.0474640418651642,1.0476874077802418,-4298,-533373,-533530.4,-0.04679107634451922,-579.3737934253121,-0.1354948903159299
2023-10-03T08:45:00-04:00,1.04659,1.04714,1.04629,1.0466,1.04787,1.0471775555555556,1.0473044444444364,1.0475904444444382,1.0479370000000052,1.0473158000000011,1.0484006000000041,1.052692750000007,1.0472912334921314,1.0475771262241937,4817,-528556,-532391.8,-0.05352390308701512,-579.3277677610115,-0.149784863142436
2023-10-03T09:00:00-04:00,1.0466,1.04759,1.0464,1.047,1.0476376,1.0471166666666667,1.047239999999992,1.0474759999999939,1.0478465000000052,1.047313000000001,1.048338900000004,1.0526269000000068,1.0472329867937051,1.047475300979355,4173,-524383,-529793,-0.059011875992230296,-577.7328891063203,-0.055365699994274896
2023-10-03T09:15:00-04:00,1.047,1.04733,1.04693,1.04699,1.04759,1.0470666666666668,1.0472144444444362,1.0473748888888827,1.0477640000000052,1.0473082000000011,1.048274100000004,1.0525639000000069,1.0471843894349642,1.047371040783484,-3847,-528230,-528723.4,-0.05637631840129403,-577.7696321817733,-0.02196291132712825
2023-10-03T09:30:00-04:00,1.04699,1.04832,1.0466199999999999,1.04813,1.04621,1.0472497777777776,1.0472977777777697,1.047307111111105,1.0477560000000052,1.047335000000001,1.048222300000004,1.052505650000007,1.0473735115479714,1.0473092326267872,7134,-521096,-527127.6,-0.045374785090001986,-570.0018789081037,0.07160724856308393
2023-10-03T09:45:00-04:00,1.04813,1.04857,1.04759,1.04805,1.0462522,1.0474002222222223,1.0473166666666585,1.0472746666666606,1.047732000000005,1.0473550000000011,1.048173500000004,1.0524487500000068,1.047508809238377,1.0473181861014298,-6688,-527784,-526009.8,-0.03788999494150893,-570.5123499374612,0.01622323166774855
2023-10-03T10:00:00-04:00,1.04805,1.04816,1.04494,1.04757,1.04857,1.047450888888889,1.047342222222214,1.0472822222222162,1.0476875000000052,1.047360800000001,1.048117700000004,1.052388250000007,1.0475210473907017,1.0473641488811438,-25084,-552868,-530872.2,-0.03648724378126738,-582.000656793051,0.021960394905183846
2023-10-03T10:15:00-04:00,1.04757,1.04827,1.04617,1.0466199999999999,1.04857,1.0473064444444444,1.0472377777777693,1.0472817777777714,1.0475950000000052,1.047350800000001,1.0480609000000038,1.0523211000000068,1.0473408379125613,1.047385719104915,-18546,-571414,-540278.4,-0.03499941137338375,-598.8192942110757,-0.08973233036772718
2023-10-03T10:30:00-04:00,1.0466199999999999,1.04826,1.04639,1.04802,1.0484974,1.0474628888888888,1.0472855555555474,1.0472959999999936,1.0475515000000049,1.0473708000000008,1.0480164000000038,1.052258850000007,1.047476670330049,1.047444175283932,11141,-560273,-546687,-0.02856374023160582,-583.9166552399106,0.04104659265551699
2023-10-03T10:45:00-04:00,1.04802,1.04821,1.0466199999999999,1.04756,1.048426252,1.0475177777777778,1.047393333333325,1.0473151111111048,1.0475100000000048,1.047393400000001,1.0479765000000039,1.052196750000007,1.0474933362640393,1.0474681402271455,-8934,-569207,-556309.2,-0.022806007112097584,-587.8379926189674,0.0926819480407932
2023-10-03T11:00:00-04:00,1.04756,1.04758,1.04614,1.04644,1.0483565269600001,1.047327111111111,1.047375555555547,1.0473268888888825,1.0474150000000049,1.0473912000000007,1.0479423000000039,1.052125850000007,1.0472826690112313,1.0474229121817165,-8246,-577453,-566243,-0.015375075465906609,-596.6542131695803,-0.015287597936168353
2023-10-03T11:15:00-04:00,1.04644,1.0466199999999999,1.04575,1.04598,1.0482881964208002,1.047048,1.0472622222222137,1.0473108888888825,1.047313500000005,1.047377800000001,1.047890900000004,1.052062500000007,1.047022135208985,1.0473231297453731,-6398,-583851,-572439.6,-0.010566383623222928,-599.4666821118998,-0.09742120343839741
2023-10-03T11:30:00-04:00,1.04598,1.04642,1.04519,1.0453,1.048221232492384,1.0466555555555555,1.047074444444436,1.047278222222216,1.047170000000005,1.0473466000000007,1.047846900000004,1.051996400000007,1.046677708167188,1.0471905037962983,-5640,-589491,-576055,-0.01447827508434111,-603.133291416093,-0.16141510425125274
2023-10-03T11:45:00-04:00,1.0453,1.0456,1.04482,1.04525,1.0481556078425365,1.0462906666666665,1.0467544444444359,1.0471719999999936,1.047053500000005,1.0473164000000008,1.0478041000000038,1.051932350000007,1.0463921665337506,1.046973603037039,-4024,-593515,-582703.4,-0.017818283523369782,-603.3257720436636,-0.2747750756108492
2023-10-03T12:00:00-04:00,1.04525,1.04638,1.04517,1.04609,1.048022183528835,1.0461577777777777,1.0465366666666582,1.0470006666666603,1.046997000000005,1.0472986000000006,1.047760300000004,1.051875150000007,1.0463317332270003,1.0467412824296312,4845,-588670,-586596,-0.030526907522227958,-599.4321580757136,-0.1870139783407244
2023-10-03T12:15:00-04:00,1.04609,1.04726,1.0459,1.04724,1.0478940961876817,1.0462984444444445,1.0464999999999915,1.046825555555549,1.046990000000005,1.0473068000000005,1.0477232000000039,1.051825450000007,1.0465133865816003,1.0465874259437047,4509,-584161,-587937.6,-0.0383541682015264,-594.4752710009877,-0.0315014748417711
2023-10-03T12:30:00-04:00,1.04724,1.04725,1.04631,1.04635,1.0477711323401744,1.0462684444444443,1.0464699999999916,1.0466671111111048,1.0469135000000047,1.0473044000000007,1.047680500000004,1.0517661500000068,1.0464807092652801,1.0464791407549636,-3227,-587388,-588645,-0.045323988055992886,-597.2177464602904,-0.02579732854331013
2023-10-03T12:45:00-04:00,1.04635,1.04651,1.04585,1.04622,1.0476530870465675,1.0462184444444442,1.0462699999999916,1.046506222222216,1.0468575000000049,1.0473064000000007,1.047643900000004,1.0517037500000068,1.046428567412224,1.046429312603971,-2989,-590377,-588822.2,-0.041597508061231525,-597.5891040366271,-0.17175244747237875
2023-10-03T13:00:00-04:00,1.04622,1.04688,1.04621,1.04667,1.0475397635647048,1.0462984444444443,1.0461711111111027,1.0463895555555491,1.0468130000000049,1.0473096000000006,1.0476150000000042,1.051645050000007,1.0464768539297793,1.0464462500831764,3014,-587363,-587591.8,-0.05144692778581781,-596.2927227783829,-0.08495933407156224
2023-10-03T13:15:00-04:00,1.04667,1.0475,1.04664,1.04734,1.04482,1.046532222222222,1.0462711111111025,1.046336444444438,1.0468005000000047,1.0473300000000008,1.047592700000004,1.0515930500000068,1.0466494831438233,1.0465098000665412,2409,-584954,-586848.6,-0.05254826325063846,-594.7506608104275,0.08600588662511953
2023-10-03T13:30:00-04:00,1.04734,1.04734,1.04663,1.0467,1.0448736,1.0466179999999998,1.0463511111111026,1.0463066666666603,1.0468060000000048,1.0473372000000007,1.047566800000004,1.0515378000000069,1.0466595865150587,1.046539040053233,-2413,-587367,-587489.8,-0.04601798413374788,-596.2251772043396,0.06883496816383239
2023-10-03T13:45:00-04:00,1.0467,1.04708,1.04634,1.04692,1.0449261280000002,1.0467317777777778,1.0465311111111026,1.0463188888888824,1.0468220000000048,1.0473462000000007,1.047546800000004,1.0514807000000068,1.046711669212047,1.0465852320425864,3073,-584294,-586871,-0.03853880082081992,-595.5792805768433,0.15497943174210055
2023-10-03T14:00:00-04:00,1.04692,1.04724,1.04632,1.04646,1.0449776054400002,1.0467175555555557,1.046665555555547,1.0463979999999935,1.0467950000000048,1.047347800000001,1.047514800000004,1.051423900000007,1.0466613353696377,1.046631785634069,-3002,-587296,-586254.8,-0.026820847112802,-596.898311639389,0.11576177947858726
2023-10-03T14:15:00-04:00,1.04646,1.04677,1.04595,1.04675,1.0450280533312002,1.0467344444444444,1.0467388888888804,1.046511555555549,1.046783000000005,1.0473514000000008,1.047478800000004,1.051365000000007,1.0466790682957101,1.0466722285072554,2434,-584862,-585754.6,-0.011354409045150874,-596.2237899185394,0.06309208576700905
2023-10-03T14:30:00-04:00,1.04675,1.04777,1.04668,1.04771,1.0450774922645762,1.0469286666666666,1.0467911111111026,1.046615555555549,1.0467620000000049,1.0473704000000008,1.0474567000000041,1.051313500000007,1.0468852546365681,1.0467193828058041,2329,-582533,-585270.4,0.0008460941158369252,-594.0878071146228,0.04487987471830435
2023-10-03T14:45:00-04:00,1.04771,1.04797,1.04742,1.04746,1.0451851925739932,1.0470624444444445,1.046914444444436,1.0467282222222156,1.046732500000005,1.0473820000000007,1.0474354000000041,1.051262000000007,1.0470002037092545,1.0467875062446435,-2764,-585297,-584856.4,0.005995623831641895,-594.7473407642011,0.10608305060449816
2023-10-03T15:00:00-04:00,1.04746,1.04775,1.04704,1.0477,1.0453522810195537,1.0472195555555557,1.0470788888888807,1.0468377777777713,1.0467390000000047,1.0473942000000007,1.047410300000004,1.051215650000007,1.0471401629674035,1.0468732049957148,2875,-582422,-584482,0.02048461606714428,-594.0886043924064,0.14146164286671523
2023-10-03T15:15:00-04:00,1.0477,1.04785,1.0473,1.04739,1.0455093441583805,1.0472817777777776,1.0471588888888805,1.046936444444438,1.0467775000000048,1.047396400000001,1.047391500000004,1.0511672000000067,1.0471901303739228,1.0469789639965716,-2716,-585138,-584050.4,0.03248086972320194,-594.8922313848661,0.06878958984207573
2023-10-03T15:30:00-04:00,1.04739,1.0475,1.04705,1.04739,1.0456569835088776,1.047328,1.0471644444444361,1.047021555555549,1.0467460000000048,1.0473896000000007,1.047373900000004,1.0511194500000067,1.0472301042991383,1.0470891711972574,0,-585138,-584105.6,0.035855076709638965,-594.8922313848661,0.004773998892442332
2023-10-03T15:45:00-04:00,1.04739,1.04748,1.04712,1.04713,1.0457957644983449,1.0473211111111111,1.0472122222222138,1.0471057777777713,1.0467245000000047,1.0473900000000007,1.047352700000004,1.0510726500000067,1.0472100834393105,1.0471541369578057,-2292,-587430,-585085,0.03789910404184651,-595.4611885068554,0.04108149421992266
2023-10-03T16:00:00-04:00,1.04713,1.04737,1.04691,1.04697,1.0459262186284441,1.0472726666666667,1.0472177777777696,1.047166444444438,1.0467510000000049,1.0473678000000006,1.047332800000004,1.0510227500000067,1.0471620667514485,1.0471865095662447,-1388,-588818,-585789.2,0.043163647910684305,-595.6732729662825,0.004775914109949516
2023-10-03T16:15:00-04:00,1.04697,1.0470599999999999,1.0467899999999999,1.0468,1.0460488455107375,1.0471891111111111,1.0472555555555472,1.0472017777777711,1.0467920000000048,1.0473388000000008,1.0473123000000042,1.0509739500000068,1.047089653401159,1.0471764076529957,-741,-589559,-587216.6,0.04037882213589666,-595.7935916000542,0.03249049175314938
2023-10-03T16:30:00-04:00,1.0468,1.04691,1.04646,1.04653,1.0461641147800933,1.047044,1.0472311111111028,1.0472162222222157,1.0468535000000048,1.0472932000000008,1.0472911000000042,1.0509215000000067,1.0469777227209272,1.0471339261223966,-846,-590405,-588270,0.03854452454412597,-596.0117994716629,-0.021017434917612512
2023-10-03T16:45:00-04:00,1.04653,1.04668,1.04647,1.04663,1.0462724678932878,1.0469237777777778,1.0471111111111027,1.0472055555555488,1.0469225000000049,1.0472530000000009,1.0472765000000042,1.0508658500000068,1.0469081781767418,1.0470695408979172,1238,-589167,-589075.8,0.03134595177348952,-595.8935037706319,-0.10308195970258659
2023-10-03T17:00:00-04:00,1.04663,1.04692,1.04658,1.04665,1.0463743198196904,1.0468315555555554,1.0470211111111025,1.0471673333333267,1.046950500000005,1.0472202000000008,1.047262100000004,1.0508123500000068,1.0468565425413934,1.046998832718334,128,-589039,-589397.6,0.014850967246156298,-595.8910578250733,-0.07732992190632362
2023-10-03T17:15:00-04:00,1.04665,1.04667,1.04646,1.04652,1.04797,1.0467313333333332,1.0468899999999914,1.0471017777777711,1.0469145000000049,1.0471800000000009,1.047247300000004,1.0507588500000067,1.0467892340331146,1.0469242661746672,-115,-589154,-589464.8,0.003916212163326297,-595.9053414920107,-0.11262766058988077
2023-10-03T17:30:00-04:00,1.04652,1.04668,1.04636,1.0464499999999999,1.0479398,1.0466433333333334,1.0467855555555472,1.047007777777771,1.0469195000000049,1.047139800000001,1.0472328000000042,1.0507046000000066,1.0467213872264918,1.0468506129397337,-224,-589378,-589428.6,-0.004430345776059261,-595.9203244832579,-0.08974689466198482
2023-10-03T17:45:00-04:00,1.0464499999999999,1.04651,1.04641,1.0465,1.047876608,1.0465862222222222,1.046686666666658,1.0468988888888824,1.0469335000000048,1.0471004000000008,1.047220700000004,1.0506509500000067,1.0466771097811933,1.0467904903517868,142,-589236,-589194.8,-0.013613895725488656,-595.9135396392616,-0.08497312366931681
2023-10-03T18:00:00-04:00,1.0465,1.04674,1.04643,1.04671,1.0478159436799999,1.046590888888889,1.0466399999999916,1.04680466666666,1.046935500000005,1.047056800000001,1.047209400000004,1.0505996000000066,1.0466836878249546,1.0467455922814295,396,-588840,-589129.4,-0.02233757160424649,-595.8340747563184,-0.04010963299684518
2023-10-03T18:15:00-04:00,1.04671,1.04678,1.0466199999999999,1.04669,1.0477577059327998,1.0466008888888887,1.0466088888888807,1.0467222222222154,1.046903000000005,1.0470228000000008,1.0471979000000042,1.0505461500000066,1.0466849502599636,1.0467112738251434,-466,-589306,-589182.8,-0.026631309869108943,-595.8429788462765,-0.026743841752873337
2023-10-03T18:30:00-04:00,1.04669,1.04671,1.04648,1.04669,1.0477017976954879,1.046617111111111,1.0465966666666582,1.0466635555555488,1.046902500000005,1.0469898000000009,1.047186500000004,1.0504919000000066,1.0466859602079708,1.0466906190601146,0,-589306,-589213.2,-0.026350083580517103,-595.8429788462765,-0.010508215513952474
2023-10-03T18:45:00-04:00,1.04669,1.04672,1.0464,1.0464499999999999,1.0476481257876684,1.0465877777777777,1.0465877777777695,1.0466239999999933,1.046879000000005,1.0469586000000008,1.0471721000000043,1.0504372000000068,1.0466387681663767,1.0466740952480917,-394,-589700,-589277.6,-0.028556482976480016,-595.9333207813289,-0.007644310244338912
2023-10-03T19:00:00-04:00,1.0464499999999999,1.04652,1.04629,1.04648,1.0475966007561617,1.0465662222222223,1.0465711111111027,1.046600888888882,1.046880000000005,1.0469248000000009,1.0471557000000042,1.0503853000000065,1.0466070145331015,1.0466600761984732,714,-588986,-589227.6,-0.027033223162433995,-595.9128515759201,-0.014331712257423584
2023-10-03T19:15:00-04:00,1.04648,1.04665,1.04638,1.0466,1.047518204710792,1.0465719999999998,1.046565555555547,1.0465859999999931,1.046872500000005,1.046905200000001,1.0471393000000042,1.0503345500000068,1.0466056116264812,1.0466444609587786,557,-588429,-589145.4,-0.02795644144414527,-595.8489803122552,-0.004777146132910286
2023-10-03T19:30:00-04:00,1.0466,1.04695,1.04659,1.04695,1.0474445124281446,1.0466488888888887,1.0466133333333252,1.046586888888882,1.046834500000005,1.046899800000001,1.0471279000000042,1.0502877000000066,1.046674489301185,1.046642368767023,729,-587700,-588824.2,-0.02600025472592519,-595.6051908989167,0.04108856018042202
2023-10-03T19:45:00-04:00,1.04695,1.04695,1.0468,1.04686,1.047375241682456,1.046698222222222,1.0466588888888806,1.0465993333333266,1.046804500000005,1.0468894000000009,1.0471200000000043,1.0502388000000067,1.046711591440948,1.0466474950136182,-683,-588383,-588639.6,-0.0188868494850203,-595.6639043045236,0.039180085049454964
2023-10-03T20:00:00-04:00,1.04686,1.04701,1.04656,1.04687,1.0473101271815086,1.0467404444444444,1.0466999999999915,1.0466217777777709,1.046763000000005,1.0468692000000008,1.0471115000000042,1.0501899500000067,1.0467432731527584,1.0466683960108947,1226,-587157,-588131,-0.012191260867348756,-595.6521930919449,0.03535594839942489
2023-10-03T20:15:00-04:00,1.04687,1.04732,1.04681,1.04701,1.04629,1.0468024444444444,1.046733333333325,1.0466542222222155,1.046744000000005,1.046862600000001,1.0471055000000042,1.0501433000000067,1.0467966185222066,1.0467063168087156,1464,-585693,-587472.4,-0.004180641944457601,-595.4564094702918,0.02866123377057322
2023-10-03T20:30:00-04:00,1.04701,1.04755,1.04701,1.0473,1.0463106,1.0469157777777778,1.0468011111111026,1.0467013333333264,1.046739500000005,1.0468574000000008,1.0470997000000042,1.0501003000000069,1.0468972948177653,1.0467646534469726,1129,-584564,-586699.4,0.0018651471329776768,-595.1436999450724,0.05827895556468481
2023-10-03T20:45:00-04:00,1.0473,1.04756,1.04701,1.04713,1.046360176,1.0469815555555555,1.0468499999999914,1.0467486666666599,1.046739500000005,1.0468482000000008,1.0470911000000043,1.0500564000000068,1.0469438358542122,1.0468185227575781,-1957,-586521,-586463.6,0.007251413889403744,-595.4613644156157,0.04203727942370673
2023-10-03T21:00:00-04:00,1.04713,1.04719,1.04667,1.04688,1.0464321654400002,1.0469875555555557,1.0468977777777695,1.0467964444444375,1.0467350000000049,1.0468540000000008,1.047087000000004,1.050011250000007,1.0469310686833697,1.0468624182060622,-2555,-589076,-586602.2,0.010203956296479787,-596.0713650841092,0.04109130871041641
2023-10-03T21:15:00-04:00,1.04688,1.04708,1.04673,1.04693,1.0464998355136002,1.046994,1.0469477777777696,1.046845999999993,1.046741500000005,1.046860600000001,1.0470882000000044,1.0499654500000069,1.0469308549466958,1.0468999345648498,1727,-587349,-586640.6,0.014971592188706433,-595.9888818959694,0.04300129959481685
2023-10-03T21:30:00-04:00,1.04693,1.04693,1.04602,1.04642,1.04756,1.0468884444444444,1.0469277777777695,1.046884888888882,1.046736000000005,1.0468490000000008,1.0470810000000041,1.0499162500000068,1.0468286839573566,1.0469063476518798,-3389,-590738,-587649.6,0.016127381291017935,-597.6397945644381,-0.017198547678202655
2023-10-03T21:45:00-04:00,1.04642,1.04688,1.04639,1.04669,1.0475292,1.0468408888888887,1.0468988888888804,1.0469044444444375,1.046739000000005,1.0468430000000009,1.0470756000000043,1.0498676500000068,1.0468009471658852,1.0468870781215036,1578,-589160,-588568.8,0.016259193564176582,-597.2326349153489,-0.024834041740307462
2023-10-03T22:00:00-04:00,1.04669,1.04684,1.04641,1.04663,1.047499016,1.0467871111111111,1.0468733333333249,1.0469091111111042,1.046738000000005,1.0468130000000009,1.0470740000000043,1.0498187000000068,1.0467667577327082,1.0468516624972026,-1571,-590731,-589410.8,0.013202064835852644,-597.322690232587,-0.021970464054405794
2023-10-03T22:15:00-04:00,1.04663,1.04676,1.04647,1.04649,1.04746943568,1.0467104444444444,1.0468311111111026,1.0468957777777708,1.046736500000005,1.0467818000000009,1.0470684000000041,1.049768050000007,1.0467114061861666,1.0468077299977623,-1324,-592055,-590006.6,0.010395223201720967,-597.4997919781896,-0.036298680829524865
2023-10-03T22:30:00-04:00,1.04649,1.04649,1.0462,1.04636,1.0474404469664,1.046616222222222,1.0467588888888804,1.0468579999999927,1.0467320000000049,1.0467576000000007,1.047059200000004,1.0497169500000068,1.0466411249489334,1.0467497839982096,-1169,-593224,-591181.6,0.006250827415893305,-597.6450107571554,-0.062081546499082096
2023-10-03T22:45:00-04:00,1.04636,1.04643,1.04597,1.04632,1.047412038027072,1.0465284444444443,1.0466499999999916,1.0468024444444373,1.046723000000005,1.0467516000000008,1.047051200000004,1.049666500000007,1.0465768999591467,1.0466994271985677,-1399,-594623,-591958.6,0.0002502165511743145,-597.6984913947946,-0.09357395206721865
2023-10-03T23:00:00-04:00,1.04632,1.04666,1.04631,1.0466199999999999,1.047354356505989,1.0465224444444443,1.0465933333333248,1.0467413333333262,1.046718500000005,1.0467236000000009,1.0470472000000042,1.049616450000007,1.0465855199673173,1.0466563417588541,1093,-593530,-592832.6,-0.006792204932445914,-597.3851073440262,-0.04870455435332867
2023-10-03T23:15:00-04:00,1.0466199999999999,1.04663,1.04627,1.04627,1.0472989822457495,1.0464577777777777,1.0465255555555473,1.0466717777777705,1.0466975000000052,1.046697800000001,1.0470456000000044,1.0495640000000068,1.0465224159738538,1.0466074734070832,-1115,-594645,-593615.4,-0.013006900617834471,-597.7579742871382,-0.0582683784196851
2023-10-03T23:30:00-04:00,1.04627,1.04639,1.04596,1.04602,1.0472458229559194,1.0463566666666666,1.0464244444444362,1.0465904444444374,1.0466640000000051,1.0466894000000009,1.0470403000000041,1.0495095000000068,1.046421932779083,1.0465495787256665,-1099,-595744,-594353.2,-0.01817563900206818,-598.0205738073386,-0.08692080654866767
2023-10-03T23:45:00-04:00,1.04602,1.04604,1.04572,1.04592,1.0471686735785641,1.0462557777777777,1.0463688888888807,1.0465124444444374,1.0466375000000052,1.046688200000001,1.047033000000004,1.0494552000000068,1.0463215462232662,1.046485662980533,-1367,-597111,-595130.6,-0.024322996287240696,-598.1512596450855,-0.0477819613539444
2023-10-04T00:00:00-04:00,1.04592,1.04626,1.04581,1.04625,1.047052779692279,1.0462319999999998,1.0463199999999917,1.0464464444444375,1.0466260000000052,1.0467072000000008,1.047026900000004,1.0494023500000067,1.046307236978613,1.0464317303844262,1055,-596056,-595417.2,-0.025037535829503167,-597.8183947988258,-0.04203727942370673
2023-10-04T00:15:00-04:00,1.04625,1.04637,1.04607,1.04623,1.0469461573168968,1.046214,1.0462755555555472,1.0463828888888818,1.0466075000000052,1.046726800000001,1.047021600000004,1.0493493500000066,1.0462917895828905,1.0463729843075409,-1106,-597162,-596143.6,-0.028295512710971582,-597.8395369732582,-0.03821789935315784
2023-10-04T00:30:00-04:00,1.04623,1.04657,1.04623,1.04644,1.046848064731545,1.046246888888889,1.0462699999999918,1.0463317777777708,1.0465820000000052,1.046733800000001,1.0470162000000043,1.0492968000000067,1.0463214316663123,1.0463327874460326,1210,-595952,-596405,-0.02938314059256197,-597.5966649470306,-0.004777876520548068
2023-10-04T00:45:00-04:00,1.04644,1.047,1.04643,1.047,1.04572,1.046392888888889,1.0463411111111027,1.046315111111104,1.0465890000000053,1.046729000000001,1.0470179000000042,1.0492478500000066,1.0464571453330498,1.046339829956826,1439,-594513,-596158.8,-0.024737654376994832,-596.8265873506086,0.061164417600058675
2023-10-04T01:00:00-04:00,1.047,1.04709,1.04678,1.04697,1.0457456,1.0465186666666666,1.046413333333325,1.0463239999999927,1.0465940000000054,1.046741400000001,1.0470229000000042,1.0491983500000068,1.0465597162664397,1.0463874639654607,-1423,-595936,-595923.8,-0.019409657054907437,-596.867360989577,0.06212248642862982
2023-10-04T01:15:00-04:00,1.04697,1.04709,1.0467899999999999,1.04705,1.045799376,1.046646,1.0464611111111026,1.046352222222215,1.0465960000000052,1.046758000000001,1.047032200000004,1.0491495000000066,1.0466577730131519,1.0464575711723685,1364,-594572,-595627,-0.013253602427228546,-596.7631364177172,0.041084634346768886
2023-10-04T01:30:00-04:00,1.04705,1.0473999999999999,1.04688,1.04701,1.04585100096,1.0467557777777778,1.0465433333333252,1.0464057777777707,1.0465815000000052,1.046764800000001,1.047037200000004,1.0491000500000067,1.0467282184105215,1.0465448569378948,-1564,-596136,-595421.8,-0.009527306379159306,-596.8228852358253,0.0707274412914413
2023-10-04T01:45:00-04:00,1.04701,1.04713,1.04667,1.04683,1.0459439409023998,1.046813111111111,1.046633333333325,1.0464784444444373,1.0465665000000053,1.046754600000001,1.047042300000004,1.0490494000000068,1.0467485747284173,1.0466302855503158,-1632,-597768,-595785,-0.0020383593753158114,-597.1034556219727,0.07743637788952194
2023-10-04T02:00:00-04:00,1.04683,1.04694,1.04641,1.04649,1.0460313044482559,1.0467844444444445,1.0466966666666584,1.0465495555555484,1.0465470000000052,1.0467504000000012,1.0470438000000042,1.0489964500000069,1.0466968597827337,1.0466782284402525,-2415,-600183,-596919,0.005364499299937676,-597.8878236664498,0.054497475906375194
2023-10-04T02:15:00-04:00,1.04649,1.04654,1.04558,1.04562,1.0473999999999999,1.046569111111111,1.0466266666666586,1.046592222222215,1.0464815000000054,1.046724400000001,1.047035300000004,1.0489394500000069,1.046481487826187,1.046662582752202,-2632,-602815,-598294.8,0.00823149755940432,-600.0759382208171,-0.060215053763432114
2023-10-04T02:30:00-04:00,1.04562,1.04596,1.04542,1.04595,1.0473636,1.0464337777777777,1.0465955555555473,1.046619111111104,1.0464580000000052,1.046714200000001,1.047031000000004,1.048884600000007,1.0463751902609495,1.0466060662017616,2679,-600136,-599407.6,0.009824541604993613,-599.2304398562106,-0.02676275771102511
2023-10-04T02:45:00-04:00,1.04595,1.04615,1.04541,1.04604,1.047285856,1.0463226666666665,1.046551111111103,1.0466206666666595,1.0464255000000053,1.046700000000001,1.047025700000004,1.048830450000007,1.0463081522087596,1.046522052961409,2877,-597259,-599632.2,0.009738250391529226,-598.9828850017717,-0.03822483850005313
2023-10-04T03:00:00-04:00,1.04604,1.04651,1.04513,1.04648,1.04717330464,1.0463084444444444,1.0464933333333253,1.0465926666666596,1.0464180000000052,1.046675400000001,1.0470229000000042,1.048779000000007,1.0463425217670077,1.0464408423691272,5012,-592247,-598528,0.011076228021211654,-596.8746673427912,-0.04966571155681509
2023-10-04T03:15:00-04:00,1.04648,1.04717,1.04627,1.047,1.04513,1.0464097777777777,1.0464966666666586,1.0465526666666596,1.0464435000000052,1.0466662000000009,1.0470241000000042,1.048730350000007,1.0464740174136062,1.0463962738953014,4693,-587554,-596002.2,0.009392337600121365,-594.5426973099197,0.0028654116163762565
2023-10-04T03:30:00-04:00,1.047,1.04834,1.04687,1.04824,1.04513,1.0467584444444444,1.0466288888888808,1.0465531111111042,1.0465375000000052,1.0466770000000012,1.047035600000004,1.0486902500000068,1.046827213930885,1.046465419116241,4328,-583226,-592084.4,0.013564112843064018,-589.4168902421064,0.1136526431402535
2023-10-04T03:45:00-04:00,1.04824,1.04853,1.04769,1.04844,1.0452583999999998,1.0471206666666666,1.0467877777777699,1.0465915555555487,1.046643500000005,1.046698000000001,1.0470472000000042,1.048651650000007,1.047149771144708,1.0466203352929928,4102,-579124,-587882,0.017380076336008497,-588.6342450463499,0.13657940229797635
2023-10-04T04:00:00-04:00,1.04844,1.04882,1.04789,1.04857,1.0454546959999997,1.0474771111111112,1.0469811111111031,1.0466775555555485,1.046741000000005,1.046721600000001,1.047055600000004,1.0486129000000068,1.0474338169157664,1.0468454682343942,3995,-575129,-583456,0.02204587142624507,-588.1388900427256,0.16621610003535195
2023-10-04T04:15:00-04:00,1.04857,1.04888,1.04825,1.04838,1.0457239203199997,1.0477568888888888,1.0471911111111032,1.0468171111111042,1.0468465000000051,1.0467466000000012,1.047068300000004,1.048570550000007,1.0476230535326132,1.0471015745875154,-3764,-578893,-580785.2,0.028844754176090545,-588.8209236694742,0.18060373247715406
2023-10-04T04:30:00-04:00,1.04838,1.04879,1.04804,1.04863,1.0460395282879997,1.0480446666666665,1.0475255555555476,1.047022888888882,1.0469770000000052,1.0467798000000013,1.0470738000000042,1.048526750000007,1.0478244428260906,1.0473716596700122,3578,-575315,-578337.4,0.03854802879725992,-587.9677025092083,0.2878674853197105
2023-10-04T04:45:00-04:00,1.04863,1.04883,1.04818,1.0486,1.0463235754591997,1.0482595555555554,1.0478199999999922,1.0472611111111043,1.047111000000005,1.0468158000000012,1.0470773000000042,1.0484750500000068,1.0479795542608725,1.0476021277360097,-2840,-578155,-577323.2,0.055270705025700376,-588.0489513767783,0.25335819111812624
2023-10-04T05:00:00-04:00,1.0486,1.04968,1.04846,1.04959,1.0465792179132798,1.0486135555555554,1.0482144444444366,1.0475464444444376,1.047278000000005,1.0468770000000012,1.047085100000004,1.0484317500000069,1.048301643408698,1.0478325021888077,3637,-574518,-576402,0.07333184490060295,-584.6152016151913,0.33937516729761213
2023-10-04T05:15:00-04:00,1.04959,1.05015,1.04909,1.0493999999999999,1.0469513117636862,1.0488506666666668,1.048538888888881,1.047857999999993,1.047436500000005,1.046932400000001,1.047092700000004,1.048387000000007,1.0485213147269583,1.048050001751046,-2701,-577219,-576820,0.09107995649928752,-585.1041449168617,0.2790306551486709
2023-10-04T05:30:00-04:00,1.0493999999999999,1.04971,1.04892,1.04952,1.04739912811677,1.0490468888888889,1.048818888888881,1.0481835555555485,1.047590500000005,1.0469898000000013,1.047105000000004,1.048346850000007,1.0487210517815666,1.0482696014008368,2531,-574688,-575979,0.10513108997324411,-584.8147223897031,0.24068767908310199
2023-10-04T05:45:00-04:00,1.04952,1.05041,1.0495,1.04982,1.0477842501804222,1.0492471111111112,1.0489944444444366,1.0484773333333264,1.0477315000000051,1.0470558000000014,1.047117900000004,1.0483097500000071,1.0489408414252532,1.0484928811206693,2669,-572019,-575319.8,0.11666862864267225,-584.0518021976154,0.1507288407234903
2023-10-04T06:00:00-04:00,1.04982,1.05085,1.04951,1.05081,1.0482043701515547,1.0496102222222223,1.0492577777777699,1.0487648888888819,1.0479235000000051,1.0471430000000013,1.0471414000000039,1.048277900000007,1.0493146731402025,1.0487599048965355,3463,-568556,-573400,0.12386028182139856,-580.7861280820526,0.22605013162412566
2023-10-04T06:15:00-04:00,1.05081,1.05116,1.05068,1.05099,1.0486805835242747,1.0499566666666666,1.049526666666659,1.0490273333333264,1.0481205000000051,1.0472328000000013,1.047166600000004,1.0482493000000073,1.0496497385121621,1.0490295239172283,2532,-566024,-571701.2,0.1299032325192903,-580.3524055251678,0.23079050516418442
2023-10-04T06:30:00-04:00,1.05099,1.05099,1.05023,1.05035,1.04917646681942,1.0501213333333335,1.0497455555555477,1.0492686666666597,1.0482875000000051,1.0473056000000012,1.047181200000004,1.0482188000000072,1.0497897908097298,1.0492832191337824,-2580,-568604,-569978.2,0.1318735133624231,-581.9234956402026,0.18790896430681672
2023-10-04T06:45:00-04:00,1.05035,1.05039,1.04997,1.05032,1.049573173455536,1.0502362222222221,1.0499333333333256,1.0494915555555486,1.0484620000000051,1.0473782000000014,1.047200500000004,1.048189300000007,1.0498958326477839,1.049518175307026,-2070,-570674,-569175.4,0.13532387933010906,-581.982618789629,0.16116265985142228
2023-10-04T07:00:00-04:00,1.05032,1.05164,1.0502799999999999,1.05154,1.0498905387644288,1.0505575555555555,1.0502599999999922,1.0497446666666597,1.048714500000005,1.0474752000000012,1.047232500000004,1.0481676000000073,1.050224666118227,1.0497749402456207,3305,-567369,-568245.4,0.14165710751406774,-578.1436935097144,0.28037383177569547
2023-10-04T07:15:00-04:00,1.05154,1.0516,1.0506199999999999,1.05097,1.04997,1.0506995555555556,1.0504133333333254,1.0499757777777707,1.0489820000000052,1.0475656000000013,1.047262100000004,1.0481484000000072,1.0503737328945817,1.0499867521964963,-4192,-571561,-568846.4,0.14388479409564825,-580.4160179101174,0.13147991120341626
2023-10-04T07:30:00-04:00,1.05097,1.05097,1.05041,1.05067,1.0502799999999999,1.0507508888888888,1.0505544444444368,1.0501813333333263,1.049218000000005,1.0476494000000012,1.047287100000004,1.0481300000000073,1.0504329863156654,1.0501434017571971,-3186,-574747,-570591,0.13122375490874166,-581.3254634699334,0.1210215361158857
2023-10-04T07:45:00-04:00,1.05067,1.05101,1.04975,1.0498,1.05164,1.0506,1.050585555555548,1.0503493333333265,1.0494060000000052,1.0477134000000012,1.0473093000000038,1.0481095000000074,1.0503063890525324,1.0502467214057576,-3522,-578269,-572524,0.11754021936863009,-584.2418311210511,0.026678862718200507
2023-10-04T08:00:00-04:00,1.0498,1.05031,1.04961,1.04979,1.0516021999999998,1.050440888888889,1.0505822222222148,1.0504791111111043,1.0495715000000052,1.047770200000001,1.047335000000004,1.0480893500000072,1.0502031112420258,1.0503081771246061,-4608,-582877,-574964.6,0.10307692517138126,-584.2857251961133,-0.0028576327370382058
2023-10-04T08:15:00-04:00,1.04979,1.05232,1.04974,1.05136,1.04961,1.0505964444444444,1.0506433333333258,1.0505557777777708,1.0497895000000053,1.047860200000001,1.0473748000000038,1.0480781000000072,1.0504344889936206,1.050350141699685,13247,-569630,-575416.8,0.09558681092563791,-564.4743438722286,0.052340575365675095
2023-10-04T08:30:00-04:00,1.05136,1.05266,1.05109,1.0525,1.04961,1.0509677777777777,1.0508111111111036,1.0506353333333265,1.0500025000000053,1.047972800000001,1.047421000000004,1.0480712500000073,1.0508475911948965,1.0504449133597478,8149,-561481,-573400.8,0.08671420776870147,-555.6383029347768,0.14367405969608657
2023-10-04T08:45:00-04:00,1.0525,1.05322,1.05231,1.05252,1.0497319999999999,1.0513095555555554,1.0510522222222147,1.0507348888888821,1.0502065000000051,1.0480830000000012,1.047472800000004,1.0480641000000075,1.0511820729559171,1.050594730687798,5909,-555572,-569565.8,0.08185893979725674,-555.5260178991479,0.2065978007330895
2023-10-04T09:00:00-04:00,1.05252,1.05258,1.05197,1.05227,1.0499412799999999,1.0515531111111112,1.0512688888888815,1.0508715555555486,1.0503915000000053,1.048182400000001,1.0475199000000037,1.0480582500000073,1.0513996583647338,1.0508133845502385,-4494,-560066,-565925.2,0.08276055929364791,-556.593456047591,0.1856577043186951
2023-10-04T09:15:00-04:00,1.05227,1.0524499999999999,1.05114,1.05154,1.0501380031999998,1.0516073333333331,1.0512688888888813,1.051008888888882,1.0505495000000054,1.048270600000001,1.0475594000000037,1.0480482000000073,1.051427726691787,1.0510583076401905,-4544,-564610,-562271.8,0.0808998625076075,-559.745802878728,0
2023-10-04T09:30:00-04:00,1.05154,1.05176,1.05102,1.0513,1.0503229230079998,1.0516135555555555,1.051305555555548,1.0511413333333264,1.0506830000000051,1.048359000000001,1.0476065000000039,1.0480362000000074,1.0514021813534296,1.0512518461121523,-6491,-571101,-562566,0.06536946074066702,-561.2272871779464,0.03139956421210324
2023-10-04T09:45:00-04:00,1.0513,1.05138,1.05052,1.0507,1.0504967476275198,1.0514924444444445,1.051308888888881,1.051240888888882,1.0507880000000054,1.0484344000000008,1.0476475000000038,1.0480240500000073,1.0512617450827437,1.051334676889722,-6293,-577394,-565748.6,0.05341192765187789,-564.8188404928894,0.0028553208904769805
2023-10-04T10:00:00-04:00,1.0507,1.05117,1.04905,1.04964,1.05322,1.0511586666666666,1.0512911111111034,1.0512886666666597,1.0507905000000053,1.048498800000001,1.047673900000004,1.0480064000000073,1.050937396066195,1.0512857415117776,-12791,-590185,-572671.2,0.03889347122666174,-577.7230567296847,-0.015240998285402934
2023-10-04T10:15:00-04:00,1.04964,1.04972,1.0483,1.0484499999999999,1.0531366,1.0505904444444443,1.0511422222222144,1.0512633333333263,1.0507430000000055,1.048534000000001,1.0476885000000038,1.0479813000000073,1.050439916852956,1.051093793209422,-8453,-598638,-580385.6,0.03121337402681701,-587.3064091171701,-0.1276445765343658
2023-10-04T10:30:00-04:00,1.0484499999999999,1.04997,1.0484499999999999,1.04955,1.052943136,1.0502719999999999,1.0509411111111033,1.0511977777777708,1.0507445000000053,1.0485924000000009,1.0477027000000039,1.0479625000000072,1.0502619334823646,1.0508606345675375,6194,-592444,-585952.4,0.028249112485007385,-580.8078636452824,-0.17215796682393178
2023-10-04T10:45:00-04:00,1.04955,1.04964,1.0486199999999999,1.04928,1.05275741056,1.0499397777777777,1.0505833333333257,1.0510533333333263,1.0507175000000055,1.048648200000001,1.0477150000000037,1.0479442500000073,1.0500655467858917,1.05059330765403,-6354,-598798,-591491.8,0.009540354339446047,-582.4424498965329,-0.3059382422802851
2023-10-04T11:00:00-04:00,1.04928,1.05056,1.04903,1.05035,1.0525791141376,1.0498931111111112,1.0503422222222143,1.0508599999999928,1.0506945000000054,1.048728000000001,1.0477428000000037,1.0479302500000072,1.0501224374287133,1.0503654461232237,5652,-593146,-594642.2,-0.013324450366171534,-576.67884056442,-0.20617185421654746
2023-10-04T11:15:00-04:00,1.05035,1.05163,1.0503,1.05142,1.052407949572096,1.0501086666666666,1.0502477777777701,1.050651333333326,1.0507160000000053,1.048830000000001,1.0477908000000038,1.0479258500000073,1.0503819499429705,1.050254356898579,5817,-587329,-594071,-0.026557524004631967,-570.7530158393278,-0.08077774715614978
2023-10-04T11:30:00-04:00,1.05142,1.05179,1.05108,1.05133,1.052243631589212,1.0503251111111112,1.0502244444444366,1.0504677777777705,1.0507650000000055,1.048924200000001,1.0478239000000038,1.0479201500000073,1.0505715599543763,1.050280685518863,-4153,-591482,-592639.8,-0.037044002782358525,-571.1085065090883,-0.01997070962586506
2023-10-04T11:45:00-04:00,1.05133,1.052,1.05127,1.05177,1.0520858863256437,1.0506342222222222,1.050276666666659,1.0503348888888815,1.0508375000000054,1.049034200000001,1.0478660000000037,1.0479212500000072,1.050811247963501,1.0503905484150902,5007,-586475,-591446,-0.04128776498169703,-569.0129894021857,0.044706553790563354
2023-10-04T12:00:00-04:00,1.05177,1.05214,1.05136,1.05174,1.0483,1.050926888888889,1.0503922222222146,1.0502966666666596,1.0508475000000055,1.049148600000001,1.0479190000000036,1.0479306500000072,1.0509969983708007,1.050576838732072,-3323,-589798,-589646,-0.04353265674247137,-569.1077724821372,0.09898163129341676
2023-10-04T12:15:00-04:00,1.05174,1.05199,1.05144,1.05158,1.0483768,1.0511644444444443,1.05060777777777,1.0503497777777704,1.0508780000000055,1.049261800000001,1.0479750000000037,1.0479329500000072,1.0511135986966407,1.0507750709856576,-3028,-592826,-589582,-0.035339916160896864,-569.5684186494407,0.1848252734270848
2023-10-04T12:30:00-04:00,1.05158,1.05218,1.05122,1.0512299999999999,1.048452064,1.051288888888889,1.0509166666666592,1.0504835555555483,1.0509060000000054,1.0493614000000009,1.0480343000000039,1.0479406000000073,1.0511368789573126,1.050926056788526,-3375,-596201,-591356.4,-0.021387670098543345,-570.6917283358176,0.26515332156993704
2023-10-04T12:45:00-04:00,1.0512299999999999,1.05163,1.05109,1.0512299999999999,1.0486011814399998,1.0513515555555555,1.0511033333333257,1.050659333333326,1.0509775000000054,1.049461400000001,1.048094100000004,1.0479491000000072,1.05115550316585,1.0510428454308205,0,-596201,-592300.2,0.0025283934509202862,-570.6917283358176,0.16006860082891752
2023-10-04T13:00:00-04:00,1.0512299999999999,1.05129,1.05066,1.05074,1.0487443341823999,1.0512788888888887,1.0512655555555481,1.0508571111111038,1.0510250000000056,1.049547400000001,1.0481406000000038,1.0479504500000072,1.0510724025326799,1.0510950763446565,-2413,-598614,-594728,0.00959208057556454,-571.8164774392486,0.13914303141201748
2023-10-04T13:15:00-04:00,1.05074,1.05108,1.05016,1.05022,1.048881760815104,1.0510697777777778,1.0512511111111036,1.0510288888888817,1.0509680000000057,1.0496118000000012,1.0481704000000038,1.0479468000000072,1.050901922026144,1.0510760610757248,-2724,-601338,-597036,0.01658758753706005,-573.164555936308,-0.012376826772024896
2023-10-04T13:30:00-04:00,1.05022,1.05058,1.05008,1.05037,1.0490136903824998,1.0508935555555556,1.051134444444437,1.051134222222215,1.0508615000000057,1.0496798000000012,1.0482106000000038,1.0479455500000072,1.0507955376209153,1.0510124488605799,2971,-598367,-598144.2,0.02126441963751458,-572.7402162741417,-0.09986494455117796
2023-10-04T13:45:00-04:00,1.05037,1.05051,1.05018,1.05027,1.0491403427672,1.0507206666666666,1.0510166666666592,1.051154222222215,1.0507490000000055,1.049744200000001,1.0482511000000039,1.0479475000000074,1.0506904300967321,1.0509231590884638,-2757,-601124,-599128.8,0.020428231562550813,-573.0026952101357,-0.10082466970409489
2023-10-04T14:00:00-04:00,1.05027,1.05027,1.04979,1.05026,1.049261929056512,1.0505693333333332,1.0508488888888812,1.0511033333333262,1.0506485000000056,1.049809200000001,1.0482870000000037,1.0479510000000074,1.0506043440773858,1.050812927270771,-2693,-603817,-600652,0.020489240090110314,-573.0283362357769,-0.1435675100069523
2023-10-04T14:15:00-04:00,1.05026,1.05069,1.05012,1.05033,1.0493786518942514,1.0504655555555555,1.0506922222222146,1.0509886666666595,1.0505880000000056,1.049879200000001,1.0483169000000039,1.0479548000000072,1.0505494752619087,1.0507083418166168,2277,-601540,-601237.2,0.015577905390674787,-572.876573815043,-0.13406355182839025
2023-10-04T14:30:00-04:00,1.05033,1.05057,1.0500099999999999,1.05031,1.0494907058184813,1.0503891111111112,1.0505511111111034,1.0508486666666594,1.0505385000000056,1.0499556000000012,1.0483530000000039,1.0479599000000073,1.050501580209527,1.0506282734532932,-2648,-604188,-601807.2,0.007542356633178086,-572.9269960632886,-0.12077064987921816
2023-10-04T14:45:00-04:00,1.05031,1.05069,1.04996,1.05032,1.049598277585742,1.0503428888888888,1.0504499999999923,1.0507117777777704,1.0505195000000056,1.050049600000001,1.048387000000004,1.0479669000000074,1.0504652641676215,1.0505622187626344,2464,-601724,-602478.6,-0.00000906573493418524,-572.9035363228314,-0.0865652616458783
2023-10-04T15:00:00-04:00,1.05032,1.05115,1.05017,1.05111,1.0497015464823123,1.0504748888888888,1.050436666666659,1.0505957777777704,1.0505930000000054,1.050152800000001,1.0484335000000038,1.0479741500000075,1.0505942113340971,1.0505429750101076,2412,-599312,-602116.2,-0.003009768147857586,-571.0893463616766,-0.011415199337908733
2023-10-04T15:15:00-04:00,1.05111,1.05149,1.05104,1.05134,1.04980068462302,1.0506555555555555,1.0505033333333256,1.0505266666666593,1.0507375000000052,1.050258800000001,1.048479400000004,1.0479791000000072,1.0507433690672776,1.050570780008086,1915,-597397,-600832.2,-0.009667681931613582,-570.670313149168,0.057102613396266814
2023-10-04T15:30:00-04:00,1.05134,1.05194,1.05113,1.05179,1.0498958572380992,1.050912888888889,1.0506777777777703,1.0505237777777705,1.0508495000000053,1.050365000000001,1.048520200000004,1.0479884500000074,1.0509526952538222,1.0506514240064686,2214,-595183,-599560.8,-0.014809752684108484,-569.7226653853617,0.14949248728838446
2023-10-04T15:45:00-04:00,1.05179,1.05181,1.05133,1.05153,1.0499872229485752,1.0510833333333334,1.0508066666666591,1.0505748888888815,1.0509620000000053,1.050455600000001,1.048560900000004,1.0479981500000073,1.0510681562030577,1.0507647392051749,-2133,-597316,-598186.4,-0.011314759666417842,-570.2499379397688,0.11043727448423411
2023-10-04T16:00:00-04:00,1.05153,1.05161,1.05104,1.0510599999999999,1.0500749340306321,1.0511339999999998,1.050894444444437,1.0506637777777703,1.0509975000000054,1.050512000000001,1.0485945000000039,1.0480024000000072,1.0510665249624462,1.0508849913641396,-911,-598227,-597487,-0.012813600177334798,-570.6571255616152,0.07521875327295327
2023-10-04T16:15:00-04:00,1.0510599999999999,1.0512,1.05099,1.05115,1.0501591366694067,1.051185111111111,1.0509933333333257,1.0507751111111037,1.0509840000000055,1.0505662000000011,1.0486321000000038,1.0480118000000074,1.051083219969957,1.0509827930913118,644,-597583,-597141.2,-0.008064844978022755,-570.6019812311297,0.08474092129568464
2023-10-04T16:30:00-04:00,1.05115,1.05116,1.0502799999999999,1.0506,1.0502399712026305,1.0511064444444442,1.0510233333333256,1.050879111111104,1.0509475000000053,1.050606800000001,1.048664200000004,1.048019050000007,1.0509865759759656,1.0510314344730494,-960,-598543,-597370.4,-0.0011146211101103398,-571.1042882282281,0.02570620662077561
2023-10-04T16:45:00-04:00,1.0506,1.05063,1.05036,1.05036,1.0502799999999999,1.050973777777778,1.0510288888888815,1.050949333333326,1.0508770000000054,1.050646400000001,1.0486965000000041,1.0480246000000073,1.0508612607807724,1.0510131475784394,-1403,-599946,-598323,0.0035660380866312266,-571.4247907981882,0.004760499281153513
2023-10-04T17:00:00-04:00,1.05036,1.0507,1.05009,1.05064,1.05218,1.0508959999999998,1.0510644444444368,1.0510008888888815,1.0508220000000053,1.050686600000001,1.048733200000004,1.0480330000000073,1.0508170086246178,1.0509629180627513,132,-599814,-598822.6,0.011826983466975501,-571.3896028626232,0.030466905324101037
2023-10-04T17:15:00-04:00,1.05064,1.05065,1.05043,1.05056,1.0521382,1.050795111111111,1.051003333333326,1.0510226666666593,1.0507710000000052,1.0507258000000013,1.048770800000004,1.0480415500000073,1.0507656068996942,1.0509027344502009,-141,-599955,-599168.2,0.01945892056037207,-571.4003391757276,-0.05232563670786601
2023-10-04T17:30:00-04:00,1.05056,1.05061,1.05051,1.05053,1.0520972359999998,1.0507004444444445,1.0509133333333258,1.0510066666666593,1.0507360000000052,1.0507446000000011,1.048810800000004,1.0480509500000073,1.0507184855197553,1.0508297875601607,-302,-600257,-599703,0.018698492473978236,-571.4089631477044,-0.07704453364277755
2023-10-04T17:45:00-04:00,1.05053,1.0506,1.0504499999999999,1.0506,1.0520570912799998,1.0506377777777776,1.0507811111111036,1.050958222222215,1.050704500000005,1.0507686000000012,1.0488505000000041,1.0480635000000074,1.0506947884158042,1.0507714300481283,188,-600069,-600008.2,0.01451145961202107,-571.3964361375286,-0.11314045579440994
2023-10-04T18:00:00-04:00,1.0506,1.05084,1.05059,1.05078,1.0520177494543999,1.0506375555555556,1.0506977777777702,1.0508919999999926,1.0507065000000053,1.0507938000000012,1.048891800000004,1.0480769500000071,1.0507118307326433,1.0507415440385026,494,-599575,-599934,0.0069386314085064515,-571.3117987874429,-0.07132464123705727
2023-10-04T18:15:00-04:00,1.05078,1.05085,1.05074,1.05079,1.0519791944653119,1.050656,1.0506677777777704,1.0508126666666595,1.0507350000000053,1.050813200000001,1.048934500000004,1.0480909000000072,1.0507274645861147,1.0507236352308018,245,-599330,-599837.2,-0.00033084189715438975,-571.3094671861562,-0.025688352710596208
2023-10-04T18:30:00-04:00,1.05079,1.05083,1.05058,1.05058,1.0519414105760057,1.0506384444444443,1.050604444444437,1.0507328888888816,1.0507455000000052,1.0508086000000012,1.048975800000004,1.0481043000000072,1.0506979716688918,1.0507101081846413,-374,-599704,-599787,-0.006530621863541434,-571.3842109503717,-0.05422632355039332
2023-10-04T18:45:00-04:00,1.05058,1.05067,1.05052,1.05064,1.0519043823644856,1.0506455555555556,1.0506088888888814,1.0506719999999927,1.0507640000000051,1.0508016000000011,1.049017200000004,1.0481189500000072,1.0506863773351134,1.0507036865477128,328,-599376,-599610.8,-0.012607888767488497,-571.3654784407104,0.003807348181995051
2023-10-04T19:00:00-04:00,1.05064,1.05069,1.05051,1.05053,1.051868094717196,1.0506297777777778,1.0506277777777702,1.050641333333326,1.0507775000000052,1.050805200000001,1.049055400000004,1.0481324000000074,1.0506551018680907,1.05069574923817,-478,-599854,-599567.8,-0.014452222691733617,-571.4155241271492,0.01618492707262305
2023-10-04T19:15:00-04:00,1.05053,1.05081,1.05052,1.05079,1.051832532822852,1.0506622222222222,1.050644444444437,1.0506306666666592,1.0508005000000051,1.0508146000000012,1.049096400000004,1.0481471500000072,1.0506820814944726,1.0506897993905362,370,-599484,-599549.6,-0.01276151822155668,-571.3239513020038,0.014277012106894128
2023-10-04T19:30:00-04:00,1.05079,1.05092,1.0506199999999999,1.05068,1.0517976821663948,1.0506693333333332,1.0506577777777701,1.050628666666659,1.0508190000000053,1.050797400000001,1.049136300000004,1.0481614000000075,1.0506816651955782,1.0506806395124288,-534,-600018,-599687.2,-0.01396675260281686,-571.3798521004506,0.011422479439548433
2023-10-04T19:45:00-04:00,1.05068,1.05076,1.05061,1.05068,1.0517635285230669,1.0506737777777777,1.050674444444437,1.050642666666659,1.0508370000000054,1.050791600000001,1.0491786000000038,1.0481753500000075,1.0506813321564625,1.050677311609943,0,-600018,-599750,-0.014501252092184906,-571.3798521004506,0.014278507039312967
2023-10-04T20:00:00-04:00,1.05068,1.05069,1.0503,1.05041,1.0517300579526054,1.0506208888888888,1.050653333333326,1.050651555555548,1.0508020000000051,1.0507864000000011,1.049217900000004,1.0481868000000074,1.05062706572517,1.0506654492879544,-1323,-601341,-600143,-0.016051007945887333,-571.7198319230417,-0.018084903864450073
2023-10-04T20:15:00-04:00,1.05041,1.0506199999999999,1.0502,1.05039,1.0516972567935534,1.0505682222222223,1.0506099999999927,1.0506479999999925,1.0507545000000051,1.050798200000001,1.0492558000000038,1.0481975500000074,1.0505796525801359,1.0506503594303633,-993,-602334,-600639,-0.014787167656631265,-571.7387388260607,-0.03711528578771127
2023-10-04T20:30:00-04:00,1.05039,1.05135,1.05039,1.05133,1.0516651116576823,1.0507122222222223,1.0506699999999924,1.0506531111111035,1.0507315000000053,1.0508290000000011,1.0492996000000039,1.0482137500000073,1.0507297220641088,1.0506598875442905,1596,-600738,-600889.8,-0.00950765914876785,-570.3104693261605,0.051389906641689305
2023-10-04T20:45:00-04:00,1.05133,1.05221,1.05119,1.05201,1.05009,1.0509802222222222,1.0508288888888813,1.0506873333333258,1.0507555000000053,1.0508420000000012,1.049351100000004,1.0482355500000073,1.050985777651287,1.0507207100354323,2163,-598575,-600601.2,0.0011057415178179022,-568.9114414281651,0.13611528869765466
2023-10-04T21:00:00-04:00,1.05201,1.05288,1.05201,1.05279,1.0501324,1.0513724444444443,1.05106777777777,1.0507659999999923,1.0508420000000052,1.050847800000001,1.049410300000004,1.0482609000000074,1.0513466221210295,1.0508537680283456,2937,-595638,-599725.2,0.016426574345813225,-566.7338385536676,0.20463717353231117
2023-10-04T21:15:00-04:00,1.05279,1.0528,1.05218,1.05218,1.0502423040000002,1.0515948888888889,1.0512511111111036,1.0508855555555479,1.0508935000000055,1.050841000000001,1.0494620000000041,1.0482837500000073,1.0515132976968236,1.0510310144226764,-2137,-597775,-599012,0.026004779550978886,-567.9720437037926,0.15706357743233695
2023-10-04T21:30:00-04:00,1.05218,1.05252,1.05202,1.05251,1.0503478118400003,1.0518466666666666,1.0514422222222146,1.0510519999999923,1.0509890000000053,1.050845800000001,1.0495141000000041,1.0483069000000074,1.0517126381574589,1.0512576115381411,1759,-596016,-597748.4,0.038680802052604074,-567.4203605317115,0.16368636930311156
2023-10-04T21:45:00-04:00,1.05251,1.05288,1.05213,1.05285,1.0504490993664002,1.0521282222222224,1.0516833333333258,1.0512546666666591,1.0511135000000054,1.0508720000000011,1.0495713000000042,1.0483312000000076,1.0519401105259671,1.0514996892305128,1920,-594096,-596420,0.04808217235579055,-566.8001288949574,0.2065329120188835
2023-10-04T22:00:00-04:00,1.05285,1.05288,1.05234,1.05267,1.0505463353917441,1.0523255555555555,1.051904444444437,1.0514697777777702,1.0512150000000053,1.0508994000000011,1.049629200000004,1.0483581000000075,1.0520860884207737,1.0517197513844099,-1536,-595632,-595831.4,0.056543755045567724,-567.0627304051442,0.1894011497315963
2023-10-04T22:15:00-04:00,1.05267,1.0527199999999999,1.05224,1.05235,1.0506396819760744,1.0524146666666667,1.0521199999999924,1.0516802222222146,1.0513045000000052,1.0509324000000009,1.0496834000000042,1.0483858000000075,1.0521388707366188,1.0518782011075278,-1200,-596832,-596070.2,0.06467919725163056,-567.4275170904302,0.18468978779712975
2023-10-04T22:30:00-04:00,1.05235,1.05235,1.05208,1.05212,1.0507292946970315,1.0524146666666667,1.0523122222222148,1.0518924444444369,1.0513840000000054,1.050982000000001,1.0497404000000041,1.0484107000000076,1.052135096589295,1.0520025608860222,-1060,-597892,-596093.6,0.07387374248207114,-567.6591890626828,0.1647007302049724
2023-10-04T22:45:00-04:00,1.05212,1.05244,1.0521099999999999,1.05231,1.0508153229091501,1.0524142222222221,1.0524211111111037,1.0520882222222148,1.0514695000000054,1.051059200000001,1.0497966000000043,1.0484361000000075,1.052170077271436,1.0520940487088175,823,-597069,-596304.2,0.08406706705960726,-567.5105653315494,0.0932152606698164
2023-10-04T23:00:00-04:00,1.05231,1.05258,1.05215,1.05254,1.0508979099927842,1.0524380000000002,1.0524799999999925,1.052247555555548,1.0515575000000053,1.0511190000000008,1.0498557000000042,1.0484648500000076,1.0522440618171487,1.0521548389670539,983,-596086,-596702.2,0.08678136376689288,-567.2957141945271,0.05037974924194081
2023-10-04T23:15:00-04:00,1.05254,1.05269,1.05227,1.0524499999999999,1.0509771935930727,1.0524319999999998,1.0524422222222147,1.0523551111111034,1.0516405000000053,1.051182400000001,1.049915300000004,1.0484918500000076,1.052285249453719,1.052194671173643,-1402,-597488,-597073.4,0.0833967287944521,-567.4155956242117,-0.03229513958149365
2023-10-04T23:30:00-04:00,1.0524499999999999,1.05282,1.05243,1.05275,1.0510533058493499,1.0524935555555555,1.052505555555548,1.0524322222222144,1.0517490000000054,1.0512304000000008,1.049979200000004,1.0485192000000074,1.052378199562975,1.0522425369389143,1291,-596197,-596946.4,0.07413441180592972,-567.0475971444738,0.05417324032011457
2023-10-04T23:45:00-04:00,1.05275,1.05285,1.0524499999999999,1.05251,1.051126373615376,1.0524944444444446,1.0525055555555483,1.0524708888888812,1.0518425000000053,1.0512522000000009,1.050041100000004,1.0485461500000075,1.0524045596503802,1.0522964295511312,-984,-597181,-596804.2,0.06852747867708515,-567.2719239077129,0
2023-10-05T00:00:00-04:00,1.05251,1.05264,1.0524499999999999,1.05251,1.051196518670761,1.0524953333333333,1.0524677777777705,1.0524802222222145,1.0519415000000052,1.0512758000000009,1.0501000000000043,1.0485736000000074,1.0524256477203042,1.0523475436409049,0,-597181,-596826.6,0.060056063190826084,-567.2719239077129,-0.03229329914042902
2023-10-05T00:15:00-04:00,1.05251,1.05254,1.05224,1.05238,1.0512638579239306,1.0524777777777778,1.0524355555555482,1.0524713333333255,1.0520210000000052,1.0512880000000009,1.0501611000000042,1.0486033500000074,1.0524165181762435,1.0523820349127238,-1176,-598357,-597280.8,0.04720882197059461,-567.4171766844086,-0.027548994461692785
2023-10-05T00:30:00-04:00,1.05238,1.05243,1.05218,1.0522799999999999,1.0513285036069735,1.0524466666666668,1.0524277777777702,1.0524684444444368,1.0521010000000053,1.0512988000000008,1.0502237000000043,1.0486320000000076,1.0523892145409948,1.052402827930179,-864,-599221,-597627.4,0.036754221983025435,-567.4992763062183,-0.006651779350977764
2023-10-05T00:45:00-04:00,1.0522799999999999,1.05236,1.05205,1.05205,1.0513905634626945,1.052371111111111,1.0524199999999924,1.0524513333333256,1.0521695000000053,1.0513082000000007,1.0502850000000041,1.0486590000000076,1.0523213716327957,1.0523914623441433,-1100,-600321,-598452.2,0.027699740247258266,-567.7397066099397,-0.006653233471468511
2023-10-05T01:00:00-04:00,1.05205,1.05235,1.052,1.05235,1.0514501409241868,1.052357111111111,1.0524244444444368,1.0524351111111034,1.052266500000005,1.0513306000000007,1.0503460000000042,1.0486864500000075,1.0523270973062366,1.0523759698753146,1290,-599031,-598822.2,0.0223255704495408,-567.3718533710253,0.0038011612547460306
2023-10-05T01:15:00-04:00,1.05235,1.05262,1.0522799999999999,1.05256,1.0515073352872193,1.0523842222222222,1.0524266666666593,1.0524268888888813,1.0523750000000052,1.0513572000000009,1.050409300000004,1.0487154500000075,1.0523736778449893,1.0523655759002515,1374,-597657,-598917.4,0.014969755031112546,-567.097667026178,0.0019001653143737036
2023-10-05T01:30:00-04:00,1.05256,1.05257,1.05219,1.05222,1.0515622418757304,1.0523428888888888,1.0524011111111036,1.0524199999999921,1.052419500000005,1.0513868000000008,1.050467100000004,1.0487416500000075,1.0523429422759913,1.052350860720201,-1585,-599242,-599094.4,0.0036471050313641395,-567.6096568414854,-0.021853769775281723
2023-10-05T01:45:00-04:00,1.05222,1.05231,1.05166,1.05173,1.0516149522007012,1.0522086666666666,1.0522877777777702,1.0523919999999922,1.0524055000000052,1.0514170000000007,1.0505144000000042,1.0487661500000076,1.052220353820793,1.0523170885761608,-1665,-600907,-599431.6,-0.005004497712947938,-568.3850175075056,-0.09688909997625465
2023-10-05T02:00:00-04:00,1.05173,1.0521,1.05115,1.05124,1.05288,1.051999111111111,1.0521466666666592,1.0523373333333255,1.052328000000005,1.0514344000000007,1.0505571000000042,1.0487900000000074,1.0520242830566344,1.0522576708609286,-3071,-603978,-600163,-0.015869245022835328,-569.8157934671153,-0.12066393668469699
2023-10-05T02:15:00-04:00,1.05124,1.05149,1.051,1.05143,1.0528454,1.0518557777777777,1.0520266666666591,1.05225777777777,1.0522905000000053,1.0514576000000007,1.0506009000000043,1.0488165500000075,1.0519054264453076,1.0521733366887427,2562,-601416,-600640,-0.019979192677507366,-569.3527403108424,-0.10261185166886488
2023-10-05T02:30:00-04:00,1.05143,1.05157,1.05084,1.05094,1.052771584,1.0516384444444444,1.0518666666666592,1.05214577777777,1.052212000000005,1.0514712000000008,1.0506402000000044,1.0488387000000075,1.0517123411562461,1.052041069350994,-1938,-603354,-601779.4,-0.029289375134150475,-570.2559102793616,-0.13683270301603107
2023-10-05T02:45:00-04:00,1.05094,1.05097,1.05047,1.05071,1.05265568896,1.051407111111111,1.0516922222222147,1.0520039999999924,1.0521050000000052,1.0514788000000008,1.0506790000000041,1.0488606500000075,1.0515118729249968,1.051874855480795,-2119,-605473,-603025.6,-0.03701750852548744,-570.7196570203744,-0.14919983274412224
2023-10-05T03:00:00-04:00,1.05071,1.0512299999999999,1.05047,1.05082,1.0524808338432001,1.0512326666666667,1.051555555555548,1.0518575555555478,1.052012500000005,1.0514890000000008,1.050722300000004,1.0488830500000075,1.0513734983399974,1.051705484384636,4037,-601436,-603131.4,-0.04171019494008537,-570.2970189946582,-0.11691459531389596
2023-10-05T03:15:00-04:00,1.05082,1.05107,1.05015,1.05057,1.0523199671357442,1.0510355555555555,1.0513577777777703,1.05169977777777,1.0519235000000051,1.0514940000000008,1.0507718000000041,1.0489035500000075,1.051212798671998,1.0515431875077088,-3301,-604737,-603283.2,-0.04627714136441343,-571.0823580631954,-0.16914524635338937
2023-10-05T03:30:00-04:00,1.05057,1.05144,1.0505,1.05129,1.0521029704221698,1.051022,1.0512166666666591,1.0515377777777701,1.051882000000005,1.0514976000000007,1.0508252000000042,1.0489281000000075,1.0512282389375984,1.0514077500061672,3705,-601032,-603206.4,-0.051557825888374924,-568.5431650536862,-0.12065820475791236
2023-10-05T03:45:00-04:00,1.05129,1.05142,1.05083,1.05087,1.0519076733799528,1.0509526666666669,1.0510666666666593,1.0513777777777702,1.051810000000005,1.0514882000000008,1.0508735000000042,1.0489496000000074,1.0511565911500786,1.0512966000049333,-3225,-604257,-603387,-0.0619688697877441,-569.8315821412646,-0.12830016536465402
2023-10-05T04:00:00-04:00,1.05087,1.05203,1.05064,1.05128,1.05015,1.0509953333333333,1.0510166666666594,1.0512426666666592,1.0517470000000049,1.0514780000000006,1.050921500000004,1.0489722000000075,1.051181272920063,1.0512304800039467,3975,-600282,-602348.8,-0.06624567401966881,-568.2807242806347,-0.04278664676295831
2023-10-05T04:15:00-04:00,1.05128,1.05164,1.05113,1.05136,1.0501875999999999,1.0510640000000002,1.0510299999999928,1.051137555555548,1.051692500000005,1.0514746000000006,1.0509651000000042,1.0489946000000074,1.0512170183360503,1.0511991840031574,3201,-597081,-601477.8,-0.064424552776867,-568.0371355126564,0.011415090749982879
2023-10-05T04:30:00-04:00,1.05136,1.05157,1.05109,1.05118,1.0502244479999998,1.051094,1.051002222222215,1.0510664444444369,1.051614000000005,1.0514770000000007,1.0509945000000043,1.0490150500000075,1.0512096146688403,1.0511985472025258,-3183,-600264,-600583.2,-0.059248278132100374,-568.5820868138284,-0.023777141607152493
2023-10-05T04:45:00-04:00,1.05118,1.05143,1.05027,1.05041,1.0502605590399998,1.0509755555555556,1.050943333333326,1.0510117777777706,1.051509000000005,1.0514622000000007,1.0510142000000042,1.0490307000000074,1.0510496917350722,1.0511628377620208,-2825,-603089,-600994.6,-0.05835792650242992,-570.6514279352347,-0.05043104268558809
2023-10-05T05:00:00-04:00,1.05041,1.05148,1.05032,1.05138,1.05027,1.051062888888889,1.0510177777777703,1.0510019999999927,1.0514525000000048,1.0514778000000007,1.0510423000000042,1.0490489500000075,1.0511157533880577,1.0511546702096166,3459,-599630,-600069.2,-0.04905903387239903,-567.4572180552833,0.06376640557336928
2023-10-05T05:15:00-04:00,1.05138,1.05164,1.05118,1.05128,1.05027,1.0511153333333334,1.0510688888888815,1.0510124444444369,1.0513975000000049,1.0514962000000008,1.0510713000000043,1.0490698000000074,1.0511486027104462,1.051148136167693,-3007,-602637,-600540.2,-0.03807008319150394,-567.7432231152997,0.04377533735557992
2023-10-05T05:30:00-04:00,1.05128,1.05134,1.05054,1.05108,1.0503052,1.0511175555555556,1.051125555555548,1.0510315555555478,1.0513375000000047,1.0515050000000008,1.0510958000000041,1.0490848000000075,1.051134882168357,1.0511317089341545,-2869,-605506,-602225.2,-0.029711450185811453,-568.2890339363939,0.048545075530427334
2023-10-05T05:45:00-04:00,1.05108,1.05122,1.05074,1.05078,1.050339696,1.0510484444444446,1.0510688888888815,1.0510448888888813,1.0512740000000047,1.0515094000000007,1.0511176000000042,1.0490974500000074,1.0510639057346856,1.0511025671473235,-2849,-608355,-603843.4,-0.02092172448619107,-569.1021975395449,-0.048511828325201456
2023-10-05T06:00:00-04:00,1.05078,1.05085,1.0505,1.05084,1.05037350208,1.0510026666666665,1.0510655555555481,1.0510693333333259,1.0511985000000048,1.0515156000000008,1.0511301000000042,1.0491076000000075,1.0510191245877485,1.0510964537178589,2474,-605881,-604401.8,-0.01972248998001377,-568.9609310517931,-0.0028547774700937788
2023-10-05T06:15:00-04:00,1.05084,1.05154,1.05052,1.05149,1.0504066320384,1.0510875555555557,1.0510888888888816,1.051083555555548,1.0511450000000047,1.0515334000000007,1.0511510000000042,1.0491218500000075,1.0511132996701988,1.051095962974287,2652,-603229,-605121.6,-0.009929577911222082,-567.32052908765,0.019975648732977275
2023-10-05T06:30:00-04:00,1.05149,1.05204,1.05143,1.052,1.050439099397632,1.051269777777778,1.0511599999999925,1.05110177777777,1.0511340000000047,1.0515578000000005,1.0511758000000042,1.0491404000000073,1.051290639736159,1.0511243703794295,3066,-600163,-604626.8,-0.0005436038213543518,-565.8334393388174,0.06087353523055603
2023-10-05T06:45:00-04:00,1.052,1.0523,1.05168,1.05188,1.0505031354217267,1.051413777777778,1.0512377777777704,1.0511242222222146,1.0511415000000048,1.0515796000000006,1.0511964000000042,1.0491571500000074,1.0514085117889271,1.0511790963035437,-2854,-603017,-604129,0.005943493324609131,-566.1589906696162,0.06659183013374712
2023-10-05T07:00:00-04:00,1.05188,1.05205,1.0511,1.05146,1.0506109472964231,1.0514582222222222,1.051354444444437,1.0511813333333258,1.0511525000000046,1.0515972000000007,1.051202900000004,1.0491721500000073,1.0514188094311416,1.0512500770428348,-2889,-605906,-603639.2,0.00983044075273781,-567.3125252933371,0.09996096762216614
2023-10-05T07:15:00-04:00,1.05146,1.05205,1.05132,1.05169,1.0507122904586377,1.0515253333333334,1.0513888888888814,1.0512459999999924,1.0511655000000046,1.0516182000000007,1.0512099000000041,1.0491882500000074,1.0514730475449132,1.0513408616342677,2613,-603293,-603121.6,0.019968525110758268,-566.7409486285093,0.029485057733648394
2023-10-05T07:30:00-04:00,1.05169,1.05247,1.05152,1.05238,1.0508075530311194,1.0517235555555555,1.0515111111111035,1.051330444444437,1.051237500000005,1.0516552000000008,1.051230200000004,1.0492057000000072,1.0516544380359305,1.051449089307414,2995,-600298,-602535.4,0.02517701598471201,-564.7759684537427,0.10463435050605936
2023-10-05T07:45:00-04:00,1.05238,1.05252,1.05206,1.05237,1.0509405487886299,1.0518953333333334,1.051654444444437,1.0514293333333256,1.051320500000005,1.0516868000000006,1.051250700000004,1.0492256000000073,1.0517975504287445,1.051550471445931,-3245,-603543,-603211.4,0.029066291255563672,-564.8068033232768,0.1227309053544938
2023-10-05T08:00:00-04:00,1.05237,1.05297,1.0521,1.05234,1.051098493909767,1.0520324444444447,1.0518277777777703,1.0515473333333254,1.051396500000005,1.0517200000000007,1.0512587000000042,1.0492456000000072,1.0519060403429956,1.0516499771567447,-3884,-607427,-604093.4,0.03366585517767879,-564.917524837573,0.1484611431508028
2023-10-05T08:15:00-04:00,1.05234,1.05264,1.05144,1.05168,1.0513230746405948,1.052002888888889,1.0519211111111035,1.051660666666659,1.051452000000005,1.0517400000000008,1.0512658000000041,1.0492639500000074,1.0518608322743965,1.0517383817253954,-3934,-611361,-605184.4,0.03832948136330537,-567.384826280073,0.07993605115906817
2023-10-05T08:30:00-04:00,1.05168,1.05177,1.04999,1.05049,1.05297,1.0517166666666669,1.0518099999999924,1.0517448888888812,1.051412000000005,1.0517416000000008,1.0512640000000042,1.0492755500000073,1.0515866658195172,1.0517611053803162,-10286,-621647,-608855.2,0.03536307158730379,-579.0236707955152,-0.09510313935464074
2023-10-05T08:45:00-04:00,1.05049,1.05175,1.05034,1.05147,1.0529104,1.0516486666666667,1.0517511111111033,1.051792888888881,1.0514420000000049,1.0517632000000008,1.051280700000004,1.0492950000000072,1.0515633326556137,1.051742884304253,6751,-614896,-611774.8,0.034357335309388094,-572.7256765261743,-0.05038022813689558
2023-10-05T09:00:00-04:00,1.05147,1.0522,1.05109,1.05117,1.0528519920000001,1.0515324444444443,1.0516722222222146,1.0517964444444368,1.051436500000005,1.051760000000001,1.051294500000004,1.0493147500000073,1.051484666124491,1.0516803074434022,-7071,-621967,-615459.6,0.025104155297206405,-574.7431377946839,-0.06749819371030806
2023-10-05T09:15:00-04:00,1.05117,1.05281,1.05077,1.05276,1.04999,1.05175,1.051816666666659,1.0517942222222145,1.0515065000000048,1.0517750000000008,1.051308500000004,1.0493416500000072,1.0517397328995928,1.0516470459547218,6466,-615501,-617074.4,0.026769026909169224,-564.9626646076638,0.12363760865842321
2023-10-05T09:30:00-04:00,1.05276,1.0532,1.05174,1.05188,1.0500464,1.0517626666666666,1.05183777777777,1.0517775555555477,1.0515415000000048,1.0517568000000008,1.0513023000000041,1.0493616500000074,1.0517677863196742,1.0516284367637774,-9264,-624765,-619755.2,0.028407740056481046,-572.7064238690339,0.018066160180272937
2023-10-05T09:45:00-04:00,1.05188,1.0530599999999999,1.05147,1.05251,1.050172544,1.051897111111111,1.0518522222222146,1.0517859999999923,1.0516465000000046,1.051763400000001,1.051302200000004,1.0493875000000075,1.0519162290557393,1.0516943494110216,7658,-617107,-618847.2,0.030181122964393015,-568.1198360453268,0.01235295235560952
2023-10-05T10:00:00-04:00,1.05251,1.05252,1.05125,1.052,1.05029364224,1.0519266666666665,1.0518111111111035,1.0517979999999922,1.0516775000000047,1.0517532000000007,1.0512995000000043,1.0494097000000076,1.0519329832445914,1.051768279528817,-7565,-624672,-620802.4,0.01936614696104056,-571.7855019297365,-0.03515873694612935
2023-10-05T10:15:00-04:00,1.052,1.05332,1.05174,1.05277,1.0504098965504,1.0521184444444445,1.0518588888888811,1.0518353333333255,1.0517520000000047,1.0517516000000007,1.0513118000000043,1.0494356000000074,1.052100386595673,1.0518914236230537,7279,-617393,-619887.6,0.016874698908820786,-566.4577167586342,0.0408613185852415
2023-10-05T10:30:00-04:00,1.05277,1.05294,1.0517,1.05214,1.0505845027573761,1.0521746666666667,1.0519099999999924,1.051853999999992,1.0518050000000048,1.0517410000000007,1.0513202000000041,1.0494633500000077,1.0521083092765384,1.0519651388984426,-5768,-623161,-621419.6,0.011078824911266527,-569.9094108608592,0.04373954054466444
2023-10-05T10:45:00-04:00,1.05214,1.05325,1.05175,1.05303,1.0507486325919335,1.0523986666666667,1.0521922222222144,1.051924888888881,1.0519175000000047,1.0517546000000007,1.0513435000000042,1.0494955000000075,1.0522926474212306,1.052070111118754,7466,-615695,-619605.6,0.015084342389386753,-563.5939585446287,0.24179192567278002
2023-10-05T11:00:00-04:00,1.05303,1.05313,1.05201,1.05253,1.0509029146364175,1.052466222222222,1.0523099999999923,1.0520164444444364,1.0520020000000048,1.0517628000000008,1.051372400000004,1.0495231500000075,1.0523401179369845,1.052154888895003,-6150,-621845,-620553.2,0.026553944433343336,-566.5141032698499,0.10081124520909403
2023-10-05T11:15:00-04:00,1.05253,1.05296,1.05222,1.05273,1.0510479397582324,1.052550222222222,1.0524833333333254,1.0521508888888806,1.0520640000000046,1.0517712000000008,1.0514152000000039,1.0495518500000076,1.0524180943495876,1.0522519111160022,5198,-616647,-618948.2,0.02997360675026103,-565.5263879553222,0.14840606181683325
2023-10-05T11:30:00-04:00,1.05273,1.05374,1.05271,1.05291,1.0511842633727384,1.0526355555555555,1.0524999999999922,1.052279111111103,1.0521095000000047,1.051778600000001,1.0514488000000042,1.0495757500000076,1.05251647547967,1.0523351288928016,5541,-611106,-617690.8,0.04008293583081716,-564.5789655393178,0.014248261712080105
2023-10-05T11:45:00-04:00,1.05291,1.05318,1.05239,1.05257,1.0513887223029192,1.0526495555555555,1.052576666666659,1.0524124444444365,1.0521440000000046,1.0517810000000007,1.051481700000004,1.0495983500000077,1.0525271803837362,1.0524189031142412,-5081,-616187,-616296,0.03569624653101431,-566.2196945664901,0.06559683614101224
2023-10-05T12:00:00-04:00,1.05257,1.05346,1.0524,1.05341,1.0515768245186856,1.0528162222222222,1.052676666666659,1.0525093333333253,1.0522415000000047,1.0517942000000007,1.0515123000000042,1.0496275500000076,1.0527037443069889,1.052501122491393,4637,-611550,-615467,0.04331043808728088,-562.5191520847552,0.08550987639071371
2023-10-05T12:15:00-04:00,1.05341,1.0539,1.05311,1.05387,1.0517498785571908,1.053054888888889,1.0528844444444367,1.0526242222222142,1.0523505000000046,1.0518214000000006,1.051536800000004,1.0496638000000078,1.0529369954455912,1.0526204979931142,3859,-607691,-612636.2,0.0453239330822134,-560.8340152434489,0.17775665399239907
2023-10-05T12:30:00-04:00,1.05387,1.054,1.05348,1.05361,1.0519648907014718,1.0532,1.0529777777777702,1.052723111111103,1.0524120000000046,1.0518434000000008,1.051559600000004,1.0496917500000078,1.053071596356473,1.0527511983944913,-2853,-610544,-611415.6,0.05193066981847026,-561.5378781487412,0.07978950767973554
2023-10-05T12:45:00-04:00,1.05361,1.05362,1.05309,1.05359,1.0522091038172952,1.0533224444444445,1.053138888888881,1.0528508888888808,1.0524730000000047,1.0518676000000007,1.051577800000004,1.049721900000008,1.0531752770851783,1.052882958715593,-2772,-613316,-611857.6,0.054244377049504154,-561.5904972392964,0.13781435930579117
2023-10-05T13:00:00-04:00,1.05359,1.05375,1.0528899999999999,1.05335,1.0524240113592198,1.0533646666666667,1.0531744444444366,1.0529704444444363,1.0525235000000046,1.0518890000000005,1.051593900000004,1.049756450000008,1.0532102216681427,1.0530195669724745,-2818,-616134,-611847,0.061304422379052516,-562.2324167715623,0.030388497953533898
2023-10-05T13:15:00-04:00,1.05335,1.0536,1.05313,1.05357,1.0526131299961135,1.0534437777777776,1.0532899999999923,1.053093111111103,1.0526180000000047,1.0519194000000005,1.0516138000000042,1.049794400000008,1.0532821773345142,1.0531352535779797,3050,-613084,-612153.8,0.060866701290958725,-561.5954015344619,0.09880953512013244
2023-10-05T13:30:00-04:00,1.05357,1.05399,1.05313,1.05372,1.0527795543965799,1.0535297777777777,1.0533999999999923,1.0531962222222142,1.0527795000000046,1.0519468000000005,1.0516387000000043,1.0498365000000078,1.0533697418676113,1.0532218028623839,3389,-609695,-612554.6,0.06293743621680056,-561.1128991853059,0.09404120714713615
2023-10-05T13:45:00-04:00,1.05372,1.05381,1.05358,1.05378,1.0529260078689904,1.0536057777777779,1.053496666666659,1.053299999999992,1.0528950000000046,1.0519712000000006,1.051664200000004,1.049879150000008,1.053451793494089,1.0532978422899069,2182,-607513,-611948.4,0.05802064916382721,-560.9886536551842,0.08262814485567868
2023-10-05T14:00:00-04:00,1.05378,1.05446,1.05378,1.05417,1.0530548869247116,1.0537404444444445,1.0536744444444368,1.053407111111103,1.0530450000000044,1.0520102000000007,1.051698500000004,1.049919550000008,1.0535954347952712,1.0533818738319254,3023,-604490,-610183.2,0.05776935402263517,-559.8698527669529,0.1520088925202168
2023-10-05T14:15:00-04:00,1.05417,1.05465,1.05412,1.05465,1.0532516027552519,1.0539355555555556,1.0538122222222146,1.0535346666666587,1.0531395000000046,1.0520686000000006,1.051742800000004,1.049956600000008,1.053806347836217,1.0535010990655402,2138,-602352,-607426.8,0.06177553802655504,-558.896347544835,0.1177129512725463
2023-10-05T14:30:00-04:00,1.05465,1.05494,1.05434,1.05453,1.0534753463144115,1.0540791111111112,1.053885555555548,1.0536537777777697,1.0532720000000046,1.0521344000000006,1.0517844000000043,1.049997500000008,1.0539510782689736,1.053634879252432,-2285,-604637,-605737.4,0.06440201615762312,-559.1563390111985,0.06262632013435081
2023-10-05T14:45:00-04:00,1.05453,1.05516,1.05443,1.05509,1.0537389839778175,1.05432,1.0540499999999922,1.0537837777777697,1.0534010000000045,1.0522076000000005,1.0518326000000042,1.050041850000008,1.054178862615179,1.0537967034019455,2225,-602412,-604280.8,0.06146326512083523,-557.9747699709624,0.14046943366142575
2023-10-05T15:00:00-04:00,1.05509,1.0551,1.05463,1.0548899999999999,1.054023187182254,1.054488,1.0541944444444367,1.053923333333325,1.0535455000000045,1.0522866000000004,1.0518789000000042,1.050082950000008,1.0543210900921431,1.0539705627215565,-1840,-604252,-603628.6,0.06284887476390001,-558.3235553826338,0.12338765553961757
2023-10-05T15:15:00-04:00,1.0548899999999999,1.0549,1.05446,1.05464,1.0542505497458032,1.054577111111111,1.05433777777777,1.0540559999999917,1.0536390000000047,1.0523652000000006,1.0519220000000042,1.050119450000008,1.0543848720737146,1.054128450177245,-1829,-606081,-603946.8,0.0608753228734478,-558.7570128995311,0.12246641667062357
2023-10-05T15:30:00-04:00,1.05464,1.0549,1.05451,1.05481,1.0544324397966427,1.0546715555555557,1.0544755555555476,1.0541886666666584,1.0537725000000047,1.0524450000000005,1.0519670000000043,1.050160000000008,1.0544698976589717,1.0542611601417957,1797,-604284,-604333.2,0.06550645596755748,-558.467350076198,0.11769507484079178
2023-10-05T15:45:00-04:00,1.05481,1.05515,1.05474,1.05495,1.05446,1.0547664444444445,1.0546122222222145,1.0543339999999917,1.0538685000000048,1.0525326000000006,1.0520133000000043,1.0502001500000078,1.0545659181271774,1.0543841281134365,1860,-602424,-603890.6,0.06589578136875955,-558.2204809718095,0.11672930190183961
2023-10-05T16:00:00-04:00,1.05495,1.05518,1.05483,1.05485,1.05451,1.0548140000000001,1.0547311111111035,1.0544702222222142,1.0539845000000045,1.0526038000000006,1.0520507000000043,1.0502421000000077,1.0546227345017418,1.0544729024907493,-961,-603385,-604085.2,0.06838898221701206,-558.3115753364713,0.10153922071021716
2023-10-05T16:15:00-04:00,1.05485,1.05504,1.0548,1.05502,1.0546440000000001,1.0548717777777776,1.054825555555548,1.0545964444444365,1.0540990000000048,1.0526868000000007,1.0520875000000043,1.0502834500000078,1.0547021876013936,1.0545491219925993,429,-602956,-603826,0.06889631714183714,-558.2424375443682,0.08063215610385586
2023-10-05T16:30:00-04:00,1.05502,1.05507,1.05496,1.05505,1.0547512,1.0549166666666667,1.0548699999999922,1.0547028888888808,1.0542060000000046,1.0527622000000008,1.0521201000000042,1.050320150000008,1.054771750081115,1.0546264975940796,260,-602696,-603149,0.06675692267676336,-558.2350443195952,0.03792727445123557
2023-10-05T16:45:00-04:00,1.05505,1.05512,1.05468,1.05468,1.05518,1.0548786666666667,1.054886666666659,1.054785111111103,1.0543115000000047,1.0528286000000007,1.0521516000000042,1.0503562500000079,1.054753400064892,1.0546831980752636,-1184,-603880,-603068.2,0.059041140441374956,-558.6502663469872,0.014224346391292282
2023-10-05T17:00:00-04:00,1.05468,1.05492,1.05434,1.05473,1.05517,1.0548473333333335,1.054846666666659,1.0548319999999918,1.0543775000000046,1.0528996000000008,1.0521883000000043,1.050391400000008,1.0547487200519134,1.054719758460211,186,-603694,-603322.2,0.051176642747386335,-558.6414485065048,-0.03412031201131069
2023-10-05T17:15:00-04:00,1.05473,1.0549,1.05461,1.05484,1.0551367999999999,1.0548460000000002,1.0548411111111033,1.054853999999992,1.0544260000000047,1.0529882000000008,1.0522252000000043,1.050428650000008,1.0547669760415308,1.0547486067681686,564,-603130,-603271.2,0.04234411913095301,-558.5826277656518,-0.004739830693236591
2023-10-05T17:30:00-04:00,1.05484,1.05497,1.05475,1.05492,1.0551049279999998,1.0548617777777776,1.0548722222222144,1.054863333333325,1.0544915000000046,1.0530590000000009,1.0522684000000042,1.0504663000000078,1.0547975808332246,1.0547676854145347,556,-602574,-603194.8,0.037884809225815094,-558.5404602331349,0.026549343851936014
2023-10-05T17:45:00-04:00,1.05492,1.05494,1.05485,1.05485,1.0550743308799997,1.0548573333333333,1.054876666666659,1.0548646666666586,1.0545545000000047,1.0531304000000008,1.0523133000000042,1.050504900000008,1.0548080646665796,1.0547749483316278,-88,-602662,-603188,0.03427459778165105,-558.5462995384851,0.003792152141147695
2023-10-05T18:00:00-04:00,1.05485,1.05508,1.05485,1.05493,1.05434,1.054868,1.0548744444444367,1.054862222222214,1.0546335000000047,1.053207400000001,1.0523562000000042,1.0505447000000079,1.0548324517332637,1.0547907586653023,489,-602173,-602846.6,0.029359677269493675,-558.5092136968963,-0.0018958244466686595
2023-10-05T18:15:00-04:00,1.05493,1.05497,1.05482,1.05483,1.0543548,1.0548591111111112,1.0548722222222144,1.0548673333333247,1.0546965000000046,1.053288400000001,1.0523989000000042,1.050584850000008,1.0548319613866108,1.0548074069322415,-291,-602464,-602600.6,0.02153741957347438,-558.5367984655539,-0.0018960041712215976
2023-10-05T18:30:00-04:00,1.05483,1.0549,1.05481,1.0548899999999999,1.054369304,1.0548626666666665,1.0548577777777701,1.0548706666666583,1.0547550000000048,1.053369400000001,1.0524425000000042,1.0506266500000079,1.0548435691092886,1.0548227255457931,305,-602159,-602406.4,0.01595570328368585,-558.5194496984541,-0.012322041288334393
2023-10-05T18:45:00-04:00,1.0548899999999999,1.05492,1.05481,1.05483,1.0543835179199998,1.0548571111111111,1.0548333333333255,1.0548628888888805,1.0548075000000048,1.0534362000000008,1.0524848000000042,1.050667650000008,1.0548408552874309,1.0548313804366345,-158,-602317,-602355,0.009142241081730638,-558.5284364174485,-0.020852092317909954
2023-10-05T19:00:00-04:00,1.05483,1.05486,1.05471,1.0547199999999999,1.0543974475615998,1.0548344444444444,1.05483777777777,1.0548551111111026,1.0548350000000049,1.0534906000000008,1.0525242000000044,1.050708000000008,1.0548166842299447,1.0548331043493075,-344,-602661,-602354.8,0.0017696821842248342,-558.5643094965228,0.003792619562314442
2023-10-05T19:15:00-04:00,1.0547199999999999,1.05484,1.05468,1.05475,1.0544110986103679,1.054816888888889,1.0548399999999922,1.0548482222222137,1.0548400000000047,1.0535480000000006,1.0525638000000044,1.050749150000008,1.0548033473839558,1.0548272834794459,463,-602198,-602359.8,-0.00018508946348779696,-558.5511401245567,0.0018962198856703634
2023-10-05T19:30:00-04:00,1.05475,1.0548,1.0547,1.0547199999999999,1.0544244766381605,1.054792888888889,1.0548266666666588,1.0548391111111026,1.0548495000000049,1.0536132000000007,1.0526052000000043,1.050790500000008,1.0547866779071646,1.0548182267835566,-670,-602868,-602440.6,-0.0005958959022367827,-558.5701967730517,-0.011376132873243336
2023-10-05T19:45:00-04:00,1.0547199999999999,1.05479,1.05461,1.05463,1.0544375871053973,1.0547535555555556,1.0547944444444366,1.0548264444444362,1.0548265000000048,1.0536720000000006,1.052645100000004,1.0508311500000078,1.0547553423257316,1.054800581426845,-807,-603675,-602743.8,-0.0030381525141856044,-558.6390586510856,-0.027490236226455415
2023-10-05T20:00:00-04:00,1.05463,1.0548,1.05443,1.05468,1.05508,1.0547306666666667,1.0547755555555476,1.0548148888888806,1.0548160000000046,1.0537180000000006,1.0526866000000041,1.050871000000008,1.0547402738605853,1.054780465141476,1558,-602117,-602703.8,-0.0034625647987626545,-558.565193883347,-0.01611603545527833
2023-10-05T20:15:00-04:00,1.05468,1.05473,1.05422,1.05436,1.055067,1.0546475555555557,1.0547122222222145,1.0547897777777695,1.0548020000000045,1.0537578000000005,1.052722300000004,1.050909350000008,1.0546642190884683,1.0547499721131808,-1948,-604065,-602984.6,-0.005715400159106302,-559.156235715941,-0.054032021081963685
2023-10-05T20:30:00-04:00,1.05436,1.05455,1.05427,1.05451,1.05503312,1.054607111111111,1.054676666666659,1.054757111111103,1.0547870000000046,1.0538012000000005,1.052760600000004,1.050948450000008,1.0546333752707746,1.0547159776905446,1223,-602842,-603113.4,-0.00911038326343587,-558.9822439104854,-0.03033664192333134
2023-10-05T20:45:00-04:00,1.05451,1.05473,1.05412,1.05416,1.0550005952000001,1.0545037777777777,1.054595555555548,1.0547108888888808,1.0547475000000044,1.0538508000000006,1.0527954000000042,1.0509870000000079,1.0545387002166198,1.0546663821524356,-1464,-604306,-603401,-0.012528273265147431,-559.4681567989361,-0.06920152812140579
2023-10-05T21:00:00-04:00,1.05416,1.05423,1.05389,1.05392,1.0549477594880001,1.0543686666666667,1.0544944444444366,1.0546508888888808,1.0547010000000046,1.0539194000000007,1.0528305000000042,1.0510242000000078,1.0544149601732957,1.0545983057219483,-1298,-605604,-603786.8,-0.01707536321249385,-559.7636717112833,-0.08626982546950375
2023-10-05T21:15:00-04:00,1.05392,1.05413,1.05381,1.05402,1.0548631387289602,1.0542737777777778,1.054416666666659,1.0545791111111031,1.0546510000000047,1.0539704000000005,1.052866800000004,1.051061300000008,1.0543359681386366,1.0545174445775587,1542,-604062,-604175.8,-0.021008631011849962,-559.6173607958439,-0.06636832524271115
2023-10-05T21:30:00-04:00,1.05402,1.05446,1.05393,1.05418,1.0547578248560643,1.0542264444444442,1.0543533333333255,1.0545073333333252,1.0546075000000046,1.0540306000000006,1.052895300000004,1.0510974500000079,1.0543047745109093,1.054445555662047,2519,-601543,-603671.4,-0.022336909405956794,-559.2349771598599,-0.05404124200049125
2023-10-05T21:45:00-04:00,1.05418,1.05434,1.05396,1.05432,1.054663042370458,1.0542197777777778,1.0543088888888812,1.05443377777777,1.0545895000000045,1.0540618000000004,1.0529184000000043,1.051134750000008,1.0543078196087274,1.0543804445296374,1754,-599789,-603060.8,-0.023118808550339,-559.0020378136381,-0.037924757281549225
2023-10-05T22:00:00-04:00,1.05432,1.05434,1.05414,1.05427,1.054577738133412,1.054212,1.0542688888888812,1.0543684444444366,1.0545665000000046,1.0541096000000005,1.0529332000000042,1.051171750000008,1.054300255686982,1.0543327556237099,-1164,-600953,-602390.2,-0.025535016160691502,-559.0572392705012,-0.03413519433354977
2023-10-05T22:15:00-04:00,1.05427,1.05444,1.05415,1.05434,1.054500964320071,1.0542262222222223,1.0542311111111033,1.05431577777777,1.0545415000000045,1.0541462000000006,1.0529548000000042,1.051208400000008,1.0543082045495857,1.0543114044989679,985,-599968,-601263,-0.02652437248436258,-558.9918385666966,-0.03223726627982013
2023-10-05T22:30:00-04:00,1.05434,1.05463,1.05425,1.05442,1.05381,1.0542639999999999,1.05423777777777,1.0542799999999923,1.0545165000000045,1.0541946000000006,1.052973900000004,1.0512440000000078,1.0543305636396685,1.054310323599174,1101,-598867,-600224,-0.027093846309961266,-558.9082981527886,0.005690655942936851
2023-10-05T22:45:00-04:00,1.05442,1.05474,1.05436,1.05448,1.0538264,1.0543124444444443,1.054234444444437,1.0542562222222147,1.0544980000000046,1.0542288000000006,1.0529902000000042,1.0512807500000079,1.0543604509117348,1.0543214588793393,1173,-597694,-599454.2,-0.02396949894786737,-558.8415505569537,-0.0028449232344856367
2023-10-05T23:00:00-04:00,1.05448,1.05455,1.05433,1.05446,1.053862944,1.0543575555555555,1.05426777777777,1.0542479999999923,1.0544745000000044,1.0542752000000006,1.053008100000004,1.051318650000008,1.0543803607293878,1.054335967103471,-1218,-598912,-599278.8,-0.022682915154035928,-558.864651990836,0.028458677999541528
2023-10-05T23:15:00-04:00,1.05446,1.05463,1.05442,1.05449,1.05389802624,1.0544019999999998,1.0543311111111031,1.0542604444444366,1.0544575000000045,1.0543044000000006,1.0530295000000043,1.0513564500000079,1.0544022885835103,1.0543563736827768,926,-597986,-598685.4,-0.01756685112591716,-558.838306752515,0.05408380142704944
2023-10-05T23:30:00-04:00,1.05449,1.0545,1.05415,1.05426,1.0539317051904,1.0543877777777777,1.05435777777777,1.05428577777777,1.0544260000000043,1.0543390000000006,1.0530509000000041,1.051395650000008,1.0543738308668082,1.0543694989462213,-1075,-599061,-598504,-0.011768738419026642,-559.0727802894854,0.022769966414301245
2023-10-05T23:45:00-04:00,1.05426,1.05434,1.05403,1.05424,1.053964036982784,1.0543642222222223,1.0543644444444369,1.0543111111111034,1.0543965000000044,1.0543692000000007,1.0530702000000043,1.0514334000000078,1.0543470646934465,1.054372799156977,-1102,-600163,-598763.2,-0.006747126374265748,-559.0936859484309,0.005691627615793416
2023-10-06T00:00:00-04:00,1.05424,1.05426,1.05406,1.05414,1.0539950755034726,1.0543193333333334,1.0543444444444368,1.0543331111111034,1.0543675000000046,1.0543938000000006,1.0530862000000043,1.051470950000008,1.0543056517547573,1.0543618393255816,-916,-601079,-599440.2,-0.004010465145975947,-559.1805731847338,-0.01707261552468387
2023-10-06T00:15:00-04:00,1.05414,1.05442,1.05414,1.05442,1.0540248724833337,1.0543344444444442,1.0543611111111035,1.0543517777777702,1.0543510000000045,1.0544308000000007,1.0531059000000043,1.051510600000008,1.0543285214038058,1.0543514714604652,1016,-600063,-599670.4,-0.0017071805910078017,-558.9107039074083,0.014227854344700357
2023-10-06T00:30:00-04:00,1.05442,1.0544499999999999,1.05421,1.05427,1.0540534775840003,1.0543162222222222,1.0543533333333257,1.0543562222222147,1.0543285000000044,1.0544480000000005,1.0531211000000043,1.051550150000008,1.0543168171230446,1.054334377168372,-906,-600969,-600267,0.0004606777656295506,-559.0395899300557,-0.0066392245385752694
2023-10-06T00:45:00-04:00,1.05427,1.05431,1.05397,1.05405,1.05474,1.0542555555555555,1.0543122222222145,1.0543471111111036,1.0542995000000046,1.0544516000000006,1.0531365000000041,1.051588800000008,1.0542634536984357,1.0543123017346976,-722,-601691,-600793,0.0007362034127744795,-559.1902534223301,-0.03509038144192841
2023-10-06T01:00:00-04:00,1.05405,1.05417,1.05398,1.05414,1.0547246000000001,1.054221111111111,1.054274444444437,1.0543291111111035,1.0542725000000046,1.0544622000000006,1.0531528000000043,1.051626400000008,1.0542387629587486,1.054290641387758,884,-600807,-600921.8,0.0002935845455938271,-559.1147731320211,-0.03224338062362557
2023-10-06T01:15:00-04:00,1.05414,1.05417,1.0538399999999999,1.05394,1.0547095080000002,1.0541542222222224,1.054216666666659,1.0543035555555478,1.0542515000000043,1.0544692000000007,1.0531684000000043,1.0516647500000078,1.054179010366999,1.0542653131102062,-874,-601681,-601042.2,-0.0014860391363450613,-559.2805955085555,-0.04931434098968704
2023-10-06T01:30:00-04:00,1.05394,1.05404,1.05363,1.05365,1.0546747276800001,1.0540408888888888,1.0541233333333258,1.054255999999992,1.0542085000000045,1.0544752000000006,1.0531821000000041,1.051702900000008,1.0540732082935993,1.0542142504881649,-1098,-602779,-601585.4,-0.005962415103107746,-559.5827189690942,-0.07965936139744824
2023-10-06T01:45:00-04:00,1.05365,1.05373,1.05332,1.05349,1.0546120440192002,1.0539142222222222,1.0540377777777703,1.0541928888888812,1.0541750000000045,1.0544736000000006,1.0531965000000043,1.051740750000008,1.0539565666348794,1.0541422003905319,-925,-603704,-602132.4,-0.0108412542244503,-559.7231830700765,-0.0730370117428279
2023-10-06T02:00:00-04:00,1.05349,1.05401,1.05341,1.05387,1.0545086804976642,1.053880666666667,1.0539966666666591,1.05412977777777,1.0541725000000044,1.0544766000000005,1.0532117000000043,1.0517788500000078,1.0539392533079035,1.0540773603124254,2225,-601479,-602090,-0.013231020667542892,-558.9206125663222,-0.03509637274244778
2023-10-06T02:15:00-04:00,1.05387,1.05402,1.05341,1.05353,1.0544135860578512,1.0537873333333332,1.0539288888888814,1.054060666666659,1.0541480000000045,1.0544716000000005,1.0532214000000042,1.0518153500000078,1.0538574026463228,1.0540010882499402,-1641,-603120,-602552.6,-0.018204831914511936,-559.4500327035308,-0.05786707647940496
2023-10-06T02:30:00-04:00,1.05353,1.05366,1.0532,1.0533,1.054326099173223,1.0536615555555557,1.0538044444444372,1.0539782222222145,1.0541040000000046,1.0544542000000006,1.0532322000000043,1.0518496500000079,1.0537459221170582,1.0539144705999521,-2157,-605277,-603271.8,-0.02292166788762198,-559.9209352881752,-0.10621953301341117
2023-10-06T02:45:00-04:00,1.0533,1.05358,1.05314,1.05346,1.0542134892559007,1.0535926666666666,1.053714444444437,1.053896444444437,1.0540610000000046,1.0544304000000004,1.0532495000000042,1.0518819500000078,1.0536887376936466,1.0538375764799615,2261,-603016,-603319.2,-0.028777251424378182,-559.5774813814056,-0.0768304134614451
2023-10-06T03:00:00-04:00,1.05346,1.05433,1.0534,1.05427,1.05314,1.0537037777777778,1.0537388888888817,1.0538366666666592,1.0540610000000046,1.0544252000000005,1.0532798000000043,1.0519184500000078,1.0538049901549174,1.053807261183969,3241,-599775,-602533.4,-0.028551434822279256,-557.0854930762018,0.020871875148248092
2023-10-06T03:15:00-04:00,1.05427,1.05452,1.05376,1.0543,1.05314,1.053816,1.0537566666666596,1.0537886666666594,1.0540590000000045,1.0544094000000006,1.0533085000000042,1.0519547000000078,1.053903992123934,1.053800208947175,2916,-596859,-601609.4,-0.02631517127199283,-557.0025162296636,0.015178249568362643
2023-10-06T03:30:00-04:00,1.0543,1.055,1.0543,1.05457,1.0531952,1.0539786666666666,1.0538266666666596,1.053768222222215,1.0540665000000045,1.0544030000000004,1.053344800000004,1.0519925000000079,1.054037193699147,1.05383616715774,3369,-593490,-599683.4,-0.02327456715923673,-556.1397352375361,0.05977569880637497
2023-10-06T03:45:00-04:00,1.05457,1.05511,1.05424,1.05496,1.053303488,1.0542053333333332,1.053972222222215,1.0538017777777706,1.0540905000000045,1.0544094000000006,1.0533873000000042,1.0520331500000077,1.0542217549593176,1.053931333726192,3383,-590107,-596649.4,-0.016037014332347367,-554.8886376337738,0.12432971100459568
2023-10-06T04:00:00-04:00,1.05496,1.05521,1.0547,1.05476,1.05344800896,1.054362888888889,1.0541133333333264,1.0538815555555483,1.0541055000000046,1.0544084000000005,1.0534267000000042,1.0520745000000078,1.054329403967454,1.0540594669809533,-4050,-594157,-594877.6,-0.006771600116695574,-555.656439256584,0.12055169009671494
2023-10-06T04:15:00-04:00,1.05476,1.05505,1.05448,1.0547,1.053624208064,1.0544802222222223,1.0542055555555485,1.0539748888888816,1.0541160000000045,1.0544034000000004,1.0534680000000043,1.0521199000000079,1.0544035231739632,1.0541791735847625,-3212,-597369,-594396.4,0.0036229248931929133,-555.8391538077614,0.07875734198714132
2023-10-06T04:30:00-04:00,1.0547,1.05493,1.05421,1.0549,1.0537827872576,1.054619111111111,1.0543577777777706,1.054095111111104,1.0541480000000045,1.0544044000000006,1.0535041000000043,1.052164650000008,1.0545028185391705,1.05429893886781,3535,-593834,-593791.4,0.01154164795782567,-555.1688210117056,0.13003901170349882
2023-10-06T04:45:00-04:00,1.0549,1.0553299999999999,1.05452,1.05481,1.05392550853184,1.0547095555555555,1.0545255555555484,1.054234888888882,1.0541765000000045,1.0544002000000006,1.0535435000000042,1.0522085000000079,1.0545642548313363,1.0544043510942476,-3088,-596922,-594477.8,0.021199063862565162,-555.4322772634828,0.14335896705593112
2023-10-06T05:00:00-04:00,1.05481,1.05538,1.05457,1.05515,1.0540940475080192,1.0548344444444444,1.0547133333333263,1.0543831111111044,1.0542270000000045,1.0544022000000006,1.0535822000000044,1.052251850000008,1.0546814038650691,1.054496280875398,2885,-594037,-595263.8,0.034636211373255434,-554.5023467546707,0.16042374651149252
2023-10-06T05:15:00-04:00,1.05515,1.05523,1.05476,1.05484,1.0542740808568964,1.0548597777777777,1.0547766666666596,1.054515777777771,1.0542480000000043,1.0544054000000005,1.0536170000000042,1.0522910500000078,1.0547131230920552,1.0545730247003182,-2372,-596409,-595714.2,0.04456312688091582,-555.1992334532445,0.05406584650990348
2023-10-06T05:30:00-04:00,1.05484,1.05576,1.05482,1.05542,1.054428909536931,1.0549884444444444,1.0549011111111042,1.054654888888882,1.0543055000000046,1.0544192000000006,1.0536594000000041,1.0523269500000079,1.054854498473644,1.0546632197602543,2492,-593917,-595023.8,0.05095215167962209,-553.8290161691065,0.10623162287773973
2023-10-06T05:45:00-04:00,1.05542,1.0554999999999999,1.05514,1.05528,1.054641884011022,1.0550642222222222,1.054979999999993,1.0547793333333266,1.0543670000000045,1.0544280000000006,1.0537081000000041,1.0523611500000079,1.0549395987789152,1.0547505758082032,-2625,-596542,-595565.4,0.0556830442896463,-554.1772187803892,0.06732601913576039
2023-10-06T06:00:00-04:00,1.05528,1.0562,1.05527,1.05602,1.05482,1.0552722222222222,1.0550977777777708,1.054893777777771,1.0544610000000045,1.0544500000000006,1.0537545000000044,1.0523984000000077,1.0551556790231322,1.0548688606465624,2896,-593646,-594910.2,0.06053281886778564,-552.1464402192491,0.10047774323197667
2023-10-06T06:15:00-04:00,1.05602,1.0561099999999999,1.05572,1.05587,1.0550684000000001,1.0554266666666667,1.055221111111104,1.0549953333333264,1.0545575000000045,1.0544704000000005,1.0538004000000043,1.0524358500000077,1.0552985432185058,1.0549922885172496,-2555,-596201,-595343,0.06134542690971084,-552.5093594821416,0.10523721036066655
2023-10-06T06:30:00-04:00,1.05587,1.05634,1.0558,1.0562799999999999,1.05527,1.0556384444444442,1.0553966666666597,1.0551193333333266,1.0546890000000047,1.0544974000000007,1.0538524000000042,1.0524741000000077,1.0554948345748045,1.0551486308137994,2160,-594041,-594869.4,0.06518589290061588,-551.6706198645754,0.1498056319332431
2023-10-06T06:45:00-04:00,1.0562799999999999,1.05629,1.05534,1.05547,1.05634,1.055653111111111,1.055459999999993,1.0552311111111041,1.0547880000000047,1.0545102000000006,1.0538993000000043,1.0525084500000077,1.0554898676598437,1.0552757046510393,-2175,-596216,-595329.2,0.06426402699883053,-553.3385014868725,0.054033557683188876
2023-10-06T07:00:00-04:00,1.05547,1.05547,1.05504,1.0550599999999999,1.05634,1.055573111111111,1.0554877777777705,1.0553326666666596,1.0548475000000046,1.0545136000000006,1.0539415000000043,1.0525358000000078,1.055403894127875,1.0553685637208312,-2055,-598271,-595675,0.058688572251702265,-554.1367714519118,0.023700950882136255
2023-10-06T07:15:00-04:00,1.0550599999999999,1.0556699999999999,1.05505,1.05548,1.05629,1.0555715555555554,1.0555244444444372,1.0554179999999929,1.0549450000000047,1.0545266000000004,1.0539814000000043,1.052566200000008,1.0554191153023,1.0554212509766647,2188,-596083,-596162.4,0.0577679288459285,-553.265768854903,0.03127517414585049
2023-10-06T07:30:00-04:00,1.05548,1.05587,1.05523,1.05585,1.0562399999999998,1.0556366666666666,1.0556366666666592,1.055501111111104,1.0550725000000045,1.0545492000000005,1.0540199000000043,1.052597850000008,1.05550529224184,1.0554626007813315,2590,-593493,-595620.8,0.053925230481246145,-552.3578407084673,0.0957491183496981
2023-10-06T07:45:00-04:00,1.05585,1.05673,1.05583,1.05659,1.05504,1.0558273333333332,1.0557666666666592,1.055575111111104,1.0552290000000046,1.0545860000000007,1.0540670000000043,1.052631700000008,1.055722233793472,1.055508080625065,3176,-590317,-594876,0.05565474202610763,-550.1319184657245,0.11085634155122068
2023-10-06T08:00:00-04:00,1.05659,1.05685,1.05584,1.05585,1.0550738,1.055844,1.0558299999999923,1.0556491111111037,1.0553080000000048,1.0546086000000006,1.0541109000000042,1.0526569000000081,1.0557477870347776,1.0555596645000518,-4000,-594317,-594496.2,0.048938581065603844,-552.9333835562514,0.054014100523080075
2023-10-06T08:15:00-04:00,1.05585,1.05637,1.05534,1.05536,1.0551448479999999,1.05575,1.0557566666666591,1.0557028888888813,1.0553610000000049,1.0546232000000004,1.0541476000000043,1.052678750000008,1.055670229627822,1.055612931600041,-4849,-599166,-594675.2,0.044775809601694354,-555.1837126749704,-0.062498816310286066
2023-10-06T08:30:00-04:00,1.05536,1.05602,1.05009,1.05075,1.05685,1.0547486666666666,1.0551877777777703,1.055635555555548,1.0551700000000048,1.0545446000000005,1.0541313000000043,1.052680750000008,1.0546861837022576,1.0554663452800326,-24229,-623395,-600137.6,0.010858395421779195,-661.0202897671475,-0.4849081799842796
2023-10-06T08:45:00-04:00,1.05075,1.05081,1.04821,1.04964,1.0567148,1.053639111111111,1.0544499999999926,1.0553982222222147,1.0549040000000045,1.0544502000000007,1.0541040000000041,1.052677350000008,1.0536769469618061,1.055100676224026,-14385,-637780,-608995,-0.025942263454403123,-676.2164353774281,-0.6286211989245257
2023-10-06T09:00:00-04:00,1.04964,1.051,1.04881,1.05048,1.056374608,1.0528451111111112,1.053895555555548,1.0550239999999924,1.0546900000000048,1.0543696000000005,1.0540854000000042,1.052672050000008,1.0530375575694448,1.0545637409792206,13473,-624307,-615793,-0.06071275062558672,-665.4343386585508,-0.472775161776254
2023-10-06T09:15:00-04:00,1.05048,1.05226,1.05042,1.05109,1.05604802368,1.0522840000000002,1.053454444444437,1.0545488888888814,1.0545095000000047,1.0543082000000006,1.0540795000000043,1.0526726500000079,1.0526480460555558,1.053943792783376,10781,-613526,-619634.8,-0.08568568188850077,-659.1739529301219,-0.3762819176160415
2023-10-06T09:30:00-04:00,1.05109,1.05176,1.05015,1.05124,1.0557345027328,1.0518411111111112,1.0529833333333258,1.0539942222222147,1.0543265000000046,1.0542546000000008,1.0540870000000044,1.0526755000000079,1.0523664368444448,1.0532830342267006,11581,-601945,-620190.6,-0.10630298043061621,-657.5212400320842,-0.4017129647174766
2023-10-06T09:45:00-04:00,1.05124,1.05169,1.05012,1.05119,1.055433522623488,1.0514824444444444,1.0524655555555482,1.0534497777777703,1.0541455000000046,1.0541980000000006,1.0540842000000044,1.0526824500000078,1.0521311494755559,1.0527720273813603,-10086,-612031,-617917.8,-0.1302573164714246,-658.0009592208506,-0.44135057063028715
2023-10-06T10:00:00-04:00,1.05119,1.05177,1.0505,1.05156,1.0551445817185485,1.0513013333333334,1.0519066666666594,1.0529411111111038,1.0539660000000044,1.0541456000000007,1.0540881000000042,1.052691300000008,1.0520169195804447,1.052440021905088,9790,-602241,-610810,-0.15629468426374257,-654.5550550550957,-0.4760597772077976
2023-10-06T10:15:00-04:00,1.05156,1.05344,1.0512,1.05334,1.0548671984498066,1.051588,1.0516277777777703,1.0524875555555482,1.0538910000000046,1.0541260000000008,1.0540939000000042,1.052701200000008,1.0522815356643558,1.05228881752407,9331,-592910,-604530.6,-0.1789662878296254,-638.7602549485882,-0.23772316143391697
2023-10-06T10:30:00-04:00,1.05334,1.05554,1.05334,1.05522,1.04821,1.0523064444444443,1.0516122222222148,1.052119111111104,1.0538810000000045,1.0541450000000008,1.0541273000000044,1.052714800000008,1.0528692285314847,1.052333054019256,11339,-581571,-598139.6,-0.18665759425707415,-618.5224210108272,-0.013265615524563085
2023-10-06T10:45:00-04:00,1.05522,1.05544,1.05359,1.05376,1.0483566,1.052736,1.0519466666666593,1.0519117777777705,1.0538050000000045,1.0541334000000007,1.0541398000000044,1.052721000000008,1.0530473828251878,1.0524692432154044,-8395,-589966,-595743.8,-0.19435299561056024,-630.1377239808241,0.2864620509160083
2023-10-06T11:00:00-04:00,1.05376,1.05647,1.05359,1.05626,1.048500268,1.0535986666666668,1.0526822222222147,1.0519551111111036,1.0538170000000044,1.0541702000000008,1.0541824000000042,1.0527409500000078,1.0536899062601504,1.0527809945723232,8320,-581646,-589666.8,-0.14649138184973876,-610.3988840172655,0.6306924278800418
2023-10-06T11:15:00-04:00,1.05626,1.05923,1.05598,1.05884,1.04881905728,1.0548302222222221,1.0536111111111035,1.0522959999999923,1.0539655000000046,1.0542574000000007,1.054243100000004,1.0527774500000078,1.0547199250081203,1.0533215956578583,8858,-572788,-583776.2,-0.07193074553701996,-588.7625066101874,0.7958266697128857
2023-10-06T11:30:00-04:00,1.05884,1.06,1.05838,1.05935,1.0494437138432,1.0559779999999999,1.054528888888881,1.0528762222222146,1.0541190000000047,1.0543552000000007,1.0543152000000042,1.0528177000000079,1.0556459400064961,1.0539944765262865,9820,-562968,-577787.8,-0.0035006635449290175,-584.0326135196354,0.7858508786117205
2023-10-06T11:45:00-04:00,1.05935,1.0599399999999999,1.05874,1.05948,1.050288216735744,1.056968222222222,1.0554444444444369,1.053642666666659,1.0543195000000047,1.0544550000000008,1.0543797000000041,1.0528616000000077,1.056412752005197,1.0547031812210288,8009,-554959,-572465.4,0.061620839441838264,-583.049774986573,0.7838362314980428
2023-10-06T12:00:00-04:00,1.05948,1.05954,1.05804,1.05819,1.0510651593968845,1.0575173333333332,1.0562222222222148,1.05449777777777,1.0544760000000049,1.0545336000000007,1.0544363000000043,1.052904350000008,1.0567682016041575,1.0554473449768227,-6682,-561641,-566800.4,0.11523813050432409,-591.1856340872639,0.6659119664380269
2023-10-06T12:15:00-04:00,1.05819,1.05838,1.05754,1.05803,1.0517799466451336,1.057878888888889,1.0569411111111036,1.0553495555555477,1.0546035000000047,1.0546094000000008,1.0544893000000042,1.052952250000008,1.057020561283326,1.0561134759814579,-4799,-566440,-563759.2,0.16666854798852998,-591.9112504699548,0.6152763513256472
2023-10-06T12:30:00-04:00,1.05803,1.05856,1.05764,1.05839,1.0524375509135229,1.0581686666666665,1.0575022222222146,1.05612777777777,1.054730500000005,1.0546944000000007,1.0545441000000042,1.052996450000008,1.057294449026661,1.056628380785166,4183,-562257,-561653,0.2182618329372649,-590.4879637956642,0.479427345396548
2023-10-06T12:45:00-04:00,1.05839,1.0587,1.05783,1.05792,1.053042546840441,1.0582522222222221,1.0578022222222148,1.0567824444444367,1.0547970000000046,1.0547644000000007,1.0545976000000041,1.0530396500000079,1.0574195592213287,1.0569831046281324,-3745,-566002,-562259.8,0.2523142954779231,-592.1510086090127,0.2558708136691803
2023-10-06T13:00:00-04:00,1.05792,1.05873,1.05771,1.0587199999999999,1.0535991430932057,1.0584357777777778,1.058353333333326,1.0573642222222144,1.0549405000000047,1.0548534000000007,1.0546507000000043,1.0530815000000078,1.0576796473770629,1.0572364837025057,3207,-562795,-563827,0.2758516718380442,-589.7258724928605,0.4706954145156253
2023-10-06T13:15:00-04:00,1.0587199999999999,1.05923,1.05843,1.05877,1.0541112116457492,1.058519111111111,1.0586322222222149,1.0578462222222145,1.055111000000005,1.054947800000001,1.0546997000000042,1.053118250000008,1.0578977179016502,1.0574623869620041,3357,-559438,-563386.4,0.31011960692473817,-589.5673319911223,0.23763088633480509
2023-10-06T13:30:00-04:00,1.05877,1.05888,1.05814,1.05817,1.0545823147140891,1.0584266666666668,1.0585577777777704,1.058169555555548,1.055482000000005,1.055028400000001,1.0547453000000042,1.0531524500000078,1.0579521743213203,1.0576487095696028,-2470,-561908,-562480,0.3154998625928353,-590.9670694222923,-0.06327679347209668
2023-10-06T13:45:00-04:00,1.05817,1.05886,1.05801,1.05882,1.055015729536962,1.0584791111111114,1.0584988888888816,1.0583688888888811,1.055941000000005,1.055126000000001,1.0547976000000043,1.0531877000000078,1.0581257394570562,1.0578149676556818,2189,-559719,-561972.4,0.27879248265344087,-589.622436707322,-0.05003067919006177
2023-10-06T14:00:00-04:00,1.05882,1.05951,1.0587,1.0594,1.055414471174005,1.0586593333333332,1.0584899999999928,1.0585064444444368,1.0563870000000048,1.055241000000001,1.0548581000000044,1.0532260000000078,1.058380591565645,1.0580071741245451,1891,-557828,-560337.6,0.2351360929778811,-588.5865854767071,-0.007550874013674633
2023-10-06T14:15:00-04:00,1.0594,1.05982,1.05899,1.0597699999999999,1.0557813134800846,1.0589153333333334,1.0586655555555484,1.0585688888888813,1.0568210000000051,1.0553666000000008,1.0549201000000041,1.0532669500000076,1.058658473252516,1.0582029392996357,1942,-555886,-558955.8,0.19591202437783226,-587.9083336360426,0.14931156030579715
2023-10-06T14:30:00-04:00,1.0597699999999999,1.05996,1.05952,1.0597,1.056118808401678,1.0591222222222223,1.0588511111111039,1.0586126666666593,1.057244000000005,1.0554832000000007,1.0549799000000042,1.0533093000000078,1.0588667786020127,1.0583967514397081,-2033,-557919,-558652,0.17133174626934103,-588.042617490086,0.1578405149192424
2023-10-06T14:45:00-04:00,1.0597,1.0599,1.05902,1.0593299999999999,1.0564293037295438,1.059218,1.0589555555555483,1.0586922222222148,1.057651000000005,1.0555992000000007,1.0550354000000042,1.0533498000000079,1.0589594228816102,1.058598201151766,-2053,-559972,-558264.8,0.14712975602391912,-588.759433570109,0.08881414223489838
2023-10-06T15:00:00-04:00,1.0593299999999999,1.05937,1.05885,1.05905,1.0567149594311802,1.0592368888888888,1.059081111111104,1.0588086666666592,1.0580255000000052,1.0557142000000008,1.0550842000000042,1.0533913500000078,1.0589775383052882,1.0587685609214126,-1907,-561879,-558696.8,0.11793137694972905,-589.2634880196192,0.10681336963098112
2023-10-06T15:15:00-04:00,1.05905,1.05943,1.05893,1.05943,1.0569777626766859,1.0593066666666668,1.0591599999999928,1.0589426666666593,1.0583300000000049,1.0558336000000008,1.0551320000000042,1.0534374000000077,1.0590680306442306,1.0589060487371296,1516,-560363,-559203.8,0.09674193539694381,-588.7195288108943,0.06706211273993223
2023-10-06T15:30:00-04:00,1.05943,1.05962,1.05923,1.0593299999999999,1.057219541662551,1.0593406666666667,1.059222222222215,1.0590539999999924,1.058535500000005,1.0559348000000008,1.0551800000000042,1.0534822000000077,1.0591204245153845,1.0589984389897034,-1331,-561694,-560365.4,0.07552889800353736,-588.8451624063185,0.05289156285122302
2023-10-06T15:45:00-04:00,1.0593299999999999,1.05959,1.0588899999999999,1.05897,1.0574419783295468,1.0592902222222222,1.0593111111111038,1.0591459999999924,1.058796000000005,1.0560282000000007,1.0552188000000042,1.0535257000000078,1.0590903396123075,1.0590431511917622,-1756,-563450,-561471.6,0.06053618405679756,-589.4419169587242,0.07560221892511712
2023-10-06T16:00:00-04:00,1.05897,1.05897,1.05846,1.05847,1.057646620063183,1.059122,1.0592722222222148,1.0592093333333257,1.0589065000000049,1.0561062000000008,1.0552546000000043,1.0535667500000079,1.058966271689846,1.0590445209534094,-1096,-564546,-562386.4,0.04217340795063431,-589.9594009289971,-0.03305566574111487
2023-10-06T16:15:00-04:00,1.05847,1.05857,1.05827,1.05844,1.0578348904581285,1.0589555555555556,1.0591655555555484,1.0592262222222146,1.058886500000005,1.056175800000001,1.0552926000000042,1.053607300000008,1.0588610173518769,1.059021216762727,-610,-565156,-563041.8,0.028776920181645755,-589.9766900349707,-0.0906173305644563
2023-10-06T16:30:00-04:00,1.05844,1.05863,1.05843,1.05856,1.0580080992214782,1.0588344444444444,1.059031111111104,1.059200444444437,1.058847000000005,1.056251800000001,1.0553301000000044,1.053648550000008,1.0588008138815015,1.0589677734101814,427,-564729,-563915,0.02210350737480724,-589.928279166145,-0.11417571737263119
2023-10-06T16:45:00-04:00,1.05856,1.05869,1.05812,1.05844,1.06,1.0587162222222222,1.058891111111104,1.0591342222222146,1.0587950000000048,1.0563266000000011,1.0553650000000043,1.0536891500000078,1.0587286511052012,1.0588894187281448,-1090,-565819,-564740,0.0136359261682573,-590.0518432532066,-0.11890157591771622
2023-10-08T17:00:00-04:00,1.05493,1.05538,1.05474,1.05508,1.0599624,1.0579539999999998,1.0584188888888817,1.0589557777777703,1.0586395000000048,1.0563302000000008,1.0553673000000043,1.0537090000000078,1.057998920884161,1.0586711349825153,-145,-565964,-565242.8,-0.01021097585428489,-590.5121433174521,-0.4011969829986751
2023-10-08T17:15:00-04:00,1.05508,1.05592,1.05497,1.05499,1.0597535040000001,1.0572682222222223,1.0579677777777705,1.0586948888888816,1.058487500000005,1.0563338000000009,1.0553670000000042,1.0537272500000079,1.0573971367073287,1.0583573079860118,-314,-566278,-565589.2,-0.03681879162007275,-590.5389280162427,-0.3833624474765075
2023-10-08T17:30:00-04:00,1.05499,1.05508,1.0548899999999999,1.05508,1.05955296384,1.0566906666666667,1.0574844444444373,1.0583586666666593,1.058322000000005,1.056332400000001,1.0553673000000043,1.053743700000008,1.056933709365863,1.057971846388809,165,-566113,-565780.6,-0.06106233433492084,-590.5248520534374,-0.410598151836372
2023-10-08T17:45:00-04:00,1.05508,1.05575,1.05508,1.05555,1.0593604452864,1.0563037777777777,1.057064444444437,1.057965333333326,1.0582035000000052,1.056346600000001,1.0553760000000043,1.053763800000008,1.0566569674926904,1.0575430771110468,552,-565561,-565947,-0.08495638779412483,-590.2789560076399,-0.3568293166435289
2023-10-08T18:00:00-04:00,1.05555,1.05629,1.05502,1.05513,1.059175627474944,1.055916888888889,1.0566377777777705,1.0575146666666595,1.0580240000000052,1.056340800000001,1.0553800000000042,1.0537841500000078,1.0563515739941522,1.057067661688837,-2554,-568115,-566406.2,-0.11210574638138712,-591.2951845141059,-0.3626165047168537
2023-10-08T18:15:00-04:00,1.05513,1.05573,1.05512,1.05528,1.0589982023759463,1.0556453333333333,1.0562833333333261,1.0570875555555481,1.0578495000000052,1.056340800000001,1.055384400000004,1.053804800000008,1.0561372591953218,1.0566953293510692,1571,-566544,-566522.2,-0.1315192457965484,-591.0718471054453,-0.30137840467845345
2023-10-08T18:30:00-04:00,1.05528,1.05577,1.05518,1.05547,1.0588278742809085,1.0554826666666666,1.055953333333326,1.0566846666666594,1.0577145000000052,1.056329800000001,1.0553899000000042,1.0538291500000079,1.0560038073562574,1.0564166634808552,1423,-565121,-566290.8,-0.14504471814458011,-590.8156402219643,-0.2806016401496673
2023-10-08T18:45:00-04:00,1.05547,1.05587,1.05538,1.05582,1.0586643593096723,1.055456,1.0556488888888815,1.0563175555555482,1.0575645000000051,1.0563288000000008,1.0553996000000043,1.0538564500000078,1.055967045885006,1.0562233307846836,904,-564217,-565911.6,-0.15925180019359889,-590.5158685562608,-0.25884220072551056
2023-10-08T19:00:00-04:00,1.05582,1.05635,1.05581,1.05625,1.0585073849372855,1.0555762222222222,1.0554055555555482,1.0559857777777704,1.057407000000005,1.056328200000001,1.0554128000000043,1.0538845000000079,1.0560236367080047,1.0560966646277463,1482,-562735,-565346.4,-0.16954151607956708,-589.9122997661262,-0.20690828011036394
2023-10-08T19:15:00-04:00,1.05625,1.05666,1.05624,1.05639,1.058356689539794,1.055773111111111,1.0555511111111038,1.055768444444437,1.057238000000005,1.056346600000001,1.0554284000000043,1.053913650000008,1.0560969093664037,1.0560457317021965,1700,-561035,-563930.4,-0.17539664203646776,-589.6869743223392,0.12416120104635879
2023-10-08T19:30:00-04:00,1.05639,1.05674,1.05615,1.05674,1.0582120219582023,1.0560108888888888,1.0557455555555484,1.0556608888888817,1.0570900000000052,1.0563802000000009,1.0554469000000042,1.0539447000000077,1.056225527493123,1.0560633853617567,1213,-559822,-562586,-0.1460712114045564,-589.2850867618738,0.16587834955780795
2023-10-08T19:45:00-04:00,1.05674,1.05683,1.0562799999999999,1.05661,1.0580731410798743,1.0561837777777776,1.0559155555555484,1.055653333333326,1.056954000000005,1.056402800000001,1.0554647000000044,1.053974750000008,1.0563024219944983,1.056123108289405,-1107,-560929,-561747.6,-0.11684620655252834,-589.4212697397113,0.14501270045873596
2023-10-08T20:00:00-04:00,1.05661,1.05693,1.0562,1.05625,1.0579398154366793,1.0562506666666667,1.0559933333333262,1.055722222222215,1.056814000000005,1.056410800000001,1.0554800000000042,1.054002100000008,1.0562919375955986,1.0561880866315234,-2058,-562987,-561501.6,-0.09191573182276278,-590.1224556077234,0.06631613850598483
2023-10-08T20:15:00-04:00,1.05625,1.05682,1.05625,1.05661,1.0578118228192122,1.056374,1.0561577777777709,1.0558726666666594,1.056673000000005,1.056411200000001,1.0554986000000042,1.0540312000000078,1.056355550076479,1.0562544693052183,2534,-560453,-561045.2,-0.07090108588823038,-589.2587964361254,0.1402670760949028
2023-10-08T20:30:00-04:00,1.05661,1.05693,1.05636,1.05683,1.0576889499064437,1.0565084444444444,1.0563299999999929,1.0560284444444374,1.0565480000000051,1.0564308000000011,1.0555197000000043,1.0540624500000078,1.0564504400611832,1.0563251754441743,1737,-558716,-560581.4,-0.04310443892341222,-588.8971303530865,0.1468804487908366
2023-10-08T20:45:00-04:00,1.05683,1.05744,1.05683,1.05735,1.0575709919101859,1.0567124444444445,1.0565388888888816,1.0561871111111039,1.0564670000000054,1.056470600000001,1.0555469000000044,1.0540960000000077,1.0566303520489466,1.0564061403553389,1902,-556814,-559979.8,-0.014593270059700975,-587.9612750121138,0.17811970022834414
2023-10-08T21:00:00-04:00,1.05735,1.05741,1.056,1.05613,1.0574577522337785,1.0566306666666667,1.0565733333333263,1.0563186666666593,1.0563500000000052,1.056578200000001,1.0555614000000044,1.0541240000000078,1.0565302816391573,1.056451712284271,-2681,-559495,-559693,0.00445336519812679,-591.0546877893398,0.029361065333109098
2023-10-08T21:15:00-04:00,1.05613,1.05645,1.0561,1.05641,1.05744,1.056598,1.056591111111104,1.056438222222215,1.0562485000000053,1.056713600000001,1.0555819000000044,1.0541521000000078,1.0565062253113258,1.0564945698274162,2004,-557491,-558593.8,0.01932525251987417,-590.5233895590083,0.015147928994097991
2023-10-08T21:30:00-04:00,1.05641,1.05641,1.0556699999999999,1.05599,1.05741,1.0564777777777778,1.0565466666666596,1.0565159999999927,1.0561200000000053,1.056823800000001,1.0555967000000044,1.0541786500000079,1.0564029802490607,1.0565040558619325,-2040,-559531,-558409.4,0.02791132574976029,-591.3344382995542,-0.03786480371831956
2023-10-08T21:45:00-04:00,1.05599,1.05636,1.05589,1.05632,1.0573032,1.0564324444444442,1.056499999999993,1.0565499999999928,1.0560140000000051,1.056928400000001,1.0556183000000043,1.054206850000008,1.0563863841992485,1.0564912446895458,1498,-558033,-558272.8,0.037351118549796745,-590.8663088665104,-0.03974487574995618
2023-10-08T22:00:00-04:00,1.05632,1.05635,1.05587,1.05633,1.057200672,1.056398444444444,1.0564688888888816,1.0565359999999928,1.0560765000000052,1.0570302000000011,1.0556424000000044,1.0542364500000079,1.0563751073593988,1.056440195751636,1547,-556486,-558207.2,0.04298673241770589,-590.8516636832325,-0.026499843840211427
2023-10-08T22:15:00-04:00,1.05633,1.05656,1.05629,1.0564,1.05710224512,1.0563846666666665,1.0564855555555484,1.0565184444444369,1.056147000000005,1.0571344000000011,1.0556662000000043,1.054266500000008,1.056380085887519,1.0564101566013082,1423,-555063,-557320.8,0.0350438476450531,-590.7573654998996,0.014201183431961611
2023-10-08T22:30:00-04:00,1.0564,1.05643,1.05608,1.05617,1.0570077553152,1.0563215555555556,1.0564366666666594,1.0564875555555482,1.0562015000000051,1.057226600000001,1.0556861000000044,1.0542907000000081,1.0563380687100152,1.0563765252810462,-1395,-556458,-557114.2,0.0289641919807751,-591.0610856816489,-0.041642611748894665
2023-10-08T22:45:00-04:00,1.05617,1.0562799999999999,1.05599,1.05614,1.056917045102592,1.0562622222222222,1.0563599999999929,1.0564502222222147,1.0562310000000052,1.057282600000001,1.0557043000000044,1.054311350000008,1.0562984549680121,1.0563556202248365,-969,-557427,-556693.4,0.019733843338544926,-591.0886096597964,-0.06528959246045792
2023-10-08T23:00:00-04:00,1.05614,1.05614,1.05558,1.05562,1.0568299632984883,1.0561142222222222,1.0561677777777705,1.0563837777777703,1.0562555000000051,1.0572906000000009,1.0557178000000045,1.054325500000008,1.0561627639744098,1.0563108961798688,-1132,-558559,-556798.6,0.007962041889656539,-591.6459600110757,-0.16361658864141573
2023-10-08T23:15:00-04:00,1.05562,1.05563,1.05536,1.05545,1.0567463647665487,1.0559706666666668,1.0560922222222149,1.0563084444444368,1.056264000000005,1.057324400000001,1.0557289000000045,1.0543418500000081,1.0560202111795278,1.0562399169438945,-1008,-559567,-557414.8,-0.011469503024140206,-591.8082911529639,-0.06438601308551162
2023-10-08T23:30:00-04:00,1.05545,1.05547,1.05524,1.0553299999999999,1.0566661101758867,1.0558182222222223,1.0559722222222148,1.0562057777777702,1.056257000000005,1.057305800000001,1.0557380000000045,1.054355950000008,1.0558821689436222,1.0561403335551152,-1136,-560703,-558542.8,-0.019269082319962837,-591.9374493319398,-0.10223303452259935
2023-10-08T23:45:00-04:00,1.0553299999999999,1.05535,1.05514,1.05522,1.0565890657688513,1.0556677777777776,1.0558866666666593,1.0560957777777702,1.0562270000000051,1.057233400000001,1.0557454000000044,1.054367800000008,1.0557497351548977,1.0560226668440917,-892,-561595,-559570.2,-0.029408900486582974,-592.0304249888432,-0.072917357171937
2023-10-09T00:00:00-04:00,1.05522,1.05537,1.05493,1.05526,1.0565151031380973,1.0555424444444446,1.0557688888888814,1.055977555555548,1.0561775000000053,1.0571516000000012,1.0557534000000044,1.054380750000008,1.0556517881239182,1.055893333475273,853,-560742,-560233.2,-0.03379651755187736,-591.9980904993528,-0.10034837927899111
2023-10-09T00:15:00-04:00,1.05526,1.05545,1.05524,1.05524,1.0564440990125734,1.0554366666666666,1.0556477777777704,1.0558735555555478,1.056120000000005,1.057066800000001,1.0557609000000046,1.054395200000008,1.0555694304991345,1.0557746667802177,-684,-561426,-560806.6,-0.03947014241974398,-592.0110541291692,-0.10318745089129679
2023-10-09T00:30:00-04:00,1.05524,1.05528,1.05497,1.05507,1.0563759350520705,1.0553211111111112,1.0554999999999926,1.0557551111111034,1.0560365000000052,1.057004400000001,1.0557690000000044,1.0544099500000081,1.0554695443993076,1.0556645334241737,-1096,-562522,-561397.6,-0.045451532568741,-592.1876205974608,-0.12589928057554461
2023-10-09T00:45:00-04:00,1.05507,1.05513,1.05478,1.055,1.0563104976499877,1.0552211111111112,1.0553699999999926,1.0556346666666592,1.055956000000005,1.0569438000000009,1.0557766000000044,1.0544234000000081,1.0553756355194461,1.0555632267393382,-959,-563481,-561953.2,-0.05086642018084921,-592.2512467075767,-0.11077762102692894
2023-10-09T01:00:00-04:00,1.055,1.05542,1.055,1.05521,1.0562476777439882,1.0551891111111111,1.0552666666666595,1.0555106666666592,1.055904000000005,1.056880200000001,1.0557873000000044,1.054436750000008,1.055342508415557,1.05548178139147,1201,-562280,-562090.2,-0.05364761866522298,-592.0121850962022,-0.08805650765997854
2023-10-09T01:15:00-04:00,1.05521,1.05541,1.05516,1.05534,1.0561873706342286,1.0552037777777776,1.0552355555555484,1.0554039999999927,1.0558405000000053,1.0568286000000011,1.0557965000000045,1.0544512000000081,1.0553420067324455,1.0554198251131754,824,-561456,-562233,-0.057122446604847235,-591.9106697580231,-0.02652469638696292
2023-10-09T01:30:00-04:00,1.05534,1.05569,1.05525,1.05535,1.0561294758088595,1.0552266666666665,1.0552244444444372,1.055319333333326,1.0557665000000052,1.056761200000001,1.0558073000000043,1.0544642000000082,1.0553436053859564,1.0553746600905398,1727,-559729,-561893.6,-0.054000151541234206,-591.8943053636099,-0.009474631673692642
2023-10-09T01:45:00-04:00,1.05535,1.05553,1.05531,1.05535,1.056073896776505,1.055251777777778,1.0552266666666594,1.0552646666666594,1.0556665000000052,1.056692800000001,1.0558203000000044,1.054478400000008,1.0553448843087652,1.0553497280724315,0,-559729,-561335,-0.04827547012525816,-591.8943053636099,0.001895141803997899
2023-10-09T02:00:00-04:00,1.05535,1.05586,1.05508,1.05556,1.0560205409054448,1.0553184444444443,1.055264444444437,1.0552435555555482,1.0556380000000054,1.0566406000000008,1.0558345000000045,1.0544936500000082,1.055387907447012,1.0553521824579446,3789,-555940,-559826.8,-0.03802626112527035,-591.140346961184,0.032220769128713155
2023-10-09T02:15:00-04:00,1.05556,1.05566,1.05438,1.05446,1.055969319269227,1.0551575555555555,1.0551755555555482,1.055225333333326,1.0555405000000053,1.056553400000001,1.0558397000000044,1.0545040500000082,1.0552023259576095,1.055324145966355,-3731,-559671,-559305,-0.03769529963599825,-595.0284253271702,-0.07581070068041372
2023-10-09T02:30:00-04:00,1.05446,1.05452,1.05399,1.05421,1.0558739601130733,1.0549644444444444,1.0550611111111037,1.055190444444437,1.0554515000000053,1.056449600000001,1.0558453000000043,1.0545137000000082,1.0550038607660877,1.0552565167730834,-3722,-563393,-559692.4,-0.037721599168276415,-595.910867525072,-0.09760812706112963
2023-10-09T02:45:00-04:00,1.05421,1.05436,1.05315,1.0537,1.0557232433040276,1.0546922222222224,1.0549088888888813,1.055127333333326,1.0553205000000054,1.056328200000001,1.0558474000000044,1.0545219500000083,1.0547430886128701,1.0551364134184662,-3694,-567087,-561164,-0.04198489987454474,-597.6979308236558,-0.1298492043181847
2023-10-09T03:00:00-04:00,1.0537,1.05396,1.05288,1.0531,1.0554659189736249,1.0543304444444446,1.0546977777777704,1.0550215555555482,1.0551590000000055,1.056196200000001,1.0558397000000044,1.0545257000000081,1.054414470890296,1.0549503307347723,-5697,-572784,-563775,-0.04612917884902674,-600.9419281663538,-0.18009478672985904
2023-10-09T03:15:00-04:00,1.0531,1.05377,1.05281,1.05362,1.05515560869679,1.054114888888889,1.0545211111111037,1.0548728888888816,1.0550200000000054,1.0560820000000009,1.0558406000000045,1.0545310000000083,1.0542555767122368,1.0547238645878174,4712,-568072,-566201.4,-0.04698331889064428,-598.6152355445702,-0.15068090711801257
2023-10-09T03:30:00-04:00,1.05362,1.05389,1.05232,1.05236,1.0548272234792393,1.0536826666666668,1.0541899999999926,1.0546757777777702,1.0548295000000054,1.055948200000001,1.0558312000000045,1.0545317000000083,1.0538764613697895,1.0544586916702534,-4181,-572253,-568717.8,-0.05577183159102681,-603.6151975802188,-0.28237345310515877
2023-10-09T03:45:00-04:00,1.05236,1.05267,1.05193,1.0523,1.054426067722561,1.0533046666666668,1.0538511111111037,1.0544337777777704,1.0546375000000054,1.0558056000000011,1.0558196000000044,1.0545345500000083,1.0535611690958315,1.054170153336202,-3765,-576018,-571242.8,-0.06713203234995543,-603.8298579625973,-0.2890036480788361
2023-10-09T04:00:00-04:00,1.0523,1.05273,1.05202,1.05242,1.0539767755325,1.0530184444444444,1.053525555555548,1.0541571111111039,1.0544775000000055,1.055667400000001,1.0558011000000045,1.0545404500000084,1.0533329352766652,1.0538881226689611,4166,-571852,-572195.8,-0.07812990372147842,-603.3547843143986,-0.2776330127445965
2023-10-09T04:15:00-04:00,1.05242,1.05296,1.05236,1.05277,1.05360835593665,1.0528673333333334,1.0532155555555482,1.0538606666666595,1.0543435000000057,1.055543400000001,1.0557858000000044,1.0545471500000083,1.053220348221332,1.0536492981351684,3337,-568515,-571342,-0.08973766073274295,-602.2450087495098,-0.2643146765697895
2023-10-09T04:30:00-04:00,1.05277,1.05365,1.05266,1.05356,1.05193,1.0529362222222223,1.053115555555548,1.0535795555555483,1.0542550000000057,1.055445200000001,1.0557757000000045,1.0545602500000082,1.0532882785770656,1.0534558385081343,3069,-565446,-570816.8,-0.10017872281594996,-599.9420270915977,-0.08535174402062676
2023-10-09T04:45:00-04:00,1.05356,1.05417,1.0534,1.05415,1.0519644000000001,1.053143111111111,1.0531088888888815,1.0533633333333259,1.0542015000000056,1.055359400000001,1.0557676000000042,1.0545774500000082,1.0534606228616525,1.0533726708065068,3202,-562244,-568815,-0.09779464073967317,-598.1488876405938,-0.0056914656472781535
2023-10-09T05:00:00-04:00,1.05415,1.0544,1.05389,1.05435,1.052052624,1.0533913333333333,1.0531811111111038,1.053229333333326,1.0541560000000056,1.055275200000001,1.0557635000000045,1.0545951000000082,1.053638498289322,1.053388136645205,2872,-559372,-565485.8,-0.09254064660541825,-597.603993650175,0.061687387301871247
2023-10-09T05:15:00-04:00,1.05435,1.05451,1.05416,1.05422,1.0521934665600001,1.0535991111111112,1.0533055555555482,1.0531853333333263,1.0541050000000056,1.055190800000001,1.0557587000000046,1.0546133500000083,1.0537547986314577,1.0534725093161632,-2807,-562179,-563551.2,-0.08291420739781001,-597.9500931427532,0.10635267306048903
2023-10-09T05:30:00-04:00,1.05422,1.05422,1.05333,1.05334,1.0523787892352001,1.053606,1.053274444444437,1.053197111111104,1.0540185000000057,1.055156000000001,1.0557431000000046,1.0546236000000082,1.0536718389051662,1.0535628074529302,-2461,-564640,-562776.2,-0.07206091227441334,-600.0043892099877,-0.026575046031781666
2023-10-09T05:45:00-04:00,1.05334,1.05352,1.05307,1.05334,1.052549286096384,1.053619111111111,1.053383333333326,1.0532506666666595,1.0539355000000057,1.0551230000000011,1.0557284000000045,1.0546359500000082,1.053605471124133,1.0536262459623438,0,-564640,-562615,-0.06690699390185822,-600.0043892099877,0.09312402599870585
2023-10-09T06:00:00-04:00,1.05334,1.05338,1.0528899999999999,1.05293,1.0527061432086733,1.0535284444444444,1.0534533333333258,1.0533195555555483,1.0538215000000057,1.055080000000001,1.0557062000000044,1.0546442000000082,1.0534703768993063,1.0536281967698746,-1946,-566586,-563483.4,-0.052151580271294705,-600.7618464412711,0.059868858690478796
2023-10-09T06:15:00-04:00,1.05293,1.05304,1.05232,1.05259,1.05451,1.0533557777777776,1.0534722222222148,1.0533777777777706,1.0536840000000058,1.055020800000001,1.0556837000000046,1.0546503500000082,1.0532943015194451,1.053559357415899,-2211,-568797,-565368.4,-0.03756605579438945,-601.4757970362774,0.016153246802607657
2023-10-09T06:30:00-04:00,1.05259,1.0530599999999999,1.05243,1.05259,1.0544662,1.0531793333333332,1.053452222222215,1.0534071111111039,1.0535460000000056,1.054970000000001,1.0556554000000045,1.0546574000000082,1.053153441215556,1.053439085932719,0,-568797,-566692,-0.023528592934800866,-601.4757970362774,-0.01709775164566515
2023-10-09T06:45:00-04:00,1.05259,1.05293,1.05249,1.0528,1.054423276,1.0530488888888887,1.0533677777777704,1.0534257777777707,1.0534185000000058,1.0549204000000012,1.0556306000000044,1.0546693500000082,1.053082752972445,1.0533212687461746,1935,-566862,-567136.4,-0.011720452075667057,-601.0897492873912,-0.07213637571662686
2023-10-09T07:00:00-04:00,1.0528,1.05346,1.0528,1.05338,1.05438121048,1.0530513333333331,1.053282222222215,1.0534055555555486,1.053309500000006,1.0548786000000012,1.0556042000000045,1.054679350000008,1.053142202377956,1.053228614996939,2403,-564459,-567100.2,-0.0045249584682860175,-599.7659081019808,-0.07304463311672318
2023-10-09T07:15:00-04:00,1.05338,1.05362,1.0529,1.05355,1.0543399862704002,1.0531048888888888,1.053193333333326,1.0533535555555484,1.0532640000000058,1.0548332000000011,1.0555810000000045,1.054690700000008,1.0532237619023648,1.053179291997551,2114,-562345,-566252,-0.0011347330482025567,-599.424739672734,-0.07587613221415203
2023-10-09T07:30:00-04:00,1.05355,1.05405,1.05314,1.0532299999999999,1.0542995865449922,1.053112222222222,1.053083333333326,1.0532757777777708,1.0532150000000058,1.0547728000000012,1.0555505000000045,1.054701450000008,1.0532250095218918,1.0531654335980403,-1677,-564022,-565297,-0.006207470575381269,-599.9341032530103,-0.09390829238679274
2023-10-09T07:45:00-04:00,1.0532299999999999,1.05334,1.05266,1.05282,1.0542599948140925,1.0530595555555555,1.0530255555555483,1.0531904444444375,1.0531710000000056,1.0547014000000012,1.0555240000000046,1.054711650000008,1.0531440076175134,1.0531635468784315,-2301,-566323,-564802.2,-0.013216006423815235,-600.8298335303473,-0.04936677615963069
2023-10-09T08:00:00-04:00,1.05282,1.05322,1.05265,1.05277,1.0542211949178106,1.0530084444444443,1.0529622222222148,1.0531093333333266,1.0531545000000058,1.0546220000000013,1.0555011000000045,1.054721300000008,1.0530692060940108,1.0531608375027448,-2985,-569308,-565291.4,-0.01442382254792654,-600.9715956549273,-0.054113581559606536
2023-10-09T08:15:00-04:00,1.05277,1.05324,1.05243,1.053,1.0541831710194545,1.0530159999999997,1.0529699999999926,1.0530468888888822,1.0531235000000057,1.0545498000000013,1.0554763000000045,1.054728850000008,1.0530553648752086,1.0531434700021953,3408,-565900,-565579.6,-0.017200147042068337,-600.2270455632646,0.0066481152593253585
2023-10-09T08:30:00-04:00,1.053,1.0533,1.05236,1.0524,1.0541459075990653,1.052902,1.0529488888888814,1.052997999999993,1.053125500000006,1.0544728000000014,1.0554418000000043,1.0547308500000079,1.052924291900167,1.0530835760017556,-4196,-570096,-567129.8,-0.016717258568380456,-602.6179287541476,-0.01805071300315531
2023-10-09T08:45:00-04:00,1.0524,1.0536,1.05225,1.0533,1.054109389447084,1.0529722222222222,1.0530277777777703,1.0529868888888818,1.0531755000000058,1.0544066000000014,1.0554089000000044,1.0547379500000078,1.0529994335201336,1.053038460801404,4199,-565897,-567504.8,-0.014225117687130247,-599.0269937484467,0.06745266438024193
2023-10-09T09:00:00-04:00,1.0533,1.05495,1.05324,1.05417,1.05225,1.0532006666666667,1.0531799999999925,1.0530177777777707,1.0532630000000058,1.0543534000000014,1.0553921000000044,1.054751500000008,1.053233546816107,1.0530563686411227,7653,-558244,-565889,-0.007677116225409835,-592.705803204441,0.13012917933131588
2023-10-09T09:15:00-04:00,1.05417,1.05471,1.05373,1.05464,1.05225,1.0534926666666666,1.0533199999999927,1.0530893333333264,1.0533565000000058,1.0542992000000013,1.0553849000000044,1.0547662500000081,1.0535148374528855,1.0531454949128978,4667,-553577,-562742.8,-0.00024412406910632894,-590.6250287562972,0.11961495376787473
2023-10-09T09:30:00-04:00,1.05464,1.0553299999999999,1.05438,1.05511,1.052304,1.0538506666666667,1.0534933333333258,1.0531939999999929,1.053434000000006,1.0542788000000014,1.0554285000000043,1.054779900000008,1.0538338699623084,1.0533011959303178,6842,-546735,-558909.8,0.005600698663576994,-587.5758935063543,0.14807080821982876
2023-10-09T09:45:00-04:00,1.05511,1.05548,1.05487,1.05529,1.05242504,1.05421,1.053722222222215,1.0533486666666598,1.053491000000006,1.0542564000000012,1.0554850000000044,1.054794500000008,1.0541250959698467,1.0535413567442538,5030,-541705,-553231.6,0.014296710762295849,-586.7177839253624,0.1955888077628033
2023-10-09T10:00:00-04:00,1.05529,1.05577,1.05437,1.05488,1.0526083376,1.0544415555555557,1.0539511111111037,1.0535333333333263,1.0535175000000059,1.0542342000000013,1.0555290000000044,1.0548072000000082,1.0542760767758774,1.0537966853954024,-5171,-546876,-549427.4,0.026657988583069447,-588.7268146183474,0.1956649759692968
2023-10-09T10:15:00-04:00,1.05488,1.05532,1.05474,1.05481,1.052861270592,1.0546133333333334,1.0541777777777706,1.053732888888882,1.0535470000000058,1.0542040000000015,1.0555662000000043,1.054822850000008,1.054382861420702,1.0540265483163214,-4760,-551636,-548105.8,0.04346635233390077,-589.0426799300417,0.1937745186508014
2023-10-09T10:30:00-04:00,1.05481,1.05514,1.0541,1.05458,1.05309396894464,1.0546937777777776,1.054353333333326,1.0539395555555486,1.0536090000000058,1.0541690000000015,1.0555996000000045,1.0548433000000081,1.0544222891365616,1.0542080386530568,-4550,-556186,-548627.6,0.05901782195418369,-590.0348017339683,0.1500474833808297
2023-10-09T10:45:00-04:00,1.05458,1.0549,1.05371,1.05453,1.0533080514290687,1.0547291111111112,1.0545899999999928,1.0541588888888822,1.053668500000006,1.0541316000000014,1.0556330000000045,1.0548586000000082,1.0544438313092492,1.0543300309224448,-4937,-561123,-551505.2,0.06815744410278633,-590.2688759625717,0.2023945267958918
2023-10-09T11:00:00-04:00,1.05453,1.05529,1.05437,1.05482,1.0535050073147432,1.0547751111111112,1.0547588888888815,1.0543662222222152,1.0537630000000058,1.0541046000000014,1.0556656000000044,1.054876850000008,1.0545190650473995,1.0544088247379553,3750,-557373,-554638.8,0.0844307645588614,-589.2376108492032,0.144308364188758
2023-10-09T11:15:00-04:00,1.05482,1.05499,1.05431,1.05473,1.0536862067295638,1.0547693333333334,1.0548211111111039,1.0545402222222153,1.0538700000000056,1.0540764000000016,1.0556795000000043,1.054886700000008,1.0545612520379195,1.0544658597903638,-3345,-560718,-557407.2,0.08985995926811745,-589.5230149939866,0.053122361668411534
2023-10-09T11:30:00-04:00,1.05473,1.05492,1.05421,1.05439,1.0538529101911986,1.0546831111111112,1.0547933333333261,1.0546633333333264,1.0539600000000058,1.0540518000000014,1.0556712000000044,1.054899250000008,1.0545270016303356,1.0544946878322903,-2786,-563504,-559780.8,0.08380704859407498,-590.4211026562319,-0.02370477129637445
2023-10-09T11:45:00-04:00,1.05439,1.05446,1.05391,1.05397,1.05577,1.0545184444444442,1.0546666666666595,1.054725999999993,1.0540185000000057,1.0540222000000015,1.0556733000000045,1.054906550000008,1.0544156013042685,1.0544933502658318,-2220,-565724,-561688.4,0.07120986284403345,-591.3054054284506,-0.10804560661920737
2023-10-09T12:00:00-04:00,1.05397,1.0544,1.05381,1.05381,1.0557328000000001,1.0543471111111111,1.054502222222215,1.0547084444444377,1.0540400000000059,1.0539918000000015,1.0556488000000044,1.054915600000008,1.0542944810434147,1.054463480212665,-2323,-568047,-563073.2,0.054309669479659546,-591.6580530370167,-0.14024580920885707
2023-10-09T12:15:00-04:00,1.05381,1.05432,1.0536,1.05396,1.0556558880000002,1.0542386666666668,1.0543999999999927,1.0546366666666598,1.054060500000006,1.0539666000000016,1.0556000000000045,1.054921550000008,1.0542275848347318,1.0544051841701312,1985,-566062,-564811,0.03906977080407346,-591.3755068474757,-0.08721371151221294
2023-10-09T12:30:00-04:00,1.05396,1.05417,1.0537,1.05373,1.0555325347200002,1.0541046666666667,1.0542799999999926,1.0545284444444376,1.054085500000006,1.0539360000000015,1.0555438000000044,1.054929500000008,1.0541280678677853,1.0543185473361043,-1431,-567493,-566166,0.027345906517168728,-591.6877862508685,-0.10238810781088252
2023-10-09T12:45:00-04:00,1.05373,1.05396,1.05345,1.05353,1.0554165826368003,1.0539546666666666,1.054163333333326,1.0544024444444375,1.0541210000000059,1.0539018000000018,1.0554843000000043,1.054932000000008,1.0540084542942283,1.054214837868883,-1989,-569482,-567361.6,0.01384669874836717,-592.0653023128577,-0.09956570388211376
2023-10-09T13:00:00-04:00,1.05353,1.05387,1.05352,1.05371,1.0552592560258562,1.0538640000000001,1.0540722222222147,1.0542835555555485,1.0541680000000058,1.0538746000000017,1.0554395000000045,1.054937900000008,1.0539487634353826,1.0541214702951058,1746,-567736,-567764,0.0015720905146291869,-591.7669909216304,-0.07775976027235289
2023-10-09T13:15:00-04:00,1.05371,1.05398,1.05366,1.05382,1.0551145155437878,1.0538135555555557,1.0539611111111038,1.0541753333333266,1.0542090000000057,1.0538510000000016,1.0553974000000046,1.054943350000008,1.053923010748306,1.054047176236084,1375,-566361,-567426.8,-0.009906410843498603,-591.623450478814,-0.09480290476101248
2023-10-09T13:30:00-04:00,1.05382,1.05616,1.05382,1.05614,1.05345,1.0542493333333331,1.0541177777777704,1.054118888888882,1.0543960000000057,1.0538696000000016,1.0553749000000046,1.0549595000000078,1.0543664085986448,1.0540749409888668,3157,-563204,-566855.2,-0.011567131820869278,-584.6732692334397,0.1336835019388975
2023-10-09T13:45:00-04:00,1.05614,1.05648,1.05602,1.05632,1.0535042,1.0546897777777777,1.054332222222215,1.0541293333333264,1.0545470000000057,1.0538892000000015,1.0553589000000045,1.0549782500000078,1.0547571268789158,1.0542007527910928,2991,-560213,-565399.2,-0.014188791306312107,-584.1635072700641,0.18304422462276648
2023-10-09T14:00:00-04:00,1.05632,1.05673,1.05631,1.05667,1.0536232319999999,1.0551573333333333,1.0546322222222149,1.0542231111111042,1.0546720000000056,1.0539156000000016,1.0553384000000046,1.054994550000008,1.0551397015031325,1.0544270022328734,2700,-557513,-563005.4,-0.007784135624385056,-583.2688920019633,0.2561742744100804
2023-10-09T14:15:00-04:00,1.05667,1.05673,1.05649,1.05663,1.05380963808,1.055556888888889,1.0549455555555483,1.0543977777777709,1.0547715000000055,1.0539412000000015,1.0553170000000045,1.0550083500000078,1.055437761202506,1.0547248017862985,-1720,-559233,-561304.8,0.0063295511031617275,-583.3340022066631,0.26760042132832723
2023-10-09T14:30:00-04:00,1.05663,1.05669,1.0563,1.05652,1.0539848597952,1.0558717777777777,1.0552299999999926,1.0546515555555487,1.0548420000000056,1.0539604000000016,1.0553005000000046,1.0550229000000078,1.055654208962005,1.0550710414290383,-1908,-561141,-560260.8,0.023532916966836827,-583.5326337049171,0.24289346844281526
2023-10-09T14:45:00-04:00,1.05652,1.05662,1.05601,1.05643,1.054149568207488,1.0561117777777778,1.0555299999999928,1.0549339999999932,1.0548990000000056,1.0539998000000017,1.0552766000000044,1.0550371000000076,1.0558093671696038,1.05535963314323,-2288,-563429,-560305.8,0.04098717706249609,-583.7275377294503,0.2562326212597083
2023-10-09T15:00:00-04:00,1.05643,1.05696,1.05641,1.05686,1.0543043941150387,1.0563777777777776,1.0558999999999927,1.0552475555555487,1.0549980000000057,1.0540528000000016,1.0552512000000045,1.0550546500000078,1.056019493735683,1.0556121065145834,2043,-561386,-560540.4,0.06356624556999142,-582.8959729310255,0.31608022552749643
2023-10-09T15:15:00-04:00,1.05686,1.05702,1.05679,1.05692,1.0545168425858356,1.056581777777778,1.0562566666666595,1.0555724444444377,1.0551035000000055,1.0541172000000016,1.0552227000000045,1.0550714000000077,1.0561995949885465,1.0558240852116663,2097,-559289,-560895.6,0.0864832954822032,-582.7769221579805,0.30463789847302936
2023-10-09T15:30:00-04:00,1.05692,1.05694,1.05666,1.05684,1.054767158327252,1.0566984444444443,1.056592222222215,1.055901777777771,1.0552165000000058,1.0541920000000018,1.0551941000000045,1.0550870000000077,1.0563276759908373,1.0560020681693325,-1816,-561105,-561270,0.10697728363009748,-582.9143781622194,0.28657645518210156
2023-10-09T15:45:00-04:00,1.05684,1.05698,1.05674,1.05691,1.0549924424945267,1.056762,1.0566777777777707,1.0561913333333266,1.0553355000000058,1.0542578000000018,1.0551699000000045,1.0551026500000078,1.05644414079267,1.0561600545354657,1706,-559399,-560921.6,0.12573303659923882,-582.801380925173,0.07290700096577513
2023-10-09T16:00:00-04:00,1.05691,1.05723,1.05682,1.05696,1.055195198245074,1.0568184444444444,1.0567488888888816,1.0564351111111043,1.0554425000000056,1.0543498000000016,1.0551490000000046,1.0551166000000078,1.0565473126341358,1.0563076436283718,1281,-558118,-559859.4,0.12252483456054337,-582.7407797386956,0.06058770069675609
2023-10-09T16:15:00-04:00,1.05696,1.05697,1.05676,1.05688,1.0554393744556652,1.0568446666666667,1.0567722222222151,1.0566095555555488,1.0555500000000058,1.0544414000000015,1.0551235000000043,1.0551277500000078,1.0566138501073086,1.056426514902697,-780,-558898,-559361.8,0.1185253091147421,-582.7998169775692,0.01987375434147307
2023-10-09T16:30:00-04:00,1.05688,1.05693,1.0565,1.05656,1.0556542495209853,1.0568022222222222,1.0567644444444373,1.0567111111111045,1.0556585000000056,1.0545242000000017,1.0550958000000044,1.0551379000000078,1.0566030800858468,1.0565072119221572,-650,-559548,-559413.6,0.10921815481743057,-582.9966226697954,-0.006624835562118669
2023-10-09T16:45:00-04:00,1.05656,1.05671,1.05652,1.05665,1.055843339578467,1.0567793333333333,1.0567788888888818,1.0567484444444377,1.0557925000000057,1.0546018000000015,1.0550726000000044,1.0551457000000077,1.0566124640686774,1.0565641695377253,1030,-558518,-558896.2,0.09920242924858752,-582.908885106382,0.012304547003387114
2023-10-09T17:00:00-04:00,1.05665,1.05673,1.05584,1.05665,1.05723,1.0567535555555556,1.0568033333333262,1.0567735555555489,1.0559345000000058,1.0546636000000016,1.0550544000000044,1.0551545000000078,1.056619971254942,1.0565993356301795,0,-558518,-558720,0.08833464877682937,-582.908885106382,0.020824853516097516
2023-10-09T17:15:00-04:00,1.05665,1.0567,1.0565,1.05651,1.0572021999999999,1.0566948888888887,1.056764444444437,1.05677666666666,1.0560620000000056,1.0547108000000016,1.0550351000000044,1.0551638500000076,1.0565979770039535,1.0566094685041432,-104,-558622,-558820.8,0.07690573253022126,-582.9226645035333,-0.033116969134970614
2023-10-09T17:30:00-04:00,1.05651,1.05656,1.0565,1.05656,1.0571749559999999,1.056654,1.0567244444444372,1.0567671111111046,1.0562035000000056,1.0547550000000014,1.0550151000000045,1.0551726000000077,1.0565903816031628,1.056604774803314,298,-558324,-558706,0.06233260287332282,-582.9085614661744,-0.0340612345305357
2023-10-09T17:45:00-04:00,1.05656,1.05674,1.0565,1.05656,1.05714825688,1.056621111111111,1.0566933333333262,1.0567528888888824,1.0563550000000057,1.0548018000000015,1.0549963000000044,1.0551806500000078,1.0565843052825301,1.0566010198426508,0,-558324,-558461.2,0.04615739048006669,-582.9085614661744,-0.026494076681433137
2023-10-09T18:00:00-04:00,1.05656,1.0569,1.05649,1.0568899999999999,1.0571220917424,1.0566604444444443,1.0566911111111041,1.056735333333327,1.0565140000000057,1.0548728000000016,1.0550144000000043,1.0551908500000078,1.056645444226024,1.0566076158741198,443,-557881,-558333.8,0.03147765573298947,-582.7701973410893,-0.0018923087112555491
2023-10-09T18:15:00-04:00,1.0568899999999999,1.05711,1.05688,1.05709,1.05584,1.0567402222222222,1.0567055555555485,1.0567157777777714,1.0566775000000057,1.0549478000000014,1.0550354000000044,1.0552012000000077,1.0567343553808193,1.0566304926992953,612,-557269,-558084,0.017942640340158376,-582.6543858564503,0.012299424765382374
2023-10-09T18:30:00-04:00,1.05709,1.05717,1.05702,1.0570599999999999,1.0558653999999998,1.056811111111111,1.0567255555555484,1.0567079999999938,1.0567235000000055,1.0550304000000015,1.0550552000000044,1.0552112500000077,1.0567994843046553,1.056670794159436,-321,-557590,-557877.6,0.004285596475447656,-582.6634957714056,0.017031261827250677
2023-10-09T18:45:00-04:00,1.0570599999999999,1.05709,1.05685,1.05686,1.055917584,1.056838,1.0567588888888817,1.0567148888888824,1.0567505000000055,1.0551158000000016,1.0550683000000045,1.0552221500000076,1.0568115874437243,1.056715035327548,-116,-557706,-557754,0.0008516839686508497,-582.685443437574,0.028394033467097655
2023-10-09T19:00:00-04:00,1.05686,1.05712,1.05679,1.05711,1.05596768064,1.0569082222222224,1.0568099999999927,1.0567382222222157,1.0567725000000054,1.0552062000000015,1.0550881000000043,1.0552340500000077,1.0568712699549794,1.0567724282620379,374,-557332,-557555.6,0.0024963815986911875,-582.5969738200276,0.04353380968153172
2023-10-09T19:15:00-04:00,1.05711,1.05742,1.05708,1.05742,1.0560157734144,1.0570302222222223,1.0568955555555481,1.0567791111111047,1.0568120000000054,1.0552986000000015,1.0551095000000044,1.0552469500000077,1.0569810159639834,1.0568395426096298,602,-556730,-557325.4,0.006402957346412366,-582.4204359006058,0.07287181185822528
2023-10-09T19:30:00-04:00,1.05742,1.05797,1.05741,1.05784,1.056100027009536,1.057219111111111,1.0570433333333262,1.0568466666666603,1.0568780000000055,1.0553878000000017,1.0551332000000044,1.0552615500000078,1.0571528127711867,1.0569232340877033,985,-555745,-557020.6,0.012210463330932099,-582.0292006298525,0.12588617239778432
2023-10-09T19:45:00-04:00,1.05784,1.05797,1.05775,1.05786,1.0562496248487732,1.0573824444444446,1.0571877777777705,1.0569391111111048,1.0569495000000055,1.0554740000000016,1.0551536000000044,1.0552766000000076,1.0572942502169493,1.057022187270162,1106,-554639,-556430.4,0.018945349986793977,-582.0082900951779,0.12304081169077752
2023-10-09T20:00:00-04:00,1.05786,1.05834,1.05745,1.05759,1.0563872548608713,1.0574628888888888,1.0573022222222148,1.0570477777777714,1.0569860000000055,1.0555612000000016,1.0551670000000042,1.0552899000000078,1.0573534001735594,1.057130549816129,-3135,-557774,-556444,0.02346307404130656,-582.8084432345347,0.09748618157038753
2023-10-09T20:15:00-04:00,1.05759,1.05781,1.0570599999999999,1.05762,1.0565825293747841,1.0575264444444445,1.057383333333326,1.057162444444438,1.0570210000000055,1.0556572000000015,1.0551793000000043,1.0553038500000078,1.0574067201388475,1.0572376398529026,3018,-554756,-555928.8,0.03006666564572564,-582.7228334991931,0.06907057498889378
2023-10-09T20:30:00-04:00,1.05762,1.05766,1.05707,1.05717,1.0567582764373058,1.057483777777778,1.057392222222215,1.0572617777777713,1.0570375000000056,1.0557452000000014,1.0551836000000043,1.0553152500000076,1.057359376111078,1.0573133118823217,-2358,-557114,-556005.6,0.03158901484372341,-583.7261239059557,0.007567945964852374
2023-10-09T20:45:00-04:00,1.05717,1.05765,1.05708,1.05726,1.0569164487935752,1.0574573333333332,1.057414444444437,1.0573359999999936,1.0570550000000056,1.0558304000000016,1.0551901000000041,1.0553274000000075,1.0573395008888624,1.0573506495058569,2451,-554663,-555789.2,0.031304607935798666,-583.5174630472476,0.01892040186935463
2023-10-09T21:00:00-04:00,1.05726,1.05745,1.05707,1.05738,1.0570588039142177,1.0574504444444444,1.057472222222215,1.0573928888888824,1.0570760000000055,1.0559300000000014,1.0552014000000043,1.0553407000000077,1.05734760071109,1.057361319604685,2444,-552219,-555305.2,0.03221391734952261,-583.2400667587284,0.04920235414341313
2023-10-09T21:15:00-04:00,1.05738,1.05807,1.05738,1.05776,1.05707,1.057508,1.0575444444444373,1.0574413333333268,1.0571200000000056,1.0560192000000017,1.0552129000000043,1.0553557500000077,1.057430080568872,1.0573766556837474,3714,-548505,-553451.4,0.03712282560535952,-581.9053337393785,0.06148839761236195
2023-10-09T21:30:00-04:00,1.05776,1.05791,1.0573299999999999,1.05736,1.05707,1.0574711111111113,1.0575377777777706,1.0574722222222157,1.0571600000000054,1.0560830000000017,1.0552182000000043,1.0553689500000076,1.0574160644550976,1.0573785245469973,-3214,-551719,-552844,0.0373247278351196,-583.1207323175057,-0.005674188118245256
2023-10-09T21:45:00-04:00,1.05736,1.05737,1.05705,1.0573,1.05834,1.0574235555555553,1.0574777777777706,1.0574893333333268,1.0571925000000055,1.0561362000000016,1.0552177000000043,1.0553823000000078,1.057392851564078,1.0573852196375975,-1994,-553713,-552163.8,0.03285511587597117,-583.2338820489125,-0.05104741737880823
2023-10-09T22:00:00-04:00,1.0573,1.0577,1.05726,1.05747,1.0583142,1.057422,1.0574344444444372,1.0574933333333267,1.0572335000000055,1.0561834000000017,1.0552311000000045,1.0553962500000076,1.0574082812512624,1.0573989757100777,1579,-552134,-551658,0.02566063639482205,-582.9799995179374,-0.036866882196142446
2023-10-09T22:15:00-04:00,1.05747,1.0576,1.05711,1.05741,1.0582889160000002,1.057417111111111,1.0574144444444373,1.0574817777777712,1.0572785000000056,1.0562258000000015,1.0552411000000044,1.0554115000000075,1.05740862500101,1.0574111805680615,-1608,-553742,-551962.6,0.017980297341728332,-583.0712361487637,-0.017019828099742715
2023-10-09T22:30:00-04:00,1.05741,1.05755,1.05724,1.05749,1.0582641376800002,1.057432222222222,1.057399999999993,1.0574528888888826,1.0573250000000054,1.0562780000000016,1.0552561000000045,1.0554264000000075,1.057424900000808,1.0574101444544488,1751,-551991,-552659.8,0.012619882124559702,-582.9387615173529,-0.012291749399591864
2023-10-09T22:45:00-04:00,1.05749,1.0574999999999999,1.05665,1.05669,1.0582398549264003,1.057290222222222,1.0573466666666596,1.0574146666666602,1.0573315000000054,1.0563156000000016,1.0552598000000044,1.0554390500000077,1.0572779200006464,1.0573825155635586,-1767,-553758,-553067.6,0.0032382734194765553,-584.2755117466697,-0.045404239620878
2023-10-09T23:00:00-04:00,1.05669,1.0569,1.05661,1.05677,1.0581762607293443,1.057174888888889,1.0572922222222152,1.0573775555555491,1.0573255000000052,1.0563594000000016,1.0552642000000043,1.0554533000000077,1.057176336000517,1.0573392124508463,1319,-552439,-552812.8,-0.0014907626758109164,-584.1756527530197,-0.04634621568962236
2023-10-09T23:15:00-04:00,1.05677,1.05702,1.0566,1.05701,1.0580822850855838,1.0571184444444444,1.057251111111104,1.0573408888888824,1.0573215000000054,1.0564090000000015,1.0552703000000045,1.0554682500000077,1.0571430688004138,1.0572861699606766,1481,-550958,-552577.6,-0.0043956994204397875,-583.8393070959703,-0.03499215040950098
2023-10-09T23:30:00-04:00,1.05701,1.05701,1.05665,1.0568899999999999,1.0579637022787372,1.057046222222222,1.0571544444444372,1.0572888888888825,1.0573130000000055,1.0564504000000015,1.0552775000000043,1.0554818000000075,1.057092455040331,1.0572229359685408,-983,-551941,-552217.4,-0.008129414880071417,-583.9509049048843,-0.08224928150054345
2023-10-09T23:45:00-04:00,1.0568899999999999,1.05702,1.05674,1.05695,1.0578546060964382,1.0570053333333334,1.0571088888888818,1.0572306666666602,1.0573175000000055,1.0564948000000016,1.0552856000000046,1.0554949500000077,1.0570639640322648,1.057150748774832,1078,-550863,-551991.8,-0.015295085710383455,-583.8897064830994,-0.03877581902095988
2023-10-10T00:00:00-04:00,1.05695,1.05695,1.05654,1.0565499999999999,1.0577542376087232,1.0568935555555554,1.0570255555555486,1.057166444444438,1.0572895000000053,1.0565380000000015,1.0552949000000045,1.0555063500000077,1.0569611712258118,1.0570873990198653,-1077,-551940,-551628.2,-0.021560246634273056,-584.2972943538598,-0.07093540149437515
2023-10-10T00:15:00-04:00,1.0565499999999999,1.05658,1.05636,1.05646,1.0576328138478508,1.0567804444444444,1.0569133333333263,1.0570906666666602,1.0572415000000053,1.0565878000000015,1.0553050000000044,1.0555169500000077,1.0568609369806494,1.0570243192158917,-1263,-553203,-551781,-0.026578387325417552,-584.4048803649334,-0.09551098376312855
2023-10-10T00:30:00-04:00,1.05646,1.05654,1.05624,1.05625,1.0574800761861087,1.0566477777777779,1.0567844444444374,1.056997333333327,1.0571620000000053,1.0566366000000016,1.0553142000000044,1.0555261000000076,1.0567387495845195,1.0569434553727128,-1053,-554256,-552440.6,-0.03284975325505296,-584.6141925963478,-0.10970200773588767
2023-10-10T00:45:00-04:00,1.05625,1.05625,1.05605,1.05614,1.0573064655200535,1.0565188888888888,1.0566344444444375,1.056893333333327,1.0570760000000052,1.0566802000000015,1.0553234000000045,1.0555344000000075,1.0566189996676156,1.0568487642981697,-1161,-555417,-553135.8,-0.037208246356190404,-584.7351014720873,-0.12766078166223438
2023-10-10T01:00:00-04:00,1.05614,1.0562,1.0559399999999999,1.05599,1.0571054310368448,1.05639,1.0565566666666597,1.0567828888888826,1.0569960000000052,1.0567254000000015,1.0553307000000045,1.0555420500000077,1.0564931997340925,1.0567346114385354,-1216,-556633,-554289.8,-0.04297779345498324,-584.9078058484012,-0.06624459396794925
2023-10-10T01:15:00-04:00,1.05599,1.05629,1.05585,1.05624,1.0568956534502127,1.0563266666666666,1.0564977777777707,1.056677333333327,1.0569270000000053,1.0567796000000014,1.0553407000000046,1.0555508000000078,1.056442559787274,1.0566308891508278,1188,-555445,-554990.8,-0.04115576748387077,-584.6265531850236,-0.05015282417176107
2023-10-10T01:30:00-04:00,1.05624,1.05669,1.05617,1.0565,1.05585,1.0563271111111112,1.056441111111104,1.0565828888888826,1.0568935000000053,1.0568354000000013,1.0553550000000045,1.0555620000000077,1.0564540478298192,1.056549511320662,1674,-553771,-555104.4,-0.03866629661379254,-584.2144877453509,-0.04824930700750328
2023-10-10T01:45:00-04:00,1.0565,1.05658,1.05608,1.05616,1.05585,1.056270888888889,1.056359999999993,1.0564979999999937,1.0568385000000053,1.0568822000000013,1.0553666000000044,1.0555716000000077,1.0563952382638553,1.056480809056529,-2084,-555855,-555424.2,-0.04215998626634122,-584.8851550430319,-0.06907057498887277
2023-10-10T02:00:00-04:00,1.05616,1.05691,1.05576,1.05597,1.05691,1.0561928888888892,1.0562511111111041,1.056421333333327,1.0567680000000053,1.0568788000000013,1.0553742000000044,1.0555807500000076,1.0563101906110843,1.0564190472452228,-4298,-560153,-556371.4,-0.045055274832896355,-585.6583522858735,-0.09271961776810453
2023-10-10T02:15:00-04:00,1.05597,1.05616,1.05564,1.05593,1.05691,1.0561286666666667,1.0561822222222153,1.056346444444438,1.0566765000000053,1.0568710000000012,1.0553801000000045,1.055588300000008,1.0562341524888674,1.0563672377961777,-4261,-564414,-557927.6,-0.04817655936157652,-585.8197583864259,-0.058681557900699725
2023-10-10T02:30:00-04:00,1.05593,1.05595,1.05545,1.05572,1.05691,1.0560362222222222,1.056099999999993,1.0562668888888826,1.0565945000000052,1.0568520000000015,1.0553838000000042,1.0555955500000078,1.056131321991094,1.0563049902369417,-3451,-567865,-560411.6,-0.046842502562962,-586.5060822904727,-0.07004524544232275
2023-10-10T02:45:00-04:00,1.05572,1.05617,1.05554,1.05614,1.0568224,1.0560442222222222,1.0560877777777709,1.0561962222222159,1.0565365000000053,1.0568422000000013,1.0553917000000044,1.0556060000000078,1.0561330575928751,1.0562407921895531,3301,-564564,-562570.2,-0.04437527802130873,-585.1928363540499,-0.010414201183416091
2023-10-10T03:00:00-04:00,1.05614,1.05663,1.0559,1.05617,1.056740056,1.0560606666666668,1.0560911111111042,1.056142444444438,1.0564715000000053,1.0568352000000012,1.0553978000000042,1.0556161500000079,1.0561404460743,1.056189833751642,5429,-559135,-563226.2,-0.04004164619640184,-585.0386238443448,0.0028405325051578854
2023-10-10T03:15:00-04:00,1.05617,1.05648,1.05543,1.05593,1.05666265264,1.0560284444444445,1.056084444444438,1.056109111111105,1.0563975000000052,1.0568252000000014,1.0554125000000043,1.0556261000000078,1.05609835685944,1.056147467001313,-4979,-564114,-564018.4,-0.03509070846699988,-586.1700326137665,-0.005681871987419292
2023-10-10T03:30:00-04:00,1.05593,1.05695,1.05593,1.05663,1.05543,1.0561375555555554,1.0561277777777711,1.0560982222222162,1.0563545000000052,1.0568206000000013,1.0554367000000042,1.0556410000000078,1.056204685487552,1.05614157360105,5157,-558957,-562927,-0.02551772447327505,-582.7513400868,0.036923426493968264
2023-10-10T03:45:00-04:00,1.05663,1.05725,1.05633,1.05717,1.05543,1.056346,1.0562022222222156,1.0561186666666607,1.0563785000000052,1.0568256000000011,1.0554714000000043,1.055659400000008,1.0563977483900415,1.0561948588808394,4443,-554514,-560256.8,-0.015272089309949107,-580.4807060900368,0.06341694273544235
2023-10-10T04:00:00-04:00,1.05717,1.05858,1.05698,1.0582,1.0555028000000002,1.0567455555555556,1.0564288888888822,1.0561868888888828,1.0564500000000054,1.0568528000000013,1.0555224000000043,1.0556810500000078,1.0567581987120331,1.0563198871046713,6028,-548486,-557041.2,-0.0059858188377226,-574.6076298582099,0.1931525526435428
2023-10-10T04:15:00-04:00,1.0582,1.05887,1.05755,1.05887,1.0556874320000003,1.0572337777777778,1.0567511111111043,1.0563188888888828,1.0565430000000053,1.0568920000000013,1.0555749000000043,1.0557077500000078,1.0571805589696266,1.0565279096837366,5601,-542885,-553791.2,0.01019926653639667,-571.0613531619334,0.2746290140818302
2023-10-10T04:30:00-04:00,1.05887,1.05992,1.05885,1.05984,1.0559420374400001,1.0578515555555554,1.057185555555549,1.056539111111105,1.0566905000000055,1.0569496000000012,1.0556497000000042,1.0557404500000078,1.0577124471757013,1.0568507277469887,5265,-537620,-548492.4,0.034068325920520115,-566.2382398430184,0.3702896972337047
2023-10-10T04:45:00-04:00,1.05984,1.06094,1.05979,1.06043,1.0563398336960002,1.0585004444444444,1.0577088888888824,1.0568553333333273,1.0568645000000054,1.057020600000001,1.0557310000000042,1.0557753000000079,1.058255957740561,1.0572609821975905,4458,-533162,-543333.4,0.060691422639586975,-563.7565256220036,0.4461410222407449
2023-10-10T05:00:00-04:00,1.06043,1.06053,1.05972,1.06001,1.05689185365248,1.0589606666666667,1.0581388888888823,1.0572426666666608,1.0570375000000054,1.0570896000000012,1.0558069000000043,1.0558040000000077,1.0586067661924488,1.0577027857580719,-4850,-538012,-540033,0.0874836128720661,-565.6774444945368,0.3664286931656615
2023-10-10T05:15:00-04:00,1.06001,1.06111,1.0599399999999999,1.06109,1.0573776312141825,1.059550888888889,1.058685555555549,1.057693999999994,1.0572690000000053,1.057178400000001,1.0558901000000043,1.055837950000008,1.059103412953959,1.0581718286064568,3675,-534337,-537203.2,0.11383741167419839,-561.9331401955201,0.4658340986772996
2023-10-10T05:30:00-04:00,1.06109,1.06109,1.06005,1.06035,1.0579001628441969,1.0598837777777776,1.0591766666666602,1.0581791111111052,1.0574740000000054,1.0572524000000012,1.0559580000000042,1.055866850000008,1.0593527303631671,1.058606262885165,-4773,-539110,-536448.2,0.13582980609082712,-565.2618116560002,0.4185883533946254
2023-10-10T05:45:00-04:00,1.06035,1.06087,1.06015,1.06019,1.0583495400460092,1.0600864444444444,1.059572222222216,1.0586564444444386,1.0576765000000052,1.057326000000001,1.0560184000000041,1.055893000000008,1.0595201842905337,1.0589678103081315,-3123,-542233,-537370.8,0.15834544142280177,-565.7330522840945,0.33692020858768046
2023-10-10T06:00:00-04:00,1.06019,1.06046,1.0597699999999999,1.06014,1.058736004439568,1.0601999999999998,1.0599022222222159,1.0590951111111053,1.0578840000000054,1.057397600000001,1.0560763000000042,1.055919900000008,1.059644147432427,1.0592454482465048,-3380,-545613,-539861,0.17349226849975627,-565.892457673694,0.28093873265417474
2023-10-10T06:15:00-04:00,1.06014,1.06022,1.05945,1.05955,1.0590683638180285,1.0601295555555554,1.0600522222222157,1.0594777777777717,1.058049500000005,1.0574574000000012,1.0561296000000042,1.055944150000008,1.0596253179459416,1.0594491585972032,-2750,-548363,-541931.2,0.17993692282995208,-567.4229159150586,0.12757512757512401
2023-10-10T06:30:00-04:00,1.05955,1.05996,1.05949,1.05978,1.0593541928835044,1.060075111111111,1.060153333333327,1.0597713333333274,1.058213500000005,1.057515200000001,1.0561940000000043,1.0559685500000078,1.0596562543567534,1.0595597268777621,2357,-546006,-544265,0.17890919171591824,-566.91127418036,0.08594067260381033
2023-10-10T06:45:00-04:00,1.05978,1.0598,1.05906,1.0592,1.06111,1.0598844444444444,1.060082222222216,1.0599524444444388,1.058365500000005,1.057557400000001,1.0562526000000043,1.0559905000000078,1.0595650034854027,1.0596021815022094,-2693,-548699,-546182.8,0.16985646255985745,-568.3851083723622,-0.06038647342994924
2023-10-10T07:00:00-04:00,1.0592,1.05921,1.05801,1.05845,1.061069,1.059558,1.0598622222222158,1.0600104444444387,1.0584895000000052,1.057585200000001,1.0563078000000043,1.056007000000008,1.0593420027883222,1.059566545201767,-3917,-552616,-548259.4,0.146402192771141,-571.1586638859575,-0.1867167092594601
2023-10-10T07:15:00-04:00,1.05845,1.0587199999999999,1.05792,1.05793,1.06094664,1.0591715555555556,1.0596311111111048,1.0599562222222165,1.058589500000005,1.057606600000001,1.0563612000000042,1.056022450000008,1.0590596022306578,1.0594496361614132,-3141,-555757,-550288.2,0.11395230819919995,-572.7017882659467,-0.1962245639191951
2023-10-10T07:30:00-04:00,1.05793,1.05836,1.05763,1.05779,1.0607650416,1.0588033333333335,1.0592644444444383,1.059798666666661,1.0586930000000052,1.057620200000001,1.0564132000000044,1.0560343000000079,1.0588056817845262,1.05928570892913,-3160,-558917,-552399,0.08460348778542609,-573.1199633815027,-0.31100095185140564
2023-10-10T07:45:00-04:00,1.05779,1.0578,1.05718,1.05757,1.060514238272,1.0584644444444444,1.0589555555555494,1.0595591111111053,1.0587645000000052,1.057623200000001,1.0564609000000045,1.056045750000008,1.058558545427621,1.0590661671433035,-3540,-562457,-555689.2,0.04302467272709251,-573.8562153785913,-0.26217758287357995
2023-10-10T08:00:00-04:00,1.05757,1.05833,1.05745,1.0582799999999999,1.0601808144448002,1.0583293333333332,1.0587433333333272,1.0592913333333276,1.058870000000005,1.057632000000001,1.0565099000000044,1.056057050000008,1.0585028363420967,1.0588537337146422,4596,-557861,-557521.6,0.013843930597103983,-570.77068912501,-0.1801563870627037
2023-10-10T08:15:00-04:00,1.0582799999999999,1.05836,1.0574,1.05791,1.0598807330003202,1.0581626666666666,1.0584955555555495,1.0590179999999942,1.0589690000000052,1.057633000000001,1.0565535000000044,1.056067250000008,1.0583842690736773,1.0586621869717132,-5036,-562897,-559577.8,-0.015515861932853637,-572.5313951763385,-0.21034957647104874
2023-10-10T08:30:00-04:00,1.05791,1.05898,1.05783,1.05869,1.0596106597002881,1.0582015555555555,1.058399999999994,1.0587717777777723,1.0590720000000053,1.0576550000000011,1.0566081000000045,1.056079300000008,1.0584454152589418,1.05853934957737,6377,-556520,-559730.4,-0.041617820251242055,-567.8296152517702,-0.08116653296211439
2023-10-10T08:45:00-04:00,1.05869,1.05952,1.05859,1.05934,1.05718,1.0583895555555554,1.0583511111111052,1.0585891111111054,1.0591805000000052,1.057689400000001,1.0566733000000044,1.056098650000008,1.0586243322071534,1.0585030796618955,5761,-550759,-558098.8,-0.05578041777287865,-564.2925553003205,-0.04151805091622752
2023-10-10T09:00:00-04:00,1.05934,1.0594999999999999,1.05846,1.05947,1.0572268,1.0586133333333332,1.0583811111111052,1.0584742222222165,1.0592440000000052,1.0577354000000008,1.0567403000000044,1.056120700000008,1.0587934657657228,1.0585500637295158,6535,-544224,-554452.2,-0.06904169746254107,-563.4905937015894,0.02549093655589053
2023-10-10T09:15:00-04:00,1.05947,1.05969,1.05868,1.05919,1.057272664,1.058775111111111,1.0584633333333275,1.0584182222222167,1.0592600000000052,1.057774000000001,1.0568022000000044,1.056139250000008,1.0588727726125782,1.0586240509836122,-5092,-549316,-552743.2,-0.07358365622815614,-564.8363231700965,0.06991355283671265
2023-10-10T09:30:00-04:00,1.05919,1.05959,1.05884,1.05892,1.05736935744,1.0588664444444444,1.0585733333333274,1.0584337777777724,1.0592140000000052,1.0578048000000009,1.0568674000000045,1.056154600000008,1.0588822180900626,1.0587236407868892,-7583,-556899,-551543.6,-0.06937114167676371,-566.769319138714,0.09357897025323475
2023-10-10T09:45:00-04:00,1.05892,1.05947,1.0585499999999999,1.05944,1.0574621831424,1.0590397777777778,1.0587566666666608,1.0585051111111057,1.0591645000000054,1.057838400000001,1.0569288000000043,1.056168850000008,1.0589937744720501,1.0588333126295109,5261,-551638,-550567.2,-0.0533184197604768,-564.1858189687301,0.15598559260344014
2023-10-10T10:00:00-04:00,1.05944,1.06063,1.0594,1.06045,1.057551295816704,1.0593784444444445,1.0590766666666607,1.0586502222222167,1.0591865000000054,1.057900200000001,1.0569916000000044,1.056191850000008,1.05928501957764,1.058965450103608,7271,-544367,-549288.8,-0.02829560136897467,-557.2541286417652,0.27232239946291914
2023-10-10T10:15:00-04:00,1.06045,1.06064,1.05965,1.0603,1.0577360180677018,1.059623111111111,1.059301111111105,1.0588342222222167,1.0591470000000052,1.057960200000001,1.0570482000000043,1.056216550000008,1.059488015662112,1.059104360082886,-5914,-550281,-550500.2,-0.003825745604319092,-558.0906603028518,0.19087576066826673
2023-10-10T10:30:00-04:00,1.0603,1.06053,1.05935,1.05941,1.0579683366222856,1.0596448888888887,1.0594677777777717,1.0590351111111054,1.0591000000000053,1.057999000000001,1.0570912000000043,1.056259850000008,1.0594724125296897,1.0592242880663083,-5962,-556243,-551885.6,0.014395960858673739,-563.0950741479903,0.14178899906419798
2023-10-10T10:45:00-04:00,1.05941,1.05978,1.0588899999999999,1.05971,1.0581820696925028,1.0596933333333334,1.059581111111105,1.0592366666666613,1.0590760000000052,1.058045000000001,1.0571354000000042,1.056310200000008,1.0595199300237517,1.0593518304530458,5412,-550831,-550672,0.03426894784642993,-561.5625230110369,0.09634548356931878
2023-10-10T11:00:00-04:00,1.05971,1.06045,1.0596,1.0601099999999999,1.0583787041171027,1.0597991111111111,1.0596666666666605,1.0594186666666612,1.0590745000000052,1.058097400000001,1.0571877000000043,1.0563583500000078,1.0596379440190014,1.0594806643624364,4445,-546386,-549621.6,0.04803604771795592,-559.8847054949242,0.07268676723242183
2023-10-10T11:15:00-04:00,1.0601099999999999,1.06067,1.05989,1.06014,1.0585596077877344,1.0598937777777777,1.059741111111105,1.0595515555555501,1.0591040000000054,1.0581664000000008,1.057241000000004,1.0564036000000079,1.059738355215201,1.0595713314899486,5326,-541060,-548960.2,0.05558945095324793,-559.7339852866429,0.06323916675320401
2023-10-10T11:30:00-04:00,1.06014,1.06114,1.06001,1.06087,1.058770647008961,1.0601195555555556,1.0599277777777718,1.0596768888888835,1.0591585000000054,1.058248400000001,1.0573039000000042,1.0564517500000077,1.0599646841721608,1.0596666651919582,4137,-536923,-546288.6,0.06286935860600099,-556.885295490956,0.1586117693709253
2023-10-10T11:45:00-04:00,1.06087,1.06195,1.06061,1.0617,1.0590549693678857,1.0604740000000001,1.0602366666666605,1.0598306666666613,1.0592835000000052,1.0583422000000011,1.057375600000004,1.0565043000000078,1.0603117473377286,1.059834532153566,3387,-533536,-541747.2,0.07792807959793396,-554.2353855114105,0.2625316360064976
2023-10-10T12:00:00-04:00,1.0617,1.06197,1.06151,1.06163,1.0594602736563816,1.0607526666666667,1.0604799999999939,1.0600104444444391,1.0594425000000052,1.058437000000001,1.0574437000000043,1.0565546500000078,1.0605753978701828,1.0600456257228523,-3158,-536694,-538919.8,0.09257752626184651,-554.4435987543229,0.2067129804425108
2023-10-10T12:15:00-04:00,1.06163,1.06166,1.06094,1.0614,1.0598618298713607,1.0609366666666666,1.0605855555555495,1.060194222222217,1.0596160000000052,1.058526000000001,1.0575104000000044,1.0565949500000078,1.0607403182961463,1.0602661005782812,-2623,-539317,-537506,0.09780564263346954,-555.0118664181987,0.08958461030694578
2023-10-10T12:30:00-04:00,1.0614,1.06183,1.06122,1.06166,1.060199137091943,1.0611515555555555,1.0607366666666609,1.060393333333328,1.0598095000000054,1.058628200000001,1.0575831000000044,1.0566271500000077,1.060924254636917,1.0605032804626244,2600,-536717,-536637.4,0.09244638487162547,-554.374971750778,0.12826558521173514
2023-10-10T12:45:00-04:00,1.06166,1.06188,1.06142,1.06171,1.0604824751572322,1.0613462222222223,1.0609922222222161,1.060606222222217,1.0600165000000055,1.058733200000001,1.0576605000000043,1.0566669000000077,1.0610814037095337,1.060726624370099,2616,-534101,-536073,0.08812152089844837,-554.2517684653573,0.21710197185225444
2023-10-10T13:00:00-04:00,1.06171,1.06185,1.06021,1.06024,1.06197,1.0611957777777778,1.0610511111111052,1.060769111111106,1.0601145000000054,1.058813000000001,1.0577248000000044,1.0566868000000078,1.060913122967627,1.0608468994960787,-4261,-538362,-537038.2,0.08394663748526683,-560.1513738189843,0.05001368298875555
2023-10-10T13:15:00-04:00,1.06024,1.06074,1.05989,1.0602,1.0619348000000002,1.0610255555555557,1.061061111111105,1.0608853333333281,1.0602290000000054,1.0588942000000008,1.0577872000000044,1.0566936000000078,1.0607704983741015,1.0608859195968623,-3992,-542354,-538170.2,0.07993714988780119,-560.3019812286276,0.008489685032699016
2023-10-10T13:30:00-04:00,1.0602,1.06035,1.05968,1.05973,1.0618530080000002,1.0607593333333334,1.0610155555555496,1.0609713333333282,1.0602810000000051,1.058969000000001,1.0578472000000043,1.0566955000000078,1.0605623986992812,1.0608503356774892,-3525,-545879,-539482.6,0.06817188585704739,-561.8646580820514,-0.03867413737808416
2023-10-10T13:45:00-04:00,1.05973,1.06012,1.05934,1.05949,1.0617226275200002,1.0604542222222222,1.0608622222222164,1.0609964444444393,1.0602885000000053,1.059034000000001,1.0579068000000043,1.056695550000008,1.060347918959425,1.0607350685419907,-2776,-548655,-541870.2,0.05844570271629618,-562.4933465215596,-0.130081913900849
2023-10-10T14:00:00-04:00,1.05949,1.05973,1.05925,1.05926,1.0615320173184002,1.060133777777778,1.060591111111105,1.060916222222217,1.0602780000000052,1.059089200000001,1.0579623000000042,1.0567009000000078,1.06013033516754,1.060544854833592,-3054,-551709,-545391.8,0.043619972665921505,-563.1563258795525,-0.2298200998398792
2023-10-10T14:15:00-04:00,1.05926,1.0597699999999999,1.05924,1.05964,1.0613038155865602,1.0599435555555556,1.0603699999999938,1.0607799999999947,1.0603005000000052,1.059158800000001,1.0580205000000042,1.0567089500000078,1.060032268134032,1.0603686838668729,2666,-549043,-547528,0.023426692776426658,-562.1999223525623,-0.1874476041558884
2023-10-10T14:30:00-04:00,1.05964,1.05987,1.05936,1.05985,1.061056157716173,1.0598395555555555,1.0601977777777716,1.0606073333333281,1.060347000000005,1.059236400000001,1.0580576000000042,1.0567162500000078,1.0599958145072255,1.0602137470934978,2334,-546709,-548399,0.00367378578711556,-561.7373690325668,-0.1460335406067402
2023-10-10T14:45:00-04:00,1.05985,1.06012,1.05965,1.05987,1.0608382187902323,1.059774,1.0599988888888827,1.0604039999999948,1.060368500000005,1.059315200000001,1.058093100000004,1.0567260000000078,1.0599706516057803,1.0600953976747975,2685,-544024,-548028,-0.01502235838874679,-561.686701485272,-0.16860388448278715
2023-10-10T15:00:00-04:00,1.05987,1.0601099999999999,1.05953,1.05966,1.0606464325354044,1.0597062222222222,1.0597711111111048,1.0601857777777728,1.0603290000000052,1.059394000000001,1.0581230000000041,1.0567307000000077,1.0599085212846242,1.0600075181398374,-1911,-545935,-547484,-0.034872185468567726,-562.0653422619711,-0.19308474065421682
2023-10-10T15:15:00-04:00,1.05966,1.05999,1.05938,1.0599399999999999,1.060477660631156,1.05974,1.0597377777777717,1.060015111111106,1.060311000000005,1.059470000000001,1.0581561000000042,1.0567365500000079,1.0599148170276993,1.0599644145118692,2158,-543777,-545897.6,-0.04927577367249832,-561.4951216251634,-0.02829548026863625
2023-10-10T15:30:00-04:00,1.0599399999999999,1.06034,1.05988,1.06029,1.05924,1.0598504444444443,1.0597477777777715,1.0598906666666614,1.0603550000000053,1.059552400000001,1.0581938000000042,1.0567471500000079,1.0599898536221595,1.0599559316094946,1964,-541813,-544451.6,-0.048759325102773116,-560.8465943500345,0.008488964346342527
2023-10-10T15:45:00-04:00,1.06029,1.06065,1.06029,1.06047,1.059262,1.0599948888888888,1.0598299999999936,1.0598171111111057,1.0603930000000052,1.059643200000001,1.058234200000004,1.056755400000008,1.0600858828977275,1.0599739452875951,2137,-539676,-543045,-0.05097098605704671,-560.4838068107762,0.06982910741414916
2023-10-10T16:00:00-04:00,1.06047,1.0605499999999999,1.06032,1.06052,1.05931752,1.0601328888888888,1.0599444444444384,1.0598062222222169,1.060413500000005,1.059721000000001,1.058270800000004,1.0567610000000078,1.060172706318182,1.0600143562300757,918,-538758,-541991.8,-0.04715655112739388,-560.4405241153677,0.09721658533821596
2023-10-10T16:15:00-04:00,1.06052,1.06064,1.06026,1.06057,1.0593708192,1.060258,1.0600899999999938,1.0598699999999945,1.0604350000000051,1.059789000000001,1.058307300000004,1.056765000000008,1.0602521650545456,1.06008308498406,707,-538051,-540415,-0.039036609001379355,-560.4071914106568,0.12367124218793518
2023-10-10T16:30:00-04:00,1.06057,1.06065,1.06022,1.06052,1.059421986432,1.060344,1.0601877777777715,1.0599599999999945,1.0604175000000051,1.059835400000001,1.058344100000004,1.056769100000008,1.0603057320436364,1.0601612679872474,-842,-538893,-539438.2,-0.02886046300654644,-560.4468870460228,0.08304707259069043
2023-10-10T16:45:00-04:00,1.06052,1.06064,1.0604,1.06051,1.05947110697472,1.0604084444444444,1.0602611111111049,1.060062666666661,1.0603580000000052,1.059868200000001,1.0583801000000042,1.056775000000008,1.0603465856349092,1.0602326143897973,-1473,-540366,-539148.8,-0.019040040666388744,-560.4607764587635,0.06227296315517337
2023-10-10T17:00:00-04:00,1.06051,1.06058,1.06015,1.06053,1.0595182626957311,1.0604622222222222,1.0603344444444383,1.06016355555555,1.0603030000000053,1.059882000000001,1.0584158000000041,1.056782400000008,1.0603832685079273,1.0602920915118372,73,-540293,-539272.2,-0.007373912605874578,-560.4593997626456,0.06227178804946671
2023-10-10T17:15:00-04:00,1.06053,1.06068,1.0605,1.06062,1.0595635321879018,1.0605193333333334,1.0604411111111047,1.0602628888888834,1.0602640000000052,1.059885800000001,1.0584532000000042,1.056788350000008,1.0604306148063418,1.0603436732094693,101,-540192,-539559,0.004235027404438089,-560.4508285765405,0.09059509654038558
2023-10-10T17:30:00-04:00,1.06062,1.06065,1.06047,1.06051,1.0596305202566276,1.0605331111111111,1.060504444444438,1.0603457777777723,1.0602065000000054,1.0598958000000012,1.0584927000000042,1.0567942500000078,1.0604464918450736,1.0603825385675747,-111,-540303,-540009.4,0.016249142743437688,-560.4623407109524,0.053776628865801986
2023-10-10T17:45:00-04:00,1.06051,1.06054,1.06046,1.06049,1.05969348904123,1.0605302222222222,1.0605266666666604,1.06041355555555,1.0601455000000053,1.0598838000000013,1.0585311000000042,1.0568018500000078,1.0604551934760589,1.0604124308540592,-127,-540430,-540316.8,0.026692573239770753,-560.4647357850206,0.0188627639608011
2023-10-10T18:00:00-04:00,1.06049,1.06067,1.06026,1.06067,1.0597526796987562,1.060558888888889,1.0605488888888825,1.0604711111111054,1.0601670000000054,1.0598902000000012,1.0585713000000039,1.0568128500000078,1.0604981547808472,1.0604427446832472,298,-540132,-540270,0.03494945556848643,-560.4141553929377,0.018859562269557647
2023-10-10T18:15:00-04:00,1.06067,1.06068,1.06043,1.06047,1.0598083189168308,1.0605431111111112,1.0605433333333272,1.060512888888883,1.0601805000000053,1.0598958000000012,1.0586109000000041,1.0568230000000078,1.0604925238246778,1.060464595746597,-214,-540346,-540280.6,0.03391602784994536,-560.4545072460116,-0.004714668275929117
2023-10-10T18:30:00-04:00,1.06047,1.06058,1.06046,1.06047,1.059860619781821,1.0605284444444443,1.060532222222216,1.0605311111111053,1.0602175000000054,1.0599024000000012,1.058650000000004,1.0568325500000078,1.0604880190597423,1.0604760765972772,0,-540346,-540311.4,0.03223128914399846,-560.4545072460116,-0.00942889201089876
2023-10-10T18:45:00-04:00,1.06047,1.06056,1.06044,1.06053,1.0599097825949118,1.060528,1.060533333333327,1.060536888888883,1.0602695000000053,1.0599220000000011,1.058689700000004,1.056843000000008,1.0604964152477938,1.060486061277821,262,-540084,-540267.6,0.028259752579195586,-560.4396836300677,0.0009429336551941984
2023-10-10T19:00:00-04:00,1.06053,1.0609,1.06042,1.06087,1.059955995639217,1.0605953333333333,1.060573333333327,1.0605462222222164,1.0603500000000052,1.0599438000000014,1.058729500000004,1.0568719500000079,1.060571132198235,1.0605092490222563,1014,-539070,-539995.6,0.025361241627708954,-560.1146008884197,0.03394593167437515
2023-10-10T19:15:00-04:00,1.06087,1.06097,1.06075,1.06075,1.0600315159880798,1.0606306666666667,1.0605977777777715,1.060555999999994,1.0604055000000052,1.0599748000000013,1.058766100000004,1.0569007500000078,1.060606905758588,1.0605309992178047,-809,-539879,-539945,0.02093161635122833,-560.2061106869811,0.02074434480873799
2023-10-10T19:30:00-04:00,1.06075,1.06077,1.06053,1.06058,1.0601253643892719,1.0606271111111112,1.060593333333327,1.060565999999994,1.0604420000000052,1.0600174000000013,1.0588013000000038,1.056928250000008,1.0606015246068705,1.0605527993742432,-298,-540177,-539911.2,0.01718107351643575,-560.2538693483057,-0.0037713790047159174
2023-10-10T19:45:00-04:00,1.06058,1.06059,1.06034,1.06043,1.0602098279503447,1.0605944444444444,1.0605844444444381,1.0605764444444385,1.0604700000000051,1.0600674000000014,1.058837000000004,1.0569526500000077,1.0605672196854965,1.060568639499394,-257,-540434,-539928.8,0.012784433436971923,-560.290217384286,-0.007543540372092672
2023-10-10T20:00:00-04:00,1.06043,1.06097,1.06043,1.06076,1.06028584515531,1.0606295555555556,1.060614444444438,1.0605926666666607,1.060525000000005,1.0601268000000013,1.058873500000004,1.0569808000000078,1.060605775748397,1.0605905115995147,1484,-538950,-539702,0.011144958096621206,-559.8284047233844,0.025459928900790435
2023-10-10T20:15:00-04:00,1.06076,1.06102,1.06053,1.06093,1.06034,1.0606926666666667,1.060643333333327,1.0606066666666607,1.0605745000000053,1.0601940000000014,1.058908600000004,1.0570090500000078,1.0606706205987178,1.0606104092796111,1726,-537224,-539332.8,0.009590762694876015,-559.5517917289276,0.024512807942142886
2023-10-10T20:30:00-04:00,1.06093,1.06143,1.06092,1.06132,1.0604216,1.060828,1.0607377777777716,1.0606346666666606,1.0606260000000052,1.0602548000000014,1.058943400000004,1.0570383000000076,1.0608004964789741,1.0606491274236884,1687,-535537,-538464.4,0.009522821772618697,-558.9316471388037,0.08015313964563046
2023-10-10T20:45:00-04:00,1.06132,1.06137,1.06087,1.06105,1.06053,1.0608904444444445,1.0608022222222158,1.0606764444444385,1.0606550000000052,1.0603176000000014,1.058975300000004,1.0570644500000077,1.0608503971831793,1.0606989019389501,-1591,-537128,-537854.6,0.011578745571793815,-559.3363978266264,0.05469273058172555
2023-10-10T21:00:00-04:00,1.06105,1.06124,1.06056,1.06077,1.06143,1.060884,1.0608288888888824,1.0607253333333273,1.0606675000000052,1.0603592000000015,1.059007100000004,1.0570870500000078,1.0608343177465434,1.0607523215511596,-2009,-539137,-537595.2,0.013060146261289858,-559.8665519192706,0.022630194336795563
2023-10-10T21:15:00-04:00,1.06077,1.06082,1.06014,1.06032,1.0614126000000002,1.0607822222222223,1.0607677777777713,1.060755999999994,1.0606550000000055,1.0603788000000014,1.059034100000004,1.0571067000000078,1.0607314541972346,1.0607774572409272,-2068,-541205,-538046.2,0.011978268511902975,-560.7438391728695,-0.05184424104744695
2023-10-10T21:30:00-04:00,1.06032,1.0603799999999999,1.06012,1.06037,1.061361696,1.0607026666666668,1.0607255555555488,1.0607724444444384,1.0606475000000053,1.0603968000000012,1.059066100000004,1.0571248500000077,1.0606591633577878,1.0607751657927411,2084,-539121,-538425.6,0.00816217679622861,-560.645566953162,-0.035823709639410506
2023-10-10T21:45:00-04:00,1.06037,1.06083,1.06037,1.06081,1.0612871942400002,1.0607195555555557,1.0607511111111045,1.0607751111111052,1.0606625000000052,1.0604292000000013,1.059101600000004,1.0571458500000077,1.0606893306862302,1.0607529326341925,1989,-537132,-538744.6,0.007425778135605889,-559.8202324001286,0.021686247147782577
2023-10-10T22:00:00-04:00,1.06081,1.06082,1.06035,1.0605,1.0612171625856002,1.0606693333333332,1.0607588888888821,1.0607664444444382,1.0606610000000054,1.0604608000000015,1.059132800000004,1.0571671000000078,1.0606514645489842,1.0607131461073533,-2199,-539331,-539185.2,0.006716426286802006,-560.462845120597,0.006601095781901162
2023-10-10T22:15:00-04:00,1.0605,1.06051,1.06019,1.06024,1.0611513328304643,1.0605655555555555,1.0607011111111044,1.060740888888883,1.0606420000000054,1.0604768000000013,1.0591576000000038,1.0571852500000078,1.0605691716391874,1.0606601168858822,-1710,-541041,-539566,0.006227142078748953,-560.882081329932,-0.049021456314326896
2023-10-10T22:30:00-04:00,1.06024,1.06094,1.06022,1.06092,1.0610894528606365,1.0606093333333333,1.0606999999999933,1.0607273333333274,1.0606625000000054,1.0604862000000015,1.059193200000004,1.0572057000000077,1.0606393373113499,1.060641693508705,1694,-539347,-539194.4,0.006388683365776679,-559.7956103422312,-0.0009425692552612772
2023-10-10T22:45:00-04:00,1.06092,1.06098,1.06071,1.06077,1.0610312856889983,1.0606233333333333,1.0606388888888825,1.060709999999994,1.0606765000000054,1.0604956000000014,1.059227900000004,1.057222800000008,1.0606654698490798,1.0606429548069634,-977,-540324,-539435,0.003712845728157622,-559.9337451686083,-0.0518222590736112
2023-10-10T23:00:00-04:00,1.06077,1.06082,1.0606,1.06068,1.06098,1.0606315555555557,1.0605977777777713,1.0606793333333273,1.0606770000000052,1.0605210000000016,1.059260000000004,1.0572455500000077,1.0606683758792639,1.0606387638455703,-1201,-541525,-540313.6,-0.0031740744113705737,-560.03564284671,-0.03487111823193831
2023-10-10T23:15:00-04:00,1.06068,1.06073,1.0603799999999999,1.06046,1.06098,1.060604,1.0605633333333269,1.0606402222222164,1.0606765000000054,1.0605360000000015,1.059290500000004,1.0572658000000077,1.0606267007034111,1.0606338110764555,-1241,-542766,-541000.6,-0.007793840351708551,-560.2930437593321,-0.02922405422476432
2023-10-10T23:30:00-04:00,1.06046,1.06073,1.06037,1.06068,1.0609284,1.0606273333333334,1.060603333333327,1.0606206666666609,1.060687000000005,1.0605474000000015,1.059322400000004,1.0572892500000077,1.0606373605627288,1.060647448861164,1510,-541256,-541043.6,-0.009585076193226955,-559.9797834760586,0.03395201448620586
2023-10-10T23:45:00-04:00,1.06068,1.06069,1.06043,1.06047,1.060879896,1.0606006666666667,1.060614444444438,1.0606035555555497,1.060684000000005,1.0605540000000016,1.059360200000004,1.0573100000000077,1.0606038884501832,1.0606403590889304,-982,-542238,-541621.8,-0.008170884623685037,-560.1742059220368,0.009430670426359571
2023-10-11T00:00:00-04:00,1.06047,1.06059,1.06045,1.06056,1.0608343022400002,1.0605897777777777,1.0605866666666603,1.0605931111111053,1.0606685000000051,1.0605478000000015,1.0593981000000041,1.0573311500000078,1.0605951107601466,1.0606262872711438,852,-541386,-541834.2,-0.006514251439940027,-560.1018983602953,-0.02356689699381449
2023-10-11T00:15:00-04:00,1.06056,1.06076,1.06044,1.06045,1.0607914441056001,1.0605624444444444,1.0605811111111048,1.060589777777772,1.060653500000005,1.0605228000000015,1.059432500000004,1.0573514000000077,1.0605660886081172,1.0606058298169143,-1140,-542526,-542034.4,-0.008022871693905089,-560.2201377809788,-0.004714757190014665
2023-10-11T00:30:00-04:00,1.06045,1.06058,1.06031,1.06052,1.06076,1.060550222222222,1.0606122222222159,1.0605995555555499,1.060650500000005,1.0605006000000015,1.059468800000004,1.0573731500000076,1.0605568708864936,1.060591863853531,847,-541679,-541817,-0.006801777351290536,-560.1642275541883,0.026409114917361722
2023-10-11T00:45:00-04:00,1.06052,1.06066,1.06027,1.06027,1.06076,1.0604817777777775,1.0605399999999936,1.060586888888883,1.060642500000005,1.0604780000000014,1.0595020000000042,1.0573938000000076,1.060499496709195,1.0605642910828241,-993,-542672,-542100.2,-0.005127219699746968,-560.3983108340886,-0.061267579082309634
2023-10-11T01:00:00-04:00,1.06027,1.0605499999999999,1.06017,1.06048,1.0607216,1.0604697777777778,1.0605077777777714,1.0605655555555498,1.060628500000005,1.0604544000000014,1.059541300000004,1.0574181000000076,1.060495597367356,1.0605426328662586,1404,-541268,-541906.2,-0.009500151077275169,-560.1202307224189,-0.027338631371541564
2023-10-11T01:15:00-04:00,1.06048,1.06069,1.0603799999999999,1.06066,1.06012,1.0605002222222222,1.0605055555555494,1.0605493333333276,1.0606150000000052,1.0604334000000015,1.0595833000000041,1.0574441500000078,1.0605284778938848,1.0605293062930063,981,-540287,-541686.4,-0.010088343719956117,-559.9537212172893,-0.0018855828336662352
2023-10-11T01:30:00-04:00,1.06066,1.06103,1.06034,1.0603799999999999,1.0601314,1.060475111111111,1.0604966666666604,1.0605324444444384,1.060568000000005,1.0604362000000014,1.059624600000004,1.0574694000000076,1.0604987823151077,1.0605158450344043,-1467,-541754,-541532,-0.010447777276649702,-560.3409895219298,-0.007543896045120044
2023-10-11T01:45:00-04:00,1.0603799999999999,1.06051,1.06005,1.06015,1.06103,1.0604057777777776,1.0604377777777714,1.0604975555555496,1.0605230000000052,1.0604352000000015,1.0596647000000041,1.0574940500000076,1.060429025852086,1.0604902760275228,-1486,-543240,-541844.2,-0.008117994693395142,-560.6633079360831,-0.04996794509184122
2023-10-11T02:00:00-04:00,1.06015,1.06031,1.0599,1.0602,1.06103,1.0603582222222223,1.0604077777777716,1.0604711111111051,1.060494500000005,1.0604446000000016,1.059706800000004,1.0575187500000076,1.0603832206816688,1.0604670208220175,2223,-541017,-541513.2,-0.00882775813530032,-560.5584642818831,-0.025460409063904916
2023-10-11T02:15:00-04:00,1.0602,1.0607199999999999,1.06007,1.06071,1.0609848,1.0604186666666666,1.0604244444444382,1.0604544444444386,1.0605140000000053,1.0604690000000017,1.059751500000004,1.0575461000000077,1.060448576545335,1.0604576166576134,2199,-538818,-541023.2,-0.00629529514219722,-559.5006544346844,0.014143471373622851
2023-10-11T02:30:00-04:00,1.06071,1.06134,1.06037,1.06118,1.0599,1.0605697777777778,1.0605055555555494,1.0604544444444386,1.0605545000000052,1.0605074000000017,1.059798300000004,1.0575766500000077,1.0605948612362681,1.06047089332609,2952,-535866,-540139,-0.004310449337123282,-558.1926249072925,0.06883870055166387
2023-10-11T02:45:00-04:00,1.06118,1.06146,1.06088,1.06104,1.0599288,1.0606766666666667,1.060563333333327,1.0604677777777718,1.060566000000005,1.0605354000000016,1.059847100000004,1.0576068500000075,1.0606838889890144,1.0605079146608714,-3127,-538993,-539586.8,-0.0017555572813829786,-558.6051656638089,0.049032550069784256
2023-10-11T03:00:00-04:00,1.06104,1.06115,1.06023,1.06092,1.059990048,1.060748,1.0606355555555493,1.0605073333333275,1.060587000000005,1.0605568000000014,1.059896600000004,1.0576354000000077,1.0607311111912117,1.0605683317286965,-5040,-544033,-539745.4,0.0015220741158891106,-559.1751724496035,0.06130513925698543
2023-10-11T03:15:00-04:00,1.06092,1.06119,1.0605,1.06085,1.06004884608,1.0607908888888888,1.0606766666666605,1.0605611111111055,1.060617500000005,1.0605764000000015,1.059945800000004,1.0576629500000077,1.0607548889529694,1.0606426653829566,-3843,-547876,-541117.2,0.005419217073850825,-559.4287353949717,0.034889861194928845
2023-10-11T03:30:00-04:00,1.06085,1.06283,1.06045,1.06217,1.0601052922368,1.0610895555555557,1.0608444444444383,1.0606451111111055,1.0606800000000054,1.0606266000000015,1.060010300000004,1.0576970500000076,1.0610379111623756,1.0607605323063647,6409,-541467,-541647,0.012687142080122376,-551.4541112728056,0.14236418833557618
2023-10-11T03:45:00-04:00,1.06217,1.06221,1.05953,1.05997,1.06283,1.0609146666666667,1.0607988888888826,1.0607037777777721,1.0606400000000051,1.0606272000000017,1.060048600000004,1.0577201500000077,1.0608243289299004,1.060806425845091,-7301,-548768,-544227.4,0.010447359808359424,-566.5761727130645,-0.03866538410756516
2023-10-11T04:00:00-04:00,1.05997,1.06033,1.05932,1.05962,1.06283,1.060678888888889,1.0607399999999936,1.0607391111111055,1.0605870000000053,1.0606138000000016,1.0600831000000042,1.0577404500000076,1.0605834631439204,1.0607863406760722,-7108,-555876,-547604,0.00844542263511738,-568.9232202710147,-0.049992925529398616
2023-10-11T04:15:00-04:00,1.05962,1.06071,1.05955,1.06032,1.0626896,1.060594888888889,1.060753333333327,1.0607626666666612,1.0605800000000052,1.0606108000000016,1.060127000000004,1.0577697500000076,1.0605307705151363,1.0607462725408572,4585,-551291,-549055.6,0.011664839265288935,-565.894304244515,0.011318619128456702
2023-10-11T04:30:00-04:00,1.06032,1.0612,1.05985,1.06115,1.062554816,1.0606742222222223,1.060802222222216,1.0607877777777723,1.0606035000000051,1.0606234000000017,1.060172200000004,1.0578044500000074,1.0606546164121091,1.0607262180326853,3822,-547469,-548974.2,0.017523655588429495,-562.9025093146821,0.04148164908410366
2023-10-11T04:45:00-04:00,1.06115,1.06136,1.06074,1.06085,1.0624254233600001,1.060683777777778,1.0607655555555493,1.0607719999999945,1.0606225000000051,1.0606290000000016,1.060209000000004,1.0578402000000076,1.0606936931296873,1.0606573744261474,-4286,-551755,-551031.8,0.018080251714042348,-564.114213597771,-0.031097457547253193
2023-10-11T05:00:00-04:00,1.06085,1.06117,1.06045,1.0606,1.0623012064256,1.0606506666666666,1.0607166666666603,1.06075555555555,1.0606245000000052,1.0606306000000016,1.060233000000004,1.0578777000000075,1.06067495450375,1.0606274995409175,-4168,-555923,-552462.8,0.012027988982505955,-565.0964448274457,-0.041468747643820775
2023-10-11T05:15:00-04:00,1.0606,1.06148,1.0605,1.06095,1.062181958168576,1.0606973333333334,1.0607199999999937,1.0607515555555502,1.0606495000000051,1.0606394000000017,1.060253800000004,1.0579143500000074,1.0607299636029999,1.0606567996327336,2855,-553068,-551901.2,0.009428269724232309,-564.1542894437005,0.0028277344191809457
2023-10-11T05:30:00-04:00,1.06095,1.06124,1.06049,1.0611,1.062067479841833,1.0607733333333333,1.0607477777777714,1.0607504444444387,1.0606785000000052,1.0606508000000017,1.060266400000004,1.0579580500000074,1.0608039708824,1.060711439706186,3137,-549931,-551629.2,0.008206844814168973,-563.7107718415518,0.023566008389485926
2023-10-11T05:45:00-04:00,1.0611,1.06124,1.06043,1.06044,1.0619575806481598,1.060711777777778,1.0605555555555493,1.0607011111111055,1.060687000000005,1.0606472000000018,1.0602665000000038,1.0579987500000074,1.06073117670592,1.0607267517649484,-3089,-553020,-552739.4,0.004700545613743325,-565.6321176148057,-0.16287411619609002
2023-10-11T06:00:00-04:00,1.06044,1.06065,1.05983,1.05985,1.0618520774222335,1.0605706666666666,1.0605422222222158,1.0606564444444389,1.060655500000005,1.0606340000000019,1.060264900000004,1.0580359000000075,1.060554941364736,1.0606990014119582,-3331,-556351,-553658.6,-0.015287162958183687,-567.4853954994576,-0.011321075124779003
2023-10-11T06:15:00-04:00,1.05985,1.06024,1.05974,1.06012,1.0617507943253441,1.0604862222222222,1.0605977777777715,1.060632666666661,1.060628500000005,1.0606266000000018,1.0602552000000038,1.0580726500000075,1.0604679530917887,1.0606576011295659,2389,-553962,-553266.4,-0.012256866201887257,-566.8767905081852,0.04718672731733498
2023-10-11T06:30:00-04:00,1.06012,1.06039,1.05992,1.06021,1.0616535625523305,1.0604086666666666,1.0605855555555492,1.0606057777777722,1.060620000000005,1.0606174000000017,1.060253800000004,1.0581059000000073,1.0604163624734309,1.0605948809036518,2798,-551164,-552885.6,-0.00467386648607407,-566.6392513616731,-0.010374226648543124
2023-10-11T06:45:00-04:00,1.06021,1.06044,1.06003,1.06018,1.0615602200502372,1.0603275555555554,1.0604777777777714,1.060551777777772,1.0606215000000052,1.0606116000000017,1.0602537000000039,1.0581360500000074,1.0603690899787446,1.060507904722921,-2340,-553504,-553600.2,-0.005095952062734359,-566.7054646590392,-0.09141026245112731
2023-10-11T07:00:00-04:00,1.06018,1.06087,1.06014,1.06021,1.0614706112482277,1.060274,1.0604066666666603,1.0605219999999942,1.0606220000000053,1.0606064000000017,1.060254400000004,1.0581653500000074,1.0603372719829958,1.0604291237783359,2678,-550826,-553161.4,-0.014228219016407695,-566.6296850744399,-0.06032898147711494
2023-10-11T07:15:00-04:00,1.06021,1.06035,1.05963,1.05995,1.0613845867982987,1.0601826666666667,1.0603344444444383,1.0604804444444387,1.0605840000000053,1.0605948000000016,1.0602584000000042,1.0581940000000074,1.0602598175863966,1.060370099022668,-2715,-553541,-552599.4,-0.021591755532008226,-567.2954965646168,-0.06128606449180082
2023-10-11T07:30:00-04:00,1.05995,1.06041,1.05974,1.0601099999999999,1.0613020033263667,1.0601377777777776,1.0602411111111048,1.0604091111111054,1.0605305000000054,1.0605796000000016,1.060261700000004,1.0582278500000075,1.0602298540691173,1.0603224792181338,2776,-550765,-551960,-0.02351854071870047,-566.8764579307191,-0.07917432489751391
2023-10-11T07:45:00-04:00,1.0601099999999999,1.06056,1.05999,1.06039,1.061222723193312,1.0601675555555554,1.060162222222216,1.0603244444444386,1.0604980000000053,1.0605724000000016,1.060273600000004,1.0582631000000076,1.060261883255294,1.0602915833745064,2955,-547810,-551289.2,-0.025252570607205756,-566.0959728867141,-0.06691169541042206
2023-10-11T08:00:00-04:00,1.06039,1.06048,1.05999,1.06029,1.0611466142655794,1.0601931111111111,1.0601455555555495,1.0602579999999944,1.0604665000000053,1.0605666000000016,1.060292000000004,1.0582999000000075,1.060267506604235,1.0602712666996044,-4516,-552326,-551053.6,-0.029523691920538952,-566.5218539304809,-0.014145071856973944
2023-10-11T08:15:00-04:00,1.06029,1.0605499999999999,1.06008,1.06025,1.0610735496949562,1.060214,1.060189999999994,1.060214666666661,1.0604365000000051,1.0605630000000017,1.060315200000004,1.0583382000000077,1.060264005283388,1.0602566133596827,-4185,-556511,-552190.6,-0.02830767351668321,-566.679735264833,0.03774118979100401
2023-10-11T08:30:00-04:00,1.06025,1.06042,1.05795,1.06026,1.061003407707158,1.0602279999999997,1.0602055555555494,1.0601888888888833,1.060341000000005,1.0605530000000016,1.060339900000004,1.0583765500000075,1.0602632042267104,1.0602572906877454,12260,-544251,-550332.6,-0.021792636306949435,-566.5641021594325,0.01320605214504292
2023-10-11T08:45:00-04:00,1.06026,1.06145,1.06016,1.06144,1.05795,1.0604748888888886,1.060342222222216,1.0602091111111054,1.0604145000000051,1.0605632000000016,1.0603786000000042,1.0584197500000077,1.0604985633813684,1.0603110325501957,7980,-536271,-547433.8,-0.006066931138456163,-557.6828843449346,0.11601475179444093
2023-10-11T09:00:00-04:00,1.06144,1.06183,1.06064,1.06082,1.05795,1.0605704444444444,1.0604133333333272,1.0602593333333277,1.060474500000005,1.0605532000000018,1.0604040000000041,1.0584569500000074,1.0605628507050948,1.0603712260401559,-7681,-543952,-546662.2,-0.0041312831987032885,-562.1694497654942,0.060367107472334515
2023-10-11T09:15:00-04:00,1.06082,1.06207,1.0607,1.06182,1.0581052,1.060851777777778,1.0605922222222162,1.060348666666661,1.0605495000000051,1.0605686000000016,1.060443100000004,1.0584983000000074,1.060814280564076,1.060480580832124,6392,-537560,-543709,0.0014547864497954242,-556.1439223433119,0.15185670763338294
2023-10-11T09:30:00-04:00,1.06182,1.06208,1.06112,1.06143,1.058343088,1.0610193333333333,1.0607566666666604,1.0604619999999942,1.060563500000005,1.0605818000000016,1.060470500000004,1.0585393000000074,1.0609374244512608,1.0606152646656986,-8132,-545692,-541545.2,0.007973987559826845,-559.1307562699653,0.13962922779377782
2023-10-11T09:45:00-04:00,1.06143,1.06347,1.0613299999999999,1.06289,1.05864204096,1.0614460000000001,1.0610655555555495,1.0606339999999943,1.060665500000005,1.0606332000000016,1.0605060000000042,1.0585896500000074,1.0613279395610087,1.0608282117325583,7819,-537873,-540269.6,0.02787983924006407,-548.3756994127083,0.26223693767627937
2023-10-11T10:00:00-04:00,1.06289,1.06345,1.06233,1.06239,1.0591248368639998,1.0617108888888889,1.0612877777777718,1.0608231111111053,1.060755000000005,1.0606736000000017,1.0605352000000041,1.0586377500000075,1.061540351648807,1.061036569386046,-7259,-545132,-542041.8,0.04245882284317147,-551.790445999843,0.18860985109252273
2023-10-11T10:15:00-04:00,1.06239,1.06271,1.0621,1.06243,1.0595593531775997,1.0619393333333333,1.0615255555555496,1.06104555555555,1.060829000000005,1.0607060000000015,1.0605676000000042,1.0586849000000074,1.0617182813190456,1.061267655508836,6102,-539030,-541057.4,0.05347091890380864,-551.560699861419,0.2018315743805969
2023-10-11T10:30:00-04:00,1.06243,1.06294,1.06187,1.0628,1.0599504178598398,1.0621942222222223,1.061808888888883,1.0612888888888832,1.060914000000005,1.0607520000000017,1.0606064000000042,1.0587369000000073,1.0619346250552364,1.0614917244070683,6193,-532837,-540112.8,0.06882148426067303,-549.4039365923096,0.24050931384108015
2023-10-11T10:45:00-04:00,1.0628,1.06283,1.06183,1.0624,1.0603023760738557,1.0623124444444445,1.0620466666666608,1.0615468888888835,1.0610120000000047,1.0607952000000016,1.0606360000000041,1.0587824000000075,1.0620277000441891,1.0617097795256538,-5591,-538428,-538660,0.08324701041472381,-551.5081895091329,0.20183728519420055
2023-10-11T11:00:00-04:00,1.0624,1.06246,1.06168,1.06187,1.06061913846647,1.0622771111111111,1.0620944444444385,1.0617526666666612,1.0611130000000049,1.0608142000000016,1.0606502000000042,1.0588209000000075,1.0619961600353514,1.0618434236205223,-5031,-543459,-539777.2,0.09199757114595612,-554.0180069037108,0.04051100391921847
2023-10-11T11:15:00-04:00,1.06187,1.06192,1.06101,1.0617699999999999,1.060904224619823,1.0622122222222221,1.062199999999994,1.0619351111111057,1.0611955000000048,1.0608342000000015,1.0606649000000041,1.0588565500000076,1.061950928028281,1.061925538896417,-4088,-547547,-540260.2,0.0864834592309944,-554.402988116101,0.08955336437847931
2023-10-11T11:30:00-04:00,1.0617699999999999,1.06234,1.06115,1.0613299999999999,1.06347,1.0620382222222222,1.0621455555555497,1.0620591111111057,1.061251500000005,1.0608472000000015,1.060684100000004,1.0588876500000075,1.0618267424226249,1.061947231117133,-3843,-551390,-542732.2,0.08585503229972447,-555.995536408104,-0.046147181254836175
2023-10-11T11:45:00-04:00,1.0613299999999999,1.06166,1.0612,1.06126,1.0634236,1.0618611111111111,1.0621266666666607,1.0621226666666612,1.061305500000005,1.0608632000000016,1.060699600000004,1.0589175000000075,1.0617133939380998,1.0619029848937056,-3615,-555005,-547165.8,0.07586278380148688,-556.2339636644704,-0.016016129184214075
2023-10-11T12:00:00-04:00,1.06126,1.06128,1.06066,1.061,1.0633781279999999,1.0616357777777776,1.0619166666666606,1.0620966666666614,1.061345000000005,1.0608696000000015,1.0607085000000043,1.0589481000000074,1.0615707151504798,1.0618115879149639,-3671,-558676,-551215.4,0.06812906653249357,-557.1333285703375,-0.1778170836116576
2023-10-11T12:15:00-04:00,1.061,1.06109,1.05995,1.0603,1.0632694028799998,1.0613124444444446,1.0616844444444384,1.0620146666666614,1.061362500000005,1.0608662000000018,1.0607101000000043,1.0589755500000075,1.0613165721203839,1.0616756703319703,-3159,-561835,-554890.6,0.04332082989372932,-559.2174944515814,-0.19672624930580346
2023-10-11T12:30:00-04:00,1.0603,1.06073,1.0601099999999999,1.0607,1.0630702387071997,1.0611155555555556,1.061492222222216,1.0618731111111057,1.0613920000000052,1.0608690000000016,1.0607084000000042,1.0590061500000074,1.061193257696307,1.0615241362655756,2625,-559210,-557223.2,0.02403092253918309,-558.2272086834026,-0.16283425731577697
2023-10-11T12:45:00-04:00,1.0607,1.0608,1.06035,1.06073,1.0628830243847678,1.060963111111111,1.0612622222222161,1.0616964444444392,1.0614090000000052,1.0608746000000016,1.0606987000000043,1.0590371500000075,1.0611006061570456,1.06137890901246,2234,-556976,-558340.4,0.0052313809278345695,-558.1640239940466,-0.19476853594279417
2023-10-11T13:00:00-04:00,1.06073,1.06096,1.0602,1.06073,1.0627070429216816,1.0608566666666668,1.0610766666666605,1.061486444444439,1.0614310000000053,1.0608788000000016,1.0606897000000044,1.0590667000000074,1.0610264849256366,1.061241527209967,0,-556976,-558734.6,-0.015797093711302806,-558.1640239940466,-0.15719126506024664
2023-10-11T13:15:00-04:00,1.06073,1.06073,1.06,1.06005,1.0625416203463807,1.0606513333333334,1.0608744444444385,1.0612779999999946,1.0614210000000053,1.0608744000000017,1.060676200000004,1.0590933000000073,1.0608311879405092,1.061093621767973,-2396,-559372,-558873.8,-0.03686177775492237,-559.7000227873305,-0.17139574524189916
2023-10-11T13:30:00-04:00,1.06005,1.06005,1.05859,1.05898,1.0623861231255978,1.0602724444444442,1.0605644444444384,1.0610539999999946,1.0613570000000052,1.0608444000000015,1.0606494000000042,1.0591162500000073,1.0604609503524074,1.0609224974143776,-3335,-562707,-559048.2,-0.058396223875077605,-563.0663262635812,-0.262768772898071
2023-10-11T13:45:00-04:00,1.05898,1.05946,1.05845,1.05927,1.0620824332755499,1.0600135555555554,1.0603355555555494,1.0608226666666614,1.0612485000000054,1.0608166000000017,1.0606250000000041,1.0591427500000072,1.0602227602819259,1.0607283979315014,2612,-560095,-559225.2,-0.07751360582491895,-562.3510341900768,-0.1940960869851932
2023-10-11T14:00:00-04:00,1.05927,1.06009,1.05912,1.05936,1.0617191899479947,1.0598184444444443,1.0601244444444384,1.0605951111111058,1.0611755000000054,1.0607962000000015,1.0606162000000041,1.0591705000000073,1.0600502082255407,1.0605183183452005,6030,-554065,-558643,-0.08675154245126089,-561.8387002242316,-0.17903247083655396
2023-10-11T14:15:00-04:00,1.05936,1.05997,1.05929,1.0597,1.0613922709531953,1.0597335555555556,1.059979999999994,1.0603757777777725,1.0610695000000052,1.0607872000000016,1.060611200000004,1.0591992000000072,1.0599801665804327,1.0603090546761595,3505,-550560,-557359.8,-0.096431348983954,-560.7137757415251,-0.1225259189443786
2023-10-11T14:30:00-04:00,1.0597,1.06044,1.05964,1.06029,1.0610980438578759,1.0597955555555554,1.0599788888888828,1.0601966666666613,1.0610125000000052,1.0607890000000015,1.0606168000000042,1.0592320000000073,1.0600421332643462,1.0601512437409268,2336,-548224,-555130.2,-0.09626293888041301,-559.4131812336458,-0.0009431293030336237
2023-10-11T14:45:00-04:00,1.06029,1.06084,1.0602,1.06071,1.05845,1.0599417777777778,1.059979999999994,1.0600797777777726,1.0609035000000053,1.0607890000000018,1.060629000000004,1.0592679000000071,1.060175706611477,1.060094194992741,2686,-545538,-551696.4,-0.08917030504936374,-558.3492081696725,0.0009427736400552005
2023-10-11T15:00:00-04:00,1.06071,1.06125,1.0607,1.06119,1.0584977999999998,1.0601837777777778,1.0600311111111052,1.060018888888884,1.0608435000000054,1.0607892000000017,1.0606483000000042,1.0593053000000072,1.0603785652891815,1.060125355994192,1890,-543648,-548407,-0.07692804877689662,-557.4939319867383,0.043366360902409376
2023-10-11T15:15:00-04:00,1.06119,1.06144,1.06085,1.0614,1.0586078879999998,1.0604575555555555,1.0601055555555494,1.060015111111106,1.0607920000000055,1.0607964000000016,1.0606659000000043,1.0593432000000071,1.0605828522313452,1.060231884795353,2128,-541520,-545898,-0.06617210402751039,-557.0728198390553,0.0631640474013131
2023-10-11T15:30:00-04:00,1.0614,1.06157,1.06128,1.06132,1.0587778147199998,1.0607004444444446,1.0602466666666608,1.0600684444444395,1.0607180000000054,1.0608044000000016,1.0606806000000042,1.0593691000000072,1.0607302817850761,1.0603819078362815,-1595,-543115,-544409,-0.055630969117833565,-557.1930384182901,0.11980566954389929
2023-10-11T15:45:00-04:00,1.06132,1.06148,1.06117,1.06124,1.0590011895423999,1.060899111111111,1.0604977777777718,1.0601722222222174,1.0606600000000053,1.0608122000000015,1.0606943000000042,1.0593937000000073,1.0608322254280609,1.0605399262690245,-1614,-544729,-543710,-0.037413133652635905,-557.3146982381372,0.21341290675932773
2023-10-11T16:00:00-04:00,1.06124,1.06179,1.06115,1.06179,1.059206694379008,1.0611575555555555,1.0607777777777718,1.060331777777773,1.0606560000000056,1.0608046000000015,1.0607156000000042,1.0594193000000072,1.0610237803424487,1.060709541015219,813,-543916,-543385.6,-0.00818406652450309,-556.8933515116663,0.23789968563256564
2023-10-11T16:15:00-04:00,1.06179,1.06203,1.06172,1.06195,1.059465024941107,1.061392,1.0610655555555497,1.0605386666666619,1.0606650000000055,1.0608442000000016,1.0607357000000042,1.0594459000000074,1.061209024273959,1.0608756328121742,473,-543443,-543344.6,0.016722730838004223,-556.822075647324,0.24448723757739296
2023-10-11T16:30:00-04:00,1.06195,1.06202,1.06179,1.06185,1.0597728219481741,1.0615488888888887,1.0613044444444386,1.0607784444444395,1.0606910000000056,1.0608888000000016,1.0607513000000042,1.0594725500000073,1.061337219419167,1.0610265062497388,-480,-543923,-543825.2,0.039838115568586456,-556.8672755154911,0.20288760970084685
2023-10-11T16:45:00-04:00,1.06185,1.06195,1.06169,1.06193,1.0600436833143931,1.061674,1.061486666666661,1.0610264444444395,1.0607245000000054,1.0609210000000016,1.060765900000004,1.0595000500000074,1.0614557755353335,1.0611716049997901,1002,-542921,-543786.4,0.05816639170430546,-556.7917846269474,0.15467466447859415
2023-10-11T17:00:00-04:00,1.06193,1.062,1.06118,1.0619399999999999,1.060282041316666,1.0617646666666667,1.0616233333333274,1.0612515555555506,1.0607715000000055,1.0609368000000017,1.0607801000000041,1.0595254500000073,1.0615526204282668,1.0613156839998314,177,-542744,-543389.4,0.07066661938234604,-556.7901178504179,0.11596006448509416
2023-10-11T17:15:00-04:00,1.0619399999999999,1.06198,1.06163,1.0617699999999999,1.0604917963586662,1.061794,1.0616877777777718,1.0614335555555505,1.0608450000000054,1.0609552000000018,1.0607921000000042,1.0595497000000074,1.0615960963426134,1.0614301471998646,-206,-542950,-543196.2,0.07720000718258022,-556.8230952314376,0.05465562246155758
2023-10-11T17:30:00-04:00,1.0617699999999999,1.06196,1.0617699999999999,1.06196,1.0606763807956263,1.0618484444444443,1.061749999999994,1.0615704444444396,1.0609080000000053,1.0609824000000017,1.0608065000000042,1.0595753000000072,1.0616688770740907,1.0615221177598908,210,-542740,-543055.6,0.07700124692233688,-556.7855164714425,0.05276050499341587
2023-10-11T17:45:00-04:00,1.06196,1.06202,1.0619,1.06196,1.060838815100151,1.0618904444444444,1.0618211111111053,1.061673777777773,1.0609695000000054,1.0610026000000017,1.0608210000000042,1.0596005500000074,1.0617271016592726,1.061600094207912,0,-542740,-542819,0.07661987457914944,-556.7855164714425,0.0603022651038305
2023-10-11T18:00:00-04:00,1.06196,1.06208,1.06185,1.06193,1.060981757288133,1.0619122222222221,1.0618977777777718,1.061755999999995,1.0610295000000054,1.0610192000000016,1.0608350000000042,1.0596254000000074,1.0617676813274182,1.0616624753663289,-428,-543168,-542868.4,0.07697928129966562,-556.797607322322,0.0650182805020617
2023-10-11T18:15:00-04:00,1.06193,1.06217,1.06193,1.06217,1.0611355112677945,1.0619666666666667,1.0619399999999939,1.0618193333333283,1.0611355000000056,1.0610538000000016,1.0608505000000041,1.0596518500000074,1.0618481450619346,1.0617215802930624,558,-542610,-542841.6,0.07927653486407917,-556.6714973150711,0.035788621102105594
2023-10-11T18:30:00-04:00,1.06217,1.06219,1.06198,1.06201,1.0613010294649474,1.0619806666666667,1.0619466666666606,1.061871111111106,1.0612870000000054,1.0610970000000015,1.060865500000004,1.0596791000000074,1.0618805160495477,1.0617784642344492,-434,-543044,-542860.4,0.07254746750275315,-556.7368729140807,0.0056499835208765935
2023-10-11T18:45:00-04:00,1.06201,1.06208,1.06187,1.06193,1.0614610441612569,1.0619773333333333,1.0619555555555495,1.0619122222222173,1.0614200000000056,1.0611332000000018,1.0608799000000042,1.0597055000000075,1.0618904128396383,1.0618227713875588,-373,-543417,-542995.8,0.059113402163990136,-556.7649705779444,0.0075340208127400304
2023-10-11T19:00:00-04:00,1.06193,1.06236,1.06188,1.06235,1.0615922562122306,1.0620562222222223,1.0620022222222163,1.0619484444444391,1.0615695000000054,1.061176000000002,1.060896700000004,1.0597340000000075,1.0619823302717106,1.0618738171100461,520,-542897,-543027.2,0.049998317688226435,-556.5593073044707,0.039550629514173714
2023-10-11T19:15:00-04:00,1.06235,1.06254,1.06234,1.06244,1.0617458049697845,1.0621437777777778,1.0620577777777716,1.0619804444444392,1.0617065000000054,1.0612212000000019,1.0609164000000042,1.0597636500000074,1.0620738642173686,1.061935053688036,451,-542446,-542882.8,0.040979948264104,-556.5210995574946,0.047083639377005014
2023-10-11T19:30:00-04:00,1.06244,1.06257,1.06223,1.06234,1.06188,1.0622002222222222,1.062121111111105,1.0620166666666615,1.0618090000000053,1.0612638000000019,1.060935100000004,1.0597925500000074,1.062127091373895,1.0619908429504283,-578,-543024,-542965.6,0.032902069251695434,-556.5755026296681,0.05368394285016355
2023-10-11T19:45:00-04:00,1.06234,1.06242,1.06231,1.06235,1.062018,1.0622459999999998,1.0621644444444387,1.0620602222222169,1.0618910000000055,1.061311800000002,1.060953300000004,1.0598215000000075,1.062171673099116,1.062049074360342,529,-542495,-542855.8,0.02912299600056017,-556.5705230562736,0.03672454706390923
2023-10-11T20:00:00-04:00,1.06235,1.0628,1.06221,1.0623,1.0621284,1.062273111111111,1.0622022222222163,1.0621095555555504,1.0619465000000055,1.0613556000000017,1.0609676000000041,1.0598485500000074,1.0621973384792929,1.0621104594882729,-1645,-544140,-543000.4,0.025192689546459084,-556.6479457512421,0.032016271799315134
2023-10-11T20:15:00-04:00,1.0623,1.0625,1.06217,1.06227,1.0628,1.0622866666666666,1.062239999999994,1.062157111111106,1.0619900000000055,1.061393200000002,1.0609828000000041,1.0598744500000075,1.0622118707834343,1.0621563675906176,-928,-545068,-543434.6,0.023267806217087655,-556.6741530373195,0.03201717627338967
2023-10-11T20:30:00-04:00,1.06227,1.0623,1.06205,1.06229,1.0628,1.0622966666666664,1.0622533333333273,1.0621962222222172,1.0620385000000054,1.061433200000002,1.060999900000004,1.0599006000000075,1.0622274966267473,1.0621870940724933,1143,-543925,-543730.4,0.02266603712964005,-556.6526330847652,0.011297626556944553
2023-10-11T20:45:00-04:00,1.06229,1.06244,1.06199,1.06223,1.06277,1.062292,1.0622777777777717,1.0622275555555505,1.0620880000000055,1.061472800000002,1.061017900000004,1.0599274500000073,1.062227997301398,1.0622072752579939,-1659,-545584,-544242.4,0.019149890149681218,-556.7463363108145,0.02071543582453169
2023-10-11T21:00:00-04:00,1.06223,1.0625,1.06212,1.06245,1.0627232,1.0623264444444445,1.0623355555555494,1.0622617777777725,1.0621210000000054,1.0615166000000018,1.061034800000004,1.0599541500000074,1.0622723978411184,1.0622274202063946,1521,-544063,-544556,0.017866582138929776,-556.4313197889692,0.048967446065169444
2023-10-11T21:15:00-04:00,1.06245,1.06266,1.06215,1.06219,1.062679208,1.0622973333333332,1.0623177777777717,1.0622848888888836,1.0621330000000053,1.061531600000002,1.061047400000004,1.0599780000000074,1.0622559182728948,1.062239136165115,-1810,-545873,-544902.6,0.0185208349309275,-556.8742582801922,-0.015060949781139735
2023-10-11T21:30:00-04:00,1.06219,1.06268,1.06201,1.06264,1.06199,1.0623617777777778,1.062339999999994,1.0623048888888835,1.0621725000000053,1.0615680000000018,1.061060600000004,1.0600020000000074,1.0623327346183158,1.062263308932091,1856,-544017,-544692.4,0.018157119608758817,-556.0879582773678,0.018824592447571436
2023-10-11T21:45:00-04:00,1.06264,1.06268,1.06237,1.06247,1.0620038,1.062387777777778,1.0623544444444384,1.0623251111111056,1.062199500000005,1.0615810000000019,1.0610748000000039,1.0600250500000075,1.0623601876946527,1.062289847145672,-1446,-545463,-545000,0.015659519984323588,-556.3192877963018,0.01223713688649241
2023-10-11T22:00:00-04:00,1.06247,1.0626,1.06227,1.06233,1.06201,1.0623828888888889,1.0623522222222161,1.0623399999999945,1.0622190000000054,1.061599000000002,1.061090400000004,1.0600487500000073,1.062354150155722,1.062315077716537,-1416,-546879,-545259,0.01377188169130994,-556.5058718880879,-0.001882618722634629
2023-10-11T22:15:00-04:00,1.06233,1.06256,1.06203,1.06221,1.0620234,1.0623544444444446,1.062342222222216,1.0623413333333278,1.0622410000000053,1.061585400000002,1.061109300000004,1.0600717000000075,1.0623253201245777,1.062325662173229,-1502,-548381,-546122.6,0.011243314195865184,-556.6755366815136,-0.008472182999145577
2023-10-11T22:30:00-04:00,1.06221,1.06242,1.06221,1.06228,1.06203,1.062342,1.0623433333333272,1.062346444444439,1.0622570000000053,1.061583200000002,1.061128400000004,1.0600972500000074,1.0623162560996622,1.0623377297385825,1474,-546907,-546329.4,0.008768508681494022,-556.578399580564,0.0009413802517103436
2023-10-11T22:45:00-04:00,1.06228,1.0624,1.06219,1.06239,1.06203,1.0623513333333332,1.0623544444444382,1.0623493333333278,1.0622785000000055,1.061582400000002,1.061144200000004,1.0601229000000074,1.0623310048797296,1.0623373837908654,1267,-545640,-546654,0.007970402819520234,-556.4472006499618,0.00941362528123102
2023-10-11T23:00:00-04:00,1.06239,1.06252,1.06227,1.06239,1.062043,1.0623584444444443,1.062372222222216,1.0623528888888834,1.0623015000000053,1.061574200000002,1.0611631000000041,1.0601479500000075,1.0623428039037837,1.0623339070326916,0,-545640,-546689.4,0.006984054122764016,-556.4472006499618,0.015062651214891122
2023-10-11T23:15:00-04:00,1.06239,1.06244,1.06207,1.06208,1.0620557400000001,1.0623,1.0623311111111047,1.062348666666661,1.0622970000000056,1.061567800000002,1.0611815000000042,1.0601695500000075,1.062290243123027,1.0623211256261524,-1076,-546716,-546656.8,0.004899563432701516,-556.7611719787583,-0.034825168243209706
2023-10-11T23:30:00-04:00,1.06208,1.06247,1.06208,1.06239,1.0620682252000002,1.0623117777777777,1.062353333333327,1.0623508888888833,1.0623160000000056,1.0615782000000018,1.0611962000000041,1.0601947000000076,1.0623101944984217,1.0623181005009212,1207,-545509,-546082.4,0.0033485249683971492,-556.4088727169324,0.018829023056136658
2023-10-11T23:45:00-04:00,1.06239,1.06291,1.06239,1.06287,1.06207,1.062415111111111,1.0623788888888825,1.0623579999999944,1.0623630000000055,1.0616002000000018,1.0612172000000042,1.0602225500000075,1.0624221555987374,1.0623392804007363,1046,-544463,-545593.6,0.0058944318466360845,-555.9362779071167,0.02164420688097121
2023-10-12T00:00:00-04:00,1.06287,1.06306,1.06271,1.06297,1.06208,1.0625333333333333,1.0624344444444382,1.0623739999999944,1.0623940000000056,1.0616330000000018,1.061240100000004,1.0602500500000076,1.06253172447899,1.0623794243205882,806,-543657,-545197,0.004338816767408241,-555.860445491111,0.047060152286647616
2023-10-12T00:15:00-04:00,1.06297,1.06309,1.06286,1.0629,1.0621387999999998,1.0626264444444442,1.0624977777777715,1.0623991111111057,1.0624170000000057,1.0616658000000019,1.0612645000000043,1.0602775000000078,1.062605379583192,1.0624319394564699,-628,-544285,-544926,0.005920904603461006,-555.9018013148878,0.05365564372652184
2023-10-12T00:30:00-04:00,1.0629,1.063,1.06274,1.06295,1.0622148959999997,1.062716888888889,1.0625799999999939,1.0624488888888834,1.0624475000000055,1.0617048000000018,1.0612872000000042,1.0603048000000077,1.0626743036665536,1.0625087515651752,1035,-543250,-544232.8,0.009470541596122511,-555.8531137619665,0.06966607356360445
2023-10-12T00:45:00-04:00,1.06295,1.06317,1.06283,1.06308,1.0622849043199998,1.062816888888889,1.0626688888888824,1.0625119999999943,1.0624840000000055,1.0617604000000016,1.0613133000000041,1.0603367500000076,1.0627554429332429,1.0625978012521395,959,-542291,-543589.2,0.014342038801840314,-555.735826965786,0.07530971118727021
2023-10-12T01:00:00-04:00,1.06308,1.06336,1.06296,1.0633299999999999,1.0623734138879999,1.0629491111111111,1.0627733333333271,1.0625908888888833,1.0625355000000056,1.0618130000000017,1.061341000000004,1.0603695500000077,1.0628703543465943,1.0626874410017109,967,-541324,-542961.4,0.01983147948253632,-555.5084216905482,0.08847974849160298
2023-10-12T01:15:00-04:00,1.0633299999999999,1.0633299999999999,1.06296,1.06312,1.06249180422144,1.0630184444444444,1.0628544444444383,1.0626748888888833,1.0625780000000056,1.0618608000000018,1.0613677000000041,1.0604001000000076,1.0629202834772755,1.0627651528013682,-957,-542281,-542686.2,0.02302607844589665,-555.6974222830264,0.06871299616902639
2023-10-12T01:30:00-04:00,1.06312,1.06324,1.063,1.06318,1.0625959877148672,1.0630835555555553,1.0629766666666605,1.0627706666666612,1.0626225000000056,1.0619098000000018,1.0613943000000041,1.0604315500000074,1.0629722267818205,1.0628385222410937,1271,-541010,-542031.2,0.02638166521358289,-555.6256900232628,0.10357035251582752
2023-10-12T01:45:00-04:00,1.06318,1.06331,1.06294,1.06313,1.0626876691890832,1.0631142222222223,1.0630588888888826,1.062866444444439,1.0626675000000056,1.0619714000000018,1.0614229000000042,1.0604624500000075,1.0630037814254563,1.0629044177928741,-1369,-542379,-541857,0.03249747485873584,-555.6900723479869,0.06965427008913515
2023-10-12T02:00:00-04:00,1.06313,1.0637,1.06283,1.06345,1.0627683488863933,1.0631924444444445,1.0631233333333272,1.062957333333328,1.0627175000000055,1.0620608000000018,1.0614526000000042,1.0604969500000074,1.063093025140365,1.0629719342342987,2977,-539402,-541279.2,0.03700351304883829,-554.7940013124594,0.05456923236143883
2023-10-12T02:15:00-04:00,1.06345,1.0635999999999999,1.06277,1.06298,1.0637,1.0631637777777776,1.063124444444438,1.0630275555555502,1.0627570000000055,1.0621350000000018,1.0614758000000042,1.0605295500000076,1.063070420112292,1.0630119473874382,-2417,-541819,-541378.2,0.03566286827358821,-555.862213264126,0.0009407603224988017
2023-10-12T02:30:00-04:00,1.06298,1.06396,1.06289,1.06387,1.06277,1.0633128888888888,1.063232222222216,1.0631031111111056,1.0628185000000054,1.0622252000000019,1.0615107000000041,1.0605676500000074,1.0632303360898336,1.0630739579099497,3048,-538771,-540676.2,0.03660108580120129,-553.3102179302532,0.09125976103115414
2023-10-12T02:45:00-04:00,1.06387,1.06388,1.0633,1.06357,1.06277,1.0633804444444444,1.0633011111111048,1.0631679999999946,1.0628735000000056,1.0623026000000018,1.0615449000000041,1.0606048000000075,1.0632982688718668,1.0631391663279592,-2685,-541456,-540765.4,0.03873666327093514,-554.0673593103095,0.05832823745235833
2023-10-12T03:00:00-04:00,1.06357,1.06362,1.06302,1.0631,1.0627938,1.0633402222222221,1.063303333333327,1.0632168888888835,1.0629120000000056,1.0623588000000017,1.0615739000000042,1.0606403500000074,1.0632586150974934,1.0631901330623665,-3376,-544832,-541256,0.037324315642865244,-555.5592404276782,0.001881325958527014
2023-10-12T03:15:00-04:00,1.0631,1.0631,1.06251,1.06253,1.06396,1.0631855555555556,1.063214444444438,1.0632351111111056,1.0629280000000056,1.0623952000000019,1.0615921000000041,1.0606718000000075,1.0631128920779946,1.0631941064498924,-2979,-547811,-542937.8,0.031253402100742074,-557.1564843369999,-0.07523534556533833
2023-10-12T03:30:00-04:00,1.06253,1.06275,1.06235,1.06243,1.063931,1.0630286666666666,1.0631377777777713,1.0632377777777724,1.0629355000000058,1.0624200000000017,1.0616046000000041,1.0607014500000074,1.0629763136623958,1.0631752851599132,-2727,-550538,-544681.6,0.021800108328898664,-557.4131359138966,-0.06490330348409205
2023-10-12T03:45:00-04:00,1.06243,1.06265,1.06199,1.06199,1.06386776,1.0627991111111112,1.063005555555549,1.063192444444439,1.0629155000000057,1.0624318000000017,1.0616141000000041,1.0607306000000074,1.0627790509299166,1.0630850281279298,-2786,-553324,-547592.2,0.01246824696395385,-558.5669436941738,-0.11192836584586094
2023-10-12T04:00:00-04:00,1.06199,1.06245,1.06193,1.06207,1.0637550944,1.0626120000000001,1.0628877777777714,1.0631097777777723,1.0628995000000057,1.0624468000000018,1.0616256000000042,1.0607611000000075,1.0626372407439333,1.062952822502343,2744,-550580,-549417,0.003458722477299216,-558.3602374163368,-0.09970558633467581
2023-10-12T04:15:00-04:00,1.06207,1.06269,1.06203,1.06259,1.0636090868480002,1.0625524444444445,1.0627922222222157,1.0630075555555498,1.0629250000000057,1.0624738000000018,1.0616430000000043,1.0607944000000074,1.0626277925951466,1.0628266580018735,2560,-548020,-550054.6,-0.0025178557184386925,-557.10683603978,-0.08086887018666443
2023-10-12T04:30:00-04:00,1.06259,1.06264,1.0621099999999999,1.06222,1.0634747599001602,1.062438,1.0627077777777711,1.0629062222222165,1.0629165000000056,1.0624824000000017,1.0616435000000042,1.0608269000000075,1.0625462340761174,1.0627133264014978,-1836,-549856,-550463.6,-0.014717267184557388,-557.746141886814,-0.07149711189298895
2023-10-12T04:45:00-04:00,1.06222,1.06265,1.06193,1.06264,1.0633511791081474,1.0624244444444444,1.0625711111111045,1.062792888888883,1.0629050000000055,1.0624962000000018,1.061670200000004,1.0608594000000076,1.062564987260894,1.0626310611211978,2471,-547385,-549833,-0.019035911073388798,-556.7691126461668,-0.11561562972920228
2023-10-12T05:00:00-04:00,1.06264,1.0627199999999999,1.06237,1.06261,1.0632374847794956,1.0624322222222222,1.062464444444438,1.062684666666661,1.0628870000000057,1.062511400000002,1.061700100000004,1.0608916000000075,1.0625739898087152,1.0625900488969573,-2636,-550021,-549172.4,-0.029725756931191866,-556.8435310757384,-0.09026204199064002
2023-10-12T05:15:00-04:00,1.06261,1.06273,1.06206,1.06212,1.063132885997136,1.0623633333333333,1.062355555555549,1.0625782222222164,1.0628480000000056,1.0625152000000018,1.061718100000004,1.0609225500000075,1.0624831918469722,1.0625592391175653,-2336,-552357,-549527.8,-0.039561180042852556,-557.9207277894906,-0.09218323770106114
2023-10-12T05:30:00-04:00,1.06212,1.06234,1.06171,1.06181,1.0630366551173651,1.062254222222222,1.0622755555555488,1.0624748888888829,1.0627910000000056,1.0625126000000018,1.061724700000004,1.0609484500000075,1.0623485534775776,1.0625033912940514,-1857,-554214,-550766.6,-0.046817096103048864,-558.4627286933433,-0.06776279257997929
2023-10-12T05:45:00-04:00,1.06181,1.06199,1.0616,1.06181,1.0629039896056285,1.0621611111111111,1.06220666666666,1.0623746666666605,1.0627275000000056,1.0625134000000018,1.061734300000004,1.0609716500000075,1.062240842782062,1.0624423130352405,0,-554214,-551638.2,-0.04848633120951381,-558.4627286933433,-0.05835678585883917
2023-10-12T06:00:00-04:00,1.06181,1.0622,1.06171,1.06209,1.0627475108529532,1.0621377777777778,1.062217777777771,1.062303999999994,1.0626655000000056,1.062516000000002,1.061749200000004,1.0609911000000074,1.0622106742256496,1.0623714504281914,1807,-552407,-552642.6,-0.047251736820213705,-557.9862215969699,0.009416284522452094
2023-10-12T06:15:00-04:00,1.06209,1.06267,1.06206,1.06211,1.0616,1.0621162222222222,1.0622222222222155,1.0622555555555493,1.0626150000000059,1.062519000000002,1.061760800000004,1.0610073000000073,1.0621905393805198,1.0622947603425523,1989,-550418,-552722,-0.04065798447853525,-557.9487671439572,0.0037662300978315933
2023-10-12T06:30:00-04:00,1.0621099999999999,1.06224,1.06183,1.06202,1.0616214000000002,1.0620757777777778,1.0621588888888822,1.062216222222216,1.0625570000000057,1.062520800000002,1.0617700000000039,1.0610182000000075,1.0621564315044159,1.062229408274041,-1308,-551726,-552595.8,-0.03620096870490385,-558.0596031213985,-0.053642514986961994
2023-10-12T06:45:00-04:00,1.06202,1.0621,1.06167,1.06185,1.0616423720000001,1.062014,1.062117777777771,1.0621846666666606,1.0624930000000057,1.062514400000002,1.061784100000004,1.0610253000000074,1.0620951452035328,1.0621787266192322,-1561,-553287,-552410.4,-0.03720702604140204,-558.3094760051483,-0.034832708855037704
2023-10-12T07:00:00-04:00,1.06185,1.06193,1.06132,1.06162,1.06267,1.0619144444444444,1.0620044444444376,1.0621442222222162,1.0624015000000058,1.0625066000000019,1.061801800000004,1.0610333500000073,1.0620001161628263,1.062130581295385,-1830,-555117,-552591,-0.03608904474253219,-558.7058596751581,-0.0959873522547637
2023-10-12T07:15:00-04:00,1.06162,1.06195,1.0616,1.06192,1.062643,1.0618975555555557,1.061927777777771,1.062086222222216,1.062348500000006,1.062506400000002,1.0618198000000039,1.0610375000000074,1.061984092930261,1.0620852650363073,1668,-553449,-552799.4,-0.036010838213110886,-558.2345045763469,-0.0649344538447859
2023-10-12T07:30:00-04:00,1.06192,1.06201,1.06138,1.06183,1.06261654,1.0618779999999999,1.061895555555549,1.0620208888888825,1.062246500000006,1.062496000000002,1.0618360000000038,1.0610449000000075,1.0619532743442088,1.062037812029045,-2166,-555615,-553838.8,-0.038200172129029215,-558.4180777268666,-0.027303882800427583
2023-10-12T07:45:00-04:00,1.06183,1.06199,1.0616,1.06195,1.0625906092000001,1.0618888888888889,1.0619111111111046,1.0619713333333272,1.062165500000006,1.062486200000002,1.0618537000000037,1.0610537000000075,1.061952619475367,1.0619970496232354,2413,-553202,-554134,-0.031196653229509853,-558.1453787072497,0.013185033103853702
2023-10-12T08:00:00-04:00,1.06195,1.062,1.06158,1.06188,1.0625651970160002,1.0618826666666668,1.0619188888888822,1.061931555555549,1.062104500000006,1.062477000000002,1.0618704000000039,1.0610624000000073,1.0619380955802935,1.0619656396985875,-4031,-557233,-554923.2,-0.022963265499753978,-558.4110880155977,0.006592516551926851
2023-10-12T08:15:00-04:00,1.06188,1.06255,1.06182,1.06249,1.06132,1.0619968888888889,1.0619633333333267,1.061923333333327,1.062102500000006,1.062479800000002,1.0618958000000038,1.0610771000000074,1.0620484764642348,1.0619753117588693,4267,-552966,-554493,-0.013826756656794927,-555.9598976739395,0.03766159176717189
2023-10-12T08:30:00-04:00,1.06248,1.06275,1.05717,1.05831,1.06275,1.0612662222222224,1.0615411111111044,1.0618459999999936,1.061896500000006,1.062400000000002,1.0618778000000038,1.0610697500000077,1.061300781171388,1.0618386494070946,-21421,-574387,-558680.6,-0.030501749747186106,-640.2334249541932,-0.357778384536444
2023-10-12T08:45:00-04:00,1.05831,1.05936,1.05804,1.05818,1.06275,1.0605939999999998,1.0611144444444376,1.0616897777777716,1.061706000000006,1.062318200000002,1.0618557000000037,1.0610646500000076,1.0606766249371102,1.0615833195256748,-11561,-585948,-564747.2,-0.04846136837285775,-641.6535476025686,-0.3615751115798258
2023-10-12T09:00:00-04:00,1.05818,1.05861,1.05708,1.05733,1.06275,1.0598371111111113,1.0606122222222156,1.0614299999999939,1.061469000000006,1.062219000000002,1.0618261000000038,1.0610590500000077,1.0600072999496881,1.061194255620539,-10564,-596512,-573409.2,-0.07174948242453252,-650.1392494680337,-0.42567217591937256
2023-10-12T09:15:00-04:00,1.05733,1.05778,1.05672,1.05724,1.0625232,1.0591626666666667,1.0601255555555487,1.061071333333327,1.061201500000006,1.062119200000002,1.0617960000000037,1.0610556000000075,1.0594538399597504,1.0606974044964301,-8484,-604996,-582961.8,-0.09353145519565277,-650.8614081129234,-0.4125770049546966
2023-10-12T09:30:00-04:00,1.05724,1.05734,1.05538,1.05538,1.062175008,1.0582135555555559,1.0593988888888821,1.0605584444444383,1.060859500000006,1.0619778000000017,1.0617472000000037,1.0610435500000077,1.0586390719678003,1.0600155235971431,-9067,-614063,-595181.2,-0.12001664316925169,-666.8129612134491,-0.6158656019285813
2023-10-12T09:45:00-04:00,1.05538,1.05569,1.05475,1.05495,1.0616314073600002,1.057323777777778,1.0586344444444378,1.0599771111111047,1.060475000000006,1.0618330000000018,1.0616823000000037,1.0610304500000076,1.0579012575742401,1.0593356188777137,-8215,-622278,-604759.4,-0.15313301730287768,-670.1600494660211,-0.6479379938408217
2023-10-12T10:00:00-04:00,1.05495,1.05626,1.0547199999999999,1.05607,1.0609432666240002,1.056810888888889,1.0579811111111046,1.0593504444444384,1.0601480000000059,1.061701600000002,1.0616348000000038,1.0610194000000077,1.0575350060593922,1.0587072951021699,6919,-615359,-610641.6,-0.1779967905601227,-662.8144122320289,-0.5536983850463661
2023-10-12T10:15:00-04:00,1.05607,1.05619,1.05496,1.05526,1.0601964746291201,1.0562666666666667,1.057245555555549,1.058677111111105,1.0598050000000059,1.0615574000000019,1.0615692000000037,1.0610061500000076,1.0570800048475137,1.058121836081735,-5788,-621147,-615568.6,-0.20815231406606924,-667.253777046861,-0.6234226089576834
2023-10-12T10:30:00-04:00,1.05526,1.05575,1.05444,1.05507,1.0595392976736258,1.0558315555555555,1.0564211111111044,1.0579362222222162,1.0594680000000058,1.061412200000002,1.0615056000000036,1.0609880500000077,1.056678003878011,1.057566668865387,-6939,-628086,-620186.6,-0.24080531495612872,-668.5031468704125,-0.6983595139718946
2023-10-12T10:45:00-04:00,1.05507,1.05575,1.055,1.05555,1.0588253959993181,1.0556573333333332,1.0561144444444377,1.0572793333333272,1.059155000000006,1.0612790000000019,1.0614322000000038,1.0609691000000077,1.0564524031024087,1.0571293350923088,6048,-622038,-621781.6,-0.2782479227829017,-665.7516327528656,-0.260793151345078
2023-10-12T11:00:00-04:00,1.05555,1.05582,1.05482,1.0553299999999999,1.0582114405594136,1.0555004444444442,1.0557977777777712,1.056711999999994,1.0588170000000061,1.0611400000000017,1.0613616000000037,1.0609484000000078,1.0562279224819269,1.0567946680738463,-3991,-626029,-622531.8,-0.27733072883259413,-666.5834455518807,-0.26933035967415936